"","unitid","year","totcohortsize","w_cohortsize","m_cohortsize","tot4yrgrads","m_4yrgrads","w_4yrgrads","women_gradrate_4yr","men_gradrate_4yr","tot_gradrate_4yr"
"1",100654,2010,"1073",549,524,69,"18",51,0.0929,0.0344,0.0643
"2",100663,2010,"1537",851,686,463,"176",287,0.3373,0.2566,0.3012
"3",100751,2010,"5443",3006,2437,2387,"856",1531,0.5093,0.3513,0.4385
"4",100858,2010,"4193",2204,1989,1963,"730",1233,0.5594,0.367,0.4682
"5",101435,2010,"271",113,158,71,"30",41,0.3628,0.1899,0.262
"6",101480,2010,"1246",685,561,180,"55",125,0.1825,0.098,0.1445
"7",101675,2010,"343",141,202,44,"18",26,0.1844,0.0891,0.1283
"8",101879,2010,"961",562,399,152,"43",109,0.194,0.1078,0.1582
"9",102049,2010,"711",455,256,417,"132",285,0.6264,0.5156,0.5865
"10",102094,2010,"1707",950,757,262,"83",179,0.1884,0.1096,0.1535
"11",102234,2010,"392",252,140,180,"56",124,0.4921,0.4,0.4592
"12",102368,2010,"1810",1083,727,295,"97",198,0.1828,0.1334,0.163
"13",102377,2010,"701",393,308,228,"99",129,0.3282,0.3214,0.3252
"14",104151,2010,"6210",2997,3213,3071,"1409",1662,0.5546,0.4385,0.4945
"15",104179,2010,"6797",3629,3168,2847,"1137",1710,0.4712,0.3589,0.4189
"16",105330,2010,"3739",2209,1530,1354,"442",912,0.4129,0.2889,0.3621
"17",106245,2010,"683",376,307,80,"40",40,0.1064,0.1303,0.1171
"18",106342,2010,"198",107,91,70,"29",41,0.3832,0.3187,0.3535
"19",106397,2010,"3774",1929,1845,1596,"634",962,0.4987,0.3436,0.4229
"20",106412,2010,"780",393,387,51,"13",38,0.0967,0.0336,0.0654
"21",106458,2010,"1659",897,762,438,"167",271,0.3021,0.2192,0.264
"22",106467,2010,"1681",823,858,259,"105",154,0.1871,0.1224,0.1541
"23",106485,2010,"689",338,351,69,"30",39,0.1154,0.0855,0.1001
"24",106704,2010,"1828",1070,758,445,"155",290,0.271,0.2045,0.2434
"25",107044,2010,"988",506,482,426,"177",249,0.4921,0.3672,0.4312
"26",107080,2010,"403",237,166,259,"96",163,0.6878,0.5783,0.6427
"27",107141,2010,"322",175,147,180,"82",98,0.56,0.5578,0.559
"28",107512,2010,"450",243,207,264,"102",162,0.6667,0.4928,0.5867
"29",107558,2010,"204",114,90,61,"28",33,0.2895,0.3111,0.299
"30",110097,2010,"877",560,317,471,"159",312,0.5571,0.5016,0.5371
"31",110404,2010,"220",87,133,179,"105",74,0.8506,0.7895,0.8136
"32",110422,2010,"3459",1642,1817,1634,"636",998,0.6078,0.35,0.4724
"33",110486,2010,"1013",613,400,148,"50",98,0.1599,0.125,0.1461
"34",110495,2010,"998",670,328,156,"41",115,0.1716,0.125,0.1563
"35",110510,2010,"1747",1114,633,251,"73",178,0.1598,0.1153,0.1437
"36",110529,2010,"1923",835,1088,352,"150",202,0.2419,0.1379,0.183
"37",110538,2010,"1880",1048,832,484,"160",324,0.3092,0.1923,0.2574
"38",110547,2010,"982",633,349,50,"17",33,0.0521,0.0487,0.0509
"39",110556,2010,"2582",1551,1031,420,"116",304,0.196,0.1125,0.1627
"40",110565,2010,"3749",2160,1589,660,"173",487,0.2255,0.1089,0.176
"41",110574,2010,"1192",751,441,168,"47",121,0.1611,0.1066,0.1409
"42",110583,2010,"3913",2310,1603,585,"189",396,0.1714,0.1179,0.1495
"43",110592,2010,"2013",1222,791,127,"48",79,0.0646,0.0607,0.0631
"44",110617,2010,"2625",1548,1077,238,"69",169,0.1092,0.0641,0.0907
"45",113698,2010,"338",255,83,192,"45",147,0.5765,0.5422,0.568
"46",115755,2010,"1282",701,581,188,"65",123,0.1755,0.1119,0.1466
"47",119173,2010,"525",507,18,140,"3",137,0.2702,0.1667,0.2667
"48",120184,2010,"145",94,51,50,"15",35,0.3723,0.2941,0.3448
"49",121309,2010,"588",360,228,367,"130",237,0.6583,0.5702,0.6241
"50",121345,2010,"401",217,184,369,"169",200,0.9217,0.9185,0.9202
"51",122409,2010,"3031",1802,1229,1017,"352",665,0.369,0.2864,0.3355
"52",122436,2010,"1148",662,486,752,"280",472,0.713,0.5761,0.6551
"53",122597,2010,"3609",2179,1430,648,"210",438,0.201,0.1469,0.1796
"54",122612,2010,"1171",750,421,721,"233",488,0.6507,0.5534,0.6157
"55",122931,2010,"1295",644,651,1056,"498",558,0.8665,0.765,0.8154
"56",123554,2010,"694",421,273,387,"139",248,0.5891,0.5092,0.5576
"57",123572,2010,"1547",925,622,430,"106",324,0.3503,0.1704,0.278
"58",126562,2010,"1020",551,469,210,"76",134,0.2432,0.162,0.2059
"59",126580,2010,"1123",568,555,284,"112",172,0.3028,0.2018,0.2529
"60",126614,2010,"5138",2403,2735,2438,"1094",1344,0.5593,0.4,0.4745
"61",126818,2010,"4321",2414,1907,1820,"656",1164,0.4822,0.344,0.4212
"62",127060,2010,"1215",663,552,806,"320",486,0.733,0.5797,0.6634
"63",127185,2010,"830",393,437,203,"74",129,0.3282,0.1693,0.2446
"64",127565,2010,"1876",916,960,112,"43",69,0.0753,0.0448,0.0597
"65",127741,2010,"2221",1420,801,653,"183",470,0.331,0.2285,0.294
"66",128106,2010,"977",467,510,182,"80",102,0.2184,0.1569,0.1863
"67",128744,2010,"594",397,197,122,"41",81,0.204,0.2081,0.2054
"68",128771,2010,"1340",592,748,279,"125",154,0.2601,0.1671,0.2082
"69",129020,2010,"3317",1629,1688,2300,"1076",1224,0.7514,0.6374,0.6934
"70",129242,2010,"921",576,345,722,"250",472,0.8194,0.7246,0.7839
"71",129941,2010,"1005",534,471,452,"198",254,0.4757,0.4204,0.4498
"72",130253,2010,"974",610,364,529,"167",362,0.5934,0.4588,0.5431
"73",130314,2010,"229",229,0,137,"0",137,0.5983,NA,0.5983
"74",130493,2010,"1248",792,456,299,"58",241,0.3043,0.1272,0.2396
"75",130590,2010,"591",300,291,473,"223",250,0.8333,0.7663,0.8003
"76",130697,2010,"748",411,337,652,"292",360,0.8759,0.8665,0.8717
"77",130776,2010,"975",524,451,209,"85",124,0.2366,0.1885,0.2144
"78",130794,2010,"1343",696,647,1161,"547",614,0.8822,0.8454,0.8645
"79",130934,2010,"887",556,331,220,"58",162,0.2914,0.1752,0.248
"80",130943,2010,"3719",2116,1603,2399,"913",1486,0.7023,0.5696,0.6451
"81",131159,2010,"1498",911,587,1145,"438",707,0.7761,0.7462,0.7644
"82",131283,2010,"991",576,415,613,"240",373,0.6476,0.5783,0.6186
"83",131450,2010,"198",107,91,39,"10",29,0.271,0.1099,0.197
"84",131469,2010,"2376",1316,1060,1805,"761",1044,0.7933,0.7179,0.7597
"85",131496,2010,"1569",859,710,1414,"623",791,0.9208,0.8775,0.9012
"86",131520,2010,"1464",1034,430,571,"122",449,0.4342,0.2837,0.39
"87",132471,2010,"625",403,222,98,"32",66,0.1638,0.1441,0.1568
"88",132602,2010,"924",579,345,132,"32",100,0.1727,0.0928,0.1429
"89",132903,2010,"6028",3179,2849,2407,"859",1548,0.4869,0.3015,0.3993
"90",133492,2010,"496",300,196,304,"117",187,0.6233,0.5969,0.6129
"91",133553,2010,"949",120,829,283,"239",44,0.3667,0.2883,0.2982
"92",133650,2010,"2701",1636,1065,331,"94",237,0.1449,0.0883,0.1225
"93",133669,2010,"2616",1359,1257,501,"169",332,0.2443,0.1344,0.1915
"94",133711,2010,"612",347,265,281,"98",183,0.5274,0.3698,0.4592
"95",133881,2010,"489",138,351,220,"142",78,0.5652,0.4046,0.4499
"96",133951,2010,"3752",2079,1673,931,"280",651,0.3131,0.1674,0.2481
"97",134079,2010,"602",357,245,314,"119",195,0.5462,0.4857,0.5216
"98",134097,2010,"5957",3515,2442,3620,"1249",2371,0.6745,0.5115,0.6077
"99",134130,2010,"6345",3661,2684,4275,"1469",2806,0.7665,0.5473,0.6738
"100",134945,2010,"624",313,311,197,"87",110,0.3514,0.2797,0.3157
"101",135726,2010,"2105",1072,1033,1465,"646",819,0.764,0.6254,0.696
"102",136172,2010,"1926",1078,848,504,"137",367,0.3404,0.1616,0.2617
"103",136950,2010,"465",286,179,298,"100",198,0.6923,0.5587,0.6409
"104",137546,2010,"545",331,214,305,"109",196,0.5921,0.5093,0.5596
"105",138354,2010,"1211",661,550,325,"118",207,0.3132,0.2145,0.2684
"106",138716,2010,"883",542,341,47,"13",34,0.0627,0.0381,0.0532
"107",138789,2010,"1161",685,476,141,"41",100,0.146,0.0861,0.1214
"108",139144,2010,"653",431,222,386,"126",260,0.6032,0.5676,0.5911
"109",139366,2010,"1154",718,436,130,"43",87,0.1212,0.0986,0.1127
"110",139393,2010,"269",131,138,160,"66",94,0.7176,0.4783,0.5948
"111",139658,2010,"1321",748,573,1125,"462",663,0.8864,0.8063,0.8516
"112",139719,2010,"840",487,353,69,"26",43,0.0883,0.0737,0.0821
"113",139755,2010,"2706",976,1730,1111,"648",463,0.4744,0.3746,0.4106
"114",139764,2010,"473",284,189,64,"13",51,0.1796,0.0688,0.1353
"115",139861,2010,"1202",767,435,505,"138",367,0.4785,0.3172,0.4201
"116",139931,2010,"3597",1785,1812,950,"305",645,0.3613,0.1683,0.2641
"117",139940,2010,"2853",1540,1313,669,"240",429,0.2786,0.1828,0.2345
"118",139959,2010,"4667",2886,1781,2903,"961",1942,0.6729,0.5396,0.622
"119",140447,2010,"596",301,295,293,"116",177,0.588,0.3932,0.4916
"120",140960,2010,"953",504,449,81,"19",62,0.123,0.0423,0.085
"121",140988,2010,"446",216,230,121,"48",73,0.338,0.2087,0.2713
"122",141185,2010,"153",78,75,54,"16",38,0.4872,0.2133,0.3529
"123",141264,2010,"2528",1554,974,401,"100",301,0.1937,0.1027,0.1586
"124",141334,2010,"1844",1124,720,309,"79",230,0.2046,0.1097,0.1676
"125",141486,2010,"287",203,84,101,"29",72,0.3547,0.3452,0.3519
"126",141565,2010,"392",230,162,43,"13",30,0.1304,0.0802,0.1097
"127",141574,2010,"1776",984,792,439,"164",275,0.2795,0.2071,0.2472
"128",142276,2010,"1432",749,683,121,"34",87,0.1162,0.0498,0.0845
"129",142285,2010,"1709",799,910,511,"226",285,0.3567,0.2484,0.299
"130",142461,2010,"253",151,102,78,"30",48,0.3179,0.2941,0.3083
"131",143084,2010,"753",432,321,532,"206",326,0.7546,0.6417,0.7065
"132",143288,2010,"150",105,45,46,"9",37,0.3524,0.2,0.3067
"133",144005,2010,"523",354,169,14,"2",12,0.0339,0.0118,0.0268
"134",144281,2010,"2209",1252,957,665,"258",407,0.3251,0.2696,0.301
"135",144740,2010,"2235",1307,928,1313,"501",812,0.6213,0.5399,0.5875
"136",144892,2010,"1446",892,554,492,"157",335,0.3756,0.2834,0.3402
"137",144962,2010,"537",330,207,301,"99",202,0.6121,0.4783,0.5605
"138",144971,2010,"174",92,82,70,"30",40,0.4348,0.3659,0.4023
"139",145600,2010,"3185",1731,1454,984,"387",597,0.3449,0.2662,0.3089
"140",145619,2010,"548",311,237,197,"63",134,0.4309,0.2658,0.3595
"141",145637,2010,"6921",3054,3867,4823,"2414",2409,0.7888,0.6243,0.6969
"142",145691,2010,"225",113,112,134,"58",76,0.6726,0.5179,0.5956
"143",145813,2010,"3179",1914,1265,1512,"499",1013,0.5293,0.3945,0.4756
"144",146481,2010,"402",238,164,258,"98",160,0.6723,0.5976,0.6418
"145",146612,2010,"632",319,313,257,"126",131,0.4107,0.4026,0.4066
"146",146719,2010,"2063",1315,748,1342,"444",898,0.6829,0.5936,0.6505
"147",146825,2010,"90",39,51,10,"4",6,0.1538,0.0784,0.1111
"148",147013,2010,"335",154,181,121,"54",67,0.4351,0.2983,0.3612
"149",147244,2010,"498",258,240,244,"101",143,0.5543,0.4208,0.49
"150",147341,2010,"355",187,168,168,"73",95,0.508,0.4345,0.4732
"151",147703,2010,"2663",1338,1325,625,"278",347,0.2593,0.2098,0.2347
"152",147767,2010,"2126",1125,1001,1785,"790",995,0.8844,0.7892,0.8396
"153",147776,2010,"976",551,425,37,"11",26,0.0472,0.0259,0.0379
"154",147828,2010,"740",417,323,344,"128",216,0.518,0.3963,0.4649
"155",148131,2010,"272",136,136,94,"44",50,0.3676,0.3235,0.3456
"156",148496,2010,"427",287,140,212,"60",152,0.5296,0.4286,0.4965
"157",148584,2010,"210",131,79,93,"29",64,0.4885,0.3671,0.4429
"158",148627,2010,"488",308,180,153,"41",112,0.3636,0.2278,0.3135
"159",149222,2010,"2314",1104,1210,602,"283",319,0.2889,0.2339,0.2602
"160",149231,2010,"2022",1104,918,520,"196",324,0.2935,0.2135,0.2572
"161",149772,2010,"1741",886,855,534,"265",269,0.3036,0.3099,0.3067
"162",149781,2010,"602",312,290,495,"226",269,0.8622,0.7793,0.8223
"163",150066,2010,"469",264,205,230,"79",151,0.572,0.3854,0.4904
"164",150136,2010,"3849",2123,1726,1588,"560",1028,0.4842,0.3244,0.4126
"165",150145,2010,"269",169,100,144,"51",93,0.5503,0.51,0.5353
"166",150163,2010,"1049",616,433,600,"211",389,0.6315,0.4873,0.572
"167",150400,2010,"608",345,263,474,"202",272,0.7884,0.7681,0.7796
"168",150534,2010,"683",403,280,398,"136",262,0.6501,0.4857,0.5827
"169",150668,2010,"179",106,73,100,"39",61,0.5755,0.5342,0.5587
"170",150941,2010,"263",146,117,144,"62",82,0.5616,0.5299,0.5475
"171",151102,2010,"2117",1078,1039,134,"47",87,0.0807,0.0452,0.0633
"172",151111,2010,"2679",1607,1072,478,"176",302,0.1879,0.1642,0.1784
"173",151306,2010,"2041",1179,862,378,"115",263,0.2231,0.1334,0.1852
"174",151324,2010,"2687",1352,1335,497,"199",298,0.2204,0.1491,0.185
"175",151333,2010,"345",217,128,59,"23",36,0.1659,0.1797,0.171
"176",151342,2010,"895",503,392,61,"25",36,0.0716,0.0638,0.0682
"177",151351,2010,"6977",3659,3318,4165,"1805",2360,0.645,0.544,0.597
"178",151360,2010,"784",495,289,47,"13",34,0.0687,0.045,0.0599
"179",151379,2010,"945",581,364,111,"29",82,0.1411,0.0797,0.1175
"180",151388,2010,"378",224,154,54,"15",39,0.1741,0.0974,0.1429
"181",151777,2010,"405",217,188,200,"81",119,0.5484,0.4309,0.4938
"182",151786,2010,"317",166,151,124,"49",75,0.4518,0.3245,0.3912
"183",152080,2010,"2056",966,1090,1846,"966",880,0.911,0.8862,0.8979
"184",152248,2010,"965",484,481,101,"48",53,0.1095,0.0998,0.1047
"185",152363,2010,"257",120,137,111,"43",68,0.5667,0.3139,0.4319
"186",152530,2010,"467",270,197,308,"112",196,0.7259,0.5685,0.6595
"187",152600,2010,"691",360,331,376,"148",228,0.6333,0.4471,0.5441
"188",153001,2010,"265",139,126,117,"43",74,0.5324,0.3413,0.4415
"189",153108,2010,"402",212,190,235,"99",136,0.6415,0.5211,0.5846
"190",153269,2010,"864",474,390,513,"218",295,0.6224,0.559,0.5938
"191",153384,2010,"415",231,184,336,"140",196,0.8485,0.7609,0.8096
"192",153603,2010,"4518",2077,2441,2006,"847",1159,0.558,0.347,0.444
"193",153834,2010,"611",342,269,438,"177",261,0.7632,0.658,0.7169
"194",154095,2010,"1934",1214,720,759,"229",530,0.4366,0.3181,0.3925
"195",155089,2010,"199",90,109,42,"17",25,0.2778,0.156,0.2111
"196",155317,2010,"3489",1743,1746,1435,"603",832,0.4773,0.3454,0.4113
"197",155335,2010,"196",118,78,69,"23",46,0.3898,0.2949,0.352
"198",155399,2010,"3465",1753,1712,1068,"416",652,0.3719,0.243,0.3082
"199",155520,2010,"232",120,112,100,"36",64,0.5333,0.3214,0.431
"200",155627,2010,"156",66,90,37,"12",25,0.3788,0.1333,0.2372
"201",155937,2010,"149",70,79,50,"21",29,0.4143,0.2658,0.3356
"202",156213,2010,"285",187,98,149,"51",98,0.5241,0.5204,0.5228
"203",156286,2010,"573",362,211,301,"107",194,0.5359,0.5071,0.5253
"204",156295,2010,"429",230,199,204,"72",132,0.5739,0.3618,0.4755
"205",156365,2010,"502",247,255,122,"46",76,0.3077,0.1804,0.243
"206",156541,2010,"446",202,244,144,"66",78,0.3861,0.2705,0.3229
"207",156745,2010,"336",191,145,172,"57",115,0.6021,0.3931,0.5119
"208",157058,2010,"569",316,253,25,"8",17,0.0538,0.0316,0.0439
"209",157076,2010,"202",96,106,64,"26",38,0.3958,0.2453,0.3168
"210",157085,2010,"4270",2203,2067,1625,"615",1010,0.4585,0.2975,0.3806
"211",157289,2010,"2507",1266,1241,696,"308",388,0.3065,0.2482,0.2776
"212",157386,2010,"1175",662,513,294,"118",176,0.2659,0.23,0.2502
"213",157401,2010,"1363",830,533,344,"104",240,0.2892,0.1951,0.2524
"214",157447,2010,"2230",1238,992,321,"116",205,0.1656,0.1169,0.1439
"215",157535,2010,"393",154,239,56,"22",34,0.2208,0.0921,0.1425
"216",157951,2010,"3279",1865,1414,747,"228",519,0.2783,0.1612,0.2278
"217",158477,2010,"192",104,88,81,"29",52,0.5,0.3295,0.4219
"218",159009,2010,"706",384,322,183,"63",120,0.3125,0.1957,0.2592
"219",159391,2010,"5477",2904,2573,2145,"777",1368,0.4711,0.302,0.3916
"220",159647,2010,"1530",679,851,504,"220",284,0.4183,0.2585,0.3294
"221",159717,2010,"1259",756,503,261,"84",177,0.2341,0.167,0.2073
"222",159966,2010,"1048",652,396,201,"63",138,0.2117,0.1591,0.1918
"223",160038,2010,"1056",678,378,213,"60",153,0.2257,0.1587,0.2017
"224",160612,2010,"2414",1408,1006,408,"133",275,0.1953,0.1322,0.169
"225",160621,2010,"852",488,364,60,"18",42,0.0861,0.0495,0.0704
"226",160658,2010,"2914",1629,1285,465,"141",324,0.1989,0.1097,0.1596
"227",161004,2010,"507",249,258,453,"230",223,0.8956,0.8915,0.8935
"228",161226,2010,"555",352,203,242,"68",174,0.4943,0.335,0.436
"229",161235,2010,"153",94,59,27,"6",21,0.2234,0.1017,0.1765
"230",161244,2010,"105",61,44,18,"6",12,0.1967,0.1364,0.1714
"231",161253,2010,"1713",828,885,622,"283",339,0.4094,0.3198,0.3631
"232",161554,2010,"763",394,369,104,"43",61,0.1548,0.1165,0.1363
"233",162007,2010,"608",353,255,73,"17",56,0.1586,0.0667,0.1201
"234",162210,2010,"123",83,40,21,"2",19,0.2289,0.05,0.1707
"235",162283,2010,"511",357,154,29,"7",22,0.0616,0.0455,0.0568
"236",162584,2010,"1028",472,556,223,"93",130,0.2754,0.1673,0.2169
"237",162654,2010,"388",259,129,185,"50",135,0.5212,0.3876,0.4768
"238",162760,2010,"327",210,117,165,"52",113,0.5381,0.4444,0.5046
"239",162928,2010,"1322",646,676,1150,"577",573,0.887,0.8536,0.8699
"240",163046,2010,"1019",630,389,818,"311",507,0.8048,0.7995,0.8027
"241",163268,2010,"1484",599,885,558,"275",283,0.4725,0.3107,0.376
"242",163286,2010,"3930",1856,2074,2700,"1314",1386,0.7468,0.6336,0.687
"243",163453,2010,"1208",663,545,115,"32",83,0.1252,0.0587,0.0952
"244",163462,2010,"424",241,183,275,"101",174,0.722,0.5519,0.6486
"245",163851,2010,"1248",770,478,595,"176",419,0.5442,0.3682,0.4768
"246",163912,2010,"443",277,166,289,"96",193,0.6968,0.5783,0.6524
"247",164076,2010,"2427",1593,834,1125,"310",815,0.5116,0.3717,0.4635
"248",164173,2010,"877",535,342,331,"98",233,0.4355,0.2865,0.3774
"249",164216,2010,"421",238,183,293,"109",184,0.7731,0.5956,0.696
"250",164270,2010,"408",213,195,250,"93",157,0.7371,0.4769,0.6127
"251",164447,2010,"367",168,199,107,"47",60,0.3571,0.2362,0.2916
"252",164492,2010,"287",140,147,95,"43",52,0.3714,0.2925,0.331
"253",164562,2010,"590",369,221,423,"141",282,0.7642,0.638,0.7169
"254",165015,2010,"686",370,316,569,"247",322,0.8703,0.7816,0.8294
"255",165024,2010,"1431",812,619,458,"174",284,0.3498,0.2811,0.3201
"256",165334,2010,"575",328,247,411,"172",239,0.7287,0.6964,0.7148
"257",165662,2010,"824",529,295,634,"219",415,0.7845,0.7424,0.7694
"258",165671,2010,"528",386,142,318,"81",237,0.614,0.5704,0.6023
"259",165820,2010,"721",413,308,246,"86",160,0.3874,0.2792,0.3412
"260",165866,2010,"719",481,238,245,"59",186,0.3867,0.2479,0.3408
"261",165936,2010,"348",212,136,212,"80",132,0.6226,0.5882,0.6092
"262",166027,2010,"1663",827,836,1434,"708",726,0.8779,0.8469,0.8623
"263",166124,2010,"727",379,348,645,"298",347,0.9156,0.8563,0.8872
"264",166513,2010,"1601",575,1026,514,"272",242,0.4209,0.2651,0.321
"265",166629,2010,"4543",2296,2247,2986,"1336",1650,0.7186,0.5946,0.6573
"266",166638,2010,"1067",595,472,194,"55",139,0.2336,0.1165,0.1818
"267",166683,2010,"1063",479,584,898,"478",420,0.8768,0.8185,0.8448
"268",167288,2010,"351",225,126,133,"41",92,0.4089,0.3254,0.3789
"269",167987,2010,"1667",765,902,471,"208",263,0.3438,0.2306,0.2825
"270",167996,2010,"727",469,258,556,"180",376,0.8017,0.6977,0.7648
"271",168005,2010,"1307",739,568,582,"221",361,0.4885,0.3891,0.4453
"272",168148,2010,"1313",649,664,1138,"560",578,0.8906,0.8434,0.8667
"273",168254,2010,"736",303,433,373,"213",160,0.5281,0.4919,0.5068
"274",168281,2010,"450",306,144,342,"103",239,0.781,0.7153,0.76
"275",168342,2010,"548",288,260,471,"215",256,0.8889,0.8269,0.8595
"276",168546,2010,"383",196,187,235,"102",133,0.6786,0.5455,0.6136
"277",168786,2010,"428",255,173,140,"53",87,0.3412,0.3064,0.3271
"278",169080,2010,"929",469,460,573,"250",323,0.6887,0.5435,0.6168
"279",169798,2010,"1955",1152,803,254,"75",179,0.1554,0.0934,0.1299
"280",169910,2010,"1960",976,984,143,"59",84,0.0861,0.06,0.073
"281",170082,2010,"3414",2084,1330,1165,"413",752,0.3608,0.3105,0.3412
"282",170301,2010,"765",455,310,524,"185",339,0.7451,0.5968,0.685
"283",170532,2010,"341",192,149,250,"106",144,0.75,0.7114,0.7331
"284",170639,2010,"501",229,272,91,"54",37,0.1616,0.1985,0.1816
"285",170976,2010,"6443",3217,3226,4929,"2317",2612,0.8119,0.7182,0.765
"286",171100,2010,"7221",3821,3400,3685,"1516",2169,0.5677,0.4459,0.5103
"287",171128,2010,"1110",273,837,308,"202",106,0.3883,0.2413,0.2775
"288",171137,2010,"883",429,454,149,"51",98,0.2284,0.1123,0.1687
"289",171146,2010,"724",398,326,94,"34",60,0.1508,0.1043,0.1298
"290",171599,2010,"229",93,136,80,"35",45,0.4839,0.2574,0.3493
"291",172051,2010,"1729",1013,716,196,"51",145,0.1431,0.0712,0.1134
"292",172699,2010,"3346",1734,1612,721,"259",462,0.2664,0.1607,0.2155
"293",173160,2010,"604",366,238,408,"146",262,0.7158,0.6134,0.6755
"294",173258,2010,"511",268,243,451,"209",242,0.903,0.8601,0.8826
"295",173328,2010,"217",126,91,81,"19",62,0.4921,0.2088,0.3733
"296",173647,2010,"585",314,271,454,"208",246,0.7834,0.7675,0.7761
"297",173902,2010,"515",314,201,434,"158",276,0.879,0.7861,0.8427
"298",174066,2010,"5310",2810,2500,3251,"1428",1823,0.6488,0.5712,0.6122
"299",174233,2010,"2316",1112,1204,819,"356",463,0.4164,0.2957,0.3536
"300",174251,2010,"418",242,176,211,"81",130,0.5372,0.4602,0.5048
"301",174491,2010,"451",247,204,219,"89",130,0.5263,0.4363,0.4856
"302",174792,2010,"503",0,503,360,"360",0,NA,0.7157,0.7157
"303",174844,2010,"844",434,410,719,"332",387,0.8917,0.8098,0.8519
"304",174899,2010,"575",358,217,328,"100",228,0.6369,0.4608,0.5704
"305",174914,2010,"1518",762,756,941,"396",545,0.7152,0.5238,0.6199
"306",175342,2010,"588",341,247,94,"25",69,0.2023,0.1012,0.1599
"307",175421,2010,"234",126,108,65,"17",48,0.381,0.1574,0.2778
"308",175616,2010,"370",208,162,61,"25",36,0.1731,0.1543,0.1649
"309",175856,2010,"879",489,390,169,"52",117,0.2393,0.1333,0.1923
"310",175980,2010,"211",106,105,145,"69",76,0.717,0.6571,0.6872
"311",176017,2010,"3065",1580,1485,1135,"440",695,0.4399,0.2963,0.3703
"312",176035,2010,"199",154,45,50,"7",43,0.2792,0.1556,0.2513
"313",176044,2010,"382",192,190,68,"25",43,0.224,0.1316,0.178
"314",176080,2010,"2688",1308,1380,847,"348",499,0.3815,0.2522,0.3151
"315",176406,2010,"198",126,72,50,"10",40,0.3175,0.1389,0.2525
"316",176628,2010,"166",94,72,46,"11",35,0.3723,0.1528,0.2771
"317",176947,2010,"314",147,167,109,"33",76,0.517,0.1976,0.3471
"318",176965,2010,"1546",862,684,496,"176",320,0.3712,0.2573,0.3208
"319",177418,2010,"151",77,74,53,"21",32,0.4156,0.2838,0.351
"320",178059,2010,"338",242,96,192,"49",143,0.5909,0.5104,0.568
"321",178341,2010,"844",439,405,88,"35",53,0.1207,0.0864,0.1043
"322",178387,2010,"1083",559,524,145,"55",90,0.161,0.105,0.1339
"323",178396,2010,"5996",3175,2821,2641,"963",1678,0.5285,0.3414,0.4405
"324",178402,2010,"1109",673,436,246,"92",154,0.2288,0.211,0.2218
"325",178411,2010,"1138",250,888,246,"166",80,0.32,0.1869,0.2162
"326",178420,2010,"479",282,197,141,"51",90,0.3191,0.2589,0.2944
"327",178615,2010,"1416",881,535,800,"260",540,0.6129,0.486,0.565
"328",179043,2010,"370",232,138,228,"79",149,0.6422,0.5725,0.6162
"329",179159,2010,"1724",1004,720,1063,"381",682,0.6793,0.5292,0.6166
"330",179557,2010,"1813",1097,716,526,"165",361,0.3291,0.2304,0.2901
"331",179566,2010,"2645",1574,1071,796,"266",530,0.3367,0.2484,0.3009
"332",179867,2010,"1619",776,843,1430,"716",714,0.9201,0.8493,0.8833
"333",179894,2010,"413",238,175,187,"67",120,0.5042,0.3829,0.4528
"334",179946,2010,"315",139,176,175,"75",100,0.7194,0.4261,0.5556
"335",180179,2010,"829",434,395,44,"11",33,0.076,0.0278,0.0531
"336",180461,2010,"2115",877,1238,502,"219",283,0.3227,0.1769,0.2374
"337",180522,2010,"226",78,148,16,"10",6,0.0769,0.0676,0.0708
"338",180984,2010,"276",139,137,138,"57",81,0.5827,0.4161,0.5
"339",181002,2010,"1010",606,404,676,"248",428,0.7063,0.6139,0.6693
"340",181020,2010,"327",179,148,163,"52",111,0.6201,0.3514,0.4985
"341",181127,2010,"312",150,162,144,"66",78,0.52,0.4074,0.4615
"342",181215,2010,"1124",656,468,305,"96",209,0.3186,0.2051,0.2714
"343",181394,2010,"1703",925,778,14,"8",6,0.0065,0.0103,0.0082
"344",181446,2010,"427",237,190,256,"106",150,0.6329,0.5579,0.5995
"345",181464,2010,"4039",1889,2150,1461,"647",814,0.4309,0.3009,0.3617
"346",181534,2010,"243",117,126,32,"6",26,0.2222,0.0476,0.1317
"347",181783,2010,"677",366,311,172,"58",114,0.3115,0.1865,0.2541
"348",182281,2010,"2923",1621,1302,341,"117",224,0.1382,0.0899,0.1167
"349",182290,2010,"2693",1430,1263,610,"233",377,0.2636,0.1845,0.2265
"350",182634,2010,"393",266,127,185,"51",134,0.5038,0.4016,0.4707
"351",182795,2010,"399",179,220,142,"50",92,0.514,0.2273,0.3559
"352",183062,2010,"1201",718,483,643,"252",391,0.5446,0.5217,0.5354
"353",183080,2010,"1056",520,536,456,"186",270,0.5192,0.347,0.4318
"354",183239,2010,"535",295,240,369,"142",227,0.7695,0.5917,0.6897
"355",183822,2010,"379",225,154,44,"22",22,0.0978,0.1429,0.1161
"356",183974,2010,"252",144,108,115,"35",80,0.5556,0.3241,0.4563
"357",184348,2010,"494",311,183,280,"96",184,0.5916,0.5246,0.5668
"358",184603,2010,"694",400,294,133,"48",85,0.2125,0.1633,0.1916
"359",184612,2010,"324",236,88,66,"21",45,0.1907,0.2386,0.2037
"360",184782,2010,"1485",715,770,713,"320",393,0.5497,0.4156,0.4801
"361",185129,2010,"681",380,301,45,"21",24,0.0632,0.0698,0.0661
"362",185572,2010,"962",579,383,532,"196",336,0.5803,0.5117,0.553
"363",185590,2010,"2169",1248,921,850,"304",546,0.4375,0.3301,0.3919
"364",185828,2010,"828",187,641,209,"141",68,0.3636,0.22,0.2524
"365",186131,2010,"1311",649,662,1169,"572",597,0.9199,0.864,0.8917
"366",186201,2010,"893",522,371,547,"188",359,0.6877,0.5067,0.6125
"367",186283,2010,"1007",601,406,585,"227",358,0.5957,0.5591,0.5809
"368",186584,2010,"1302",728,574,708,"288",420,0.5769,0.5017,0.5438
"369",186876,2010,"858",518,340,433,"137",296,0.5714,0.4029,0.5047
"370",187134,2010,"1421",800,621,1065,"443",622,0.7775,0.7134,0.7495
"371",187444,2010,"1509",774,735,443,"160",283,0.3656,0.2177,0.2936
"372",187985,2010,"3488",1951,1537,574,"204",370,0.1896,0.1327,0.1646
"373",188030,2010,"2255",1181,1074,381,"151",230,0.1948,0.1406,0.169
"374",188429,2010,"909",634,275,521,"133",388,0.612,0.4836,0.5732
"375",188641,2010,"526",240,286,225,"91",134,0.5583,0.3182,0.4278
"376",190044,2010,"712",182,530,399,"279",120,0.6593,0.5264,0.5604
"377",190099,2010,"849",466,383,721,"312",409,0.8777,0.8146,0.8492
"378",190150,2010,"1392",676,716,1188,"595",593,0.8772,0.831,0.8534
"379",190248,2010,"138",76,62,62,"22",40,0.5263,0.3548,0.4493
"380",190415,2010,"3172",1579,1593,2763,"1325",1438,0.9107,0.8318,0.8711
"381",190512,2010,"1255",527,728,483,"242",241,0.4573,0.3324,0.3849
"382",190549,2010,"1143",661,482,284,"95",189,0.2859,0.1971,0.2485
"383",190558,2010,"2237",1184,1053,146,"52",94,0.0794,0.0494,0.0653
"384",190567,2010,"1368",685,683,171,"58",113,0.165,0.0849,0.125
"385",190594,2010,"1740",1141,599,413,"100",313,0.2743,0.1669,0.2374
"386",190637,2010,"619",386,233,116,"33",83,0.215,0.1416,0.1874
"387",190664,2010,"1471",821,650,452,"133",319,0.3886,0.2046,0.3073
"388",190691,2010,"1085",652,433,71,"16",55,0.0844,0.037,0.0654
"389",190725,2010,"441",325,116,148,"36",112,0.3446,0.3103,0.3356
"390",191241,2010,"1865",1021,844,1388,"607",781,0.7649,0.7192,0.7442
"391",191515,2010,"467",252,215,414,"185",229,0.9087,0.8605,0.8865
"392",191533,2010,"487",270,217,241,"104",137,0.5074,0.4793,0.4949
"393",191630,2010,"618",339,279,448,"182",266,0.7847,0.6523,0.7249
"394",191649,2010,"1435",819,616,764,"289",475,0.58,0.4692,0.5324
"395",191676,2010,"253",178,75,154,"46",108,0.6067,0.6133,0.6087
"396",191931,2010,"871",504,367,525,"202",323,0.6409,0.5504,0.6028
"397",191968,2010,"1614",869,745,1071,"442",629,0.7238,0.5933,0.6636
"398",192192,2010,"270",196,74,141,"32",109,0.5561,0.4324,0.5222
"399",192323,2010,"615",372,243,355,"130",225,0.6048,0.535,0.5772
"400",192439,2010,"883",618,265,58,"13",45,0.0728,0.0491,0.0657
"401",192703,2010,"658",300,358,375,"190",185,0.6167,0.5307,0.5699
"402",192749,2010,"428",274,154,181,"57",124,0.4526,0.3701,0.4229
"403",192819,2010,"1088",612,476,814,"331",483,0.7892,0.6954,0.7482
"404",192925,2010,"377",234,143,112,"46",66,0.2821,0.3217,0.2971
"405",193016,2010,"1086",708,378,212,"45",167,0.2359,0.119,0.1952
"406",193292,2010,"387",257,130,180,"59",121,0.4708,0.4538,0.4651
"407",193353,2010,"443",301,142,187,"60",127,0.4219,0.4225,0.4221
"408",193399,2010,"377",249,128,147,"41",106,0.4257,0.3203,0.3899
"409",193584,2010,"467",353,114,273,"60",213,0.6034,0.5263,0.5846
"410",193645,2010,"635",566,69,140,"10",130,0.2297,0.1449,0.2205
"411",193654,2010,"1166",859,307,603,"139",464,0.5402,0.4528,0.5172
"412",193900,2010,"5434",3100,2334,3417,"1477",1940,0.6258,0.6328,0.6288
"413",193973,2010,"668",377,291,397,"163",234,0.6207,0.5601,0.5943
"414",194161,2010,"314",181,133,67,"28",39,0.2155,0.2105,0.2134
"415",194310,2010,"1766",1089,677,696,"240",456,0.4187,0.3545,0.3941
"416",194824,2010,"1152",322,830,703,"494",209,0.6491,0.5952,0.6102
"417",195003,2010,"2583",820,1763,699,"346",353,0.4305,0.1963,0.2706
"418",195030,2010,"1305",641,664,120,"69",51,0.0796,0.1039,0.092
"419",195164,2010,"494",242,252,257,"116",141,0.5826,0.4603,0.5202
"420",195173,2010,"559",289,270,151,"65",86,0.2976,0.2407,0.2701
"421",195216,2010,"609",316,293,492,"227",265,0.8386,0.7747,0.8079
"422",195234,2010,"639",432,207,313,"83",230,0.5324,0.401,0.4898
"423",195243,2010,"290",173,117,123,"40",83,0.4798,0.3419,0.4241
"424",195304,2010,"338",238,100,249,"68",181,0.7605,0.68,0.7367
"425",195474,2010,"768",410,358,539,"228",311,0.7585,0.6369,0.7018
"426",195526,2010,"768",485,283,653,"225",428,0.8825,0.7951,0.8503
"427",195544,2010,"697",498,199,403,"102",301,0.6044,0.5126,0.5782
"428",195809,2010,"3105",1626,1479,1117,"500",617,0.3795,0.3381,0.3597
"429",196413,2010,"3452",1929,1523,2379,"962",1417,0.7346,0.6316,0.6892
"430",196592,2010,"1030",668,362,152,"21",131,0.1961,0.058,0.1476
"431",197045,2010,"564",281,283,190,"83",107,0.3808,0.2933,0.3369
"432",197133,2010,"665",382,283,576,"242",334,0.8743,0.8551,0.8662
"433",197869,2010,"2816",1538,1278,1387,"500",887,0.5767,0.3912,0.4925
"434",197984,2010,"307",139,168,103,"53",50,0.3597,0.3155,0.3355
"435",198385,2010,"499",246,253,452,"223",229,0.9309,0.8814,0.9058
"436",198464,2010,"4196",2446,1750,1417,"448",969,0.3962,0.256,0.3377
"437",198507,2010,"573",319,254,94,"31",63,0.1975,0.122,0.164
"438",198516,2010,"1359",794,565,1041,"386",655,0.8249,0.6832,0.766
"439",198835,2010,"423",229,194,149,"53",96,0.4192,0.2732,0.3522
"440",198969,2010,"531",190,341,104,"46",58,0.3053,0.1349,0.1959
"441",199102,2010,"2040",1065,975,374,"108",266,0.2498,0.1108,0.1833
"442",199111,2010,"590",335,255,231,"87",144,0.4299,0.3412,0.3915
"443",199120,2010,"3944",2371,1573,3299,"1235",2064,0.8705,0.7851,0.8365
"444",199139,2010,"2947",1513,1434,840,"312",528,0.349,0.2176,0.285
"445",199148,2010,"2505",1722,783,762,"162",600,0.3484,0.2069,0.3042
"446",199157,2010,"1218",809,409,238,"56",182,0.225,0.1369,0.1954
"447",199193,2010,"4685",2098,2587,2187,"962",1225,0.5839,0.3719,0.4668
"448",199218,2010,"1985",1236,749,1044,"320",724,0.5858,0.4272,0.5259
"449",199281,2010,"1036",582,454,209,"74",135,0.232,0.163,0.2017
"450",199306,2010,"199",88,111,67,"31",36,0.4091,0.2793,0.3367
"451",199412,2010,"349",252,97,162,"38",124,0.4921,0.3918,0.4642
"452",199582,2010,"440",196,244,78,"25",53,0.2704,0.1025,0.1773
"453",199643,2010,"679",360,319,54,"23",31,0.0861,0.0721,0.0795
"454",199847,2010,"1217",639,578,1019,"462",557,0.8717,0.7993,0.8373
"455",199962,2010,"605",336,269,267,"95",172,0.5119,0.3532,0.4413
"456",199999,2010,"690",465,225,139,"25",114,0.2452,0.1111,0.2014
"457",200004,2010,"1415",746,669,520,"196",324,0.4343,0.293,0.3675
"458",200059,2010,"307",146,161,33,"14",19,0.1301,0.087,0.1075
"459",200156,2010,"202",98,104,72,"27",45,0.4592,0.2596,0.3564
"460",200217,2010,"362",203,159,138,"38",100,0.4926,0.239,0.3812
"461",200226,2010,"130",54,76,17,"10",7,0.1296,0.1316,0.1308
"462",200253,2010,"461",298,163,83,"10",73,0.245,0.0613,0.18
"463",200280,2010,"2073",978,1095,527,"237",290,0.2965,0.2164,0.2542
"464",200332,2010,"2373",1074,1299,635,"297",338,0.3147,0.2286,0.2676
"465",200572,2010,"217",95,122,45,"22",23,0.2421,0.1803,0.2074
"466",201104,2010,"688",407,281,345,"115",230,0.5651,0.4093,0.5015
"467",201371,2010,"219",91,128,96,"45",51,0.5604,0.3516,0.4384
"468",201548,2010,"715",409,306,381,"167",214,0.5232,0.5458,0.5329
"469",201645,2010,"1019",415,604,655,"356",299,0.7205,0.5894,0.6428
"470",201690,2010,"503",231,272,49,"18",31,0.1342,0.0662,0.0974
"471",202134,2010,"1148",615,533,237,"105",132,0.2146,0.197,0.2064
"472",202480,2010,"2029",995,1034,1187,"506",681,0.6844,0.4894,0.585
"473",202523,2010,"623",349,274,482,"199",283,0.8109,0.7263,0.7737
"474",202763,2010,"659",461,198,338,"95",243,0.5271,0.4798,0.5129
"475",203085,2010,"334",158,176,137,"57",80,0.5063,0.3239,0.4102
"476",203128,2010,"295",157,138,160,"65",95,0.6051,0.471,0.5424
"477",203368,2010,"703",380,323,460,"189",271,0.7132,0.5851,0.6543
"478",203517,2010,"3887",2325,1562,1243,"396",847,0.3643,0.2535,0.3198
"479",203535,2010,"483",265,218,429,"191",238,0.8981,0.8761,0.8882
"480",203580,2010,"256",123,133,78,"28",50,0.4065,0.2105,0.3047
"481",203775,2010,"375",196,179,167,"68",99,0.5051,0.3799,0.4453
"482",203845,2010,"387",191,196,199,"85",114,0.5969,0.4337,0.5142
"483",204024,2010,"3574",1944,1630,2368,"969",1399,0.7197,0.5945,0.6626
"484",204185,2010,"630",261,369,333,"151",182,0.6973,0.4092,0.5286
"485",204194,2010,"388",240,148,217,"83",134,0.5583,0.5608,0.5593
"486",204617,2010,"272",146,126,78,"30",48,0.3288,0.2381,0.2868
"487",204796,2010,"6651",3319,3332,3907,"1657",2250,0.6779,0.4973,0.5874
"488",204857,2010,"3949",2129,1820,1799,"689",1110,0.5214,0.3786,0.4556
"489",206330,2010,"145",68,77,36,"17",19,0.2794,0.2208,0.2483
"490",206589,2010,"617",332,285,436,"180",256,0.7711,0.6316,0.7066
"491",206604,2010,"2739",1586,1153,527,"197",330,0.2081,0.1709,0.1924
"492",206622,2010,"1042",554,488,641,"298",343,0.6191,0.6107,0.6152
"493",206695,2010,"2633",1330,1303,250,"122",128,0.0962,0.0936,0.0949
"494",206914,2010,"892",520,372,43,"21",22,0.0423,0.0565,0.0482
"495",207209,2010,"469",226,243,11,"2",9,0.0398,0.0082,0.0235
"496",207306,2010,"382",182,200,51,"16",35,0.1923,0.08,0.1335
"497",207324,2010,"497",247,250,166,"77",89,0.3603,0.308,0.334
"498",207388,2010,"3403",1761,1642,1320,"497",823,0.4673,0.3027,0.3879
"499",207500,2010,"3669",1945,1724,1455,"549",906,0.4658,0.3184,0.3966
"500",207722,2010,"199",129,70,54,"13",41,0.3178,0.1857,0.2714
"501",207847,2010,"651",344,307,55,"20",35,0.1017,0.0651,0.0845
"502",207865,2010,"977",529,448,123,"44",79,0.1493,0.0982,0.1259
"503",208822,2010,"488",287,201,275,"119",156,0.5436,0.592,0.5635
"504",209056,2010,"491",306,185,364,"125",239,0.781,0.6757,0.7413
"505",209065,2010,"528",310,218,302,"117",185,0.5968,0.5367,0.572
"506",209542,2010,"3480",1677,1803,1145,"447",698,0.4162,0.2479,0.329
"507",209551,2010,"3911",2065,1846,1953,"790",1163,0.5632,0.428,0.4994
"508",209612,2010,"474",231,243,229,"109",120,0.5195,0.4486,0.4831
"509",209807,2010,"1366",733,633,288,"123",165,0.2251,0.1943,0.2108
"510",209922,2010,"373",212,161,247,"105",142,0.6698,0.6522,0.6622
"511",210146,2010,"735",435,300,176,"55",121,0.2782,0.1833,0.2395
"512",210401,2010,"427",235,192,301,"119",182,0.7745,0.6198,0.7049
"513",210429,2010,"1039",636,403,204,"45",159,0.25,0.1117,0.1963
"514",210571,2010,"485",255,230,230,"90",140,0.549,0.3913,0.4742
"515",210669,2010,"594",332,262,415,"173",242,0.7289,0.6603,0.6987
"516",210775,2010,"388",268,120,142,"39",103,0.3843,0.325,0.366
"517",211088,2010,"552",397,155,317,"75",242,0.6096,0.4839,0.5743
"518",211158,2010,"2136",1263,873,808,"251",557,0.441,0.2875,0.3783
"519",211291,2010,"929",491,438,782,"355",427,0.8697,0.8105,0.8418
"520",211352,2010,"339",222,117,174,"47",127,0.5721,0.4017,0.5133
"521",211361,2010,"1351",711,640,332,"136",196,0.2757,0.2125,0.2457
"522",211431,2010,"189",181,8,76,"1",75,0.4144,0.125,0.4021
"523",211440,2010,"1484",619,865,1119,"630",489,0.79,0.7283,0.754
"524",211468,2010,"91",90,1,36,"0",36,0.4,0,0.3956
"525",211556,2010,"150",150,0,72,"0",72,0.48,NA,0.48
"526",211583,2010,"219",125,94,82,"31",51,0.408,0.3298,0.3744
"527",211608,2010,"471",258,213,25,"5",20,0.0775,0.0235,0.0531
"528",211644,2010,"1309",811,498,430,"127",303,0.3736,0.255,0.3285
"529",211981,2010,"490",297,193,238,"66",172,0.5791,0.342,0.4857
"530",212009,2010,"657",355,302,535,"240",295,0.831,0.7947,0.8143
"531",212054,2010,"2696",1200,1496,735,"275",460,0.3833,0.1838,0.2726
"532",212106,2010,"1411",821,590,834,"318",516,0.6285,0.539,0.5911
"533",212115,2010,"1144",658,486,422,"137",285,0.4331,0.2819,0.3689
"534",212133,2010,"449",302,147,195,"67",128,0.4238,0.4558,0.4343
"535",212160,2010,"1551",927,624,340,"103",237,0.2557,0.1651,0.2192
"536",212197,2010,"491",303,188,339,"104",235,0.7756,0.5532,0.6904
"537",212577,2010,"629",345,284,525,"227",298,0.8638,0.7993,0.8347
"538",212601,2010,"617",362,255,276,"100",176,0.4862,0.3922,0.4473
"539",212832,2010,"284",190,94,38,"13",25,0.1316,0.1383,0.1338
"540",212911,2010,"325",166,159,281,"138",143,0.8614,0.8679,0.8646
"541",213020,2010,"2984",1751,1233,1087,"333",754,0.4306,0.2701,0.3643
"542",213251,2010,"421",227,194,303,"130",173,0.7621,0.6701,0.7197
"543",213321,2010,"528",240,288,310,"150",160,0.6667,0.5208,0.5871
"544",213349,2010,"2009",1175,834,677,"217",460,0.3915,0.2602,0.337
"545",213358,2010,"269",151,118,93,"48",45,0.298,0.4068,0.3457
"546",213367,2010,"982",605,377,524,"182",342,0.5653,0.4828,0.5336
"547",213385,2010,"648",294,354,553,"279",274,0.932,0.7881,0.8534
"548",213507,2010,"460",245,215,331,"152",179,0.7306,0.707,0.7196
"549",213543,2010,"1208",516,692,932,"495",437,0.8469,0.7153,0.7715
"550",213613,2010,"1185",630,555,361,"158",203,0.3222,0.2847,0.3046
"551",213668,2010,"346",211,135,205,"67",138,0.654,0.4963,0.5925
"552",213783,2010,"631",346,285,162,"70",92,0.2659,0.2456,0.2567
"553",213826,2010,"452",338,114,241,"44",197,0.5828,0.386,0.5332
"554",213996,2010,"721",433,288,523,"210",313,0.7229,0.7292,0.7254
"555",214041,2010,"1315",728,587,494,"193",301,0.4135,0.3288,0.3757
"556",214069,2010,"375",265,110,255,"62",193,0.7283,0.5636,0.68
"557",214157,2010,"373",216,157,245,"96",149,0.6898,0.6115,0.6568
"558",214175,2010,"603",341,262,485,"199",286,0.8387,0.7595,0.8043
"559",214272,2010,"547",350,197,166,"48",118,0.3371,0.2437,0.3035
"560",214777,2010,"7321",3542,3779,4942,"2239",2703,0.7631,0.5925,0.675
"561",215062,2010,"2363",1213,1150,1999,"917",1082,0.892,0.7974,0.846
"562",215743,2010,"429",258,171,243,"82",161,0.624,0.4795,0.5664
"563",215798,2010,"422",202,220,261,"113",148,0.7327,0.5136,0.6185
"564",215929,2010,"950",508,442,688,"291",397,0.7815,0.6584,0.7242
"565",216010,2010,"1706",888,818,693,"275",418,0.4707,0.3362,0.4062
"566",216038,2010,"1562",969,593,808,"265",543,0.5604,0.4469,0.5173
"567",216287,2010,"387",195,192,339,"169",170,0.8718,0.8802,0.876
"568",216339,2010,"4305",2273,2032,1920,"783",1137,0.5002,0.3853,0.446
"569",216524,2010,"441",236,205,323,"144",179,0.7585,0.7024,0.7324
"570",216694,2010,"401",229,172,213,"77",136,0.5939,0.4477,0.5312
"571",216764,2010,"2060",1295,765,946,"263",683,0.5274,0.3438,0.4592
"572",216807,2010,"402",248,154,274,"99",175,0.7056,0.6429,0.6816
"573",216852,2010,"718",371,347,298,"116",182,0.4906,0.3343,0.415
"574",216931,2010,"499",249,250,240,"106",134,0.5382,0.424,0.481
"575",217059,2010,"1231",657,574,481,"182",299,0.4551,0.3171,0.3907
"576",217156,2010,"1495",784,711,1251,"599",652,0.8316,0.8425,0.8368
"577",217402,2010,"1102",633,469,888,"383",505,0.7978,0.8166,0.8058
"578",217536,2010,"592",423,169,380,"96",284,0.6714,0.568,0.6419
"579",217776,2010,"153",80,73,77,"40",37,0.4625,0.5479,0.5033
"580",217819,2010,"2001",1329,672,1162,"325",837,0.6298,0.4836,0.5807
"581",217882,2010,"2977",1498,1479,1755,"707",1048,0.6996,0.478,0.5895
"582",217998,2010,"144",81,63,85,"34",51,0.6296,0.5397,0.5903
"583",218061,2010,"737",479,258,130,"40",90,0.1879,0.155,0.1764
"584",218229,2010,"685",476,209,195,"44",151,0.3172,0.2105,0.2847
"585",218238,2010,"275",129,146,52,"19",33,0.2558,0.1301,0.1891
"586",218399,2010,"319",173,146,19,"6",13,0.0751,0.0411,0.0596
"587",218414,2010,"288",110,178,82,"41",41,0.3727,0.2303,0.2847
"588",218663,2010,"4421",2431,1990,2400,"911",1489,0.6125,0.4578,0.5429
"589",218724,2010,"1996",1087,909,530,"181",349,0.3211,0.1991,0.2655
"590",218733,2010,"816",414,402,156,"58",98,0.2367,0.1443,0.1912
"591",218742,2010,"838",559,279,200,"54",146,0.2612,0.1935,0.2387
"592",218973,2010,"429",202,227,334,"173",161,0.797,0.7621,0.7786
"593",219000,2010,"418",276,142,226,"55",171,0.6196,0.3873,0.5407
"594",219046,2010,"648",386,262,105,"30",75,0.1943,0.1145,0.162
"595",219082,2010,"314",113,201,62,"43",19,0.1681,0.2139,0.1975
"596",219198,2010,"120",64,56,48,"17",31,0.4844,0.3036,0.4
"597",219259,2010,"380",208,172,84,"25",59,0.2837,0.1453,0.2211
"598",219356,2010,"2157",1051,1106,613,"270",343,0.3264,0.2441,0.2842
"599",219471,2010,"1034",622,412,313,"114",199,0.3199,0.2767,0.3027
"600",219602,2010,"1478",903,575,252,"88",164,0.1816,0.153,0.1705
"601",219709,2010,"1013",581,432,597,"247",350,0.6024,0.5718,0.5893
"602",219718,2010,"377",133,244,51,"27",24,0.1805,0.1107,0.1353
"603",219949,2010,"163",67,96,56,"29",27,0.403,0.3021,0.3436
"604",220075,2010,"2052",1165,887,406,"147",259,0.2223,0.1657,0.1979
"605",220215,2010,"370",214,156,164,"62",102,0.4766,0.3974,0.4432
"606",220613,2010,"851",494,357,288,"93",195,0.3947,0.2605,0.3384
"607",220631,2010,"352",232,120,115,"46",69,0.2974,0.3833,0.3267
"608",220710,2010,"277",126,151,129,"53",76,0.6032,0.351,0.4657
"609",221351,2010,"500",307,193,382,"139",243,0.7915,0.7202,0.764
"610",221519,2010,"401",216,185,317,"138",179,0.8287,0.7459,0.7905
"611",221731,2010,"218",142,76,70,"20",50,0.3521,0.2632,0.3211
"612",221847,2010,"1898",846,1052,468,"177",291,0.344,0.1683,0.2466
"613",221892,2010,"234",142,92,92,"33",59,0.4155,0.3587,0.3932
"614",222178,2010,"977",526,451,465,"194",271,0.5152,0.4302,0.4759
"615",222983,2010,"318",173,145,220,"90",130,0.7514,0.6207,0.6918
"616",223232,2010,"3254",1913,1341,1897,"668",1229,0.6424,0.4981,0.583
"617",224004,2010,"235",157,78,54,"11",43,0.2739,0.141,0.2298
"618",224323,2010,"375",207,168,223,"89",134,0.6473,0.5298,0.5947
"619",225432,2010,"824",453,371,11,"3",8,0.0177,0.0081,0.0133
"620",225548,2010,"318",149,169,88,"32",56,0.3758,0.1893,0.2767
"621",225627,2010,"871",571,300,257,"70",187,0.3275,0.2333,0.2951
"622",226231,2010,"425",169,256,152,"85",67,0.3964,0.332,0.3576
"623",226833,2010,"742",380,362,141,"39",102,0.2684,0.1077,0.19
"624",227216,2010,"3534",1908,1626,1009,"345",664,0.348,0.2122,0.2855
"625",227331,2010,"299",219,80,77,"18",59,0.2694,0.225,0.2575
"626",227526,2010,"1731",1046,685,154,"43",111,0.1061,0.0628,0.089
"627",227757,2010,"944",453,491,783,"376",407,0.8985,0.7658,0.8294
"628",227845,2010,"770",505,265,403,"122",281,0.5564,0.4604,0.5234
"629",227863,2010,"191",127,64,63,"14",49,0.3858,0.2188,0.3298
"630",228042,2010,"253",150,103,106,"40",66,0.44,0.3883,0.419
"631",228149,2010,"585",358,227,249,"85",164,0.4581,0.3744,0.4256
"632",228246,2010,"1476",786,690,1008,"429",579,0.7366,0.6217,0.6829
"633",228343,2010,"383",224,159,252,"98",154,0.6875,0.6164,0.658
"634",228431,2010,"2280",1473,807,556,"128",428,0.2906,0.1586,0.2439
"635",228459,2010,"4033",2403,1630,1091,"306",785,0.3267,0.1877,0.2705
"636",228501,2010,"322",146,176,42,"17",25,0.1712,0.0966,0.1304
"637",228529,2010,"1435",858,577,339,"98",241,0.2809,0.1698,0.2362
"638",228705,2010,"1287",539,748,196,"70",126,0.2338,0.0936,0.1523
"639",228723,2010,"8033",3862,4171,4175,"1709",2466,0.6385,0.4097,0.5197
"640",228769,2010,"2585",1319,1266,549,"228",321,0.2434,0.1801,0.2124
"641",228778,2010,"7232",3869,3363,3986,"1608",2378,0.6146,0.4781,0.5512
"642",228787,2010,"1346",544,802,680,"362",318,0.5846,0.4514,0.5052
"643",228796,2010,"2450",1262,1188,363,"134",229,0.1815,0.1128,0.1482
"644",228875,2010,"1824",1104,720,1141,"397",744,0.6739,0.5514,0.6255
"645",228981,2010,"338",159,179,102,"39",63,0.3962,0.2179,0.3018
"646",229018,2010,"341",180,161,71,"29",42,0.2333,0.1801,0.2082
"647",229027,2010,"4811",2243,2568,610,"248",362,0.1614,0.0966,0.1268
"648",229115,2010,"4759",2290,2469,1623,"645",978,0.4271,0.2612,0.341
"649",229780,2010,"242",112,130,25,"10",15,0.1339,0.0769,0.1033
"650",229814,2010,"1227",637,590,336,"102",234,0.3673,0.1729,0.2738
"651",230603,2010,"1103",768,335,232,"43",189,0.2461,0.1284,0.2103
"652",230728,2010,"2941",1882,1059,548,"113",435,0.2311,0.1067,0.1863
"653",230764,2010,"2269",1217,1052,663,"237",426,0.35,0.2253,0.2922
"654",230782,2010,"2041",1193,848,196,"64",132,0.1106,0.0755,0.096
"655",231059,2010,"546",294,252,401,"168",233,0.7925,0.6667,0.7344
"656",231174,2010,"2452",1425,1027,1523,"576",947,0.6646,0.5609,0.6211
"657",231420,2010,"264",98,166,89,"36",53,0.5408,0.2169,0.3371
"658",231554,2010,"112",58,54,28,"8",20,0.3448,0.1481,0.25
"659",231624,2010,"1396",791,605,1180,"483",697,0.8812,0.7983,0.8453
"660",231712,2010,"1150",673,477,723,"250",473,0.7028,0.5241,0.6287
"661",232025,2010,"248",124,124,84,"34",50,0.4032,0.2742,0.3387
"662",232043,2010,"206",122,84,96,"32",64,0.5246,0.381,0.466
"663",232089,2010,"565",243,322,106,"49",57,0.2346,0.1522,0.1876
"664",232186,2010,"2577",1324,1253,1198,"462",736,0.5559,0.3687,0.4649
"665",232265,2010,"978",605,373,351,"87",264,0.4364,0.2332,0.3589
"666",232423,2010,"3995",2482,1513,2599,"838",1761,0.7095,0.5539,0.6506
"667",232557,2010,"3438",1874,1564,1005,"410",595,0.3175,0.2621,0.2923
"668",232566,2010,"970",667,303,454,"93",361,0.5412,0.3069,0.468
"669",232609,2010,"571",328,243,275,"89",186,0.5671,0.3663,0.4816
"670",232681,2010,"950",612,338,586,"179",407,0.665,0.5296,0.6168
"671",232706,2010,"415",295,120,151,"36",115,0.3898,0.3,0.3639
"672",232937,2010,"902",528,374,185,"67",118,0.2235,0.1791,0.2051
"673",232982,2010,"2579",1280,1299,666,"252",414,0.3234,0.194,0.2582
"674",233277,2010,"1836",1068,768,783,"259",524,0.4906,0.3372,0.4265
"675",233374,2010,"816",452,364,685,"286",399,0.8827,0.7857,0.8395
"676",233426,2010,"564",323,241,321,"115",206,0.6378,0.4772,0.5691
"677",233541,2010,"414",228,186,164,"57",107,0.4693,0.3065,0.3961
"678",233897,2010,"399",197,202,92,"33",59,0.2995,0.1634,0.2306
"679",233921,2010,"5193",2158,3035,3130,"1587",1543,0.715,0.5229,0.6027
"680",234030,2010,"3533",2086,1447,1256,"445",811,0.3888,0.3075,0.3555
"681",234085,2010,"440",51,389,64,"27",37,0.7255,0.0694,0.1455
"682",234155,2010,"1282",802,480,307,"64",243,0.303,0.1333,0.2395
"683",234164,2010,"460",260,200,76,"26",50,0.1923,0.13,0.1652
"684",235097,2010,"1524",887,637,324,"109",215,0.2424,0.1711,0.2126
"685",235167,2010,"612",332,280,265,"118",147,0.4428,0.4214,0.433
"686",236230,2010,"687",415,272,398,"141",257,0.6193,0.5184,0.5793
"687",236328,2010,"625",355,270,436,"168",268,0.7549,0.6222,0.6976
"688",236577,2010,"726",501,225,405,"120",285,0.5689,0.5333,0.5579
"689",236595,2010,"1037",660,377,667,"232",435,0.6591,0.6154,0.6432
"690",236896,2010,"305",151,154,72,"35",37,0.245,0.2273,0.2361
"691",236939,2010,"3241",1634,1607,1327,"525",802,0.4908,0.3267,0.4094
"692",236948,2010,"5460",2917,2543,3525,"1504",2021,0.6928,0.5914,0.6456
"693",237011,2010,"2722",1614,1108,1077,"345",732,0.4535,0.3114,0.3957
"694",237057,2010,"415",237,178,345,"141",204,0.8608,0.7921,0.8313
"695",237066,2010,"683",403,280,430,"161",269,0.6675,0.575,0.6296
"696",237215,2010,"289",181,108,22,"13",9,0.0497,0.1204,0.0761
"697",237330,2010,"568",288,280,105,"37",68,0.2361,0.1321,0.1849
"698",237358,2010,"253",149,104,64,"29",35,0.2349,0.2788,0.253
"699",237367,2010,"766",393,373,103,"49",54,0.1374,0.1314,0.1345
"700",237792,2010,"759",436,323,191,"59",132,0.3028,0.1827,0.2516
"701",237899,2010,"270",128,142,26,"9",17,0.1328,0.0634,0.0963
"702",237932,2010,"526",285,241,103,"31",72,0.2526,0.1286,0.1958
"703",237969,2010,"371",196,175,141,"43",98,0.5,0.2457,0.3801
"704",238032,2010,"5006",2290,2716,1619,"755",864,0.3773,0.278,0.3234
"705",238333,2010,"333",191,142,212,"89",123,0.644,0.6268,0.6366
"706",238430,2010,"213",128,85,37,"14",23,0.1797,0.1647,0.1737
"707",238458,2010,"751",502,249,386,"115",271,0.5398,0.4618,0.514
"708",238476,2010,"730",384,346,398,"164",234,0.6094,0.474,0.5452
"709",238616,2010,"537",317,220,198,"71",127,0.4006,0.3227,0.3687
"710",238661,2010,"324",243,81,130,"36",94,0.3868,0.4444,0.4012
"711",239080,2010,"309",219,90,92,"12",80,0.3653,0.1333,0.2977
"712",239105,2010,"1929",1015,914,1161,"504",657,0.6473,0.5514,0.6019
"713",239628,2010,"289",162,127,167,"66",101,0.6235,0.5197,0.5779
"714",239716,2010,"603",367,236,408,"144",264,0.7193,0.6102,0.6766
"715",240107,2010,"340",242,98,103,"21",82,0.3388,0.2143,0.3029
"716",240189,2010,"2033",973,1060,590,"267",323,0.332,0.2519,0.2902
"717",240277,2010,"894",572,322,214,"46",168,0.2937,0.1429,0.2394
"718",240329,2010,"1836",1093,743,660,"209",451,0.4126,0.2813,0.3595
"719",240338,2010,"246",136,110,108,"32",76,0.5588,0.2909,0.439
"720",240365,2010,"1817",1039,778,328,"116",212,0.204,0.1491,0.1805
"721",240374,2010,"711",355,356,40,"14",26,0.0732,0.0393,0.0563
"722",240417,2010,"1571",756,815,324,"124",200,0.2646,0.1521,0.2062
"723",240426,2010,"369",197,172,80,"27",53,0.269,0.157,0.2168
"724",240444,2010,"5920",3108,2812,3337,"1328",2009,0.6464,0.4723,0.5637
"725",240453,2010,"3731",1876,1855,506,"225",281,0.1498,0.1213,0.1356
"726",240462,2010,"1534",508,1026,297,"170",127,0.25,0.1657,0.1936
"727",240471,2010,"1230",758,472,360,"112",248,0.3272,0.2373,0.2927
"728",240480,2010,"1644",881,763,499,"213",286,0.3246,0.2792,0.3035
"729",240727,2010,"1451",711,740,386,"144",242,0.3404,0.1946,0.266
"730",243443,2010,"933",541,392,63,"19",44,0.0813,0.0485,0.0675
"731",243780,2010,"6454",2706,3748,3133,"1579",1554,0.5743,0.4213,0.4854
"732",100654,2009,"1042",537,505,115,"22",93,0.1732,0.0436,0.1104
"733",100663,2009,"1494",819,675,474,"188",286,0.3492,0.2785,0.3173
"734",100751,2009,"5062",2746,2316,2093,"772",1321,0.4811,0.3333,0.4135
"735",100858,2009,"3911",2007,1904,1733,"617",1116,0.5561,0.3241,0.4431
"736",101435,2009,"237",99,138,58,"30",28,0.2828,0.2174,0.2447
"737",101480,2009,"1220",695,525,137,"30",107,0.154,0.0571,0.1123
"738",101675,2009,"392",179,213,21,"4",17,0.095,0.0188,0.0536
"739",101879,2009,"1064",597,467,122,"33",89,0.1491,0.0707,0.1147
"740",102049,2009,"730",486,244,430,"132",298,0.6132,0.541,0.589
"741",102094,2009,"1753",927,826,244,"83",161,0.1737,0.1005,0.1392
"742",102234,2009,"355",203,152,152,"55",97,0.4778,0.3618,0.4282
"743",102368,2009,"1997",1192,805,265,"78",187,0.1569,0.0969,0.1327
"744",102377,2009,"688",410,278,123,"25",98,0.239,0.0899,0.1788
"745",104151,2009,"6747",3279,3468,3054,"1335",1719,0.5242,0.3849,0.4526
"746",104179,2009,"6782",3697,3085,2922,"1146",1776,0.4804,0.3715,0.4308
"747",105330,2009,"3377",1951,1426,1122,"354",768,0.3936,0.2482,0.3322
"748",106245,2009,"674",387,287,74,"27",47,0.1214,0.0941,0.1098
"749",106342,2009,"216",114,102,75,"39",36,0.3158,0.3824,0.3472
"750",106397,2009,"2890",1448,1442,1129,"466",663,0.4579,0.3232,0.3907
"751",106412,2009,"959",523,436,67,"16",51,0.0975,0.0367,0.0699
"752",106458,2009,"1645",874,771,349,"154",195,0.2231,0.1997,0.2122
"753",106467,2009,"1744",882,862,375,"139",236,0.2676,0.1613,0.215
"754",106485,2009,"740",373,367,63,"16",47,0.126,0.0436,0.0851
"755",106704,2009,"1753",1023,730,403,"136",267,0.261,0.1863,0.2299
"756",107044,2009,"950",530,420,430,"143",287,0.5415,0.3405,0.4526
"757",107080,2009,"412",245,167,265,"107",158,0.6449,0.6407,0.6432
"758",107141,2009,"305",170,135,167,"62",105,0.6176,0.4593,0.5475
"759",107512,2009,"389",198,191,208,"84",124,0.6263,0.4398,0.5347
"760",107558,2009,"152",72,80,39,"12",27,0.375,0.15,0.2566
"761",110097,2009,"775",508,267,402,"131",271,0.5335,0.4906,0.5187
"762",110404,2009,"251",106,145,212,"122",90,0.8491,0.8414,0.8446
"763",110422,2009,"3877",1803,2074,1557,"593",964,0.5347,0.2859,0.4016
"764",110486,2009,"1061",652,409,139,"39",100,0.1534,0.0954,0.131
"765",110495,2009,"798",555,243,124,"37",87,0.1568,0.1523,0.1554
"766",110510,2009,"1968",1275,693,265,"75",190,0.149,0.1082,0.1347
"767",110529,2009,"2728",1192,1536,401,"134",267,0.224,0.0872,0.147
"768",110538,2009,"2468",1338,1130,561,"159",402,0.3004,0.1407,0.2273
"769",110547,2009,"1069",703,366,66,"13",53,0.0754,0.0355,0.0617
"770",110556,2009,"2619",1574,1045,407,"123",284,0.1804,0.1177,0.1554
"771",110565,2009,"3842",2233,1609,666,"180",486,0.2176,0.1119,0.1733
"772",110574,2009,"1436",884,552,184,"54",130,0.1471,0.0978,0.1281
"773",110583,2009,"3473",2133,1340,551,"172",379,0.1777,0.1284,0.1587
"774",110592,2009,"1877",1173,704,127,"40",87,0.0742,0.0568,0.0677
"775",110617,2009,"2954",1712,1242,196,"50",146,0.0853,0.0403,0.0664
"776",113698,2009,"289",207,82,152,"25",127,0.6135,0.3049,0.526
"777",115755,2009,"1345",745,600,214,"57",157,0.2107,0.095,0.1591
"778",119173,2009,"367",351,16,109,"5",104,0.2963,0.3125,0.297
"779",120184,2009,"116",78,38,33,"10",23,0.2949,0.2632,0.2845
"780",121309,2009,"533",343,190,338,"113",225,0.656,0.5947,0.6341
"781",121345,2009,"389",190,199,355,"180",175,0.9211,0.9045,0.9126
"782",122409,2009,"3291",1881,1410,990,"332",658,0.3498,0.2355,0.3008
"783",122436,2009,"1081",621,460,714,"259",455,0.7327,0.563,0.6605
"784",122597,2009,"3855",2497,1358,704,"178",526,0.2107,0.1311,0.1826
"785",122612,2009,"1073",744,329,648,"172",476,0.6398,0.5228,0.6039
"786",122931,2009,"1084",571,513,830,"371",459,0.8039,0.7232,0.7657
"787",123554,2009,"567",354,213,320,"101",219,0.6186,0.4742,0.5644
"788",123572,2009,"1465",953,512,413,"94",319,0.3347,0.1836,0.2819
"789",126562,2009,"1037",556,481,172,"64",108,0.1942,0.1331,0.1659
"790",126580,2009,"1035",543,492,247,"98",149,0.2744,0.1992,0.2386
"791",126614,2009,"5515",2719,2796,2598,"1102",1496,0.5502,0.3941,0.4711
"792",126818,2009,"4274",2360,1914,1732,"593",1139,0.4826,0.3098,0.4052
"793",127060,2009,"1196",684,512,797,"314",483,0.7061,0.6133,0.6664
"794",127185,2009,"766",344,422,138,"64",74,0.2151,0.1517,0.1802
"795",127565,2009,"1959",985,974,115,"46",69,0.0701,0.0472,0.0587
"796",127741,2009,"2275",1360,915,605,"165",440,0.3235,0.1803,0.2659
"797",128106,2009,"1013",513,500,178,"67",111,0.2164,0.134,0.1757
"798",128744,2009,"429",260,169,108,"37",71,0.2731,0.2189,0.2517
"799",128771,2009,"1277",621,656,321,"128",193,0.3108,0.1951,0.2514
"800",129020,2009,"3206",1652,1554,2216,"986",1230,0.7446,0.6345,0.6912
"801",129242,2009,"848",479,369,664,"270",394,0.8225,0.7317,0.783
"802",129941,2009,"1252",639,613,553,"247",306,0.4789,0.4029,0.4417
"803",130253,2009,"907",542,365,526,"180",346,0.6384,0.4932,0.5799
"804",130314,2009,"184",184,0,82,"0",82,0.4457,NA,0.4457
"805",130493,2009,"1237",792,445,280,"65",215,0.2715,0.1461,0.2264
"806",130590,2009,"573",272,301,464,"232",232,0.8529,0.7708,0.8098
"807",130697,2009,"744",389,355,681,"322",359,0.9229,0.907,0.9153
"808",130776,2009,"1008",549,459,255,"99",156,0.2842,0.2157,0.253
"809",130794,2009,"1305",651,654,1145,"553",592,0.9094,0.8456,0.8774
"810",130934,2009,"739",463,276,165,"42",123,0.2657,0.1522,0.2233
"811",130943,2009,"4211",2424,1787,2486,"929",1557,0.6423,0.5199,0.5904
"812",131159,2009,"1527",917,610,1164,"449",715,0.7797,0.7361,0.7623
"813",131283,2009,"813",456,357,501,"184",317,0.6952,0.5154,0.6162
"814",131450,2009,"211",112,99,51,"13",38,0.3393,0.1313,0.2417
"815",131469,2009,"2582",1435,1147,1940,"825",1115,0.777,0.7193,0.7514
"816",131496,2009,"1550",861,689,1389,"601",788,0.9152,0.8723,0.8961
"817",131520,2009,"1600",1097,503,633,"144",489,0.4458,0.2863,0.3956
"818",132471,2009,"648",433,215,102,"25",77,0.1778,0.1163,0.1574
"819",132602,2009,"917",551,366,233,"76",157,0.2849,0.2077,0.2541
"820",132903,2009,"6251",3342,2909,2529,"868",1661,0.497,0.2984,0.4046
"821",133492,2009,"504",300,204,301,"122",179,0.5967,0.598,0.5972
"822",133553,2009,"853",134,719,265,"203",62,0.4627,0.2823,0.3107
"823",133650,2009,"2348",1421,927,267,"88",179,0.126,0.0949,0.1137
"824",133669,2009,"2447",1314,1133,487,"156",331,0.2519,0.1377,0.199
"825",133711,2009,"564",337,227,281,"94",187,0.5549,0.4141,0.4982
"826",133881,2009,"538",145,393,222,"144",78,0.5379,0.3664,0.4126
"827",133951,2009,"2946",1615,1331,828,"278",550,0.3406,0.2089,0.2811
"828",134079,2009,"557",319,238,257,"91",166,0.5204,0.3824,0.4614
"829",134097,2009,"5925",3476,2449,3650,"1245",2405,0.6919,0.5084,0.616
"830",134130,2009,"6253",3728,2525,4149,"1367",2782,0.7462,0.5414,0.6635
"831",134945,2009,"665",337,328,187,"78",109,0.3234,0.2378,0.2812
"832",135726,2009,"1903",924,979,1297,"599",698,0.7554,0.6118,0.6816
"833",136172,2009,"2025",1129,896,536,"155",381,0.3375,0.173,0.2647
"834",136950,2009,"464",287,177,299,"103",196,0.6829,0.5819,0.6444
"835",137546,2009,"502",273,229,287,"124",163,0.5971,0.5415,0.5717
"836",138354,2009,"1154",643,511,313,"91",222,0.3453,0.1781,0.2712
"837",138716,2009,"745",468,277,66,"15",51,0.109,0.0542,0.0886
"838",138789,2009,"1063",611,452,110,"20",90,0.1473,0.0442,0.1035
"839",139144,2009,"569",402,167,315,"85",230,0.5721,0.509,0.5536
"840",139366,2009,"1231",734,497,138,"43",95,0.1294,0.0865,0.1121
"841",139393,2009,"277",158,119,139,"48",91,0.5759,0.4034,0.5018
"842",139658,2009,"1287",712,575,1067,"448",619,0.8694,0.7791,0.8291
"843",139719,2009,"984",550,434,118,"26",92,0.1673,0.0599,0.1199
"844",139755,2009,"2654",887,1767,1064,"638",426,0.4803,0.3611,0.4009
"845",139764,2009,"435",251,184,49,"16",33,0.1315,0.087,0.1126
"846",139861,2009,"1206",741,465,476,"138",338,0.4561,0.2968,0.3947
"847",139931,2009,"3490",1683,1807,854,"292",562,0.3339,0.1616,0.2447
"848",139940,2009,"2937",1745,1192,702,"233",469,0.2688,0.1955,0.239
"849",139959,2009,"4675",2862,1813,2881,"951",1930,0.6744,0.5245,0.6163
"850",140447,2009,"628",349,279,294,"108",186,0.533,0.3871,0.4682
"851",140960,2009,"866",448,418,68,"18",50,0.1116,0.0431,0.0785
"852",140988,2009,"333",175,158,105,"32",73,0.4171,0.2025,0.3153
"853",141185,2009,"168",109,59,59,"21",38,0.3486,0.3559,0.3512
"854",141264,2009,"2416",1421,995,365,"85",280,0.197,0.0854,0.1511
"855",141334,2009,"1911",1095,816,298,"81",217,0.1982,0.0993,0.1559
"856",141486,2009,"262",164,98,73,"25",48,0.2927,0.2551,0.2786
"857",141565,2009,"460",269,191,54,"17",37,0.1375,0.089,0.1174
"858",141574,2009,"1847",984,863,392,"155",237,0.2409,0.1796,0.2122
"859",142276,2009,"1189",599,590,122,"47",75,0.1252,0.0797,0.1026
"860",142285,2009,"1754",841,913,512,"180",332,0.3948,0.1972,0.2919
"861",142461,2009,"263",151,112,95,"33",62,0.4106,0.2946,0.3612
"862",143084,2009,"616",342,274,434,"168",266,0.7778,0.6131,0.7045
"863",143288,2009,"146",93,53,46,"18",28,0.3011,0.3396,0.3151
"864",144005,2009,"589",428,161,13,"6",7,0.0164,0.0373,0.0221
"865",144281,2009,"2089",1170,919,616,"241",375,0.3205,0.2622,0.2949
"866",144740,2009,"2523",1494,1029,1425,"538",887,0.5937,0.5228,0.5648
"867",144892,2009,"1637",997,640,520,"178",342,0.343,0.2781,0.3177
"868",144962,2009,"584",341,243,317,"106",211,0.6188,0.4362,0.5428
"869",144971,2009,"143",75,68,55,"23",32,0.4267,0.3382,0.3846
"870",145600,2009,"3126",1680,1446,1056,"411",645,0.3839,0.2842,0.3378
"871",145619,2009,"451",215,236,156,"68",88,0.4093,0.2881,0.3459
"872",145637,2009,"6974",3332,3642,4938,"2317",2621,0.7866,0.6362,0.7081
"873",145691,2009,"224",99,125,139,"71",68,0.6869,0.568,0.6205
"874",145813,2009,"3060",1816,1244,1462,"500",962,0.5297,0.4019,0.4778
"875",146481,2009,"354",213,141,232,"81",151,0.7089,0.5745,0.6554
"876",146612,2009,"653",360,293,288,"114",174,0.4833,0.3891,0.441
"877",146719,2009,"2076",1358,718,1323,"434",889,0.6546,0.6045,0.6373
"878",146825,2009,"96",34,62,19,"6",13,0.3824,0.0968,0.1979
"879",147013,2009,"305",148,157,102,"44",58,0.3919,0.2803,0.3344
"880",147244,2009,"541",317,224,259,"97",162,0.511,0.433,0.4787
"881",147341,2009,"378",187,191,183,"79",104,0.5561,0.4136,0.4841
"882",147703,2009,"2988",1573,1415,754,"310",444,0.2823,0.2191,0.2523
"883",147767,2009,"2128",1076,1052,1754,"826",928,0.8625,0.7852,0.8242
"884",147776,2009,"996",545,451,50,"20",30,0.055,0.0443,0.0502
"885",147828,2009,"771",447,324,395,"134",261,0.5839,0.4136,0.5123
"886",148131,2009,"248",127,121,81,"31",50,0.3937,0.2562,0.3266
"887",148496,2009,"405",279,126,193,"51",142,0.509,0.4048,0.4765
"888",148584,2009,"223",144,79,92,"26",66,0.4583,0.3291,0.4126
"889",148627,2009,"438",282,156,131,"34",97,0.344,0.2179,0.2991
"890",149222,2009,"2445",1131,1314,624,"264",360,0.3183,0.2009,0.2552
"891",149231,2009,"1911",1068,843,503,"198",305,0.2856,0.2349,0.2632
"892",149772,2009,"1633",817,816,515,"226",289,0.3537,0.277,0.3154
"893",149781,2009,"620",318,302,501,"232",269,0.8459,0.7682,0.8081
"894",150066,2009,"547",313,234,238,"83",155,0.4952,0.3547,0.4351
"895",150136,2009,"4131",2240,1891,1542,"570",972,0.4339,0.3014,0.3733
"896",150145,2009,"295",175,120,165,"60",105,0.6,0.5,0.5593
"897",150163,2009,"944",571,373,501,"166",335,0.5867,0.445,0.5307
"898",150400,2009,"717",405,312,543,"222",321,0.7926,0.7115,0.7573
"899",150534,2009,"701",433,268,403,"152",251,0.5797,0.5672,0.5749
"900",150668,2009,"238",148,90,126,"45",81,0.5473,0.5,0.5294
"901",150941,2009,"250",138,112,142,"64",78,0.5652,0.5714,0.568
"902",151102,2009,"2040",1054,986,131,"54",77,0.0731,0.0548,0.0642
"903",151111,2009,"2794",1670,1124,500,"187",313,0.1874,0.1664,0.179
"904",151306,2009,"2048",1199,849,420,"100",320,0.2669,0.1178,0.2051
"905",151324,2009,"1969",954,1015,393,"183",210,0.2201,0.1803,0.1996
"906",151333,2009,"406",232,174,51,"14",37,0.1595,0.0805,0.1256
"907",151342,2009,"1045",611,434,60,"21",39,0.0638,0.0484,0.0574
"908",151351,2009,"7301",3640,3661,4387,"2001",2386,0.6555,0.5466,0.6009
"909",151360,2009,"773",483,290,70,"22",48,0.0994,0.0759,0.0906
"910",151379,2009,"995",612,383,80,"27",53,0.0866,0.0705,0.0804
"911",151388,2009,"358",217,141,51,"11",40,0.1843,0.078,0.1425
"912",151777,2009,"426",210,216,198,"88",110,0.5238,0.4074,0.4648
"913",151786,2009,"312",166,146,103,"39",64,0.3855,0.2671,0.3301
"914",152080,2009,"2055",930,1125,1867,"1009",858,0.9226,0.8969,0.9085
"915",152248,2009,"1060",499,561,92,"37",55,0.1102,0.066,0.0868
"916",152363,2009,"240",108,132,102,"41",61,0.5648,0.3106,0.425
"917",152530,2009,"482",263,219,342,"141",201,0.7643,0.6438,0.7095
"918",152600,2009,"671",330,341,371,"157",214,0.6485,0.4604,0.5529
"919",153001,2009,"271",123,148,116,"55",61,0.4959,0.3716,0.428
"920",153108,2009,"442",213,229,264,"117",147,0.6901,0.5109,0.5973
"921",153269,2009,"860",512,348,482,"185",297,0.5801,0.5316,0.5605
"922",153384,2009,"377",202,175,299,"124",175,0.8663,0.7086,0.7931
"923",153603,2009,"4320",1974,2346,1757,"742",1015,0.5142,0.3163,0.4067
"924",153834,2009,"657",380,277,451,"190",261,0.6868,0.6859,0.6865
"925",154095,2009,"1913",1194,719,721,"220",501,0.4196,0.306,0.3769
"926",155089,2009,"217",114,103,62,"33",29,0.2544,0.3204,0.2857
"927",155317,2009,"3894",1984,1910,1459,"599",860,0.4335,0.3136,0.3747
"928",155335,2009,"174",106,68,55,"16",39,0.3679,0.2353,0.3161
"929",155399,2009,"3420",1686,1734,972,"343",629,0.3731,0.1978,0.2842
"930",155520,2009,"198",110,88,83,"29",54,0.4909,0.3295,0.4192
"931",155627,2009,"150",67,83,55,"30",25,0.3731,0.3614,0.3667
"932",155937,2009,"182",82,100,49,"24",25,0.3049,0.24,0.2692
"933",156213,2009,"315",198,117,168,"64",104,0.5253,0.547,0.5333
"934",156286,2009,"600",383,217,303,"98",205,0.5352,0.4516,0.505
"935",156295,2009,"391",221,170,174,"74",100,0.4525,0.4353,0.445
"936",156365,2009,"515",260,255,127,"44",83,0.3192,0.1725,0.2466
"937",156541,2009,"453",211,242,107,"31",76,0.3602,0.1281,0.2362
"938",156745,2009,"378",211,167,186,"63",123,0.5829,0.3772,0.4921
"939",157058,2009,"476",265,211,24,"7",17,0.0642,0.0332,0.0504
"940",157076,2009,"227",118,109,79,"30",49,0.4153,0.2752,0.348
"941",157085,2009,"4105",2102,2003,1438,"551",887,0.422,0.2751,0.3503
"942",157289,2009,"2441",1273,1168,622,"270",352,0.2765,0.2312,0.2548
"943",157386,2009,"1240",708,532,231,"74",157,0.2218,0.1391,0.1863
"944",157401,2009,"1374",837,537,330,"101",229,0.2736,0.1881,0.2402
"945",157447,2009,"2187",1219,968,340,"121",219,0.1797,0.125,0.1555
"946",157535,2009,"185",62,123,38,"20",18,0.2903,0.1626,0.2054
"947",157951,2009,"3288",1783,1505,700,"249",451,0.2529,0.1654,0.2129
"948",158477,2009,"278",162,116,128,"49",79,0.4877,0.4224,0.4604
"949",159009,2009,"910",548,362,177,"65",112,0.2044,0.1796,0.1945
"950",159391,2009,"4776",2516,2260,1823,"665",1158,0.4603,0.2942,0.3817
"951",159647,2009,"1448",622,826,438,"209",229,0.3682,0.253,0.3025
"952",159717,2009,"1221",728,493,256,"83",173,0.2376,0.1684,0.2097
"953",159966,2009,"1212",707,505,200,"67",133,0.1881,0.1327,0.165
"954",160038,2009,"1235",781,454,231,"64",167,0.2138,0.141,0.187
"955",160612,2009,"2508",1497,1011,359,"118",241,0.161,0.1167,0.1431
"956",160621,2009,"992",539,453,96,"31",65,0.1206,0.0684,0.0968
"957",160658,2009,"2553",1427,1126,373,"126",247,0.1731,0.1119,0.1461
"958",161004,2009,"493",253,240,422,"200",222,0.8775,0.8333,0.856
"959",161226,2009,"487",312,175,210,"64",146,0.4679,0.3657,0.4312
"960",161235,2009,"118",69,49,20,"5",15,0.2174,0.102,0.1695
"961",161244,2009,"101",67,34,16,"4",12,0.1791,0.1176,0.1584
"962",161253,2009,"1654",756,898,550,"288",262,0.3466,0.3207,0.3325
"963",161554,2009,"825",447,378,107,"27",80,0.179,0.0714,0.1297
"964",162007,2009,"635",401,234,71,"18",53,0.1322,0.0769,0.1118
"965",162210,2009,"144",83,61,21,"7",14,0.1687,0.1148,0.1458
"966",162283,2009,"541",392,149,29,"2",27,0.0689,0.0134,0.0536
"967",162584,2009,"1028",505,523,217,"67",150,0.297,0.1281,0.2111
"968",162654,2009,"398",276,122,227,"53",174,0.6304,0.4344,0.5704
"969",162760,2009,"251",168,83,136,"46",90,0.5357,0.5542,0.5418
"970",162928,2009,"1427",663,764,1240,"643",597,0.9005,0.8416,0.869
"971",163046,2009,"968",592,376,740,"275",465,0.7855,0.7314,0.7645
"972",163268,2009,"1522",656,866,574,"257",317,0.4832,0.2968,0.3771
"973",163286,2009,"4199",1953,2246,2912,"1448",1464,0.7496,0.6447,0.6935
"974",163453,2009,"1261",715,546,121,"35",86,0.1203,0.0641,0.096
"975",163462,2009,"464",268,196,298,"126",172,0.6418,0.6429,0.6422
"976",163851,2009,"1273",738,535,577,"169",408,0.5528,0.3159,0.4533
"977",163912,2009,"486",273,213,327,"121",206,0.7546,0.5681,0.6728
"978",164076,2009,"2395",1564,831,1076,"275",801,0.5121,0.3309,0.4493
"979",164173,2009,"522",346,176,220,"62",158,0.4566,0.3523,0.4215
"980",164216,2009,"378",215,163,269,"111",158,0.7349,0.681,0.7116
"981",164270,2009,"420",195,225,266,"124",142,0.7282,0.5511,0.6333
"982",164447,2009,"354",165,189,88,"40",48,0.2909,0.2116,0.2486
"983",164492,2009,"373",172,201,95,"46",49,0.2849,0.2289,0.2547
"984",164562,2009,"515",294,221,363,"135",228,0.7755,0.6109,0.7049
"985",165015,2009,"775",434,341,621,"255",366,0.8433,0.7478,0.8013
"986",165024,2009,"1453",866,587,420,"162",258,0.2979,0.276,0.2891
"987",165334,2009,"548",356,192,422,"144",278,0.7809,0.75,0.7701
"988",165662,2009,"764",486,278,593,"215",378,0.7778,0.7734,0.7762
"989",165671,2009,"423",308,115,235,"60",175,0.5682,0.5217,0.5556
"990",165820,2009,"781",410,371,217,"89",128,0.3122,0.2399,0.2778
"991",165866,2009,"719",520,199,261,"59",202,0.3885,0.2965,0.363
"992",165936,2009,"381",237,144,233,"71",162,0.6835,0.4931,0.6115
"993",166027,2009,"1662",837,825,1425,"673",752,0.8984,0.8158,0.8574
"994",166124,2009,"746",379,367,666,"320",346,0.9129,0.8719,0.8928
"995",166513,2009,"1499",548,951,465,"243",222,0.4051,0.2555,0.3102
"996",166629,2009,"4215",2175,2040,2703,"1192",1511,0.6947,0.5843,0.6413
"997",166638,2009,"934",545,389,154,"53",101,0.1853,0.1362,0.1649
"998",166683,2009,"1066",477,589,874,"462",412,0.8637,0.7844,0.8199
"999",167288,2009,"347",229,118,119,"40",79,0.345,0.339,0.3429
"1000",167987,2009,"1780",822,958,494,"212",282,0.3431,0.2213,0.2775
"1001",167996,2009,"683",397,286,564,"219",345,0.869,0.7657,0.8258
"1002",168005,2009,"1257",736,521,510,"182",328,0.4457,0.3493,0.4057
"1003",168148,2009,"1302",669,633,1141,"542",599,0.8954,0.8562,0.8763
"1004",168254,2009,"683",257,426,322,"187",135,0.5253,0.439,0.4714
"1005",168281,2009,"423",261,162,322,"118",204,0.7816,0.7284,0.7612
"1006",168342,2009,"545",293,252,481,"216",265,0.9044,0.8571,0.8826
"1007",168546,2009,"434",218,216,241,"106",135,0.6193,0.4907,0.5553
"1008",168786,2009,"402",271,131,158,"46",112,0.4133,0.3511,0.393
"1009",169080,2009,"943",492,451,540,"244",296,0.6016,0.541,0.5726
"1010",169798,2009,"2196",1308,888,288,"84",204,0.156,0.0946,0.1311
"1011",169910,2009,"1958",980,978,152,"58",94,0.0959,0.0593,0.0776
"1012",170082,2009,"3716",2278,1438,1363,"461",902,0.396,0.3206,0.3668
"1013",170301,2009,"803",486,317,515,"186",329,0.677,0.5868,0.6413
"1014",170532,2009,"389",219,170,299,"121",178,0.8128,0.7118,0.7686
"1015",170639,2009,"437",209,228,65,"33",32,0.1531,0.1447,0.1487
"1016",170976,2009,"6019",2983,3036,4503,"2101",2402,0.8052,0.692,0.7481
"1017",171100,2009,"7249",3869,3380,3612,"1445",2167,0.5601,0.4275,0.4983
"1018",171128,2009,"1155",301,854,260,"162",98,0.3256,0.1897,0.2251
"1019",171137,2009,"886",418,468,146,"60",86,0.2057,0.1282,0.1648
"1020",171146,2009,"713",401,312,77,"29",48,0.1197,0.0929,0.108
"1021",171599,2009,"258",141,117,68,"26",42,0.2979,0.2222,0.2636
"1022",172051,2009,"1728",1028,700,177,"59",118,0.1148,0.0843,0.1024
"1023",172699,2009,"3162",1591,1571,718,"279",439,0.2759,0.1776,0.2271
"1024",173160,2009,"683",387,296,430,"169",261,0.6744,0.5709,0.6296
"1025",173258,2009,"528",272,256,480,"222",258,0.9485,0.8672,0.9091
"1026",173328,2009,"183",82,101,56,"22",34,0.4146,0.2178,0.306
"1027",173647,2009,"611",372,239,495,"193",302,0.8118,0.8075,0.8101
"1028",173902,2009,"564",329,235,481,"196",285,0.8663,0.834,0.8528
"1029",174066,2009,"5381",2849,2532,3188,"1380",1808,0.6346,0.545,0.5925
"1030",174233,2009,"2079",1028,1051,728,"296",432,0.4202,0.2816,0.3502
"1031",174251,2009,"404",235,169,206,"74",132,0.5617,0.4379,0.5099
"1032",174491,2009,"450",258,192,240,"86",154,0.5969,0.4479,0.5333
"1033",174792,2009,"461",0,461,303,"303",0,NA,0.6573,0.6573
"1034",174844,2009,"778",445,333,652,"267",385,0.8652,0.8018,0.838
"1035",174899,2009,"540",359,181,337,"90",247,0.688,0.4972,0.6241
"1036",174914,2009,"1350",586,764,812,"439",373,0.6365,0.5746,0.6015
"1037",175342,2009,"463",277,186,77,"20",57,0.2058,0.1075,0.1663
"1038",175421,2009,"208",116,92,67,"18",49,0.4224,0.1957,0.3221
"1039",175616,2009,"367",230,137,62,"22",40,0.1739,0.1606,0.1689
"1040",175856,2009,"841",507,334,157,"47",110,0.217,0.1407,0.1867
"1041",175980,2009,"281",116,165,166,"80",86,0.7414,0.4848,0.5907
"1042",176017,2009,"2547",1358,1189,996,"360",636,0.4683,0.3028,0.391
"1043",176035,2009,"216",177,39,56,"10",46,0.2599,0.2564,0.2593
"1044",176044,2009,"413",222,191,43,"13",30,0.1351,0.0681,0.1041
"1045",176080,2009,"2447",1210,1237,755,"282",473,0.3909,0.228,0.3085
"1046",176406,2009,"231",154,77,57,"12",45,0.2922,0.1558,0.2468
"1047",176628,2009,"118",79,39,36,"9",27,0.3418,0.2308,0.3051
"1048",176947,2009,"260",129,131,106,"42",64,0.4961,0.3206,0.4077
"1049",176965,2009,"1478",822,656,452,"148",304,0.3698,0.2256,0.3058
"1050",177418,2009,"173",104,69,65,"19",46,0.4423,0.2754,0.3757
"1051",178059,2009,"340",233,107,190,"57",133,0.5708,0.5327,0.5588
"1052",178341,2009,"811",395,416,119,"53",66,0.1671,0.1274,0.1467
"1053",178387,2009,"1004",572,432,127,"35",92,0.1608,0.081,0.1265
"1054",178396,2009,"5492",2958,2534,2527,"907",1620,0.5477,0.3579,0.4601
"1055",178402,2009,"979",610,369,224,"62",162,0.2656,0.168,0.2288
"1056",178411,2009,"1099",260,839,263,"180",83,0.3192,0.2145,0.2393
"1057",178420,2009,"494",295,199,109,"34",75,0.2542,0.1709,0.2206
"1058",178615,2009,"1337",776,561,739,"263",476,0.6134,0.4688,0.5527
"1059",179043,2009,"417",263,154,251,"84",167,0.635,0.5455,0.6019
"1060",179159,2009,"1714",966,748,1026,"393",633,0.6553,0.5254,0.5986
"1061",179557,2009,"1640",943,697,455,"165",290,0.3075,0.2367,0.2774
"1062",179566,2009,"2625",1542,1083,768,"225",543,0.3521,0.2078,0.2926
"1063",179867,2009,"1481",720,761,1280,"622",658,0.9139,0.8173,0.8643
"1064",179894,2009,"486",289,197,219,"78",141,0.4879,0.3959,0.4506
"1065",179946,2009,"311",152,159,149,"61",88,0.5789,0.3836,0.4791
"1066",180179,2009,"715",400,315,51,"19",32,0.08,0.0603,0.0713
"1067",180461,2009,"1795",728,1067,387,"190",197,0.2706,0.1781,0.2156
"1068",180522,2009,"233",71,162,21,"13",8,0.1127,0.0802,0.0901
"1069",180984,2009,"288",139,149,117,"47",70,0.5036,0.3154,0.4062
"1070",181002,2009,"1052",635,417,709,"275",434,0.6835,0.6595,0.674
"1071",181020,2009,"309",167,142,175,"65",110,0.6587,0.4577,0.5663
"1072",181127,2009,"290",150,140,132,"50",82,0.5467,0.3571,0.4552
"1073",181215,2009,"974",548,426,231,"81",150,0.2737,0.1901,0.2372
"1074",181394,2009,"1747",932,815,278,"93",185,0.1985,0.1141,0.1591
"1075",181446,2009,"393",233,160,201,"63",138,0.5923,0.3938,0.5115
"1076",181464,2009,"3965",1870,2095,1308,"552",756,0.4043,0.2635,0.3299
"1077",181534,2009,"227",113,114,35,"12",23,0.2035,0.1053,0.1542
"1078",181783,2009,"663",361,302,158,"56",102,0.2825,0.1854,0.2383
"1079",182281,2009,"3083",1659,1424,397,"146",251,0.1513,0.1025,0.1288
"1080",182290,2009,"2124",1144,980,467,"172",295,0.2579,0.1755,0.2199
"1081",182634,2009,"432",313,119,190,"45",145,0.4633,0.3782,0.4398
"1082",182795,2009,"388",175,213,138,"62",76,0.4343,0.2911,0.3557
"1083",183062,2009,"1171",712,459,616,"228",388,0.5449,0.4967,0.526
"1084",183080,2009,"971",450,521,430,"196",234,0.52,0.3762,0.4428
"1085",183239,2009,"528",285,243,372,"154",218,0.7649,0.6337,0.7045
"1086",183822,2009,"439",278,161,32,"16",16,0.0576,0.0994,0.0729
"1087",183974,2009,"270",165,105,156,"50",106,0.6424,0.4762,0.5778
"1088",184348,2009,"505",296,209,317,"114",203,0.6858,0.5455,0.6277
"1089",184603,2009,"641",361,280,175,"57",118,0.3269,0.2036,0.273
"1090",184612,2009,"251",172,79,46,"17",29,0.1686,0.2152,0.1833
"1091",184782,2009,"1586",738,848,677,"344",333,0.4512,0.4057,0.4269
"1092",185129,2009,"634",358,276,32,"12",20,0.0559,0.0435,0.0505
"1093",185572,2009,"998",581,417,504,"191",313,0.5387,0.458,0.505
"1094",185590,2009,"2100",1284,816,757,"219",538,0.419,0.2684,0.3605
"1095",185828,2009,"899",169,730,212,"151",61,0.3609,0.2068,0.2358
"1096",186131,2009,"1297",643,654,1164,"568",596,0.9269,0.8685,0.8975
"1097",186201,2009,"933",575,358,559,"165",394,0.6852,0.4609,0.5991
"1098",186283,2009,"1027",611,416,557,"216",341,0.5581,0.5192,0.5424
"1099",186584,2009,"1124",659,465,570,"232",338,0.5129,0.4989,0.5071
"1100",186876,2009,"865",483,382,459,"175",284,0.588,0.4581,0.5306
"1101",187134,2009,"1283",718,565,918,"366",552,0.7688,0.6478,0.7155
"1102",187444,2009,"1435",703,732,284,"129",155,0.2205,0.1762,0.1979
"1103",187985,2009,"3344",1762,1582,516,"193",323,0.1833,0.122,0.1543
"1104",188030,2009,"2446",1306,1140,328,"116",212,0.1623,0.1018,0.1341
"1105",188429,2009,"985",690,295,539,"131",408,0.5913,0.4441,0.5472
"1106",188641,2009,"465",234,231,204,"85",119,0.5085,0.368,0.4387
"1107",190044,2009,"774",220,554,405,"262",143,0.65,0.4729,0.5233
"1108",190099,2009,"750",400,350,644,"299",345,0.8625,0.8543,0.8587
"1109",190150,2009,"1432",701,731,1260,"629",631,0.9001,0.8605,0.8799
"1110",190248,2009,"101",54,47,27,"7",20,0.3704,0.1489,0.2673
"1111",190415,2009,"3174",1597,1577,2742,"1327",1415,0.886,0.8415,0.8639
"1112",190512,2009,"1430",619,811,598,"294",304,0.4911,0.3625,0.4182
"1113",190549,2009,"952",541,411,223,"94",129,0.2384,0.2287,0.2342
"1114",190558,2009,"2407",1245,1162,127,"52",75,0.0602,0.0448,0.0528
"1115",190567,2009,"1753",909,844,195,"75",120,0.132,0.0889,0.1112
"1116",190594,2009,"1983",1241,742,487,"115",372,0.2998,0.155,0.2456
"1117",190637,2009,"754",461,293,111,"34",77,0.167,0.116,0.1472
"1118",190664,2009,"1684",944,740,473,"153",320,0.339,0.2068,0.2809
"1119",190691,2009,"1028",627,401,50,"12",38,0.0606,0.0299,0.0486
"1120",190725,2009,"400",306,94,103,"29",74,0.2418,0.3085,0.2575
"1121",191241,2009,"1811",926,885,1358,"647",711,0.7678,0.7311,0.7499
"1122",191515,2009,"466",241,225,407,"180",227,0.9419,0.8,0.8734
"1123",191533,2009,"402",239,163,202,"66",136,0.569,0.4049,0.5025
"1124",191630,2009,"545",315,230,416,"161",255,0.8095,0.7,0.7633
"1125",191649,2009,"1554",834,720,755,"297",458,0.5492,0.4125,0.4858
"1126",191676,2009,"282",199,83,186,"53",133,0.6683,0.6386,0.6596
"1127",191931,2009,"792",480,312,448,"150",298,0.6208,0.4808,0.5657
"1128",191968,2009,"2024",1144,880,1390,"571",819,0.7159,0.6489,0.6868
"1129",192192,2009,"254",175,79,57,"24",33,0.1886,0.3038,0.2244
"1130",192323,2009,"605",394,211,344,"102",242,0.6142,0.4834,0.5686
"1131",192439,2009,"1005",692,313,81,"19",62,0.0896,0.0607,0.0806
"1132",192703,2009,"693",343,350,412,"183",229,0.6676,0.5229,0.5945
"1133",192749,2009,"490",298,192,250,"86",164,0.5503,0.4479,0.5102
"1134",192819,2009,"1041",577,464,708,"279",429,0.7435,0.6013,0.6801
"1135",192925,2009,"402",257,145,104,"35",69,0.2685,0.2414,0.2587
"1136",193016,2009,"880",552,328,157,"39",118,0.2138,0.1189,0.1784
"1137",193292,2009,"414",307,107,189,"42",147,0.4788,0.3925,0.4565
"1138",193353,2009,"474",362,112,217,"42",175,0.4834,0.375,0.4578
"1139",193399,2009,"390",275,115,131,"30",101,0.3673,0.2609,0.3359
"1140",193584,2009,"491",387,104,315,"68",247,0.6382,0.6538,0.6415
"1141",193645,2009,"530",465,65,86,"8",78,0.1677,0.1231,0.1623
"1142",193654,2009,"1136",836,300,533,"113",420,0.5024,0.3767,0.4692
"1143",193900,2009,"5367",3037,2330,3359,"1449",1910,0.6289,0.6219,0.6259
"1144",193973,2009,"671",404,267,378,"141",237,0.5866,0.5281,0.5633
"1145",194161,2009,"260",151,109,68,"26",42,0.2781,0.2385,0.2615
"1146",194310,2009,"1637",1036,601,603,"194",409,0.3948,0.3228,0.3684
"1147",194824,2009,"1337",360,977,840,"599",241,0.6694,0.6131,0.6283
"1148",195003,2009,"2582",798,1784,796,"413",383,0.4799,0.2315,0.3083
"1149",195030,2009,"1195",594,601,890,"431",459,0.7727,0.7171,0.7448
"1150",195164,2009,"465",249,216,252,"106",146,0.5863,0.4907,0.5419
"1151",195173,2009,"580",301,279,168,"63",105,0.3488,0.2258,0.2897
"1152",195216,2009,"579",307,272,476,"219",257,0.8371,0.8051,0.8221
"1153",195234,2009,"583",381,202,271,"76",195,0.5118,0.3762,0.4648
"1154",195243,2009,"293",156,137,105,"56",49,0.3141,0.4088,0.3584
"1155",195304,2009,"365",273,92,263,"72",191,0.6996,0.7826,0.7205
"1156",195474,2009,"783",417,366,563,"239",324,0.777,0.653,0.719
"1157",195526,2009,"663",414,249,549,"194",355,0.8575,0.7791,0.8281
"1158",195544,2009,"700",519,181,374,"73",301,0.58,0.4033,0.5343
"1159",195809,2009,"3101",1651,1450,1245,"534",711,0.4306,0.3683,0.4015
"1160",196413,2009,"3240",1868,1372,2215,"854",1361,0.7286,0.6224,0.6836
"1161",196592,2009,"867",555,312,58,"7",51,0.0919,0.0224,0.0669
"1162",197045,2009,"559",271,288,161,"76",85,0.3137,0.2639,0.288
"1163",197133,2009,"658",392,266,568,"217",351,0.8954,0.8158,0.8632
"1164",197869,2009,"2732",1471,1261,1267,"464",803,0.5459,0.368,0.4638
"1165",197984,2009,"396",224,172,138,"50",88,0.3929,0.2907,0.3485
"1166",198385,2009,"487",252,235,438,"207",231,0.9167,0.8809,0.8994
"1167",198464,2009,"3942",2273,1669,1397,"445",952,0.4188,0.2666,0.3544
"1168",198507,2009,"659",375,284,106,"35",71,0.1893,0.1232,0.1608
"1169",198516,2009,"1290",774,516,1025,"374",651,0.8411,0.7248,0.7946
"1170",198835,2009,"355",215,140,119,"36",83,0.386,0.2571,0.3352
"1171",198969,2009,"472",144,328,80,"35",45,0.3125,0.1067,0.1695
"1172",199102,2009,"1875",1028,847,383,"116",267,0.2597,0.137,0.2043
"1173",199111,2009,"637",363,274,230,"75",155,0.427,0.2737,0.3611
"1174",199120,2009,"3955",2354,1601,3216,"1225",1991,0.8458,0.7651,0.8131
"1175",199139,2009,"3152",1571,1581,820,"319",501,0.3189,0.2018,0.2602
"1176",199148,2009,"2495",1733,762,804,"180",624,0.3601,0.2362,0.3222
"1177",199157,2009,"1345",858,487,215,"49",166,0.1935,0.1006,0.1599
"1178",199193,2009,"4716",2067,2649,2031,"920",1111,0.5375,0.3473,0.4307
"1179",199218,2009,"1943",1178,765,975,"314",661,0.5611,0.4105,0.5018
"1180",199281,2009,"1202",642,560,218,"77",141,0.2196,0.1375,0.1814
"1181",199306,2009,"225",100,125,71,"34",37,0.37,0.272,0.3156
"1182",199412,2009,"311",232,79,144,"31",113,0.4871,0.3924,0.463
"1183",199582,2009,"424",206,218,91,"35",56,0.2718,0.1606,0.2146
"1184",199643,2009,"581",334,247,74,"24",50,0.1497,0.0972,0.1274
"1185",199847,2009,"1193",628,565,983,"445",538,0.8567,0.7876,0.824
"1186",199962,2009,"375",195,180,150,"59",91,0.4667,0.3278,0.4
"1187",199999,2009,"794",540,254,135,"39",96,0.1778,0.1535,0.17
"1188",200004,2009,"1547",848,699,568,"211",357,0.421,0.3019,0.3672
"1189",200059,2009,"307",177,130,43,"13",30,0.1695,0.1,0.1401
"1190",200156,2009,"233",116,117,49,"17",32,0.2759,0.1453,0.2103
"1191",200217,2009,"311",192,119,122,"32",90,0.4688,0.2689,0.3923
"1192",200226,2009,"147",57,90,17,"7",10,0.1754,0.0778,0.1156
"1193",200253,2009,"418",238,180,68,"21",47,0.1975,0.1167,0.1627
"1194",200280,2009,"1970",940,1030,468,"218",250,0.266,0.2117,0.2376
"1195",200332,2009,"2435",1111,1324,655,"299",356,0.3204,0.2258,0.269
"1196",200572,2009,"152",53,99,32,"13",19,0.3585,0.1313,0.2105
"1197",201104,2009,"614",338,276,281,"94",187,0.5533,0.3406,0.4577
"1198",201371,2009,"257",116,141,107,"48",59,0.5086,0.3404,0.4163
"1199",201548,2009,"608",323,285,336,"150",186,0.5759,0.5263,0.5526
"1200",201645,2009,"965",401,564,609,"309",300,0.7481,0.5479,0.6311
"1201",201690,2009,"702",363,339,42,"14",28,0.0771,0.0413,0.0598
"1202",202134,2009,"1127",601,526,181,"70",111,0.1847,0.1331,0.1606
"1203",202480,2009,"1692",834,858,1050,"463",587,0.7038,0.5396,0.6206
"1204",202523,2009,"649",362,287,500,"205",295,0.8149,0.7143,0.7704
"1205",202763,2009,"565",398,167,251,"51",200,0.5025,0.3054,0.4442
"1206",203085,2009,"375",168,207,118,"48",70,0.4167,0.2319,0.3147
"1207",203128,2009,"293",143,150,154,"74",80,0.5594,0.4933,0.5256
"1208",203368,2009,"660",335,325,373,"163",210,0.6269,0.5015,0.5652
"1209",203517,2009,"4003",2437,1566,1298,"400",898,0.3685,0.2554,0.3243
"1210",203535,2009,"468",248,220,393,"176",217,0.875,0.8,0.8397
"1211",203580,2009,"263",127,136,95,"44",51,0.4016,0.3235,0.3612
"1212",203775,2009,"477",275,202,230,"80",150,0.5455,0.396,0.4822
"1213",203845,2009,"386",178,208,218,"109",109,0.6124,0.524,0.5648
"1214",204024,2009,"3219",1745,1474,2104,"855",1249,0.7158,0.5801,0.6536
"1215",204185,2009,"578",286,292,315,"124",191,0.6678,0.4247,0.545
"1216",204194,2009,"300",190,110,172,"61",111,0.5842,0.5545,0.5733
"1217",204617,2009,"274",143,131,98,"40",58,0.4056,0.3053,0.3577
"1218",204796,2009,"6724",3237,3487,3935,"1699",2236,0.6908,0.4872,0.5852
"1219",204857,2009,"4052",2217,1835,1954,"702",1252,0.5647,0.3826,0.4822
"1220",206330,2009,"182",75,107,28,"10",18,0.24,0.0935,0.1538
"1221",206589,2009,"479",264,215,371,"154",217,0.822,0.7163,0.7745
"1222",206604,2009,"2463",1378,1085,515,"196",319,0.2315,0.1806,0.2091
"1223",206622,2009,"1178",637,541,779,"352",427,0.6703,0.6506,0.6613
"1224",206695,2009,"2564",1306,1258,240,"111",129,0.0988,0.0882,0.0936
"1225",206914,2009,"855",489,366,73,"28",45,0.092,0.0765,0.0854
"1226",207209,2009,"561",253,308,17,"6",11,0.0435,0.0195,0.0303
"1227",207306,2009,"402",199,203,32,"8",24,0.1206,0.0394,0.0796
"1228",207324,2009,"471",218,253,148,"67",81,0.3716,0.2648,0.3142
"1229",207388,2009,"2973",1544,1429,997,"365",632,0.4093,0.2554,0.3354
"1230",207500,2009,"3700",1917,1783,1411,"555",856,0.4465,0.3113,0.3814
"1231",207722,2009,"166",113,53,49,"12",37,0.3274,0.2264,0.2952
"1232",207847,2009,"639",313,326,84,"38",46,0.147,0.1166,0.1315
"1233",207865,2009,"900",481,419,105,"30",75,0.1559,0.0716,0.1167
"1234",208822,2009,"411",239,172,249,"102",147,0.6151,0.593,0.6058
"1235",209056,2009,"494",298,196,327,"122",205,0.6879,0.6224,0.6619
"1236",209065,2009,"420",252,168,226,"76",150,0.5952,0.4524,0.5381
"1237",209542,2009,"3314",1620,1694,1072,"400",672,0.4148,0.2361,0.3235
"1238",209551,2009,"3788",2027,1761,1900,"778",1122,0.5535,0.4418,0.5016
"1239",209612,2009,"333",204,129,213,"82",131,0.6422,0.6357,0.6396
"1240",209807,2009,"1551",800,751,296,"109",187,0.2338,0.1451,0.1908
"1241",209922,2009,"367",192,175,253,"122",131,0.6823,0.6971,0.6894
"1242",210146,2009,"652",378,274,131,"37",94,0.2487,0.135,0.2009
"1243",210401,2009,"541",294,247,384,"165",219,0.7449,0.668,0.7098
"1244",210429,2009,"933",553,380,192,"39",153,0.2767,0.1026,0.2058
"1245",210571,2009,"541",317,224,268,"83",185,0.5836,0.3705,0.4954
"1246",210669,2009,"580",299,281,395,"177",218,0.7291,0.6299,0.681
"1247",210775,2009,"328",188,140,124,"53",71,0.3777,0.3786,0.378
"1248",211088,2009,"529",381,148,257,"70",187,0.4908,0.473,0.4858
"1249",211158,2009,"2031",1221,810,772,"252",520,0.4259,0.3111,0.3801
"1250",211291,2009,"920",466,454,780,"371",409,0.8777,0.8172,0.8478
"1251",211352,2009,"357",237,120,178,"57",121,0.5105,0.475,0.4986
"1252",211361,2009,"1373",679,694,323,"156",167,0.2459,0.2248,0.2353
"1253",211431,2009,"250",245,5,100,"1",99,0.4041,0.2,0.4
"1254",211440,2009,"1423",611,812,1026,"558",468,0.766,0.6872,0.721
"1255",211468,2009,"195",194,1,84,"0",84,0.433,0,0.4308
"1256",211556,2009,"131",131,0,66,"0",66,0.5038,NA,0.5038
"1257",211583,2009,"273",164,109,101,"27",74,0.4512,0.2477,0.37
"1258",211608,2009,"372",199,173,22,"7",15,0.0754,0.0405,0.0591
"1259",211644,2009,"1384",805,579,395,"122",273,0.3391,0.2107,0.2854
"1260",211981,2009,"452",252,200,227,"74",153,0.6071,0.37,0.5022
"1261",212009,2009,"581",340,241,472,"191",281,0.8265,0.7925,0.8124
"1262",212054,2009,"2268",898,1370,516,"209",307,0.3419,0.1526,0.2275
"1263",212106,2009,"1425",814,611,787,"296",491,0.6032,0.4845,0.5523
"1264",212115,2009,"1342",737,605,466,"167",299,0.4057,0.276,0.3472
"1265",212133,2009,"489",318,171,213,"61",152,0.478,0.3567,0.4356
"1266",212160,2009,"1407",803,604,266,"82",184,0.2291,0.1358,0.1891
"1267",212197,2009,"544",340,204,391,"133",258,0.7588,0.652,0.7188
"1268",212577,2009,"629",334,295,511,"229",282,0.8443,0.7763,0.8124
"1269",212601,2009,"648",382,266,310,"106",204,0.534,0.3985,0.4784
"1270",212832,2009,"313",214,99,47,"18",29,0.1355,0.1818,0.1502
"1271",212911,2009,"323",186,137,275,"121",154,0.828,0.8832,0.8514
"1272",213020,2009,"2993",1774,1219,1068,"329",739,0.4166,0.2699,0.3568
"1273",213251,2009,"366",207,159,246,"98",148,0.715,0.6164,0.6721
"1274",213321,2009,"499",233,266,303,"142",161,0.691,0.5338,0.6072
"1275",213349,2009,"1985",1132,853,689,"221",468,0.4134,0.2591,0.3471
"1276",213358,2009,"190",121,69,46,"15",31,0.2562,0.2174,0.2421
"1277",213367,2009,"1005",580,425,522,"209",313,0.5397,0.4918,0.5194
"1278",213385,2009,"616",298,318,533,"263",270,0.906,0.827,0.8653
"1279",213507,2009,"378",205,173,258,"92",166,0.8098,0.5318,0.6825
"1280",213543,2009,"1189",489,700,878,"469",409,0.8364,0.67,0.7384
"1281",213613,2009,"1185",702,483,336,"117",219,0.312,0.2422,0.2835
"1282",213668,2009,"383",194,189,220,"89",131,0.6753,0.4709,0.5744
"1283",213783,2009,"704",397,307,189,"71",118,0.2972,0.2313,0.2685
"1284",213826,2009,"411",287,124,231,"54",177,0.6167,0.4355,0.562
"1285",213996,2009,"697",440,257,497,"173",324,0.7364,0.6732,0.7131
"1286",214041,2009,"1317",726,591,472,"179",293,0.4036,0.3029,0.3584
"1287",214069,2009,"371",236,135,237,"78",159,0.6737,0.5778,0.6388
"1288",214157,2009,"379",223,156,248,"97",151,0.6771,0.6218,0.6544
"1289",214175,2009,"576",337,239,475,"187",288,0.8546,0.7824,0.8247
"1290",214272,2009,"519",323,196,189,"57",132,0.4087,0.2908,0.3642
"1291",214777,2009,"6574",3217,3357,4226,"1910",2316,0.7199,0.569,0.6428
"1292",215062,2009,"2402",1232,1170,2091,"976",1115,0.905,0.8342,0.8705
"1293",215743,2009,"349",207,142,15,"3",12,0.058,0.0211,0.043
"1294",215798,2009,"446",197,249,267,"125",142,0.7208,0.502,0.5987
"1295",215929,2009,"1027",578,449,747,"296",451,0.7803,0.6592,0.7274
"1296",216010,2009,"1673",873,800,669,"273",396,0.4536,0.3412,0.3999
"1297",216038,2009,"1534",915,619,795,"258",537,0.5869,0.4168,0.5183
"1298",216287,2009,"394",204,190,343,"159",184,0.902,0.8368,0.8706
"1299",216339,2009,"4183",2320,1863,1808,"687",1121,0.4832,0.3688,0.4322
"1300",216524,2009,"509",260,249,379,"178",201,0.7731,0.7149,0.7446
"1301",216694,2009,"380",221,159,211,"77",134,0.6063,0.4843,0.5553
"1302",216764,2009,"2241",1353,888,954,"277",677,0.5004,0.3119,0.4257
"1303",216807,2009,"451",277,174,313,"117",196,0.7076,0.6724,0.694
"1304",216852,2009,"710",372,338,304,"127",177,0.4758,0.3757,0.4282
"1305",216931,2009,"527",243,284,250,"121",129,0.5309,0.4261,0.4744
"1306",217059,2009,"1092",595,497,431,"144",287,0.4824,0.2897,0.3947
"1307",217156,2009,"1490",770,720,1238,"598",640,0.8312,0.8306,0.8309
"1308",217402,2009,"952",549,403,772,"324",448,0.816,0.804,0.8109
"1309",217536,2009,"501",346,155,343,"98",245,0.7081,0.6323,0.6846
"1310",217776,2009,"168",100,68,67,"26",41,0.41,0.3824,0.3988
"1311",217819,2009,"2136",1497,639,1203,"320",883,0.5898,0.5008,0.5632
"1312",217882,2009,"3336",1564,1772,1926,"853",1073,0.6861,0.4814,0.5773
"1313",217998,2009,"182",99,83,102,"45",57,0.5758,0.5422,0.5604
"1314",218061,2009,"791",533,258,142,"44",98,0.1839,0.1705,0.1795
"1315",218229,2009,"581",405,176,160,"46",114,0.2815,0.2614,0.2754
"1316",218238,2009,"288",133,155,63,"22",41,0.3083,0.1419,0.2188
"1317",218399,2009,"300",166,134,37,"9",28,0.1687,0.0672,0.1233
"1318",218414,2009,"342",133,209,84,"32",52,0.391,0.1531,0.2456
"1319",218663,2009,"3881",2089,1792,2132,"825",1307,0.6257,0.4604,0.5493
"1320",218724,2009,"1766",950,816,465,"142",323,0.34,0.174,0.2633
"1321",218733,2009,"713",358,355,106,"37",69,0.1927,0.1042,0.1487
"1322",218742,2009,"837",540,297,219,"63",156,0.2889,0.2121,0.2616
"1323",218973,2009,"391",203,188,302,"138",164,0.8079,0.734,0.7724
"1324",219000,2009,"431",261,170,245,"80",165,0.6322,0.4706,0.5684
"1325",219046,2009,"540",308,232,85,"23",62,0.2013,0.0991,0.1574
"1326",219082,2009,"284",116,168,54,"28",26,0.2241,0.1667,0.1901
"1327",219198,2009,"109",66,43,47,"16",31,0.4697,0.3721,0.4312
"1328",219259,2009,"317",197,120,65,"16",49,0.2487,0.1333,0.205
"1329",219356,2009,"2043",1032,1011,602,"247",355,0.344,0.2443,0.2947
"1330",219471,2009,"971",559,412,286,"91",195,0.3488,0.2209,0.2945
"1331",219602,2009,"1465",897,568,214,"74",140,0.1561,0.1303,0.1461
"1332",219709,2009,"986",558,428,561,"222",339,0.6075,0.5187,0.569
"1333",219718,2009,"351",151,200,90,"36",54,0.3576,0.18,0.2564
"1334",219949,2009,"200",101,99,62,"25",37,0.3663,0.2525,0.31
"1335",220075,2009,"2063",1144,919,415,"146",269,0.2351,0.1589,0.2012
"1336",220215,2009,"405",240,165,177,"72",105,0.4375,0.4364,0.437
"1337",220613,2009,"829",507,322,288,"80",208,0.4103,0.2484,0.3474
"1338",220631,2009,"314",218,96,61,"15",46,0.211,0.1562,0.1943
"1339",220710,2009,"304",154,150,56,"46",10,0.0649,0.3067,0.1842
"1340",221351,2009,"427",236,191,320,"133",187,0.7924,0.6963,0.7494
"1341",221519,2009,"401",203,198,296,"140",156,0.7685,0.7071,0.7382
"1342",221731,2009,"246",163,83,75,"22",53,0.3252,0.2651,0.3049
"1343",221847,2009,"1879",884,995,476,"181",295,0.3337,0.1819,0.2533
"1344",221892,2009,"240",145,95,96,"35",61,0.4207,0.3684,0.4
"1345",222178,2009,"979",520,459,406,"136",270,0.5192,0.2963,0.4147
"1346",222983,2009,"413",213,200,295,"129",166,0.7793,0.645,0.7143
"1347",223232,2009,"3097",1825,1272,1672,"592",1080,0.5918,0.4654,0.5399
"1348",224004,2009,"225",122,103,58,"22",36,0.2951,0.2136,0.2578
"1349",224323,2009,"319",169,150,212,"96",116,0.6864,0.64,0.6646
"1350",225432,2009,"722",378,344,10,"6",4,0.0106,0.0174,0.0139
"1351",225548,2009,"209",84,125,74,"31",43,0.5119,0.248,0.3541
"1352",225627,2009,"717",469,248,178,"49",129,0.2751,0.1976,0.2483
"1353",226231,2009,"341",109,232,123,"83",40,0.367,0.3578,0.3607
"1354",226833,2009,"701",386,315,139,"40",99,0.2565,0.127,0.1983
"1355",227216,2009,"3255",1832,1423,881,"271",610,0.333,0.1904,0.2707
"1356",227331,2009,"246",170,76,54,"14",40,0.2353,0.1842,0.2195
"1357",227526,2009,"1638",957,681,180,"42",138,0.1442,0.0617,0.1099
"1358",227757,2009,"887",427,460,710,"342",368,0.8618,0.7435,0.8005
"1359",227845,2009,"755",470,285,383,"123",260,0.5532,0.4316,0.5073
"1360",227863,2009,"284",181,103,106,"34",72,0.3978,0.3301,0.3732
"1361",228042,2009,"289",155,134,98,"44",54,0.3484,0.3284,0.3391
"1362",228149,2009,"530",335,195,270,"76",194,0.5791,0.3897,0.5094
"1363",228246,2009,"1325",702,623,886,"374",512,0.7293,0.6003,0.6687
"1364",228343,2009,"375",231,144,257,"88",169,0.7316,0.6111,0.6853
"1365",228431,2009,"2553",1613,940,576,"135",441,0.2734,0.1436,0.2256
"1366",228459,2009,"3804",2260,1544,985,"271",714,0.3159,0.1755,0.2589
"1367",228501,2009,"374",135,239,36,"15",21,0.1556,0.0628,0.0963
"1368",228529,2009,"1207",668,539,293,"96",197,0.2949,0.1781,0.2428
"1369",228705,2009,"971",414,557,165,"75",90,0.2174,0.1346,0.1699
"1370",228723,2009,"7933",3908,4025,4017,"1602",2415,0.618,0.398,0.5064
"1371",228769,2009,"2435",1261,1174,502,"206",296,0.2347,0.1755,0.2062
"1372",228778,2009,"7198",3853,3345,3746,"1514",2232,0.5793,0.4526,0.5204
"1373",228787,2009,"1293",560,733,615,"304",311,0.5554,0.4147,0.4756
"1374",228796,2009,"2281",1153,1128,274,"95",179,0.1552,0.0842,0.1201
"1375",228875,2009,"1818",1142,676,1068,"348",720,0.6305,0.5148,0.5875
"1376",228981,2009,"345",171,174,104,"43",61,0.3567,0.2471,0.3014
"1377",229018,2009,"326",176,150,72,"29",43,0.2443,0.1933,0.2209
"1378",229027,2009,"4559",2281,2278,507,"180",327,0.1434,0.079,0.1112
"1379",229115,2009,"4514",2185,2329,1582,"641",941,0.4307,0.2752,0.3505
"1380",229780,2009,"214",103,111,38,"11",27,0.2621,0.0991,0.1776
"1381",229814,2009,"1193",603,590,260,"78",182,0.3018,0.1322,0.2179
"1382",230603,2009,"1101",742,359,193,"42",151,0.2035,0.117,0.1753
"1383",230728,2009,"2664",1663,1001,508,"100",408,0.2453,0.0999,0.1907
"1384",230764,2009,"2102",1177,925,597,"205",392,0.3331,0.2216,0.284
"1385",230782,2009,"1845",1011,834,140,"43",97,0.0959,0.0516,0.0759
"1386",231059,2009,"470",230,240,322,"146",176,0.7652,0.6083,0.6851
"1387",231174,2009,"2607",1482,1125,1733,"691",1042,0.7031,0.6142,0.6647
"1388",231420,2009,"222",78,144,52,"27",25,0.3205,0.1875,0.2342
"1389",231554,2009,"115",64,51,36,"11",25,0.3906,0.2157,0.313
"1390",231624,2009,"1384",728,656,1133,"503",630,0.8654,0.7668,0.8186
"1391",231712,2009,"1212",719,493,689,"235",454,0.6314,0.4767,0.5685
"1392",232025,2009,"283",115,168,108,"52",56,0.487,0.3095,0.3816
"1393",232043,2009,"218",135,83,110,"40",70,0.5185,0.4819,0.5046
"1394",232089,2009,"531",262,269,106,"45",61,0.2328,0.1673,0.1996
"1395",232186,2009,"2627",1367,1260,1198,"446",752,0.5501,0.354,0.456
"1396",232265,2009,"1017",632,385,135,"135",0,0,0.3506,0.1327
"1397",232423,2009,"3948",2488,1460,2625,"823",1802,0.7243,0.5637,0.6649
"1398",232557,2009,"3871",2113,1758,1154,"439",715,0.3384,0.2497,0.2981
"1399",232566,2009,"934",631,303,414,"96",318,0.504,0.3168,0.4433
"1400",232609,2009,"592",348,244,278,"91",187,0.5374,0.373,0.4696
"1401",232681,2009,"925",600,325,543,"156",387,0.645,0.48,0.587
"1402",232706,2009,"383",274,109,131,"31",100,0.365,0.2844,0.342
"1403",232937,2009,"1160",654,506,183,"63",120,0.1835,0.1245,0.1578
"1404",232982,2009,"2691",1346,1345,698,"263",435,0.3232,0.1955,0.2594
"1405",233277,2009,"1444",838,606,637,"217",420,0.5012,0.3581,0.4411
"1406",233374,2009,"918",546,372,758,"293",465,0.8516,0.7876,0.8257
"1407",233426,2009,"560",325,235,327,"123",204,0.6277,0.5234,0.5839
"1408",233541,2009,"443",235,208,155,"46",109,0.4638,0.2212,0.3499
"1409",233897,2009,"397",172,225,87,"40",47,0.2733,0.1778,0.2191
"1410",233921,2009,"5036",2266,2770,3075,"1446",1629,0.7189,0.522,0.6106
"1411",234030,2009,"3588",2094,1494,1318,"475",843,0.4026,0.3179,0.3673
"1412",234085,2009,"429",42,387,261,"237",24,0.5714,0.6124,0.6084
"1413",234155,2009,"1225",806,419,353,"93",260,0.3226,0.222,0.2882
"1414",234164,2009,"554",303,251,99,"34",65,0.2145,0.1355,0.1787
"1415",235097,2009,"1459",848,611,298,"98",200,0.2358,0.1604,0.2042
"1416",235167,2009,"576",284,292,234,"112",122,0.4296,0.3836,0.4062
"1417",236230,2009,"712",436,276,373,"123",250,0.5734,0.4457,0.5239
"1418",236328,2009,"719",419,300,517,"198",319,0.7613,0.66,0.7191
"1419",236577,2009,"682",489,193,361,"93",268,0.5481,0.4819,0.5293
"1420",236595,2009,"730",459,271,468,"156",312,0.6797,0.5756,0.6411
"1421",236896,2009,"316",157,159,59,"20",39,0.2484,0.1258,0.1867
"1422",236939,2009,"3627",1888,1739,1366,"549",817,0.4327,0.3157,0.3766
"1423",236948,2009,"5119",2795,2324,3227,"1338",1889,0.6758,0.5757,0.6304
"1424",237011,2009,"2670",1521,1149,1062,"369",693,0.4556,0.3211,0.3978
"1425",237057,2009,"395",238,157,314,"117",197,0.8277,0.7452,0.7949
"1426",237066,2009,"555",324,231,354,"145",209,0.6451,0.6277,0.6378
"1427",237215,2009,"304",177,127,28,"18",10,0.0565,0.1417,0.0921
"1428",237330,2009,"607",348,259,121,"44",77,0.2213,0.1699,0.1993
"1429",237358,2009,"234",139,95,60,"23",37,0.2662,0.2421,0.2564
"1430",237367,2009,"795",412,383,118,"58",60,0.1456,0.1514,0.1484
"1431",237792,2009,"786",437,349,169,"63",106,0.2426,0.1805,0.215
"1432",237899,2009,"246",120,126,28,"9",19,0.1583,0.0714,0.1138
"1433",237932,2009,"569",340,229,130,"33",97,0.2853,0.1441,0.2285
"1434",237969,2009,"399",197,202,151,"61",90,0.4569,0.302,0.3784
"1435",238032,2009,"4555",2098,2457,1501,"661",840,0.4004,0.269,0.3295
"1436",238333,2009,"332",199,133,233,"90",143,0.7186,0.6767,0.7018
"1437",238430,2009,"209",119,90,19,"4",15,0.1261,0.0444,0.0909
"1438",238458,2009,"738",482,256,311,"102",209,0.4336,0.3984,0.4214
"1439",238476,2009,"721",351,370,359,"158",201,0.5726,0.427,0.4979
"1440",238616,2009,"468",266,202,171,"63",108,0.406,0.3119,0.3654
"1441",238661,2009,"285",213,72,110,"27",83,0.3897,0.375,0.386
"1442",239080,2009,"316",228,88,88,"19",69,0.3026,0.2159,0.2785
"1443",239105,2009,"1945",1005,940,1135,"505",630,0.6269,0.5372,0.5835
"1444",239628,2009,"248",123,125,148,"68",80,0.6504,0.544,0.5968
"1445",239716,2009,"543",308,235,359,"135",224,0.7273,0.5745,0.6611
"1446",240107,2009,"405",287,118,119,"24",95,0.331,0.2034,0.2938
"1447",240189,2009,"1941",941,1000,542,"250",292,0.3103,0.25,0.2792
"1448",240277,2009,"1037",647,390,248,"58",190,0.2937,0.1487,0.2392
"1449",240329,2009,"1826",1128,698,660,"193",467,0.414,0.2765,0.3614
"1450",240338,2009,"202",104,98,89,"33",56,0.5385,0.3367,0.4406
"1451",240365,2009,"1874",1061,813,274,"95",179,0.1687,0.1169,0.1462
"1452",240374,2009,"788",427,361,88,"31",57,0.1335,0.0859,0.1117
"1453",240417,2009,"1517",788,729,350,"111",239,0.3033,0.1523,0.2307
"1454",240426,2009,"364",194,170,58,"22",36,0.1856,0.1294,0.1593
"1455",240444,2009,"5673",3033,2640,3179,"1277",1902,0.6271,0.4837,0.5604
"1456",240453,2009,"4051",2020,2031,578,"250",328,0.1624,0.1231,0.1427
"1457",240462,2009,"1531",512,1019,304,"166",138,0.2695,0.1629,0.1986
"1458",240471,2009,"1325",836,489,382,"108",274,0.3278,0.2209,0.2883
"1459",240480,2009,"1632",835,797,422,"156",266,0.3186,0.1957,0.2586
"1460",240727,2009,"1568",799,769,405,"136",269,0.3367,0.1769,0.2583
"1461",243443,2009,"726",461,265,43,"12",31,0.0672,0.0453,0.0592
"1462",243780,2009,"6308",2660,3648,2868,"1412",1456,0.5474,0.3871,0.4547
"1463",100654,2008,"1044",568,476,115,"23",92,0.162,0.0483,0.1102
"1464",100663,2008,"1246",710,536,406,"140",266,0.3746,0.2612,0.3258
"1465",100751,2008,"5009",2776,2233,1942,"703",1239,0.4463,0.3148,0.3877
"1466",100858,2008,"3967",2049,1918,1676,"627",1049,0.512,0.3269,0.4225
"1467",101435,2008,"253",106,147,76,"28",48,0.4528,0.1905,0.3004
"1468",101480,2008,"1243",663,580,108,"31",77,0.1161,0.0534,0.0869
"1469",101675,2008,"461",213,248,38,"5",33,0.1549,0.0202,0.0824
"1470",101879,2008,"988",533,455,119,"34",85,0.1595,0.0747,0.1204
"1471",102049,2008,"705",442,263,336,"104",232,0.5249,0.3954,0.4766
"1472",102094,2008,"1543",875,668,230,"68",162,0.1851,0.1018,0.1491
"1473",102234,2008,"344",213,131,175,"62",113,0.5305,0.4733,0.5087
"1474",102368,2008,"1827",1081,746,246,"76",170,0.1573,0.1019,0.1346
"1475",102377,2008,"722",414,308,154,"44",110,0.2657,0.1429,0.2133
"1476",104151,2008,"6743",3320,3423,2886,"1224",1662,0.5006,0.3576,0.428
"1477",104179,2008,"6331",3377,2954,2536,"1017",1519,0.4498,0.3443,0.4006
"1478",105330,2008,"3248",1899,1349,1078,"316",762,0.4013,0.2342,0.3319
"1479",106245,2008,"618",375,243,50,"23",27,0.072,0.0947,0.0809
"1480",106342,2008,"102",52,50,50,"25",25,0.4808,0.5,0.4902
"1481",106397,2008,"2977",1488,1489,1108,"475",633,0.4254,0.319,0.3722
"1482",106412,2008,"952",504,448,93,"21",72,0.1429,0.0469,0.0977
"1483",106458,2008,"1743",981,762,352,"129",223,0.2273,0.1693,0.202
"1484",106467,2008,"1450",763,687,305,"115",190,0.249,0.1674,0.2103
"1485",106485,2008,"661",361,300,89,"33",56,0.1551,0.11,0.1346
"1486",106704,2008,"2075",1165,910,444,"157",287,0.2464,0.1725,0.214
"1487",107044,2008,"980",537,443,425,"158",267,0.4972,0.3567,0.4337
"1488",107080,2008,"430",238,192,284,"122",162,0.6807,0.6354,0.6605
"1489",107141,2008,"307",165,142,160,"72",88,0.5333,0.507,0.5212
"1490",107512,2008,"404",220,184,205,"80",125,0.5682,0.4348,0.5074
"1491",107558,2008,"195",113,82,72,"27",45,0.3982,0.3293,0.3692
"1492",110097,2008,"846",530,316,430,"157",273,0.5151,0.4968,0.5083
"1493",110404,2008,"236",97,139,200,"112",88,0.9072,0.8058,0.8475
"1494",110422,2008,"3448",1553,1895,1246,"458",788,0.5074,0.2417,0.3614
"1495",110486,2008,"901",592,309,144,"45",99,0.1672,0.1456,0.1598
"1496",110495,2008,"899",576,323,133,"33",100,0.1736,0.1022,0.1479
"1497",110510,2008,"1916",1213,703,241,"77",164,0.1352,0.1095,0.1258
"1498",110529,2008,"2538",1068,1470,299,"135",164,0.1536,0.0918,0.1178
"1499",110538,2008,"2727",1420,1307,537,"163",374,0.2634,0.1247,0.1969
"1500",110547,2008,"889",599,290,42,"14",28,0.0467,0.0483,0.0472
"1501",110556,2008,"2731",1604,1127,402,"121",281,0.1752,0.1074,0.1472
"1502",110565,2008,"4519",2673,1846,630,"180",450,0.1684,0.0975,0.1394
"1503",110574,2008,"1356",828,528,141,"45",96,0.1159,0.0852,0.104
"1504",110583,2008,"4536",2856,1680,676,"183",493,0.1726,0.1089,0.149
"1505",110592,2008,"1676",1014,662,105,"40",65,0.0641,0.0604,0.0626
"1506",110617,2008,"2536",1493,1043,191,"50",141,0.0944,0.0479,0.0753
"1507",113698,2008,"267",202,65,146,"31",115,0.5693,0.4769,0.5468
"1508",115755,2008,"1168",661,507,147,"37",110,0.1664,0.073,0.1259
"1509",119173,2008,"313",302,11,84,"2",82,0.2715,0.1818,0.2684
"1510",120184,2008,"147",85,62,63,"21",42,0.4941,0.3387,0.4286
"1511",121309,2008,"538",327,211,318,"116",202,0.6177,0.5498,0.5911
"1512",121345,2008,"382",194,188,344,"168",176,0.9072,0.8936,0.9005
"1513",122409,2008,"3578",2086,1492,1053,"346",707,0.3389,0.2319,0.2943
"1514",122436,2008,"1259",771,488,838,"289",549,0.7121,0.5922,0.6656
"1515",122597,2008,"3512",2334,1178,524,"145",379,0.1624,0.1231,0.1492
"1516",122612,2008,"1036",686,350,632,"196",436,0.6356,0.56,0.61
"1517",122931,2008,"1220",623,597,951,"436",515,0.8266,0.7303,0.7795
"1518",123554,2008,"665",436,229,349,"100",249,0.5711,0.4367,0.5248
"1519",123572,2008,"1631",1058,573,444,"96",348,0.3289,0.1675,0.2722
"1520",126562,2008,"1036",603,433,156,"68",88,0.1459,0.157,0.1506
"1521",126580,2008,"1075",577,498,288,"110",178,0.3085,0.2209,0.2679
"1522",126614,2008,"5811",2890,2921,2678,"1158",1520,0.526,0.3964,0.4609
"1523",126818,2008,"4386",2435,1951,1693,"567",1126,0.4624,0.2906,0.386
"1524",127060,2008,"1131",633,498,743,"317",426,0.673,0.6365,0.6569
"1525",127185,2008,"758",355,403,136,"62",74,0.2085,0.1538,0.1794
"1526",127565,2008,"1918",969,949,88,"33",55,0.0568,0.0348,0.0459
"1527",127741,2008,"2071",1227,844,558,"156",402,0.3276,0.1848,0.2694
"1528",128106,2008,"1002",465,537,160,"65",95,0.2043,0.121,0.1597
"1529",128744,2008,"444",266,178,90,"30",60,0.2256,0.1685,0.2027
"1530",128771,2008,"1297",578,719,279,"133",146,0.2526,0.185,0.2151
"1531",129020,2008,"3587",1780,1807,2382,"1098",1284,0.7213,0.6076,0.6641
"1532",129242,2008,"898",537,361,688,"257",431,0.8026,0.7119,0.7661
"1533",129941,2008,"1129",569,560,430,"175",255,0.4482,0.3125,0.3809
"1534",130253,2008,"981",577,404,583,"201",382,0.662,0.4975,0.5943
"1535",130314,2008,"225",225,0,92,"0",92,0.4089,NA,0.4089
"1536",130493,2008,"1288",858,430,293,"77",216,0.2517,0.1791,0.2275
"1537",130590,2008,"589",300,289,464,"214",250,0.8333,0.7405,0.7878
"1538",130697,2008,"715",355,360,622,"300",322,0.907,0.8333,0.8699
"1539",130776,2008,"928",462,466,180,"82",98,0.2121,0.176,0.194
"1540",130794,2008,"1316",664,652,1150,"543",607,0.9142,0.8328,0.8739
"1541",130934,2008,"721",455,266,154,"36",118,0.2593,0.1353,0.2136
"1542",130943,2008,"3834",2211,1623,2378,"891",1487,0.6725,0.549,0.6202
"1543",131159,2008,"1570",967,603,1199,"442",757,0.7828,0.733,0.7637
"1544",131283,2008,"901",475,426,537,"234",303,0.6379,0.5493,0.596
"1545",131450,2008,"179",97,82,29,"9",20,0.2062,0.1098,0.162
"1546",131469,2008,"2449",1408,1041,1755,"687",1068,0.7585,0.6599,0.7166
"1547",131496,2008,"1571",822,749,1430,"665",765,0.9307,0.8879,0.9102
"1548",131520,2008,"1477",1004,473,629,"133",496,0.494,0.2812,0.4259
"1549",132471,2008,"584",400,184,120,"34",86,0.215,0.1848,0.2055
"1550",132602,2008,"719",478,241,198,"38",160,0.3347,0.1577,0.2754
"1551",132903,2008,"6139",3283,2856,2464,"867",1597,0.4864,0.3036,0.4014
"1552",133492,2008,"487",285,202,283,"116",167,0.586,0.5743,0.5811
"1553",133553,2008,"1058",158,900,325,"263",62,0.3924,0.2922,0.3072
"1554",133650,2008,"2090",1196,894,254,"79",175,0.1463,0.0884,0.1215
"1555",133669,2008,"2677",1407,1270,457,"149",308,0.2189,0.1173,0.1707
"1556",133711,2008,"645",365,280,312,"116",196,0.537,0.4143,0.4837
"1557",133881,2008,"635",194,441,247,"152",95,0.4897,0.3447,0.389
"1558",133951,2008,"3106",1642,1464,732,"234",498,0.3033,0.1598,0.2357
"1559",134079,2008,"497",304,193,277,"102",175,0.5757,0.5285,0.5573
"1560",134097,2008,"4993",2928,2065,3066,"1093",1973,0.6738,0.5293,0.6141
"1561",134130,2008,"6382",3787,2595,4289,"1442",2847,0.7518,0.5557,0.672
"1562",134945,2008,"539",249,290,151,"67",84,0.3373,0.231,0.2801
"1563",135726,2008,"1983",987,996,1358,"647",711,0.7204,0.6496,0.6848
"1564",136172,2008,"1694",1013,681,444,"115",329,0.3248,0.1689,0.2621
"1565",136950,2008,"464",262,202,293,"118",175,0.6679,0.5842,0.6315
"1566",137546,2008,"617",360,257,344,"133",211,0.5861,0.5175,0.5575
"1567",138354,2008,"1030",605,425,277,"94",183,0.3025,0.2212,0.2689
"1568",138716,2008,"626",392,234,65,"9",56,0.1429,0.0385,0.1038
"1569",138789,2008,"864",511,353,87,"23",64,0.1252,0.0652,0.1007
"1570",139144,2008,"448",311,137,243,"70",173,0.5563,0.5109,0.5424
"1571",139366,2008,"1114",642,472,131,"38",93,0.1449,0.0805,0.1176
"1572",139393,2008,"267",149,118,129,"51",78,0.5235,0.4322,0.4831
"1573",139658,2008,"1661",893,768,1064,"501",563,0.6305,0.6523,0.6406
"1574",139719,2008,"1074",568,506,117,"32",85,0.1496,0.0632,0.1089
"1575",139755,2008,"2633",838,1795,974,"604",370,0.4415,0.3365,0.3699
"1576",139764,2008,"418",240,178,42,"16",26,0.1083,0.0899,0.1005
"1577",139861,2008,"1177",751,426,470,"136",334,0.4447,0.3192,0.3993
"1578",139931,2008,"3106",1453,1653,828,"300",528,0.3634,0.1815,0.2666
"1579",139940,2008,"2743",1609,1134,614,"206",408,0.2536,0.1817,0.2238
"1580",139959,2008,"4778",3013,1765,2853,"924",1929,0.6402,0.5235,0.5971
"1581",140447,2008,"615",365,250,298,"94",204,0.5589,0.376,0.4846
"1582",140960,2008,"905",490,415,71,"22",49,0.1,0.053,0.0785
"1583",140988,2008,"330",163,167,117,"46",71,0.4356,0.2754,0.3545
"1584",141185,2008,"155",93,62,63,"20",43,0.4624,0.3226,0.4065
"1585",141264,2008,"2106",1223,883,344,"93",251,0.2052,0.1053,0.1633
"1586",141334,2008,"2008",1216,792,321,"88",233,0.1916,0.1111,0.1599
"1587",141486,2008,"236",161,75,69,"18",51,0.3168,0.24,0.2924
"1588",141565,2008,"536",326,210,61,"16",45,0.138,0.0762,0.1138
"1589",141574,2008,"1808",1027,781,358,"114",244,0.2376,0.146,0.198
"1590",142276,2008,"1031",525,506,94,"35",59,0.1124,0.0692,0.0912
"1591",142285,2008,"1663",777,886,460,"202",258,0.332,0.228,0.2766
"1592",142461,2008,"301",169,132,96,"34",62,0.3669,0.2576,0.3189
"1593",143084,2008,"640",369,271,454,"179",275,0.7453,0.6605,0.7094
"1594",143288,2008,"171",94,77,52,"18",34,0.3617,0.2338,0.3041
"1595",144005,2008,"402",279,123,10,"4",6,0.0215,0.0325,0.0249
"1596",144281,2008,"2329",1289,1040,690,"277",413,0.3204,0.2663,0.2963
"1597",144740,2008,"2553",1502,1051,1430,"537",893,0.5945,0.5109,0.5601
"1598",144892,2008,"1764",1029,735,582,"196",386,0.3751,0.2667,0.3299
"1599",144962,2008,"576",348,228,350,"113",237,0.681,0.4956,0.6076
"1600",144971,2008,"153",75,78,53,"18",35,0.4667,0.2308,0.3464
"1601",145600,2008,"2944",1659,1285,981,"392",589,0.355,0.3051,0.3332
"1602",145619,2008,"434",227,207,141,"57",84,0.37,0.2754,0.3249
"1603",145637,2008,"7277",3386,3891,5015,"2439",2576,0.7608,0.6268,0.6892
"1604",145691,2008,"166",84,82,110,"51",59,0.7024,0.622,0.6627
"1605",145813,2008,"3387",2088,1299,1545,"503",1042,0.499,0.3872,0.4562
"1606",146481,2008,"378",218,160,242,"85",157,0.7202,0.5312,0.6402
"1607",146612,2008,"650",345,305,272,"127",145,0.4203,0.4164,0.4185
"1608",146719,2008,"2176",1460,716,1419,"448",971,0.6651,0.6257,0.6521
"1609",146825,2008,"90",36,54,21,"8",13,0.3611,0.1481,0.2333
"1610",147013,2008,"308",145,163,110,"40",70,0.4828,0.2454,0.3571
"1611",147244,2008,"484",298,186,247,"83",164,0.5503,0.4462,0.5103
"1612",147341,2008,"383",179,204,182,"84",98,0.5475,0.4118,0.4752
"1613",147703,2008,"2844",1469,1375,718,"315",403,0.2743,0.2291,0.2525
"1614",147767,2008,"2077",1075,1002,1773,"822",951,0.8847,0.8204,0.8536
"1615",147776,2008,"952",519,433,48,"18",30,0.0578,0.0416,0.0504
"1616",147828,2008,"590",357,233,260,"76",184,0.5154,0.3262,0.4407
"1617",148131,2008,"245",108,137,81,"31",50,0.463,0.2263,0.3306
"1618",148496,2008,"416",291,125,198,"59",139,0.4777,0.472,0.476
"1619",148584,2008,"203",125,78,77,"27",50,0.4,0.3462,0.3793
"1620",148627,2008,"547",375,172,176,"55",121,0.3227,0.3198,0.3218
"1621",149222,2008,"2592",1183,1409,627,"305",322,0.2722,0.2165,0.2419
"1622",149231,2008,"1901",1101,800,545,"194",351,0.3188,0.2425,0.2867
"1623",149772,2008,"1806",881,925,536,"278",258,0.2928,0.3005,0.2968
"1624",149781,2008,"580",291,289,462,"219",243,0.8351,0.7578,0.7966
"1625",150066,2008,"540",316,224,259,"97",162,0.5127,0.433,0.4796
"1626",150136,2008,"3983",2188,1795,1384,"504",880,0.4022,0.2808,0.3475
"1627",150145,2008,"242",149,93,132,"45",87,0.5839,0.4839,0.5455
"1628",150163,2008,"934",566,368,580,"209",371,0.6555,0.5679,0.621
"1629",150400,2008,"600",341,259,448,"172",276,0.8094,0.6641,0.7467
"1630",150534,2008,"616",377,239,325,"116",209,0.5544,0.4854,0.5276
"1631",150668,2008,"172",97,75,95,"36",59,0.6082,0.48,0.5523
"1632",150941,2008,"275",161,114,133,"51",82,0.5093,0.4474,0.4836
"1633",151102,2008,"1905",1009,896,118,"36",82,0.0813,0.0402,0.0619
"1634",151111,2008,"2802",1657,1145,463,"170",293,0.1768,0.1485,0.1652
"1635",151306,2008,"2055",1232,823,340,"83",257,0.2086,0.1009,0.1655
"1636",151324,2008,"1907",954,953,357,"151",206,0.2159,0.1584,0.1872
"1637",151333,2008,"341",212,129,31,"6",25,0.1179,0.0465,0.0909
"1638",151342,2008,"943",590,353,54,"23",31,0.0525,0.0652,0.0573
"1639",151351,2008,"7550",3990,3560,4485,"1959",2526,0.6331,0.5503,0.594
"1640",151360,2008,"596",387,209,47,"13",34,0.0879,0.0622,0.0789
"1641",151379,2008,"970",590,380,81,"26",55,0.0932,0.0684,0.0835
"1642",151388,2008,"291",190,101,26,"8",18,0.0947,0.0792,0.0893
"1643",151777,2008,"396",202,194,190,"77",113,0.5594,0.3969,0.4798
"1644",151786,2008,"326",158,168,111,"50",61,0.3861,0.2976,0.3405
"1645",152080,2008,"1991",951,1040,1806,"932",874,0.919,0.8962,0.9071
"1646",152248,2008,"1213",624,589,108,"50",58,0.0929,0.0849,0.089
"1647",152363,2008,"296",144,152,118,"51",67,0.4653,0.3355,0.3986
"1648",152530,2008,"465",266,199,312,"115",197,0.7406,0.5779,0.671
"1649",152600,2008,"655",336,319,390,"169",221,0.6577,0.5298,0.5954
"1650",153001,2008,"273",117,156,96,"46",50,0.4274,0.2949,0.3516
"1651",153108,2008,"404",204,200,255,"101",154,0.7549,0.505,0.6312
"1652",153269,2008,"901",544,357,507,"199",308,0.5662,0.5574,0.5627
"1653",153384,2008,"462",251,211,392,"171",221,0.8805,0.8104,0.8485
"1654",153603,2008,"4528",2074,2454,1787,"772",1015,0.4894,0.3146,0.3947
"1655",153834,2008,"630",371,259,469,"194",275,0.7412,0.749,0.7444
"1656",154095,2008,"1972",1206,766,747,"254",493,0.4088,0.3316,0.3788
"1657",155089,2008,"169",100,69,20,"2",18,0.18,0.029,0.1183
"1658",155317,2008,"4435",2260,2175,1649,"670",979,0.4332,0.308,0.3718
"1659",155335,2008,"115",74,41,36,"10",26,0.3514,0.2439,0.313
"1660",155399,2008,"3518",1780,1738,960,"339",621,0.3489,0.1951,0.2729
"1661",155520,2008,"208",114,94,69,"25",44,0.386,0.266,0.3317
"1662",155627,2008,"201",100,101,40,"17",23,0.23,0.1683,0.199
"1663",155937,2008,"150",71,79,44,"15",29,0.4085,0.1899,0.2933
"1664",156213,2008,"313",208,105,173,"57",116,0.5577,0.5429,0.5527
"1665",156286,2008,"567",356,211,301,"109",192,0.5393,0.5166,0.5309
"1666",156295,2008,"413",241,172,184,"72",112,0.4647,0.4186,0.4455
"1667",156365,2008,"442",192,250,112,"56",56,0.2917,0.224,0.2534
"1668",156541,2008,"478",223,255,120,"38",82,0.3677,0.149,0.251
"1669",156745,2008,"379",209,170,169,"61",108,0.5167,0.3588,0.4459
"1670",157058,2008,"566",293,273,32,"7",25,0.0853,0.0256,0.0565
"1671",157076,2008,"219",103,116,81,"44",37,0.3592,0.3793,0.3699
"1672",157085,2008,"4074",2086,1988,1323,"513",810,0.3883,0.258,0.3247
"1673",157289,2008,"2548",1344,1204,915,"391",524,0.3899,0.3248,0.3591
"1674",157386,2008,"1313",777,536,235,"78",157,0.2021,0.1455,0.179
"1675",157401,2008,"1452",875,577,415,"120",295,0.3371,0.208,0.2858
"1676",157447,2008,"2001",1117,884,252,"77",175,0.1567,0.0871,0.1259
"1677",157535,2008,"177",83,94,41,"13",28,0.3373,0.1383,0.2316
"1678",157951,2008,"3203",1821,1382,684,"247",437,0.24,0.1787,0.2135
"1679",158477,2008,"246",148,98,104,"41",63,0.4257,0.4184,0.4228
"1680",159009,2008,"1203",626,577,144,"53",91,0.1454,0.0919,0.1197
"1681",159391,2008,"5131",2781,2350,1900,"699",1201,0.4319,0.2974,0.3703
"1682",159647,2008,"1503",695,808,428,"187",241,0.3468,0.2314,0.2848
"1683",159717,2008,"1272",742,530,203,"62",141,0.19,0.117,0.1596
"1684",159966,2008,"1217",712,505,207,"60",147,0.2065,0.1188,0.1701
"1685",160038,2008,"1183",736,447,225,"69",156,0.212,0.1544,0.1902
"1686",160612,2008,"2613",1538,1075,358,"112",246,0.1599,0.1042,0.137
"1687",160621,2008,"1034",605,429,62,"19",43,0.0711,0.0443,0.06
"1688",160658,2008,"2566",1435,1131,373,"128",245,0.1707,0.1132,0.1454
"1689",161004,2008,"488",232,256,420,"203",217,0.9353,0.793,0.8607
"1690",161226,2008,"512",335,177,184,"47",137,0.409,0.2655,0.3594
"1691",161235,2008,"111",60,51,27,"14",13,0.2167,0.2745,0.2432
"1692",161244,2008,"105",62,43,23,"8",15,0.2419,0.186,0.219
"1693",161253,2008,"1931",947,984,717,"320",397,0.4192,0.3252,0.3713
"1694",161554,2008,"991",531,460,126,"53",73,0.1375,0.1152,0.1271
"1695",162007,2008,"664",393,271,52,"12",40,0.1018,0.0443,0.0783
"1696",162210,2008,"98",61,37,16,"4",12,0.1967,0.1081,0.1633
"1697",162283,2008,"570",428,142,28,"6",22,0.0514,0.0423,0.0491
"1698",162584,2008,"1030",478,552,201,"86",115,0.2406,0.1558,0.1951
"1699",162654,2008,"360",262,98,205,"54",151,0.5763,0.551,0.5694
"1700",162760,2008,"308",200,108,179,"57",122,0.61,0.5278,0.5812
"1701",162928,2008,"1315",612,703,1140,"587",553,0.9036,0.835,0.8669
"1702",163046,2008,"1066",637,429,825,"307",518,0.8132,0.7156,0.7739
"1703",163268,2008,"1555",650,905,531,"237",294,0.4523,0.2619,0.3415
"1704",163286,2008,"3907",1824,2083,2610,"1298",1312,0.7193,0.6231,0.668
"1705",163453,2008,"1430",808,622,169,"46",123,0.1522,0.074,0.1182
"1706",163462,2008,"410",218,192,236,"99",137,0.6284,0.5156,0.5756
"1707",163851,2008,"1198",694,504,533,"151",382,0.5504,0.2996,0.4449
"1708",163912,2008,"458",279,179,332,"119",213,0.7634,0.6648,0.7249
"1709",164076,2008,"2825",1786,1039,1210,"385",825,0.4619,0.3705,0.4283
"1710",164173,2008,"626",436,190,301,"81",220,0.5046,0.4263,0.4808
"1711",164216,2008,"415",248,167,291,"108",183,0.7379,0.6467,0.7012
"1712",164270,2008,"426",223,203,263,"117",146,0.6547,0.5764,0.6174
"1713",164447,2008,"371",185,186,102,"46",56,0.3027,0.2473,0.2749
"1714",164492,2008,"245",135,110,81,"38",43,0.3185,0.3455,0.3306
"1715",164562,2008,"606",357,249,402,"151",251,0.7031,0.6064,0.6634
"1716",165015,2008,"754",426,328,643,"274",369,0.8662,0.8354,0.8528
"1717",165024,2008,"1464",915,549,412,"134",278,0.3038,0.2441,0.2814
"1718",165334,2008,"586",348,238,424,"162",262,0.7529,0.6807,0.7235
"1719",165662,2008,"772",466,306,598,"243",355,0.7618,0.7941,0.7746
"1720",165671,2008,"480",346,134,268,"73",195,0.5636,0.5448,0.5583
"1721",165820,2008,"763",421,342,227,"76",151,0.3587,0.2222,0.2975
"1722",165866,2008,"644",450,194,213,"49",164,0.3644,0.2526,0.3307
"1723",165936,2008,"419",260,159,256,"91",165,0.6346,0.5723,0.611
"1724",166027,2008,"1656",836,820,1420,"677",743,0.8888,0.8256,0.8575
"1725",166124,2008,"737",420,317,664,"285",379,0.9024,0.8991,0.9009
"1726",166513,2008,"1514",540,974,411,"213",198,0.3667,0.2187,0.2715
"1727",166629,2008,"4256",2200,2056,2594,"1140",1454,0.6609,0.5545,0.6095
"1728",166638,2008,"972",570,402,154,"60",94,0.1649,0.1493,0.1584
"1729",166683,2008,"1046",487,559,849,"441",408,0.8378,0.7889,0.8117
"1730",167288,2008,"325",193,132,109,"38",71,0.3679,0.2879,0.3354
"1731",167987,2008,"1768",837,931,485,"210",275,0.3286,0.2256,0.2743
"1732",167996,2008,"634",384,250,503,"185",318,0.8281,0.74,0.7934
"1733",168005,2008,"1557",920,637,607,"215",392,0.4261,0.3375,0.3899
"1734",168148,2008,"1298",702,596,1141,"511",630,0.8974,0.8574,0.879
"1735",168254,2008,"735",281,454,370,"206",164,0.5836,0.4537,0.5034
"1736",168281,2008,"420",259,161,313,"116",197,0.7606,0.7205,0.7452
"1737",168342,2008,"538",284,254,476,"222",254,0.8944,0.874,0.8848
"1738",168546,2008,"485",242,243,297,"137",160,0.6612,0.5638,0.6124
"1739",168786,2008,"456",283,173,138,"43",95,0.3357,0.2486,0.3026
"1740",169080,2008,"935",500,435,539,"235",304,0.608,0.5402,0.5765
"1741",169798,2008,"2167",1283,884,269,"84",185,0.1442,0.095,0.1241
"1742",169910,2008,"2103",992,1111,169,"75",94,0.0948,0.0675,0.0804
"1743",170082,2008,"3879",2413,1466,1216,"403",813,0.3369,0.2749,0.3135
"1744",170301,2008,"805",499,306,565,"189",376,0.7535,0.6176,0.7019
"1745",170532,2008,"364",200,164,279,"128",151,0.755,0.7805,0.7665
"1746",170639,2008,"490",250,240,72,"32",40,0.16,0.1333,0.1469
"1747",170976,2008,"5738",2905,2833,4336,"1989",2347,0.8079,0.7021,0.7557
"1748",171100,2008,"7385",4098,3287,3831,"1442",2389,0.583,0.4387,0.5188
"1749",171128,2008,"1361",318,1043,333,"218",115,0.3616,0.209,0.2447
"1750",171137,2008,"905",436,469,145,"60",85,0.195,0.1279,0.1602
"1751",171146,2008,"846",512,334,78,"31",47,0.0918,0.0928,0.0922
"1752",171599,2008,"282",99,183,76,"34",42,0.4242,0.1858,0.2695
"1753",172051,2008,"1647",949,698,144,"50",94,0.0991,0.0716,0.0874
"1754",172699,2008,"3803",1934,1869,880,"381",499,0.258,0.2039,0.2314
"1755",173160,2008,"632",377,255,408,"155",253,0.6711,0.6078,0.6456
"1756",173258,2008,"488",244,244,444,"220",224,0.918,0.9016,0.9098
"1757",173328,2008,"211",116,95,60,"25",35,0.3017,0.2632,0.2844
"1758",173647,2008,"616",346,270,495,"211",284,0.8208,0.7815,0.8036
"1759",173902,2008,"478",279,199,401,"161",240,0.8602,0.809,0.8389
"1760",174066,2008,"5089",2813,2276,2975,"1224",1751,0.6225,0.5378,0.5846
"1761",174233,2008,"2213",1110,1103,760,"306",454,0.409,0.2774,0.3434
"1762",174251,2008,"373",209,164,200,"80",120,0.5742,0.4878,0.5362
"1763",174491,2008,"455",273,182,202,"62",140,0.5128,0.3407,0.444
"1764",174792,2008,"461",0,461,332,"332",0,NA,0.7202,0.7202
"1765",174844,2008,"813",454,359,698,"292",406,0.8943,0.8134,0.8585
"1766",174899,2008,"575",381,194,314,"93",221,0.5801,0.4794,0.5461
"1767",174914,2008,"1321",638,683,792,"374",418,0.6552,0.5476,0.5995
"1768",175342,2008,"451",261,190,87,"36",51,0.1954,0.1895,0.1929
"1769",175421,2008,"239",146,93,79,"27",52,0.3562,0.2903,0.3305
"1770",175616,2008,"384",227,157,58,"19",39,0.1718,0.121,0.151
"1771",175856,2008,"938",547,391,177,"48",129,0.2358,0.1228,0.1887
"1772",175980,2008,"266",141,125,165,"66",99,0.7021,0.528,0.6203
"1773",176017,2008,"2316",1272,1044,857,"301",556,0.4371,0.2883,0.37
"1774",176035,2008,"252",212,40,54,"7",47,0.2217,0.175,0.2143
"1775",176044,2008,"446",203,243,57,"23",34,0.1675,0.0947,0.1278
"1776",176080,2008,"2474",1278,1196,746,"282",464,0.3631,0.2358,0.3015
"1777",176406,2008,"237",158,79,68,"19",49,0.3101,0.2405,0.2869
"1778",176628,2008,"183",105,78,45,"9",36,0.3429,0.1154,0.2459
"1779",176947,2008,"300",141,159,110,"47",63,0.4468,0.2956,0.3667
"1780",176965,2008,"1583",854,729,463,"185",278,0.3255,0.2538,0.2925
"1781",177418,2008,"187",112,75,44,"12",32,0.2857,0.16,0.2353
"1782",178059,2008,"318",236,82,149,"39",110,0.4661,0.4756,0.4686
"1783",178341,2008,"727",398,329,106,"34",72,0.1809,0.1033,0.1458
"1784",178387,2008,"956",536,420,146,"44",102,0.1903,0.1048,0.1527
"1785",178396,2008,"5698",3031,2667,2622,"1004",1618,0.5338,0.3765,0.4602
"1786",178402,2008,"971",589,382,218,"68",150,0.2547,0.178,0.2245
"1787",178411,2008,"1036",234,802,253,"181",72,0.3077,0.2257,0.2442
"1788",178420,2008,"437",244,193,92,"34",58,0.2377,0.1762,0.2105
"1789",178615,2008,"1334",779,555,757,"251",506,0.6496,0.4523,0.5675
"1790",179043,2008,"358",237,121,223,"69",154,0.6498,0.5702,0.6229
"1791",179159,2008,"1624",923,701,945,"365",580,0.6284,0.5207,0.5819
"1792",179557,2008,"1672",1054,618,492,"141",351,0.333,0.2282,0.2943
"1793",179566,2008,"2532",1464,1068,785,"258",527,0.36,0.2416,0.31
"1794",179867,2008,"1408",711,697,1270,"605",665,0.9353,0.868,0.902
"1795",179894,2008,"407",250,157,173,"58",115,0.46,0.3694,0.4251
"1796",179946,2008,"244",108,136,123,"67",56,0.5185,0.4926,0.5041
"1797",180179,2008,"692",402,290,47,"14",33,0.0821,0.0483,0.0679
"1798",180461,2008,"1805",765,1040,354,"154",200,0.2614,0.1481,0.1961
"1799",180522,2008,"199",70,129,14,"5",9,0.1286,0.0388,0.0704
"1800",180984,2008,"273",129,144,125,"57",68,0.5271,0.3958,0.4579
"1801",181002,2008,"984",582,402,647,"257",390,0.6701,0.6393,0.6575
"1802",181020,2008,"247",105,142,135,"62",73,0.6952,0.4366,0.5466
"1803",181127,2008,"320",151,169,153,"63",90,0.596,0.3728,0.4781
"1804",181215,2008,"1019",530,489,232,"87",145,0.2736,0.1779,0.2277
"1805",181394,2008,"1755",920,835,286,"107",179,0.1946,0.1281,0.163
"1806",181446,2008,"383",212,171,211,"76",135,0.6368,0.4444,0.5509
"1807",181464,2008,"4164",2015,2149,1377,"566",811,0.4025,0.2634,0.3307
"1808",181534,2008,"210",101,109,23,"10",13,0.1287,0.0917,0.1095
"1809",181783,2008,"653",345,308,148,"52",96,0.2783,0.1688,0.2266
"1810",182281,2008,"3020",1709,1311,422,"142",280,0.1638,0.1083,0.1397
"1811",182290,2008,"2260",1211,1049,467,"179",288,0.2378,0.1706,0.2066
"1812",182634,2008,"376",251,125,138,"44",94,0.3745,0.352,0.367
"1813",182795,2008,"474",205,269,185,"89",96,0.4683,0.3309,0.3903
"1814",183062,2008,"1287",777,510,667,"238",429,0.5521,0.4667,0.5183
"1815",183080,2008,"1087",500,587,476,"214",262,0.524,0.3646,0.4379
"1816",183239,2008,"500",286,214,351,"143",208,0.7273,0.6682,0.702
"1817",183822,2008,"392",237,155,23,"10",13,0.0549,0.0645,0.0587
"1818",183974,2008,"310",196,114,188,"63",125,0.6378,0.5526,0.6065
"1819",184348,2008,"390",256,134,222,"75",147,0.5742,0.5597,0.5692
"1820",184603,2008,"461",276,185,126,"39",87,0.3152,0.2108,0.2733
"1821",184612,2008,"245",170,75,42,"9",33,0.1941,0.12,0.1714
"1822",184782,2008,"1174",516,658,502,"269",233,0.4516,0.4088,0.4276
"1823",185129,2008,"563",306,257,42,"19",23,0.0752,0.0739,0.0746
"1824",185572,2008,"960",549,411,473,"187",286,0.5209,0.455,0.4927
"1825",185590,2008,"2257",1365,892,817,"230",587,0.43,0.2578,0.362
"1826",185828,2008,"779",158,621,185,"136",49,0.3101,0.219,0.2375
"1827",186131,2008,"1243",620,623,1121,"545",576,0.929,0.8748,0.9019
"1828",186201,2008,"877",513,364,511,"177",334,0.6511,0.4863,0.5827
"1829",186283,2008,"875",516,359,460,"167",293,0.5678,0.4652,0.5257
"1830",186584,2008,"1216",688,528,687,"282",405,0.5887,0.5341,0.565
"1831",186876,2008,"840",458,382,425,"156",269,0.5873,0.4084,0.506
"1832",187134,2008,"1295",763,532,939,"356",583,0.7641,0.6692,0.7251
"1833",187444,2008,"1204",617,587,215,"75",140,0.2269,0.1278,0.1786
"1834",187985,2008,"3148",1737,1411,459,"161",298,0.1716,0.1141,0.1458
"1835",188030,2008,"2171",1175,996,337,"130",207,0.1762,0.1305,0.1552
"1836",188429,2008,"944",614,330,510,"146",364,0.5928,0.4424,0.5403
"1837",188641,2008,"502",219,283,193,"99",94,0.4292,0.3498,0.3845
"1838",190044,2008,"734",204,530,407,"274",133,0.652,0.517,0.5545
"1839",190099,2008,"737",386,351,661,"307",354,0.9171,0.8746,0.8969
"1840",190150,2008,"1374",653,721,1208,"613",595,0.9112,0.8502,0.8792
"1841",190248,2008,"104",58,46,40,"12",28,0.4828,0.2609,0.3846
"1842",190415,2008,"3132",1573,1559,2718,"1307",1411,0.897,0.8384,0.8678
"1843",190512,2008,"1497",693,804,530,"250",280,0.404,0.3109,0.354
"1844",190549,2008,"1330",792,538,319,"107",212,0.2677,0.1989,0.2398
"1845",190558,2008,"2282",1209,1073,112,"47",65,0.0538,0.0438,0.0491
"1846",190567,2008,"1744",919,825,182,"67",115,0.1251,0.0812,0.1044
"1847",190594,2008,"1988",1273,715,445,"108",337,0.2647,0.151,0.2238
"1848",190637,2008,"987",654,333,139,"40",99,0.1514,0.1201,0.1408
"1849",190664,2008,"1642",961,681,445,"125",320,0.333,0.1836,0.271
"1850",190691,2008,"1024",673,351,80,"26",54,0.0802,0.0741,0.0781
"1851",190725,2008,"405",309,96,110,"24",86,0.2783,0.25,0.2716
"1852",191241,2008,"1852",991,861,1385,"629",756,0.7629,0.7305,0.7478
"1853",191515,2008,"461",257,204,396,"164",232,0.9027,0.8039,0.859
"1854",191533,2008,"444",250,194,224,"91",133,0.532,0.4691,0.5045
"1855",191630,2008,"544",288,256,404,"179",225,0.7812,0.6992,0.7426
"1856",191649,2008,"1637",864,773,816,"344",472,0.5463,0.445,0.4985
"1857",191676,2008,"327",211,116,193,"56",137,0.6493,0.4828,0.5902
"1858",191931,2008,"921",498,423,469,"167",302,0.6064,0.3948,0.5092
"1859",191968,2008,"1441",862,579,1017,"397",620,0.7193,0.6857,0.7058
"1860",192192,2008,"270",200,70,98,"21",77,0.385,0.3,0.363
"1861",192323,2008,"541",335,206,331,"114",217,0.6478,0.5534,0.6118
"1862",192439,2008,"992",706,286,73,"18",55,0.0779,0.0629,0.0736
"1863",192703,2008,"726",351,375,475,"226",249,0.7094,0.6027,0.6543
"1864",192749,2008,"476",326,150,270,"82",188,0.5767,0.5467,0.5672
"1865",192819,2008,"1018",611,407,697,"249",448,0.7332,0.6118,0.6847
"1866",192925,2008,"408",253,155,105,"49",56,0.2213,0.3161,0.2574
"1867",193016,2008,"677",441,236,92,"14",78,0.1769,0.0593,0.1359
"1868",193292,2008,"393",288,105,156,"32",124,0.4306,0.3048,0.3969
"1869",193353,2008,"432",318,114,191,"50",141,0.4434,0.4386,0.4421
"1870",193399,2008,"374",267,107,146,"34",112,0.4195,0.3178,0.3904
"1871",193584,2008,"471",361,110,306,"62",244,0.6759,0.5636,0.6497
"1872",193645,2008,"504",461,43,86,"2",84,0.1822,0.0465,0.1706
"1873",193654,2008,"1058",746,312,482,"113",369,0.4946,0.3622,0.4556
"1874",193900,2008,"4786",2738,2048,2740,"1134",1606,0.5866,0.5537,0.5725
"1875",193973,2008,"738",454,284,435,"146",289,0.6366,0.5141,0.5894
"1876",194161,2008,"253",140,113,61,"22",39,0.2786,0.1947,0.2411
"1877",194310,2008,"1616",1002,614,589,"208",381,0.3802,0.3388,0.3645
"1878",194824,2008,"1355",380,975,833,"599",234,0.6158,0.6144,0.6148
"1879",195003,2008,"2594",848,1746,706,"357",349,0.4116,0.2045,0.2722
"1880",195030,2008,"1282",642,640,936,"442",494,0.7695,0.6906,0.7301
"1881",195164,2008,"563",315,248,310,"113",197,0.6254,0.4556,0.5506
"1882",195173,2008,"566",292,274,160,"68",92,0.3151,0.2482,0.2827
"1883",195216,2008,"616",334,282,490,"220",270,0.8084,0.7801,0.7955
"1884",195234,2008,"574",415,159,312,"72",240,0.5783,0.4528,0.5436
"1885",195243,2008,"352",213,139,140,"44",96,0.4507,0.3165,0.3977
"1886",195304,2008,"348",273,75,246,"57",189,0.6923,0.76,0.7069
"1887",195474,2008,"824",444,380,613,"272",341,0.768,0.7158,0.7439
"1888",195526,2008,"652",400,252,552,"212",340,0.85,0.8413,0.8466
"1889",195544,2008,"613",420,193,326,"84",242,0.5762,0.4352,0.5318
"1890",195809,2008,"3258",1737,1521,1294,"521",773,0.445,0.3425,0.3972
"1891",196413,2008,"3161",1853,1308,2173,"846",1327,0.7161,0.6468,0.6874
"1892",196592,2008,"790",486,304,69,"27",42,0.0864,0.0888,0.0873
"1893",197045,2008,"568",254,314,171,"82",89,0.3504,0.2611,0.3011
"1894",197133,2008,"638",365,273,560,"235",325,0.8904,0.8608,0.8777
"1895",197869,2008,"2768",1415,1353,1221,"462",759,0.5364,0.3415,0.4411
"1896",197984,2008,"286",134,152,93,"39",54,0.403,0.2566,0.3252
"1897",198385,2008,"480",250,230,436,"209",227,0.908,0.9087,0.9083
"1898",198464,2008,"4515",2608,1907,1468,"483",985,0.3777,0.2533,0.3251
"1899",198507,2008,"636",368,268,95,"25",70,0.1902,0.0933,0.1494
"1900",198516,2008,"1290",777,513,977,"358",619,0.7967,0.6979,0.7574
"1901",198835,2008,"345",217,128,140,"32",108,0.4977,0.25,0.4058
"1902",198969,2008,"439",148,291,64,"26",38,0.2568,0.0893,0.1458
"1903",199102,2008,"1592",848,744,342,"105",237,0.2795,0.1411,0.2148
"1904",199111,2008,"586",361,225,225,"77",148,0.41,0.3422,0.384
"1905",199120,2008,"3852",2270,1582,3096,"1188",1908,0.8405,0.7509,0.8037
"1906",199139,2008,"3059",1610,1449,766,"289",477,0.2963,0.1994,0.2504
"1907",199148,2008,"2471",1703,768,759,"183",576,0.3382,0.2383,0.3072
"1908",199157,2008,"1026",683,343,224,"56",168,0.246,0.1633,0.2183
"1909",199193,2008,"4792",2184,2608,2029,"863",1166,0.5339,0.3309,0.4234
"1910",199218,2008,"2069",1229,840,1017,"326",691,0.5622,0.3881,0.4915
"1911",199281,2008,"1054",563,491,157,"50",107,0.1901,0.1018,0.149
"1912",199306,2008,"192",91,101,48,"15",33,0.3626,0.1485,0.25
"1913",199412,2008,"307",214,93,164,"49",115,0.5374,0.5269,0.5342
"1914",199582,2008,"484",233,251,87,"33",54,0.2318,0.1315,0.1798
"1915",199643,2008,"532",308,224,64,"21",43,0.1396,0.0938,0.1203
"1916",199847,2008,"1197",621,576,991,"455",536,0.8631,0.7899,0.8279
"1917",199962,2008,"431",223,208,183,"79",104,0.4664,0.3798,0.4246
"1918",199999,2008,"1353",886,467,234,"62",172,0.1941,0.1328,0.1729
"1919",200004,2008,"1218",617,601,485,"198",287,0.4652,0.3295,0.3982
"1920",200059,2008,"320",142,178,34,"16",18,0.1268,0.0899,0.1062
"1921",200156,2008,"267",123,144,74,"27",47,0.3821,0.1875,0.2772
"1922",200217,2008,"373",227,146,108,"25",83,0.3656,0.1712,0.2895
"1923",200226,2008,"89",52,37,17,"5",12,0.2308,0.1351,0.191
"1924",200253,2008,"406",259,147,55,"11",44,0.1699,0.0748,0.1355
"1925",200280,2008,"1923",896,1027,450,"214",236,0.2634,0.2084,0.234
"1926",200332,2008,"2650",1182,1468,667,"326",341,0.2885,0.2221,0.2517
"1927",200572,2008,"154",70,84,35,"14",21,0.3,0.1667,0.2273
"1928",201104,2008,"570",306,264,236,"83",153,0.5,0.3144,0.414
"1929",201371,2008,"272",140,132,144,"62",82,0.5857,0.4697,0.5294
"1930",201548,2008,"632",354,278,321,"122",199,0.5621,0.4388,0.5079
"1931",201645,2008,"1023",442,581,651,"337",314,0.7104,0.58,0.6364
"1932",201690,2008,"646",330,316,72,"10",62,0.1879,0.0316,0.1115
"1933",202134,2008,"1005",548,457,150,"50",100,0.1825,0.1094,0.1493
"1934",202480,2008,"1985",1045,940,1177,"452",725,0.6938,0.4809,0.5929
"1935",202523,2008,"604",325,279,476,"202",274,0.8431,0.724,0.7881
"1936",202763,2008,"562",391,171,242,"56",186,0.4757,0.3275,0.4306
"1937",203085,2008,"402",177,225,142,"61",81,0.4576,0.2711,0.3532
"1938",203128,2008,"331",164,167,189,"82",107,0.6524,0.491,0.571
"1939",203368,2008,"789",393,396,473,"209",264,0.6718,0.5278,0.5995
"1940",203517,2008,"3684",2261,1423,1135,"325",810,0.3582,0.2284,0.3081
"1941",203535,2008,"455",237,218,404,"192",212,0.8945,0.8807,0.8879
"1942",203580,2008,"249",131,118,91,"29",62,0.4733,0.2458,0.3655
"1943",203775,2008,"389",233,156,147,"44",103,0.4421,0.2821,0.3779
"1944",203845,2008,"385",178,207,201,"95",106,0.5955,0.4589,0.5221
"1945",204024,2008,"3598",1955,1643,2357,"959",1398,0.7151,0.5837,0.6551
"1946",204185,2008,"663",321,342,336,"126",210,0.6542,0.3684,0.5068
"1947",204194,2008,"368",234,134,183,"66",117,0.5,0.4925,0.4973
"1948",204617,2008,"356",194,162,113,"49",64,0.3299,0.3025,0.3174
"1949",204796,2008,"6151",3068,3083,3780,"1643",2137,0.6965,0.5329,0.6145
"1950",204857,2008,"3908",2114,1794,1910,"769",1141,0.5397,0.4287,0.4887
"1951",206330,2008,"226",72,154,67,"32",35,0.4861,0.2078,0.2965
"1952",206589,2008,"518",267,251,364,"160",204,0.764,0.6375,0.7027
"1953",206604,2008,"2596",1496,1100,556,"193",363,0.2426,0.1755,0.2142
"1954",206622,2008,"859",436,423,542,"244",298,0.6835,0.5768,0.631
"1955",206695,2008,"2189",1090,1099,199,"74",125,0.1147,0.0673,0.0909
"1956",206914,2008,"817",457,360,66,"22",44,0.0963,0.0611,0.0808
"1957",207209,2008,"593",281,312,19,"2",17,0.0605,0.0064,0.032
"1958",207306,2008,"317",162,155,47,"14",33,0.2037,0.0903,0.1483
"1959",207324,2008,"430",206,224,113,"50",63,0.3058,0.2232,0.2628
"1960",207388,2008,"2946",1501,1445,992,"361",631,0.4204,0.2498,0.3367
"1961",207500,2008,"3750",2058,1692,1394,"525",869,0.4223,0.3103,0.3717
"1962",207722,2008,"203",126,77,88,"28",60,0.4762,0.3636,0.4335
"1963",207847,2008,"583",296,287,68,"29",39,0.1318,0.101,0.1166
"1964",207865,2008,"920",511,409,124,"41",83,0.1624,0.1002,0.1348
"1965",208822,2008,"401",245,156,204,"74",130,0.5306,0.4744,0.5087
"1966",209056,2008,"534",323,211,381,"135",246,0.7616,0.6398,0.7135
"1967",209065,2008,"474",274,200,290,"106",184,0.6715,0.53,0.6118
"1968",209542,2008,"3006",1422,1584,922,"373",549,0.3861,0.2355,0.3067
"1969",209551,2008,"4191",2129,2062,1903,"824",1079,0.5068,0.3996,0.4541
"1970",209612,2008,"345",227,118,174,"60",114,0.5022,0.5085,0.5043
"1971",209807,2008,"1567",839,728,264,"105",159,0.1895,0.1442,0.1685
"1972",209922,2008,"329",194,135,219,"88",131,0.6753,0.6519,0.6657
"1973",210146,2008,"675",407,268,147,"46",101,0.2482,0.1716,0.2178
"1974",210401,2008,"482",278,204,333,"129",204,0.7338,0.6324,0.6909
"1975",210429,2008,"882",524,358,197,"58",139,0.2653,0.162,0.2234
"1976",210571,2008,"505",260,245,224,"86",138,0.5308,0.351,0.4436
"1977",210669,2008,"562",306,256,412,"179",233,0.7614,0.6992,0.7331
"1978",210775,2008,"383",233,150,148,"44",104,0.4464,0.2933,0.3864
"1979",211088,2008,"593",434,159,294,"73",221,0.5092,0.4591,0.4958
"1980",211158,2008,"1805",1028,777,781,"263",518,0.5039,0.3385,0.4327
"1981",211291,2008,"956",529,427,814,"357",457,0.8639,0.8361,0.8515
"1982",211352,2008,"503",341,162,210,"62",148,0.434,0.3827,0.4175
"1983",211361,2008,"1363",748,615,355,"130",225,0.3008,0.2114,0.2605
"1984",211431,2008,"226",215,11,99,"2",97,0.4512,0.1818,0.4381
"1985",211440,2008,"1462",625,837,1050,"580",470,0.752,0.693,0.7182
"1986",211468,2008,"194",194,0,114,"0",114,0.5876,NA,0.5876
"1987",211556,2008,"176",176,0,82,"0",82,0.4659,NA,0.4659
"1988",211583,2008,"194",115,79,72,"24",48,0.4174,0.3038,0.3711
"1989",211608,2008,"280",157,123,31,"6",25,0.1592,0.0488,0.1107
"1990",211644,2008,"1305",747,558,355,"116",239,0.3199,0.2079,0.272
"1991",211981,2008,"429",253,176,220,"78",142,0.5613,0.4432,0.5128
"1992",212009,2008,"613",337,276,495,"204",291,0.8635,0.7391,0.8075
"1993",212054,2008,"2402",992,1410,579,"206",373,0.376,0.1461,0.241
"1994",212106,2008,"1425",838,587,801,"308",493,0.5883,0.5247,0.5621
"1995",212115,2008,"1262",655,607,458,"167",291,0.4443,0.2751,0.3629
"1996",212133,2008,"550",367,183,233,"68",165,0.4496,0.3716,0.4236
"1997",212160,2008,"1219",697,522,245,"77",168,0.241,0.1475,0.201
"1998",212197,2008,"508",331,177,328,"114",214,0.6465,0.6441,0.6457
"1999",212577,2008,"588",321,267,485,"210",275,0.8567,0.7865,0.8248
"2000",212601,2008,"620",367,253,289,"106",183,0.4986,0.419,0.4661
"2001",212832,2008,"339",223,116,56,"23",33,0.148,0.1983,0.1652
"2002",212911,2008,"327",182,145,287,"124",163,0.8956,0.8552,0.8777
"2003",213020,2008,"3065",1790,1275,1041,"323",718,0.4011,0.2533,0.3396
"2004",213251,2008,"461",260,201,332,"134",198,0.7615,0.6667,0.7202
"2005",213321,2008,"559",295,264,315,"134",181,0.6136,0.5076,0.5635
"2006",213349,2008,"1812",1034,778,680,"206",474,0.4584,0.2648,0.3753
"2007",213358,2008,"227",148,79,60,"15",45,0.3041,0.1899,0.2643
"2008",213367,2008,"902",519,383,471,"190",281,0.5414,0.4961,0.5222
"2009",213385,2008,"600",270,330,530,"280",250,0.9259,0.8485,0.8833
"2010",213507,2008,"395",217,178,276,"110",166,0.765,0.618,0.6987
"2011",213543,2008,"1205",516,689,910,"484",426,0.8256,0.7025,0.7552
"2012",213613,2008,"1269",731,538,340,"119",221,0.3023,0.2212,0.2679
"2013",213668,2008,"340",161,179,178,"77",101,0.6273,0.4302,0.5235
"2014",213783,2008,"665",410,255,203,"67",136,0.3317,0.2627,0.3053
"2015",213826,2008,"422",291,131,238,"62",176,0.6048,0.4733,0.564
"2016",213996,2008,"709",448,261,529,"186",343,0.7656,0.7126,0.7461
"2017",214041,2008,"1311",729,582,503,"190",313,0.4294,0.3265,0.3837
"2018",214069,2008,"378",248,130,238,"72",166,0.6694,0.5538,0.6296
"2019",214157,2008,"387",226,161,253,"94",159,0.7035,0.5839,0.6537
"2020",214175,2008,"597",344,253,484,"197",287,0.8343,0.7787,0.8107
"2021",214272,2008,"539",348,191,185,"51",134,0.3851,0.267,0.3432
"2022",214777,2008,"7241",3428,3813,4746,"2226",2520,0.7351,0.5838,0.6554
"2023",215062,2008,"2392",1278,1114,2078,"943",1135,0.8881,0.8465,0.8687
"2024",215743,2008,"412",224,188,254,"99",155,0.692,0.5266,0.6165
"2025",215798,2008,"442",195,247,302,"167",135,0.6923,0.6761,0.6833
"2026",215929,2008,"961",555,406,710,"274",436,0.7856,0.6749,0.7388
"2027",216010,2008,"1716",871,845,638,"247",391,0.4489,0.2923,0.3718
"2028",216038,2008,"1527",887,640,749,"272",477,0.5378,0.425,0.4905
"2029",216287,2008,"372",184,188,330,"159",171,0.9293,0.8457,0.8871
"2030",216339,2008,"4157",2260,1897,1718,"663",1055,0.4668,0.3495,0.4133
"2031",216524,2008,"543",304,239,428,"181",247,0.8125,0.7573,0.7882
"2032",216694,2008,"376",218,158,195,"76",119,0.5459,0.481,0.5186
"2033",216764,2008,"1992",1231,761,872,"232",640,0.5199,0.3049,0.4378
"2034",216807,2008,"441",246,195,313,"128",185,0.752,0.6564,0.7098
"2035",216852,2008,"718",337,381,266,"121",145,0.4303,0.3176,0.3705
"2036",216931,2008,"559",290,269,249,"114",135,0.4655,0.4238,0.4454
"2037",217059,2008,"1097",580,517,427,"185",242,0.4172,0.3578,0.3892
"2038",217156,2008,"1546",813,733,1307,"612",695,0.8549,0.8349,0.8454
"2039",217402,2008,"987",575,412,821,"336",485,0.8435,0.8155,0.8318
"2040",217536,2008,"556",382,174,355,"94",261,0.6832,0.5402,0.6385
"2041",217776,2008,"142",84,58,52,"13",39,0.4643,0.2241,0.3662
"2042",217819,2008,"1949",1296,653,1070,"318",752,0.5802,0.487,0.549
"2043",217882,2008,"2866",1412,1454,1747,"737",1010,0.7153,0.5069,0.6096
"2044",217998,2008,"163",83,80,72,"32",40,0.4819,0.4,0.4417
"2045",218061,2008,"676",452,224,104,"34",70,0.1549,0.1518,0.1538
"2046",218229,2008,"554",398,156,162,"39",123,0.309,0.25,0.2924
"2047",218238,2008,"229",98,131,29,"8",21,0.2143,0.0611,0.1266
"2048",218399,2008,"292",162,130,37,"6",31,0.1914,0.0462,0.1267
"2049",218414,2008,"297",118,179,78,"27",51,0.4322,0.1508,0.2626
"2050",218663,2008,"3826",2133,1693,2129,"812",1317,0.6174,0.4796,0.5565
"2051",218724,2008,"1641",835,806,422,"157",265,0.3174,0.1948,0.2572
"2052",218733,2008,"923",484,439,138,"38",100,0.2066,0.0866,0.1495
"2053",218742,2008,"708",455,253,164,"47",117,0.2571,0.1858,0.2316
"2054",218973,2008,"415",203,212,296,"140",156,0.7685,0.6604,0.7133
"2055",219000,2008,"426",292,134,211,"50",161,0.5514,0.3731,0.4953
"2056",219046,2008,"545",345,200,64,"17",47,0.1362,0.085,0.1174
"2057",219082,2008,"258",121,137,45,"18",27,0.2231,0.1314,0.1744
"2058",219198,2008,"136",88,48,66,"20",46,0.5227,0.4167,0.4853
"2059",219259,2008,"389",204,185,67,"16",51,0.25,0.0865,0.1722
"2060",219356,2008,"2008",987,1021,563,"237",326,0.3303,0.2321,0.2804
"2061",219471,2008,"1023",597,426,295,"111",184,0.3082,0.2606,0.2884
"2062",219602,2008,"1326",806,520,208,"70",138,0.1712,0.1346,0.1569
"2063",219709,2008,"928",519,409,520,"217",303,0.5838,0.5306,0.5603
"2064",219718,2008,"268",122,146,57,"19",38,0.3115,0.1301,0.2127
"2065",219949,2008,"194",82,112,43,"20",23,0.2805,0.1786,0.2216
"2066",220075,2008,"1932",1069,863,380,"133",247,0.2311,0.1541,0.1967
"2067",220215,2008,"405",220,185,154,"61",93,0.4227,0.3297,0.3802
"2068",220613,2008,"848",501,347,333,"103",230,0.4591,0.2968,0.3927
"2069",220631,2008,"256",169,87,31,"10",21,0.1243,0.1149,0.1211
"2070",220710,2008,"297",146,151,120,"50",70,0.4795,0.3311,0.404
"2071",221351,2008,"475",276,199,353,"143",210,0.7609,0.7186,0.7432
"2072",221519,2008,"409",199,210,310,"149",161,0.809,0.7095,0.7579
"2073",221731,2008,"251",141,110,77,"30",47,0.3333,0.2727,0.3068
"2074",221847,2008,"1659",736,923,379,"165",214,0.2908,0.1788,0.2285
"2075",221892,2008,"218",125,93,86,"31",55,0.44,0.3333,0.3945
"2076",222178,2008,"971",518,453,434,"167",267,0.5154,0.3687,0.447
"2077",222983,2008,"318",191,127,229,"88",141,0.7382,0.6929,0.7201
"2078",223232,2008,"3054",1801,1253,1669,"594",1075,0.5969,0.4741,0.5465
"2079",224004,2008,"229",129,100,44,"16",28,0.2171,0.16,0.1921
"2080",224323,2008,"341",168,173,216,"104",112,0.6667,0.6012,0.6334
"2081",225432,2008,"699",400,299,20,"9",11,0.0275,0.0301,0.0286
"2082",225548,2008,"304",128,176,107,"48",59,0.4609,0.2727,0.352
"2083",225627,2008,"880",553,327,157,"39",118,0.2134,0.1193,0.1784
"2084",226231,2008,"340",106,234,118,"76",42,0.3962,0.3248,0.3471
"2085",226833,2008,"706",405,301,119,"44",75,0.1852,0.1462,0.1686
"2086",227216,2008,"3442",1928,1514,891,"271",620,0.3216,0.179,0.2589
"2087",227331,2008,"306",213,93,67,"14",53,0.2488,0.1505,0.219
"2088",227526,2008,"1290",761,529,355,"112",243,0.3193,0.2117,0.2752
"2089",227757,2008,"777",386,391,636,"307",329,0.8523,0.7852,0.8185
"2090",227845,2008,"741",480,261,397,"121",276,0.575,0.4636,0.5358
"2091",227863,2008,"293",187,106,101,"30",71,0.3797,0.283,0.3447
"2092",228042,2008,"266",145,121,84,"34",50,0.3448,0.281,0.3158
"2093",228149,2008,"535",335,200,237,"63",174,0.5194,0.315,0.443
"2094",228246,2008,"1397",751,646,941,"404",537,0.715,0.6254,0.6736
"2095",228343,2008,"349",216,133,227,"78",149,0.6898,0.5865,0.6504
"2096",228431,2008,"2480",1545,935,590,"131",459,0.2971,0.1401,0.2379
"2097",228459,2008,"3444",2051,1393,916,"289",627,0.3057,0.2075,0.266
"2098",228501,2008,"315",124,191,43,"18",25,0.2016,0.0942,0.1365
"2099",228529,2008,"1274",722,552,276,"92",184,0.2548,0.1667,0.2166
"2100",228705,2008,"737",310,427,124,"70",54,0.1742,0.1639,0.1682
"2101",228723,2008,"8038",3940,4098,3989,"1575",2414,0.6127,0.3843,0.4963
"2102",228769,2008,"2254",1106,1148,396,"151",245,0.2215,0.1315,0.1757
"2103",228778,2008,"6679",3679,3000,3487,"1358",2129,0.5787,0.4527,0.5221
"2104",228787,2008,"1090",434,656,553,"280",273,0.629,0.4268,0.5073
"2105",228796,2008,"2060",1006,1054,251,"83",168,0.167,0.0787,0.1218
"2106",228875,2008,"1628",996,632,954,"309",645,0.6476,0.4889,0.586
"2107",228981,2008,"396",191,205,123,"44",79,0.4136,0.2146,0.3106
"2108",229018,2008,"332",176,156,65,"19",46,0.2614,0.1218,0.1958
"2109",229027,2008,"4758",2432,2326,512,"198",314,0.1291,0.0851,0.1076
"2110",229115,2008,"4338",2056,2282,1413,"560",853,0.4149,0.2454,0.3257
"2111",229780,2008,"197",88,109,23,"9",14,0.1591,0.0826,0.1168
"2112",229814,2008,"1149",599,550,259,"83",176,0.2938,0.1509,0.2254
"2113",230603,2008,"836",574,262,169,"29",140,0.2439,0.1107,0.2022
"2114",230728,2008,"2580",1646,934,484,"83",401,0.2436,0.0889,0.1876
"2115",230764,2008,"1908",1054,854,465,"171",294,0.2789,0.2002,0.2437
"2116",230782,2008,"1549",853,696,136,"41",95,0.1114,0.0589,0.0878
"2117",231059,2008,"543",277,266,396,"180",216,0.7798,0.6767,0.7293
"2118",231174,2008,"2453",1457,996,1611,"617",994,0.6822,0.6195,0.6567
"2119",231420,2008,"234",88,146,53,"17",36,0.4091,0.1164,0.2265
"2120",231554,2008,"80",47,33,29,"8",21,0.4468,0.2424,0.3625
"2121",231624,2008,"1381",780,601,1146,"462",684,0.8769,0.7687,0.8298
"2122",231712,2008,"1134",640,494,624,"207",417,0.6516,0.419,0.5503
"2123",232025,2008,"241",123,118,87,"31",56,0.4553,0.2627,0.361
"2124",232043,2008,"183",103,80,90,"35",55,0.534,0.4375,0.4918
"2125",232089,2008,"581",253,328,80,"26",54,0.2134,0.0793,0.1377
"2126",232186,2008,"2476",1328,1148,1099,"406",693,0.5218,0.3537,0.4439
"2127",232265,2008,"1190",792,398,489,"120",369,0.4659,0.3015,0.4109
"2128",232423,2008,"3956",2425,1531,2577,"876",1701,0.7014,0.5722,0.6514
"2129",232557,2008,"3063",1663,1400,857,"314",543,0.3265,0.2243,0.2798
"2130",232566,2008,"1043",700,343,467,"104",363,0.5186,0.3032,0.4477
"2131",232609,2008,"593",336,257,252,"85",167,0.497,0.3307,0.425
"2132",232681,2008,"848",553,295,539,"160",379,0.6854,0.5424,0.6356
"2133",232706,2008,"404",294,110,141,"25",116,0.3946,0.2273,0.349
"2134",232937,2008,"1143",657,486,182,"53",129,0.1963,0.1091,0.1592
"2135",232982,2008,"2757",1381,1376,652,"233",419,0.3034,0.1693,0.2365
"2136",233277,2008,"1871",1119,752,809,"261",548,0.4897,0.3471,0.4324
"2137",233374,2008,"737",412,325,591,"255",336,0.8155,0.7846,0.8019
"2138",233426,2008,"529",284,245,302,"115",187,0.6585,0.4694,0.5709
"2139",233541,2008,"399",200,199,145,"52",93,0.465,0.2613,0.3634
"2140",233897,2008,"427",194,233,98,"42",56,0.2887,0.1803,0.2295
"2141",233921,2008,"5449",2449,3000,3306,"1509",1797,0.7338,0.503,0.6067
"2142",234030,2008,"3640",2128,1512,1227,"429",798,0.375,0.2837,0.3371
"2143",234085,2008,"391",33,358,210,"192",18,0.5455,0.5363,0.5371
"2144",234155,2008,"1323",832,491,302,"64",238,0.2861,0.1303,0.2283
"2145",234164,2008,"345",170,175,48,"20",28,0.1647,0.1143,0.1391
"2146",235097,2008,"1488",859,629,295,"110",185,0.2154,0.1749,0.1983
"2147",235167,2008,"658",321,337,302,"146",156,0.486,0.4332,0.459
"2148",236230,2008,"712",444,268,372,"115",257,0.5788,0.4291,0.5225
"2149",236328,2008,"676",377,299,459,"187",272,0.7215,0.6254,0.679
"2150",236577,2008,"712",492,220,431,"122",309,0.628,0.5545,0.6053
"2151",236595,2008,"881",557,324,530,"170",360,0.6463,0.5247,0.6016
"2152",236896,2008,"310",158,152,63,"24",39,0.2468,0.1579,0.2032
"2153",236939,2008,"3391",1744,1647,1408,"536",872,0.5,0.3254,0.4152
"2154",236948,2008,"5377",2896,2481,3296,"1351",1945,0.6716,0.5445,0.613
"2155",237011,2008,"2667",1560,1107,1057,"328",729,0.4673,0.2963,0.3963
"2156",237057,2008,"401",230,171,328,"130",198,0.8609,0.7602,0.818
"2157",237066,2008,"545",289,256,354,"149",205,0.7093,0.582,0.6495
"2158",237215,2008,"270",156,114,33,"15",18,0.1154,0.1316,0.1222
"2159",237330,2008,"706",380,326,128,"38",90,0.2368,0.1166,0.1813
"2160",237358,2008,"129",68,61,35,"19",16,0.2353,0.3115,0.2713
"2161",237367,2008,"755",370,385,116,"52",64,0.173,0.1351,0.1536
"2162",237792,2008,"698",395,303,137,"42",95,0.2405,0.1386,0.1963
"2163",237899,2008,"302",147,155,16,"5",11,0.0748,0.0323,0.053
"2164",237932,2008,"550",299,251,96,"30",66,0.2207,0.1195,0.1745
"2165",237969,2008,"382",208,174,168,"63",105,0.5048,0.3621,0.4398
"2166",238032,2008,"5083",2300,2783,1656,"766",890,0.387,0.2752,0.3258
"2167",238333,2008,"337",182,155,240,"104",136,0.7473,0.671,0.7122
"2168",238430,2008,"258",177,81,39,"14",25,0.1412,0.1728,0.1512
"2169",238458,2008,"655",447,208,263,"77",186,0.4161,0.3702,0.4015
"2170",238476,2008,"753",359,394,405,"192",213,0.5933,0.4873,0.5378
"2171",238616,2008,"402",222,180,139,"59",80,0.3604,0.3278,0.3458
"2172",238661,2008,"298",219,79,108,"29",79,0.3607,0.3671,0.3624
"2173",239080,2008,"284",210,74,103,"15",88,0.419,0.2027,0.3627
"2174",239105,2008,"1950",1043,907,1153,"481",672,0.6443,0.5303,0.5913
"2175",239628,2008,"282",143,139,145,"59",86,0.6014,0.4245,0.5142
"2176",239716,2008,"531",293,238,335,"131",204,0.6962,0.5504,0.6309
"2177",240107,2008,"357",250,107,102,"27",75,0.3,0.2523,0.2857
"2178",240189,2008,"2132",1025,1107,575,"276",299,0.2917,0.2493,0.2697
"2179",240277,2008,"1000",614,386,236,"67",169,0.2752,0.1736,0.236
"2180",240329,2008,"1779",1081,698,577,"192",385,0.3562,0.2751,0.3243
"2181",240338,2008,"223",128,95,110,"43",67,0.5234,0.4526,0.4933
"2182",240365,2008,"1807",1048,759,294,"112",182,0.1737,0.1476,0.1627
"2183",240374,2008,"833",420,413,70,"36",34,0.081,0.0872,0.084
"2184",240417,2008,"1633",837,796,313,"103",210,0.2509,0.1294,0.1917
"2185",240426,2008,"303",168,135,59,"15",44,0.2619,0.1111,0.1947
"2186",240444,2008,"5759",3027,2732,3148,"1333",1815,0.5996,0.4879,0.5466
"2187",240453,2008,"4002",2100,1902,572,"246",326,0.1552,0.1293,0.1429
"2188",240462,2008,"1468",496,972,235,"117",118,0.2379,0.1204,0.1601
"2189",240471,2008,"1332",783,549,365,"136",229,0.2925,0.2477,0.274
"2190",240480,2008,"1608",882,726,412,"145",267,0.3027,0.1997,0.2562
"2191",240727,2008,"1674",851,823,408,"148",260,0.3055,0.1798,0.2437
"2192",243443,2008,"750",435,315,43,"9",34,0.0782,0.0286,0.0573
"2193",243780,2008,"7058",3083,3975,3028,"1409",1619,0.5251,0.3545,0.429
"2194",100654,2007,"882",475,407,88,"21",67,0.1411,0.0516,0.0998
"2195",100663,2007,"1378",807,571,404,"137",267,0.3309,0.2399,0.2932
"2196",100751,2007,"4438",2461,1977,1897,"708",1189,0.4831,0.3581,0.4274
"2197",100858,2007,"4165",2207,1958,1565,"548",1017,0.4608,0.2799,0.3758
"2198",101435,2007,"257",117,140,78,"23",55,0.4701,0.1643,0.3035
"2199",101480,2007,"1252",696,556,127,"44",83,0.1193,0.0791,0.1014
"2200",101675,2007,"486",246,240,29,"7",22,0.0894,0.0292,0.0597
"2201",101879,2007,"1023",558,465,126,"31",95,0.1703,0.0667,0.1232
"2202",102049,2007,"711",459,252,348,"112",236,0.5142,0.4444,0.4895
"2203",102094,2007,"1457",801,656,200,"68",132,0.1648,0.1037,0.1373
"2204",102234,2007,"380",243,137,179,"65",114,0.4691,0.4745,0.4711
"2205",102368,2007,"1763",1011,752,222,"75",147,0.1454,0.0997,0.1259
"2206",102377,2007,"796",444,352,133,"31",102,0.2297,0.0881,0.1671
"2207",104151,2007,"7308",3775,3533,2753,"1126",1627,0.431,0.3187,0.3767
"2208",104179,2007,"6231",3395,2836,2485,"976",1509,0.4445,0.3441,0.3988
"2209",105330,2007,"2880",1676,1204,868,"261",607,0.3622,0.2168,0.3014
"2210",106245,2007,"812",471,341,57,"28",29,0.0616,0.0821,0.0702
"2211",106342,2007,"143",84,59,62,"19",43,0.5119,0.322,0.4336
"2212",106397,2007,"2877",1425,1452,1055,"456",599,0.4204,0.314,0.3667
"2213",106412,2007,"786",411,375,44,"10",34,0.0827,0.0267,0.056
"2214",106458,2007,"1655",962,693,309,"102",207,0.2152,0.1472,0.1867
"2215",106467,2007,"1548",762,786,278,"131",147,0.1929,0.1667,0.1796
"2216",106485,2007,"617",303,314,52,"19",33,0.1089,0.0605,0.0843
"2217",106704,2007,"1763",1054,709,362,"118",244,0.2315,0.1664,0.2053
"2218",107044,2007,"960",549,411,388,"124",264,0.4809,0.3017,0.4042
"2219",107080,2007,"365",194,171,231,"99",132,0.6804,0.5789,0.6329
"2220",107141,2007,"361",206,155,200,"81",119,0.5777,0.5226,0.554
"2221",107512,2007,"372",202,170,179,"60",119,0.5891,0.3529,0.4812
"2222",107558,2007,"178",102,76,61,"17",44,0.4314,0.2237,0.3427
"2223",110097,2007,"789",514,275,385,"118",267,0.5195,0.4291,0.488
"2224",110404,2007,"231",86,145,190,"117",73,0.8488,0.8069,0.8225
"2225",110422,2007,"4419",1885,2534,1282,"460",822,0.4361,0.1815,0.2901
"2226",110486,2007,"859",578,281,129,"25",104,0.1799,0.089,0.1502
"2227",110495,2007,"910",592,318,166,"34",132,0.223,0.1069,0.1824
"2228",110510,2007,"1656",1098,558,156,"43",113,0.1029,0.0771,0.0942
"2229",110529,2007,"3414",1459,1955,343,"118",225,0.1542,0.0604,0.1005
"2230",110538,2007,"2710",1418,1292,458,"138",320,0.2257,0.1068,0.169
"2231",110547,2007,"913",602,311,35,"11",24,0.0399,0.0354,0.0383
"2232",110556,2007,"2552",1526,1026,350,"112",238,0.156,0.1092,0.1371
"2233",110565,2007,"4040",2430,1610,550,"135",415,0.1708,0.0839,0.1361
"2234",110574,2007,"1032",602,430,111,"49",62,0.103,0.114,0.1076
"2235",110583,2007,"4134",2620,1514,581,"166",415,0.1584,0.1096,0.1405
"2236",110592,2007,"1767",1106,661,119,"40",79,0.0714,0.0605,0.0673
"2237",110617,2007,"2357",1426,931,194,"64",130,0.0912,0.0687,0.0823
"2238",113698,2007,"297",225,72,107,"23",84,0.3733,0.3194,0.3603
"2239",115755,2007,"1039",551,488,112,"39",73,0.1325,0.0799,0.1078
"2240",119173,2007,"348",331,17,93,"7",86,0.2598,0.4118,0.2672
"2241",120184,2007,"96",57,39,35,"12",23,0.4035,0.3077,0.3646
"2242",121309,2007,"530",336,194,327,"109",218,0.6488,0.5619,0.617
"2243",121345,2007,"375",188,187,348,"172",176,0.9362,0.9198,0.928
"2244",122409,2007,"4506",2685,1821,1472,"449",1023,0.381,0.2466,0.3267
"2245",122436,2007,"1089",635,454,704,"254",450,0.7087,0.5595,0.6465
"2246",122597,2007,"3341",2123,1218,424,"118",306,0.1441,0.0969,0.1269
"2247",122612,2007,"1052",680,372,595,"179",416,0.6118,0.4812,0.5656
"2248",122931,2007,"1201",619,582,923,"431",492,0.7948,0.7405,0.7685
"2249",123554,2007,"600",366,234,283,"102",181,0.4945,0.4359,0.4717
"2250",123572,2007,"1673",1073,600,434,"97",337,0.3141,0.1617,0.2594
"2251",126562,2007,"1010",571,439,163,"66",97,0.1699,0.1503,0.1614
"2252",126580,2007,"933",511,422,247,"89",158,0.3092,0.2109,0.2647
"2253",126614,2007,"5540",2734,2806,2456,"1059",1397,0.511,0.3774,0.4433
"2254",126818,2007,"4352",2387,1965,1609,"564",1045,0.4378,0.287,0.3697
"2255",127060,2007,"1130",619,511,752,"321",431,0.6963,0.6282,0.6655
"2256",127185,2007,"863",404,459,149,"50",99,0.245,0.1089,0.1727
"2257",127565,2007,"1910",1036,874,108,"38",70,0.0676,0.0435,0.0565
"2258",127741,2007,"2199",1328,871,583,"149",434,0.3268,0.1711,0.2651
"2259",128106,2007,"602",308,294,109,"41",68,0.2208,0.1395,0.1811
"2260",128744,2007,"331",209,122,62,"17",45,0.2153,0.1393,0.1873
"2261",128771,2007,"1466",676,790,294,"133",161,0.2382,0.1684,0.2005
"2262",129020,2007,"3160",1682,1478,2136,"921",1215,0.7224,0.6231,0.6759
"2263",129242,2007,"842",496,346,664,"268",396,0.7984,0.7746,0.7886
"2264",129941,2007,"700",331,369,296,"138",158,0.4773,0.374,0.4229
"2265",130253,2007,"956",580,376,606,"220",386,0.6655,0.5851,0.6339
"2266",130314,2007,"165",165,0,61,"0",61,0.3697,NA,0.3697
"2267",130493,2007,"1333",884,449,239,"56",183,0.207,0.1247,0.1793
"2268",130590,2007,"576",292,284,469,"224",245,0.839,0.7887,0.8142
"2269",130697,2007,"733",377,356,632,"305",327,0.8674,0.8567,0.8622
"2270",130776,2007,"913",494,419,190,"77",113,0.2287,0.1838,0.2081
"2271",130794,2007,"1313",661,652,1177,"578",599,0.9062,0.8865,0.8964
"2272",130934,2007,"799",495,304,145,"37",108,0.2182,0.1217,0.1815
"2273",130943,2007,"3912",2305,1607,2445,"879",1566,0.6794,0.547,0.625
"2274",131159,2007,"1288",840,448,975,"334",641,0.7631,0.7455,0.757
"2275",131283,2007,"864",451,413,535,"233",302,0.6696,0.5642,0.6192
"2276",131450,2007,"174",97,77,27,"9",18,0.1856,0.1169,0.1552
"2277",131469,2007,"2123",1198,925,1604,"668",936,0.7813,0.7222,0.7555
"2278",131496,2007,"1577",864,713,1387,"616",771,0.8924,0.864,0.8795
"2279",131520,2007,"1451",1028,423,574,"129",445,0.4329,0.305,0.3956
"2280",132471,2007,"472",316,156,102,"28",74,0.2342,0.1795,0.2161
"2281",132602,2007,"821",511,310,136,"44",92,0.18,0.1419,0.1657
"2282",132903,2007,"6350",3310,3040,2277,"827",1450,0.4381,0.272,0.3586
"2283",133492,2007,"535",319,216,315,"127",188,0.5893,0.588,0.5888
"2284",133553,2007,"1014",158,856,341,"277",64,0.4051,0.3236,0.3363
"2285",133650,2007,"1853",1071,782,217,"74",143,0.1335,0.0946,0.1171
"2286",133669,2007,"2563",1326,1237,388,"150",238,0.1795,0.1213,0.1514
"2287",133711,2007,"531",333,198,246,"85",161,0.4835,0.4293,0.4633
"2288",133881,2007,"675",186,489,261,"170",91,0.4892,0.3476,0.3867
"2289",133951,2007,"3230",1707,1523,661,"209",452,0.2648,0.1372,0.2046
"2290",134079,2007,"423",259,164,199,"77",122,0.471,0.4695,0.4704
"2291",134097,2007,"6104",3436,2668,3458,"1266",2192,0.638,0.4745,0.5665
"2292",134130,2007,"6440",3792,2648,4197,"1467",2730,0.7199,0.554,0.6517
"2293",134945,2007,"581",274,307,141,"60",81,0.2956,0.1954,0.2427
"2294",135726,2007,"1977",1049,928,1400,"606",794,0.7569,0.653,0.7081
"2295",136172,2007,"2048",1185,863,435,"151",284,0.2397,0.175,0.2124
"2296",136950,2007,"525",305,220,319,"124",195,0.6393,0.5636,0.6076
"2297",137546,2007,"557",322,235,314,"121",193,0.5994,0.5149,0.5637
"2298",138354,2007,"912",511,401,184,"57",127,0.2485,0.1421,0.2018
"2299",138716,2007,"626",401,225,100,"17",83,0.207,0.0756,0.1597
"2300",138789,2007,"793",477,316,77,"16",61,0.1279,0.0506,0.0971
"2301",139144,2007,"537",373,164,269,"75",194,0.5201,0.4573,0.5009
"2302",139366,2007,"996",568,428,117,"29",88,0.1549,0.0678,0.1175
"2303",139393,2007,"291",163,128,139,"51",88,0.5399,0.3984,0.4777
"2304",139658,2007,"1597",863,734,1027,"477",550,0.6373,0.6499,0.6431
"2305",139719,2007,"716",386,330,56,"12",44,0.114,0.0364,0.0782
"2306",139755,2007,"2622",854,1768,1072,"645",427,0.5,0.3648,0.4088
"2307",139764,2007,"388",252,136,59,"16",43,0.1706,0.1176,0.1521
"2308",139861,2007,"1197",778,419,464,"124",340,0.437,0.2959,0.3876
"2309",139931,2007,"3028",1402,1626,773,"287",486,0.3466,0.1765,0.2553
"2310",139940,2007,"2521",1486,1035,540,"154",386,0.2598,0.1488,0.2142
"2311",139959,2007,"4675",2942,1733,2655,"853",1802,0.6125,0.4922,0.5679
"2312",140447,2007,"602",337,265,265,"87",178,0.5282,0.3283,0.4402
"2313",140960,2007,"612",343,269,51,"10",41,0.1195,0.0372,0.0833
"2314",140988,2007,"276",131,145,91,"35",56,0.4275,0.2414,0.3297
"2315",141185,2007,"218",128,90,75,"28",47,0.3672,0.3111,0.344
"2316",141264,2007,"2029",1233,796,316,"86",230,0.1865,0.108,0.1557
"2317",141334,2007,"1803",1051,752,311,"93",218,0.2074,0.1237,0.1725
"2318",141486,2007,"242",156,86,65,"18",47,0.3013,0.2093,0.2686
"2319",141565,2007,"497",299,198,41,"11",30,0.1003,0.0556,0.0825
"2320",141574,2007,"1727",946,781,322,"111",211,0.223,0.1421,0.1865
"2321",142276,2007,"998",526,472,88,"26",62,0.1179,0.0551,0.0882
"2322",142285,2007,"1615",764,851,402,"173",229,0.2997,0.2033,0.2489
"2323",142461,2007,"220",139,81,70,"22",48,0.3453,0.2716,0.3182
"2324",143084,2007,"713",418,295,525,"199",326,0.7799,0.6746,0.7363
"2325",143288,2007,"175",93,82,59,"23",36,0.3871,0.2805,0.3371
"2326",144005,2007,"372",255,117,15,"4",11,0.0431,0.0342,0.0403
"2327",144281,2007,"2166",1148,1018,692,"313",379,0.3301,0.3075,0.3195
"2328",144740,2007,"2513",1458,1055,1363,"522",841,0.5768,0.4948,0.5424
"2329",144892,2007,"1641",988,653,551,"171",380,0.3846,0.2619,0.3358
"2330",144962,2007,"508",304,204,300,"99",201,0.6612,0.4853,0.5906
"2331",144971,2007,"122",73,49,53,"15",38,0.5205,0.3061,0.4344
"2332",145600,2007,"3272",1813,1459,978,"390",588,0.3243,0.2673,0.2989
"2333",145619,2007,"385",185,200,146,"68",78,0.4216,0.34,0.3792
"2334",145637,2007,"6930",3295,3635,4722,"2281",2441,0.7408,0.6275,0.6814
"2335",145691,2007,"258",125,133,144,"58",86,0.688,0.4361,0.5581
"2336",145813,2007,"3140",1887,1253,1457,"455",1002,0.531,0.3631,0.464
"2337",146481,2007,"356",214,142,208,"75",133,0.6215,0.5282,0.5843
"2338",146612,2007,"634",365,269,283,"131",152,0.4164,0.487,0.4464
"2339",146719,2007,"2035",1377,658,1215,"371",844,0.6129,0.5638,0.5971
"2340",146825,2007,"125",73,52,35,"3",32,0.4384,0.0577,0.28
"2341",147013,2007,"298",131,167,94,"42",52,0.3969,0.2515,0.3154
"2342",147244,2007,"475",268,207,228,"91",137,0.5112,0.4396,0.48
"2343",147341,2007,"393",213,180,223,"90",133,0.6244,0.5,0.5674
"2344",147703,2007,"2997",1584,1413,793,"353",440,0.2778,0.2498,0.2646
"2345",147767,2007,"1979",1057,922,1705,"770",935,0.8846,0.8351,0.8615
"2346",147776,2007,"870",506,364,36,"9",27,0.0534,0.0247,0.0414
"2347",147828,2007,"704",384,320,343,"135",208,0.5417,0.4219,0.4872
"2348",148131,2007,"234",104,130,92,"42",50,0.4808,0.3231,0.3932
"2349",148496,2007,"366",265,101,184,"43",141,0.5321,0.4257,0.5027
"2350",148584,2007,"198",124,74,63,"18",45,0.3629,0.2432,0.3182
"2351",148627,2007,"507",342,165,152,"50",102,0.2982,0.303,0.2998
"2352",149222,2007,"2541",1127,1414,582,"268",314,0.2786,0.1895,0.229
"2353",149231,2007,"1833",1026,807,509,"179",330,0.3216,0.2218,0.2777
"2354",149772,2007,"1943",952,991,572,"258",314,0.3298,0.2603,0.2944
"2355",149781,2007,"580",292,288,432,"216",216,0.7397,0.75,0.7448
"2356",150066,2007,"479",239,240,216,"90",126,0.5272,0.375,0.4509
"2357",150136,2007,"3747",2033,1714,1223,"432",791,0.3891,0.252,0.3264
"2358",150145,2007,"249",159,90,106,"33",73,0.4591,0.3667,0.4257
"2359",150163,2007,"987",613,374,502,"157",345,0.5628,0.4198,0.5086
"2360",150400,2007,"664",369,295,493,"211",282,0.7642,0.7153,0.7425
"2361",150534,2007,"651",375,276,344,"129",215,0.5733,0.4674,0.5284
"2362",150668,2007,"202",114,88,110,"44",66,0.5789,0.5,0.5446
"2363",150941,2007,"244",138,106,138,"63",75,0.5435,0.5943,0.5656
"2364",151102,2007,"1804",942,862,91,"33",58,0.0616,0.0383,0.0504
"2365",151111,2007,"2737",1659,1078,392,"144",248,0.1495,0.1336,0.1432
"2366",151306,2007,"2074",1209,865,299,"74",225,0.1861,0.0855,0.1442
"2367",151324,2007,"1820",924,896,375,"138",237,0.2565,0.154,0.206
"2368",151333,2007,"381",234,147,27,"6",21,0.0897,0.0408,0.0709
"2369",151342,2007,"876",524,352,44,"26",18,0.0344,0.0739,0.0502
"2370",151351,2007,"7167",3707,3460,4169,"1874",2295,0.6191,0.5416,0.5817
"2371",151360,2007,"556",356,200,38,"13",25,0.0702,0.065,0.0683
"2372",151379,2007,"783",449,334,69,"21",48,0.1069,0.0629,0.0881
"2373",151388,2007,"264",157,107,22,"4",18,0.1146,0.0374,0.0833
"2374",151777,2007,"316",147,169,126,"55",71,0.483,0.3254,0.3987
"2375",151786,2007,"271",142,129,76,"23",53,0.3732,0.1783,0.2804
"2376",152080,2007,"1984",948,1036,1782,"913",869,0.9167,0.8813,0.8982
"2377",152248,2007,"1220",630,590,104,"40",64,0.1016,0.0678,0.0852
"2378",152363,2007,"300",138,162,107,"50",57,0.413,0.3086,0.3567
"2379",152530,2007,"472",272,200,306,"129",177,0.6507,0.645,0.6483
"2380",152600,2007,"713",370,343,413,"193",220,0.5946,0.5627,0.5792
"2381",153001,2007,"226",122,104,97,"35",62,0.5082,0.3365,0.4292
"2382",153108,2007,"422",219,203,260,"111",149,0.6804,0.5468,0.6161
"2383",153269,2007,"923",557,366,484,"170",314,0.5637,0.4645,0.5244
"2384",153384,2007,"426",233,193,344,"152",192,0.824,0.7876,0.8075
"2385",153603,2007,"4307",1920,2387,1622,"682",940,0.4896,0.2857,0.3766
"2386",153834,2007,"659",374,285,439,"177",262,0.7005,0.6211,0.6662
"2387",154095,2007,"1922",1177,745,708,"237",471,0.4002,0.3181,0.3684
"2388",155089,2007,"139",72,67,14,"7",7,0.0972,0.1045,0.1007
"2389",155317,2007,"4028",2084,1944,1444,"582",862,0.4136,0.2994,0.3585
"2390",155335,2007,"133",72,61,44,"13",31,0.4306,0.2131,0.3308
"2391",155399,2007,"3301",1629,1672,843,"290",553,0.3395,0.1734,0.2554
"2392",155520,2007,"217",109,108,89,"33",56,0.5138,0.3056,0.4101
"2393",155627,2007,"161",79,82,35,"11",24,0.3038,0.1341,0.2174
"2394",155937,2007,"165",70,95,50,"25",25,0.3571,0.2632,0.303
"2395",156213,2007,"311",173,138,175,"65",110,0.6358,0.471,0.5627
"2396",156286,2007,"567",351,216,304,"97",207,0.5897,0.4491,0.5362
"2397",156295,2007,"420",252,168,197,"72",125,0.496,0.4286,0.469
"2398",156365,2007,"377",168,209,98,"47",51,0.3036,0.2249,0.2599
"2399",156541,2007,"481",217,264,115,"45",70,0.3226,0.1705,0.2391
"2400",156745,2007,"366",206,160,180,"59",121,0.5874,0.3688,0.4918
"2401",157058,2007,"602",343,259,39,"5",34,0.0991,0.0193,0.0648
"2402",157076,2007,"280",120,160,69,"27",42,0.35,0.1688,0.2464
"2403",157085,2007,"3826",2006,1820,1276,"498",778,0.3878,0.2736,0.3335
"2404",157289,2007,"2525",1314,1211,634,"262",372,0.2831,0.2164,0.2511
"2405",157386,2007,"1445",803,642,257,"87",170,0.2117,0.1355,0.1779
"2406",157401,2007,"1393",835,558,397,"128",269,0.3222,0.2294,0.285
"2407",157447,2007,"1896",1068,828,253,"84",169,0.1582,0.1014,0.1334
"2408",157535,2007,"233",103,130,35,"15",20,0.1942,0.1154,0.1502
"2409",157951,2007,"3013",1716,1297,610,"197",413,0.2407,0.1519,0.2025
"2410",158477,2007,"200",114,86,97,"35",62,0.5439,0.407,0.485
"2411",159009,2007,"1184",610,574,83,"24",59,0.0967,0.0418,0.0701
"2412",159391,2007,"4585",2415,2170,1737,"658",1079,0.4468,0.3032,0.3788
"2413",159647,2007,"1522",704,818,432,"180",252,0.358,0.22,0.2838
"2414",159717,2007,"1247",717,530,163,"55",108,0.1506,0.1038,0.1307
"2415",159966,2007,"1156",696,460,196,"59",137,0.1968,0.1283,0.1696
"2416",160038,2007,"1281",812,469,223,"69",154,0.1897,0.1471,0.1741
"2417",160612,2007,"2524",1458,1066,336,"102",234,0.1605,0.0957,0.1331
"2418",160621,2007,"1178",658,520,95,"18",77,0.117,0.0346,0.0806
"2419",160658,2007,"2691",1554,1137,361,"111",250,0.1609,0.0976,0.1342
"2420",161004,2007,"475",250,225,416,"196",220,0.88,0.8711,0.8758
"2421",161226,2007,"479",327,152,181,"45",136,0.4159,0.2961,0.3779
"2422",161235,2007,"110",60,50,36,"18",18,0.3,0.36,0.3273
"2423",161244,2007,"110",72,38,15,"6",9,0.125,0.1579,0.1364
"2424",161253,2007,"1816",863,953,648,"301",347,0.4021,0.3158,0.3568
"2425",161554,2007,"900",499,401,87,"32",55,0.1102,0.0798,0.0967
"2426",162007,2007,"820",506,314,106,"19",87,0.1719,0.0605,0.1293
"2427",162210,2007,"126",83,43,22,"5",17,0.2048,0.1163,0.1746
"2428",162283,2007,"555",421,134,23,"9",14,0.0333,0.0672,0.0414
"2429",162584,2007,"1057",520,537,233,"92",141,0.2712,0.1713,0.2204
"2430",162654,2007,"399",277,122,236,"67",169,0.6101,0.5492,0.5915
"2431",162760,2007,"295",193,102,163,"48",115,0.5959,0.4706,0.5525
"2432",162928,2007,"1260",607,653,1095,"545",550,0.9061,0.8346,0.869
"2433",163046,2007,"979",545,434,777,"320",457,0.8385,0.7373,0.7937
"2434",163268,2007,"1423",655,768,523,"230",293,0.4473,0.2995,0.3675
"2435",163286,2007,"4229",2028,2201,2772,"1300",1472,0.7258,0.5906,0.6555
"2436",163453,2007,"1286",698,588,143,"42",101,0.1447,0.0714,0.1112
"2437",163462,2007,"448",256,192,275,"114",161,0.6289,0.5938,0.6138
"2438",163851,2007,"1142",646,496,533,"172",361,0.5588,0.3468,0.4667
"2439",163912,2007,"464",256,208,331,"134",197,0.7695,0.6442,0.7134
"2440",164076,2007,"2649",1670,979,1069,"314",755,0.4521,0.3207,0.4035
"2441",164173,2007,"604",436,168,254,"61",193,0.4427,0.3631,0.4205
"2442",164216,2007,"324",197,127,210,"69",141,0.7157,0.5433,0.6481
"2443",164270,2007,"439",226,213,279,"118",161,0.7124,0.554,0.6355
"2444",164447,2007,"390",202,188,111,"55",56,0.2772,0.2926,0.2846
"2445",164492,2007,"258",137,121,112,"45",67,0.4891,0.3719,0.4341
"2446",164562,2007,"594",331,263,417,"176",241,0.7281,0.6692,0.702
"2447",165015,2007,"701",391,310,604,"264",340,0.8696,0.8516,0.8616
"2448",165024,2007,"1551",935,616,445,"139",306,0.3273,0.2256,0.2869
"2449",165334,2007,"572",361,211,432,"157",275,0.7618,0.7441,0.7552
"2450",165662,2007,"842",477,365,671,"274",397,0.8323,0.7507,0.7969
"2451",165671,2007,"582",436,146,299,"74",225,0.5161,0.5068,0.5137
"2452",165820,2007,"698",366,332,142,"56",86,0.235,0.1687,0.2034
"2453",165866,2007,"633",420,213,212,"52",160,0.381,0.2441,0.3349
"2454",165936,2007,"454",286,168,264,"95",169,0.5909,0.5655,0.5815
"2455",166027,2007,"1657",839,818,1434,"695",739,0.8808,0.8496,0.8654
"2456",166124,2007,"718",398,320,639,"272",367,0.9221,0.85,0.89
"2457",166513,2007,"1220",424,796,346,"179",167,0.3939,0.2249,0.2836
"2458",166629,2007,"4374",2321,2053,2504,"1060",1444,0.6221,0.5163,0.5725
"2459",166638,2007,"950",558,392,144,"42",102,0.1828,0.1071,0.1516
"2460",166683,2007,"1068",492,576,892,"463",429,0.872,0.8038,0.8352
"2461",167288,2007,"334",207,127,128,"37",91,0.4396,0.2913,0.3832
"2462",167987,2007,"1901",859,1042,575,"262",313,0.3644,0.2514,0.3025
"2463",167996,2007,"659",409,250,539,"199",340,0.8313,0.796,0.8179
"2464",168005,2007,"1308",752,556,531,"218",313,0.4162,0.3921,0.406
"2465",168148,2007,"1370",703,667,1194,"570",624,0.8876,0.8546,0.8715
"2466",168254,2007,"713",293,420,372,"193",179,0.6109,0.4595,0.5217
"2467",168281,2007,"418",262,156,297,"98",199,0.7595,0.6282,0.7105
"2468",168342,2007,"539",258,281,483,"248",235,0.9109,0.8826,0.8961
"2469",168546,2007,"500",258,242,322,"144",178,0.6899,0.595,0.644
"2470",168786,2007,"410",269,141,124,"35",89,0.3309,0.2482,0.3024
"2471",169080,2007,"1034",556,478,590,"246",344,0.6187,0.5146,0.5706
"2472",169798,2007,"2365",1345,1020,294,"109",185,0.1375,0.1069,0.1243
"2473",169910,2007,"2035",933,1102,182,"79",103,0.1104,0.0717,0.0894
"2474",170082,2007,"3446",2201,1245,1137,"346",791,0.3594,0.2779,0.3299
"2475",170301,2007,"819",495,324,554,"199",355,0.7172,0.6142,0.6764
"2476",170532,2007,"363",213,150,263,"100",163,0.7653,0.6667,0.7245
"2477",170639,2007,"469",230,239,66,"35",31,0.1348,0.1464,0.1407
"2478",170976,2007,"5955",3019,2936,4513,"2063",2450,0.8115,0.7027,0.7579
"2479",171100,2007,"7398",4099,3299,3666,"1372",2294,0.5596,0.4159,0.4955
"2480",171128,2007,"1215",287,928,275,"197",78,0.2718,0.2123,0.2263
"2481",171137,2007,"859",420,439,128,"61",67,0.1595,0.139,0.149
"2482",171146,2007,"594",346,248,56,"16",40,0.1156,0.0645,0.0943
"2483",171599,2007,"182",67,115,48,"18",30,0.4478,0.1565,0.2637
"2484",172051,2007,"1533",883,650,155,"56",99,0.1121,0.0862,0.1011
"2485",172699,2007,"3473",1750,1723,842,"362",480,0.2743,0.2101,0.2424
"2486",173160,2007,"597",370,227,374,"126",248,0.6703,0.5551,0.6265
"2487",173258,2007,"509",255,254,456,"221",235,0.9216,0.8701,0.8959
"2488",173328,2007,"201",112,89,61,"20",41,0.3661,0.2247,0.3035
"2489",173647,2007,"666",374,292,542,"234",308,0.8235,0.8014,0.8138
"2490",173902,2007,"485",270,215,411,"176",235,0.8704,0.8186,0.8474
"2491",174066,2007,"5256",2927,2329,2863,"1182",1681,0.5743,0.5075,0.5447
"2492",174233,2007,"2196",1100,1096,649,"244",405,0.3682,0.2226,0.2955
"2493",174251,2007,"358",205,153,180,"65",115,0.561,0.4248,0.5028
"2494",174491,2007,"526",315,211,264,"99",165,0.5238,0.4692,0.5019
"2495",174792,2007,"516",0,516,364,"364",0,NA,0.7054,0.7054
"2496",174844,2007,"751",406,345,624,"287",337,0.83,0.8319,0.8309
"2497",174899,2007,"487",336,151,288,"76",212,0.631,0.5033,0.5914
"2498",174914,2007,"1313",672,641,822,"365",457,0.6801,0.5694,0.626
"2499",175342,2007,"514",305,209,94,"27",67,0.2197,0.1292,0.1829
"2500",175421,2007,"241",134,107,60,"15",45,0.3358,0.1402,0.249
"2501",175616,2007,"477",293,184,78,"27",51,0.1741,0.1467,0.1635
"2502",175856,2007,"919",541,378,153,"41",112,0.207,0.1085,0.1665
"2503",175980,2007,"296",154,142,175,"75",100,0.6494,0.5282,0.5912
"2504",176017,2007,"2434",1293,1141,885,"328",557,0.4308,0.2875,0.3636
"2505",176035,2007,"235",213,22,46,"6",40,0.1878,0.2727,0.1957
"2506",176044,2007,"485",256,229,51,"15",36,0.1406,0.0655,0.1052
"2507",176080,2007,"2262",1105,1157,699,"274",425,0.3846,0.2368,0.309
"2508",176406,2007,"200",135,65,53,"9",44,0.3259,0.1385,0.265
"2509",176628,2007,"114",79,35,30,"5",25,0.3165,0.1429,0.2632
"2510",176947,2007,"270",123,147,69,"31",38,0.3089,0.2109,0.2556
"2511",176965,2007,"1426",786,640,428,"148",280,0.3562,0.2313,0.3001
"2512",177418,2007,"193",110,83,5,"1",4,0.0364,0.012,0.0259
"2513",178059,2007,"294",211,83,149,"43",106,0.5024,0.5181,0.5068
"2514",178341,2007,"766",416,350,110,"29",81,0.1947,0.0829,0.1436
"2515",178387,2007,"935",538,397,126,"36",90,0.1673,0.0907,0.1348
"2516",178396,2007,"4897",2672,2225,2305,"829",1476,0.5524,0.3726,0.4707
"2517",178402,2007,"916",568,348,188,"59",129,0.2271,0.1695,0.2052
"2518",178411,2007,"1018",208,810,257,"180",77,0.3702,0.2222,0.2525
"2519",178420,2007,"462",280,182,94,"25",69,0.2464,0.1374,0.2035
"2520",178615,2007,"1402",814,588,754,"248",506,0.6216,0.4218,0.5378
"2521",179043,2007,"367",230,137,222,"81",141,0.613,0.5912,0.6049
"2522",179159,2007,"1629",933,696,988,"380",608,0.6517,0.546,0.6065
"2523",179557,2007,"1650",946,704,438,"158",280,0.296,0.2244,0.2655
"2524",179566,2007,"2610",1514,1096,796,"263",533,0.352,0.24,0.305
"2525",179867,2007,"1325",645,680,1169,"593",576,0.893,0.8721,0.8823
"2526",179894,2007,"483",278,205,224,"80",144,0.518,0.3902,0.4638
"2527",179946,2007,"223",95,128,115,"57",58,0.6105,0.4453,0.5157
"2528",180179,2007,"724",393,331,60,"16",44,0.112,0.0483,0.0829
"2529",180461,2007,"1852",791,1061,371,"162",209,0.2642,0.1527,0.2003
"2530",180522,2007,"186",69,117,19,"12",7,0.1014,0.1026,0.1022
"2531",180984,2007,"264",141,123,111,"41",70,0.4965,0.3333,0.4205
"2532",181002,2007,"947",577,370,638,"254",384,0.6655,0.6865,0.6737
"2533",181020,2007,"259",115,144,132,"65",67,0.5826,0.4514,0.5097
"2534",181127,2007,"302",117,185,131,"70",61,0.5214,0.3784,0.4338
"2535",181215,2007,"915",484,431,193,"74",119,0.2459,0.1717,0.2109
"2536",181394,2007,"1596",834,762,228,"106",122,0.1463,0.1391,0.1429
"2537",181446,2007,"438",272,166,239,"74",165,0.6066,0.4458,0.5457
"2538",181464,2007,"4214",2061,2153,1363,"555",808,0.392,0.2578,0.3234
"2539",181534,2007,"197",89,108,38,"13",25,0.2809,0.1204,0.1929
"2540",181783,2007,"654",364,290,162,"48",114,0.3132,0.1655,0.2477
"2541",182281,2007,"2780",1596,1184,406,"117",289,0.1811,0.0988,0.146
"2542",182290,2007,"2226",1166,1060,349,"131",218,0.187,0.1236,0.1568
"2543",182634,2007,"353",240,113,169,"44",125,0.5208,0.3894,0.4788
"2544",182795,2007,"533",239,294,207,"100",107,0.4477,0.3401,0.3884
"2545",183062,2007,"1295",762,533,666,"252",414,0.5433,0.4728,0.5143
"2546",183080,2007,"1006",444,562,414,"206",208,0.4685,0.3665,0.4115
"2547",183239,2007,"568",300,268,404,"169",235,0.7833,0.6306,0.7113
"2548",183822,2007,"313",176,137,45,"24",21,0.1193,0.1752,0.1438
"2549",183974,2007,"275",175,100,154,"54",100,0.5714,0.54,0.56
"2550",184348,2007,"452",268,184,293,"107",186,0.694,0.5815,0.6482
"2551",184603,2007,"400",210,190,117,"30",87,0.4143,0.1579,0.2925
"2552",184612,2007,"294",213,81,72,"18",54,0.2535,0.2222,0.2449
"2553",184782,2007,"1226",506,720,561,"301",260,0.5138,0.4181,0.4576
"2554",185129,2007,"649",340,309,32,"16",16,0.0471,0.0518,0.0493
"2555",185572,2007,"944",538,406,393,"165",228,0.4238,0.4064,0.4163
"2556",185590,2007,"2068",1276,792,711,"205",506,0.3966,0.2588,0.3438
"2557",185828,2007,"730",148,582,171,"117",54,0.3649,0.201,0.2342
"2558",186131,2007,"1243",593,650,1091,"553",538,0.9073,0.8508,0.8777
"2559",186201,2007,"898",519,379,527,"181",346,0.6667,0.4776,0.5869
"2560",186283,2007,"990",569,421,547,"201",346,0.6081,0.4774,0.5525
"2561",186584,2007,"1256",664,592,631,"277",354,0.5331,0.4679,0.5024
"2562",186876,2007,"794",480,314,335,"93",242,0.5042,0.2962,0.4219
"2563",187134,2007,"1297",774,523,940,"334",606,0.7829,0.6386,0.7247
"2564",187444,2007,"1299",642,657,211,"89",122,0.19,0.1355,0.1624
"2565",187985,2007,"2850",1637,1213,415,"147",268,0.1637,0.1212,0.1456
"2566",188030,2007,"2105",1123,982,329,"94",235,0.2093,0.0957,0.1563
"2567",188429,2007,"883",603,280,464,"134",330,0.5473,0.4786,0.5255
"2568",188641,2007,"518",239,279,231,"107",124,0.5188,0.3835,0.4459
"2569",190044,2007,"682",189,493,418,"289",129,0.6825,0.5862,0.6129
"2570",190099,2007,"744",382,362,644,"297",347,0.9084,0.8204,0.8656
"2571",190150,2007,"1371",671,700,1173,"586",587,0.8748,0.8371,0.8556
"2572",190248,2007,"127",76,51,35,"9",26,0.3421,0.1765,0.2756
"2573",190415,2007,"3005",1454,1551,2601,"1285",1316,0.9051,0.8285,0.8656
"2574",190512,2007,"1470",695,775,578,"259",319,0.459,0.3342,0.3932
"2575",190549,2007,"1300",743,557,305,"103",202,0.2719,0.1849,0.2346
"2576",190558,2007,"2273",1272,1001,122,"48",74,0.0582,0.048,0.0537
"2577",190567,2007,"1771",916,855,166,"65",101,0.1103,0.076,0.0937
"2578",190594,2007,"1854",1226,628,402,"89",313,0.2553,0.1417,0.2168
"2579",190637,2007,"874",610,264,129,"35",94,0.1541,0.1326,0.1476
"2580",190664,2007,"1755",1064,691,440,"112",328,0.3083,0.1621,0.2507
"2581",190691,2007,"983",636,347,50,"11",39,0.0613,0.0317,0.0509
"2582",190725,2007,"361",268,93,99,"19",80,0.2985,0.2043,0.2742
"2583",191241,2007,"1760",910,850,1338,"645",693,0.7615,0.7588,0.7602
"2584",191515,2007,"468",247,221,419,"193",226,0.915,0.8733,0.8953
"2585",191533,2007,"452",256,196,243,"92",151,0.5898,0.4694,0.5376
"2586",191630,2007,"600",338,262,444,"172",272,0.8047,0.6565,0.74
"2587",191649,2007,"1716",907,809,850,"344",506,0.5579,0.4252,0.4953
"2588",191676,2007,"264",174,90,171,"54",117,0.6724,0.6,0.6477
"2589",191931,2007,"906",486,420,476,"195",281,0.5782,0.4643,0.5254
"2590",191968,2007,"1794",1055,739,1241,"488",753,0.7137,0.6604,0.6918
"2591",192192,2007,"274",192,82,98,"28",70,0.3646,0.3415,0.3577
"2592",192323,2007,"577",348,229,362,"125",237,0.681,0.5459,0.6274
"2593",192439,2007,"1021",721,300,61,"16",45,0.0624,0.0533,0.0597
"2594",192703,2007,"708",356,352,427,"201",226,0.6348,0.571,0.6031
"2595",192749,2007,"463",315,148,249,"59",190,0.6032,0.3986,0.5378
"2596",192819,2007,"1019",561,458,713,"295",418,0.7451,0.6441,0.6997
"2597",192925,2007,"409",255,154,131,"56",75,0.2941,0.3636,0.3203
"2598",193016,2007,"532",343,189,111,"21",90,0.2624,0.1111,0.2086
"2599",193292,2007,"370",282,88,140,"31",109,0.3865,0.3523,0.3784
"2600",193353,2007,"364",252,112,150,"31",119,0.4722,0.2768,0.4121
"2601",193399,2007,"394",272,122,144,"39",105,0.386,0.3197,0.3655
"2602",193584,2007,"456",335,121,268,"60",208,0.6209,0.4959,0.5877
"2603",193645,2007,"805",733,72,126,"2",124,0.1692,0.0278,0.1565
"2604",193654,2007,"999",740,259,482,"118",364,0.4919,0.4556,0.4825
"2605",193900,2007,"4884",3064,1820,2973,"1082",1891,0.6172,0.5945,0.6087
"2606",193973,2007,"737",435,302,440,"164",276,0.6345,0.543,0.597
"2607",194161,2007,"304",172,132,74,"22",52,0.3023,0.1667,0.2434
"2608",194310,2007,"1537",937,600,528,"183",345,0.3682,0.305,0.3435
"2609",194824,2007,"1288",389,899,836,"576",260,0.6684,0.6407,0.6491
"2610",195003,2007,"2497",788,1709,648,"306",342,0.434,0.1791,0.2595
"2611",195030,2007,"1181",603,578,905,"415",490,0.8126,0.718,0.7663
"2612",195164,2007,"527",264,263,283,"133",150,0.5682,0.5057,0.537
"2613",195173,2007,"478",261,217,130,"48",82,0.3142,0.2212,0.272
"2614",195216,2007,"627",383,244,482,"181",301,0.7859,0.7418,0.7687
"2615",195234,2007,"611",456,155,326,"63",263,0.5768,0.4065,0.5336
"2616",195243,2007,"324",163,161,117,"49",68,0.4172,0.3043,0.3611
"2617",195304,2007,"363",278,85,226,"50",176,0.6331,0.5882,0.6226
"2618",195474,2007,"781",463,318,578,"219",359,0.7754,0.6887,0.7401
"2619",195526,2007,"682",406,276,564,"213",351,0.8645,0.7717,0.827
"2620",195544,2007,"672",474,198,373,"87",286,0.6034,0.4394,0.5551
"2621",195809,2007,"3151",1689,1462,1121,"455",666,0.3943,0.3112,0.3558
"2622",196413,2007,"3092",1756,1336,2119,"846",1273,0.7249,0.6332,0.6853
"2623",196592,2007,"848",545,303,80,"22",58,0.1064,0.0726,0.0943
"2624",197045,2007,"492",265,227,146,"60",86,0.3245,0.2643,0.2967
"2625",197133,2007,"677",409,268,607,"233",374,0.9144,0.8694,0.8966
"2626",197869,2007,"2730",1401,1329,1133,"431",702,0.5011,0.3243,0.415
"2627",197984,2007,"210",90,120,69,"28",41,0.4556,0.2333,0.3286
"2628",198385,2007,"464",234,230,417,"198",219,0.9359,0.8609,0.8987
"2629",198464,2007,"4195",2535,1660,1294,"391",903,0.3562,0.2355,0.3085
"2630",198507,2007,"642",391,251,138,"39",99,0.2532,0.1554,0.215
"2631",198516,2007,"1286",746,540,987,"380",607,0.8137,0.7037,0.7675
"2632",198835,2007,"367",214,153,146,"48",98,0.4579,0.3137,0.3978
"2633",198969,2007,"433",138,295,76,"31",45,0.3261,0.1051,0.1755
"2634",199102,2007,"1569",819,750,251,"64",187,0.2283,0.0853,0.16
"2635",199111,2007,"571",341,230,211,"67",144,0.4223,0.2913,0.3695
"2636",199120,2007,"3877",2338,1539,3124,"1151",1973,0.8439,0.7479,0.8058
"2637",199139,2007,"2926",1520,1406,749,"304",445,0.2928,0.2162,0.256
"2638",199148,2007,"2431",1689,742,721,"166",555,0.3286,0.2237,0.2966
"2639",199157,2007,"1236",764,472,185,"47",138,0.1806,0.0996,0.1497
"2640",199193,2007,"4895",2179,2716,1975,"836",1139,0.5227,0.3078,0.4035
"2641",199218,2007,"1913",1138,775,991,"340",651,0.5721,0.4387,0.518
"2642",199281,2007,"1101",585,516,170,"57",113,0.1932,0.1105,0.1544
"2643",199306,2007,"189",90,99,63,"28",35,0.3889,0.2828,0.3333
"2644",199412,2007,"290",198,92,126,"32",94,0.4747,0.3478,0.4345
"2645",199582,2007,"417",188,229,91,"31",60,0.3191,0.1354,0.2182
"2646",199643,2007,"565",321,244,89,"35",54,0.1682,0.1434,0.1575
"2647",199847,2007,"1123",573,550,919,"433",486,0.8482,0.7873,0.8183
"2648",199962,2007,"426",209,217,200,"87",113,0.5407,0.4009,0.4695
"2649",199999,2007,"962",661,301,171,"40",131,0.1982,0.1329,0.1778
"2650",200004,2007,"1249",651,598,400,"142",258,0.3963,0.2375,0.3203
"2651",200059,2007,"355",191,164,48,"19",29,0.1518,0.1159,0.1352
"2652",200156,2007,"264",140,124,88,"26",62,0.4429,0.2097,0.3333
"2653",200217,2007,"352",206,146,99,"20",79,0.3835,0.137,0.2812
"2654",200226,2007,"89",42,47,18,"5",13,0.3095,0.1064,0.2022
"2655",200253,2007,"418",231,187,60,"21",39,0.1688,0.1123,0.1435
"2656",200280,2007,"1832",883,949,441,"200",241,0.2729,0.2107,0.2407
"2657",200332,2007,"2125",965,1160,544,"244",300,0.3109,0.2103,0.256
"2658",200572,2007,"184",86,98,42,"14",28,0.3256,0.1429,0.2283
"2659",201104,2007,"639",371,268,264,"77",187,0.504,0.2873,0.4131
"2660",201371,2007,"206",117,89,108,"41",67,0.5726,0.4607,0.5243
"2661",201548,2007,"627",377,250,323,"117",206,0.5464,0.468,0.5152
"2662",201645,2007,"1132",492,640,734,"368",366,0.7439,0.575,0.6484
"2663",201690,2007,"564",278,286,59,"15",44,0.1583,0.0524,0.1046
"2664",202134,2007,"1132",622,510,94,"37",57,0.0916,0.0725,0.083
"2665",202480,2007,"1763",893,870,1064,"460",604,0.6764,0.5287,0.6035
"2666",202523,2007,"585",325,260,455,"199",256,0.7877,0.7654,0.7778
"2667",202763,2007,"594",416,178,258,"53",205,0.4928,0.2978,0.4343
"2668",203085,2007,"369",149,220,130,"64",66,0.443,0.2909,0.3523
"2669",203128,2007,"333",184,149,199,"77",122,0.663,0.5168,0.5976
"2670",203368,2007,"720",358,362,471,"216",255,0.7123,0.5967,0.6542
"2671",203517,2007,"3729",2300,1429,1031,"308",723,0.3143,0.2155,0.2765
"2672",203535,2007,"458",249,209,395,"175",220,0.8835,0.8373,0.8624
"2673",203580,2007,"237",108,129,66,"21",45,0.4167,0.1628,0.2785
"2674",203775,2007,"387",235,152,177,"58",119,0.5064,0.3816,0.4574
"2675",203845,2007,"415",201,214,182,"75",107,0.5323,0.3505,0.4386
"2676",204024,2007,"3456",1902,1554,2359,"968",1391,0.7313,0.6229,0.6826
"2677",204185,2007,"593",282,311,316,"130",186,0.6596,0.418,0.5329
"2678",204194,2007,"350",210,140,171,"56",115,0.5476,0.4,0.4886
"2679",204617,2007,"391",207,184,112,"48",64,0.3092,0.2609,0.2864
"2680",204796,2007,"6155",3039,3116,3602,"1534",2068,0.6805,0.4923,0.5852
"2681",204857,2007,"3970",2059,1911,1902,"781",1121,0.5444,0.4087,0.4791
"2682",206330,2007,"240",101,139,57,"29",28,0.2772,0.2086,0.2375
"2683",206589,2007,"545",287,258,384,"159",225,0.784,0.6163,0.7046
"2684",206604,2007,"2371",1339,1032,447,"160",287,0.2143,0.155,0.1885
"2685",206622,2007,"858",447,411,572,"268",304,0.6801,0.6521,0.6667
"2686",206695,2007,"2140",1101,1039,168,"70",98,0.089,0.0674,0.0785
"2687",206914,2007,"716",382,334,50,"22",28,0.0733,0.0659,0.0698
"2688",207209,2007,"559",270,289,48,"8",40,0.1481,0.0277,0.0859
"2689",207306,2007,"328",173,155,43,"13",30,0.1734,0.0839,0.1311
"2690",207324,2007,"521",269,252,148,"63",85,0.316,0.25,0.2841
"2691",207388,2007,"3111",1599,1512,1013,"399",614,0.384,0.2639,0.3256
"2692",207500,2007,"3824",2043,1781,1331,"452",879,0.4302,0.2538,0.3481
"2693",207722,2007,"198",123,75,51,"13",38,0.3089,0.1733,0.2576
"2694",207847,2007,"631",326,305,82,"33",49,0.1503,0.1082,0.13
"2695",207865,2007,"896",552,344,116,"32",84,0.1522,0.093,0.1295
"2696",208822,2007,"435",279,156,225,"61",164,0.5878,0.391,0.5172
"2697",209056,2007,"506",322,184,338,"108",230,0.7143,0.587,0.668
"2698",209065,2007,"476",276,200,281,"96",185,0.6703,0.48,0.5903
"2699",209542,2007,"2974",1436,1538,879,"333",546,0.3802,0.2165,0.2956
"2700",209551,2007,"3505",1839,1666,1528,"629",899,0.4889,0.3776,0.4359
"2701",209612,2007,"372",242,130,194,"59",135,0.5579,0.4538,0.5215
"2702",209807,2007,"1427",759,668,252,"93",159,0.2095,0.1392,0.1766
"2703",209922,2007,"337",187,150,236,"99",137,0.7326,0.66,0.7003
"2704",210146,2007,"703",405,298,127,"37",90,0.2222,0.1242,0.1807
"2705",210401,2007,"444",238,206,315,"130",185,0.7773,0.6311,0.7095
"2706",210429,2007,"916",527,389,184,"54",130,0.2467,0.1388,0.2009
"2707",210571,2007,"512",307,205,247,"90",157,0.5114,0.439,0.4824
"2708",210669,2007,"581",351,230,431,"159",272,0.7749,0.6913,0.7418
"2709",210775,2007,"302",165,137,107,"48",59,0.3576,0.3504,0.3543
"2710",211088,2007,"476",364,112,253,"53",200,0.5495,0.4732,0.5315
"2711",211158,2007,"1679",969,710,710,"237",473,0.4881,0.3338,0.4229
"2712",211291,2007,"887",441,446,774,"373",401,0.9093,0.8363,0.8726
"2713",211352,2007,"513",329,184,202,"66",136,0.4134,0.3587,0.3938
"2714",211361,2007,"1250",622,628,281,"124",157,0.2524,0.1975,0.2248
"2715",211431,2007,"199",194,5,93,"0",93,0.4794,0,0.4673
"2716",211440,2007,"1407",554,853,1046,"612",434,0.7834,0.7175,0.7434
"2717",211468,2007,"222",221,1,112,"0",112,0.5068,0,0.5045
"2718",211556,2007,"175",175,0,77,"0",77,0.44,NA,0.44
"2719",211583,2007,"234",128,106,63,"24",39,0.3047,0.2264,0.2692
"2720",211608,2007,"278",166,112,26,"5",21,0.1265,0.0446,0.0935
"2721",211644,2007,"1381",799,582,417,"142",275,0.3442,0.244,0.302
"2722",211981,2007,"475",270,205,221,"79",142,0.5259,0.3854,0.4653
"2723",212009,2007,"619",319,300,515,"237",278,0.8715,0.79,0.832
"2724",212054,2007,"2260",945,1315,640,"254",386,0.4085,0.1932,0.2832
"2725",212106,2007,"1354",785,569,796,"307",489,0.6229,0.5395,0.5879
"2726",212115,2007,"1183",612,571,422,"156",266,0.4346,0.2732,0.3567
"2727",212133,2007,"483",319,164,206,"58",148,0.4639,0.3537,0.4265
"2728",212160,2007,"1243",707,536,239,"75",164,0.232,0.1399,0.1923
"2729",212197,2007,"487",324,163,344,"113",231,0.713,0.6933,0.7064
"2730",212577,2007,"569",301,268,477,"214",263,0.8738,0.7985,0.8383
"2731",212601,2007,"610",365,245,276,"96",180,0.4932,0.3918,0.4525
"2732",212832,2007,"291",208,83,58,"23",35,0.1683,0.2771,0.1993
"2733",212911,2007,"315",169,146,287,"131",156,0.9231,0.8973,0.9111
"2734",213020,2007,"2524",1450,1074,786,"257",529,0.3648,0.2393,0.3114
"2735",213251,2007,"377",220,157,271,"104",167,0.7591,0.6624,0.7188
"2736",213321,2007,"555",268,287,338,"173",165,0.6157,0.6028,0.609
"2737",213349,2007,"1888",1111,777,645,"182",463,0.4167,0.2342,0.3416
"2738",213358,2007,"294",192,102,93,"29",64,0.3333,0.2843,0.3163
"2739",213367,2007,"804",472,332,424,"136",288,0.6102,0.4096,0.5274
"2740",213385,2007,"591",277,314,500,"253",247,0.8917,0.8057,0.846
"2741",213507,2007,"450",261,189,308,"109",199,0.7625,0.5767,0.6844
"2742",213543,2007,"1165",450,715,851,"485",366,0.8133,0.6783,0.7305
"2743",213613,2007,"1217",656,561,321,"144",177,0.2698,0.2567,0.2638
"2744",213668,2007,"399",211,188,215,"84",131,0.6209,0.4468,0.5388
"2745",213783,2007,"661",397,264,198,"63",135,0.3401,0.2386,0.2995
"2746",213826,2007,"407",297,110,218,"46",172,0.5791,0.4182,0.5356
"2747",213996,2007,"723",459,264,514,"185",329,0.7168,0.7008,0.7109
"2748",214041,2007,"1326",766,560,491,"161",330,0.4308,0.2875,0.3703
"2749",214069,2007,"364",273,91,234,"51",183,0.6703,0.5604,0.6429
"2750",214157,2007,"401",214,187,282,"130",152,0.7103,0.6952,0.7032
"2751",214175,2007,"551",304,247,445,"189",256,0.8421,0.7652,0.8076
"2752",214272,2007,"540",336,204,157,"44",113,0.3363,0.2157,0.2907
"2753",214777,2007,"6492",3121,3371,4191,"1943",2248,0.7203,0.5764,0.6456
"2754",215062,2007,"2342",1107,1235,2058,"1052",1006,0.9088,0.8518,0.8787
"2755",215743,2007,"403",258,145,230,"71",159,0.6163,0.4897,0.5707
"2756",215798,2007,"423",200,223,269,"130",139,0.695,0.583,0.6359
"2757",215929,2007,"1025",574,451,771,"307",464,0.8084,0.6807,0.7522
"2758",216010,2007,"1720",927,793,639,"251",388,0.4186,0.3165,0.3715
"2759",216038,2007,"1498",876,622,596,"185",411,0.4692,0.2974,0.3979
"2760",216287,2007,"365",190,175,324,"152",172,0.9053,0.8686,0.8877
"2761",216339,2007,"4385",2478,1907,1705,"684",1021,0.412,0.3587,0.3888
"2762",216524,2007,"468",242,226,353,"159",194,0.8017,0.7035,0.7543
"2763",216694,2007,"402",232,170,182,"67",115,0.4957,0.3941,0.4527
"2764",216764,2007,"1955",1215,740,857,"235",622,0.5119,0.3176,0.4384
"2765",216807,2007,"311",179,132,195,"76",119,0.6648,0.5758,0.627
"2766",216852,2007,"782",382,400,312,"133",179,0.4686,0.3325,0.399
"2767",216931,2007,"620",299,321,291,"146",145,0.4849,0.4548,0.4694
"2768",217059,2007,"1177",597,580,437,"189",248,0.4154,0.3259,0.3713
"2769",217156,2007,"1477",814,663,1246,"548",698,0.8575,0.8265,0.8436
"2770",217402,2007,"989",559,430,820,"361",459,0.8211,0.8395,0.8291
"2771",217536,2007,"556",353,203,338,"117",221,0.6261,0.5764,0.6079
"2772",217776,2007,"183",114,69,49,"20",29,0.2544,0.2899,0.2678
"2773",217819,2007,"2061",1352,709,1071,"302",769,0.5688,0.426,0.5197
"2774",217882,2007,"2702",1304,1398,1598,"677",921,0.7063,0.4843,0.5914
"2775",217998,2007,"163",94,69,84,"30",54,0.5745,0.4348,0.5153
"2776",218061,2007,"776",493,283,127,"47",80,0.1623,0.1661,0.1637
"2777",218229,2007,"433",296,137,139,"35",104,0.3514,0.2555,0.321
"2778",218238,2007,"225",92,133,42,"18",24,0.2609,0.1353,0.1867
"2779",218399,2007,"295",152,143,40,"14",26,0.1711,0.0979,0.1356
"2780",218414,2007,"323",122,201,88,"41",47,0.3852,0.204,0.2724
"2781",218663,2007,"3690",2117,1573,1999,"734",1265,0.5975,0.4666,0.5417
"2782",218724,2007,"1647",886,761,443,"143",300,0.3386,0.1879,0.269
"2783",218733,2007,"1292",652,640,177,"59",118,0.181,0.0922,0.137
"2784",218742,2007,"805",488,317,191,"54",137,0.2807,0.1703,0.2373
"2785",218973,2007,"385",193,192,301,"141",160,0.829,0.7344,0.7818
"2786",219000,2007,"429",272,157,207,"54",153,0.5625,0.3439,0.4825
"2787",219046,2007,"472",268,204,51,"14",37,0.1381,0.0686,0.1081
"2788",219082,2007,"243",110,133,44,"23",21,0.1909,0.1729,0.1811
"2789",219198,2007,"108",73,35,49,"14",35,0.4795,0.4,0.4537
"2790",219259,2007,"340",203,137,70,"15",55,0.2709,0.1095,0.2059
"2791",219356,2007,"1933",950,983,495,"183",312,0.3284,0.1862,0.2561
"2792",219471,2007,"1030",612,418,282,"105",177,0.2892,0.2512,0.2738
"2793",219602,2007,"1188",683,505,178,"55",123,0.1801,0.1089,0.1498
"2794",219709,2007,"799",453,346,449,"187",262,0.5784,0.5405,0.562
"2795",219718,2007,"255",115,140,27,"13",14,0.1217,0.0929,0.1059
"2796",219949,2007,"210",75,135,43,"22",21,0.28,0.163,0.2048
"2797",220075,2007,"1918",1063,855,330,"110",220,0.207,0.1287,0.1721
"2798",220215,2007,"385",222,163,148,"58",90,0.4054,0.3558,0.3844
"2799",220613,2007,"783",437,346,271,"88",183,0.4188,0.2543,0.3461
"2800",220631,2007,"230",159,71,23,"19",4,0.0252,0.2676,0.1
"2801",220710,2007,"317",158,159,148,"49",99,0.6266,0.3082,0.4669
"2802",221351,2007,"452",252,200,335,"148",187,0.7421,0.74,0.7412
"2803",221519,2007,"401",235,166,303,"115",188,0.8,0.6928,0.7556
"2804",221731,2007,"153",86,67,49,"19",30,0.3488,0.2836,0.3203
"2805",221847,2007,"1649",730,919,371,"157",214,0.2932,0.1708,0.225
"2806",221892,2007,"238",139,99,85,"31",54,0.3885,0.3131,0.3571
"2807",222178,2007,"887",476,411,324,"113",211,0.4433,0.2749,0.3653
"2808",222983,2007,"333",174,159,223,"91",132,0.7586,0.5723,0.6697
"2809",223232,2007,"2721",1618,1103,1556,"552",1004,0.6205,0.5005,0.5718
"2810",224004,2007,"160",87,73,29,"9",20,0.2299,0.1233,0.1812
"2811",224323,2007,"362",200,162,201,"85",116,0.58,0.5247,0.5552
"2812",225432,2007,"831",438,393,22,"7",15,0.0342,0.0178,0.0265
"2813",225548,2007,"255",103,152,77,"31",46,0.4466,0.2039,0.302
"2814",225627,2007,"715",463,252,138,"41",97,0.2095,0.1627,0.193
"2815",226231,2007,"322",97,225,108,"71",37,0.3814,0.3156,0.3354
"2816",226833,2007,"735",384,351,118,"43",75,0.1953,0.1225,0.1605
"2817",227216,2007,"3495",1996,1499,862,"254",608,0.3046,0.1694,0.2466
"2818",227331,2007,"283",189,94,51,"13",38,0.2011,0.1383,0.1802
"2819",227526,2007,"1391",784,607,155,"36",119,0.1518,0.0593,0.1114
"2820",227757,2007,"742",346,396,585,"288",297,0.8584,0.7273,0.7884
"2821",227845,2007,"725",437,288,372,"127",245,0.5606,0.441,0.5131
"2822",227863,2007,"288",179,109,77,"25",52,0.2905,0.2294,0.2674
"2823",228042,2007,"262",135,127,92,"36",56,0.4148,0.2835,0.3511
"2824",228149,2007,"565",334,231,187,"54",133,0.3982,0.2338,0.331
"2825",228246,2007,"1306",697,609,870,"359",511,0.7331,0.5895,0.6662
"2826",228343,2007,"371",232,139,242,"84",158,0.681,0.6043,0.6523
"2827",228431,2007,"2268",1375,893,521,"156",365,0.2655,0.1747,0.2297
"2828",228459,2007,"3237",1900,1337,983,"288",695,0.3658,0.2154,0.3037
"2829",228501,2007,"242",92,150,34,"6",28,0.3043,0.04,0.1405
"2830",228529,2007,"1190",685,505,259,"86",173,0.2526,0.1703,0.2176
"2831",228705,2007,"651",251,400,115,"58",57,0.2271,0.145,0.1767
"2832",228723,2007,"8025",4074,3951,3968,"1491",2477,0.608,0.3774,0.4945
"2833",228769,2007,"2096",1041,1055,354,"130",224,0.2152,0.1232,0.1689
"2834",228778,2007,"7419",3973,3446,3776,"1472",2304,0.5799,0.4272,0.509
"2835",228787,2007,"1030",421,609,472,"237",235,0.5582,0.3892,0.4583
"2836",228796,2007,"2017",1046,971,245,"94",151,0.1444,0.0968,0.1215
"2837",228875,2007,"1642",965,677,961,"348",613,0.6352,0.514,0.5853
"2838",228981,2007,"365",177,188,114,"39",75,0.4237,0.2074,0.3123
"2839",229018,2007,"372",198,174,48,"15",33,0.1667,0.0862,0.129
"2840",229027,2007,"4833",2309,2524,465,"179",286,0.1239,0.0709,0.0962
"2841",229115,2007,"4439",2065,2374,1455,"600",855,0.414,0.2527,0.3278
"2842",229780,2007,"247",129,118,53,"20",33,0.2558,0.1695,0.2146
"2843",229814,2007,"923",480,443,227,"79",148,0.3083,0.1783,0.2459
"2844",230603,2007,"865",579,286,185,"39",146,0.2522,0.1364,0.2139
"2845",230728,2007,"2654",1697,957,544,"113",431,0.254,0.1181,0.205
"2846",230764,2007,"1953",1082,871,469,"170",299,0.2763,0.1952,0.2401
"2847",230782,2007,"1364",783,581,110,"27",83,0.106,0.0465,0.0806
"2848",231059,2007,"524",280,244,364,"154",210,0.75,0.6311,0.6947
"2849",231174,2007,"2432",1346,1086,1577,"650",927,0.6887,0.5985,0.6484
"2850",231420,2007,"238",70,168,43,"23",20,0.2857,0.1369,0.1807
"2851",231554,2007,"89",49,40,34,"10",24,0.4898,0.25,0.382
"2852",231624,2007,"1341",729,612,1114,"474",640,0.8779,0.7745,0.8307
"2853",231712,2007,"1241",706,535,618,"200",418,0.5921,0.3738,0.498
"2854",232025,2007,"240",103,137,80,"37",43,0.4175,0.2701,0.3333
"2855",232043,2007,"203",121,82,100,"34",66,0.5455,0.4146,0.4926
"2856",232089,2007,"525",228,297,103,"42",61,0.2675,0.1414,0.1962
"2857",232186,2007,"2174",1222,952,942,"316",626,0.5123,0.3319,0.4333
"2858",232265,2007,"1179",757,422,585,"163",422,0.5575,0.3863,0.4962
"2859",232423,2007,"3864",2401,1463,2520,"829",1691,0.7043,0.5666,0.6522
"2860",232557,2007,"2715",1474,1241,715,"278",437,0.2965,0.224,0.2634
"2861",232566,2007,"984",650,334,412,"107",305,0.4692,0.3204,0.4187
"2862",232609,2007,"598",324,274,274,"95",179,0.5525,0.3467,0.4582
"2863",232681,2007,"951",649,302,626,"175",451,0.6949,0.5795,0.6583
"2864",232706,2007,"396",288,108,176,"35",141,0.4896,0.3241,0.4444
"2865",232937,2007,"938",571,367,179,"46",133,0.2329,0.1253,0.1908
"2866",232982,2007,"2513",1327,1186,581,"200",381,0.2871,0.1686,0.2312
"2867",233277,2007,"1840",1055,785,758,"273",485,0.4597,0.3478,0.412
"2868",233374,2007,"801",427,374,653,"295",358,0.8384,0.7888,0.8152
"2869",233426,2007,"565",335,230,327,"115",212,0.6328,0.5,0.5788
"2870",233541,2007,"397",205,192,135,"49",86,0.4195,0.2552,0.3401
"2871",233897,2007,"401",184,217,97,"41",56,0.3043,0.1889,0.2419
"2872",233921,2007,"5112",2264,2848,3063,"1430",1633,0.7213,0.5021,0.5992
"2873",234030,2007,"3802",2159,1643,1129,"405",724,0.3353,0.2465,0.2969
"2874",234085,2007,"410",36,374,240,"221",19,0.5278,0.5909,0.5854
"2875",234155,2007,"1185",796,389,259,"58",201,0.2525,0.1491,0.2186
"2876",234164,2007,"375",209,166,81,"17",64,0.3062,0.1024,0.216
"2877",235097,2007,"1313",770,543,243,"81",162,0.2104,0.1492,0.1851
"2878",235167,2007,"677",347,330,288,"138",150,0.4323,0.4182,0.4254
"2879",236230,2007,"714",453,261,394,"134",260,0.574,0.5134,0.5518
"2880",236328,2007,"641",393,248,437,"157",280,0.7125,0.6331,0.6817
"2881",236577,2007,"716",499,217,390,"110",280,0.5611,0.5069,0.5447
"2882",236595,2007,"736",479,257,432,"127",305,0.6367,0.4942,0.587
"2883",236896,2007,"344",162,182,58,"25",33,0.2037,0.1374,0.1686
"2884",236939,2007,"3184",1588,1596,1275,"508",767,0.483,0.3183,0.4004
"2885",236948,2007,"5163",2771,2392,2968,"1213",1755,0.6333,0.5071,0.5749
"2886",237011,2007,"2572",1484,1088,970,"324",646,0.4353,0.2978,0.3771
"2887",237057,2007,"400",239,161,319,"124",195,0.8159,0.7702,0.7975
"2888",237066,2007,"532",293,239,347,"141",206,0.7031,0.59,0.6523
"2889",237215,2007,"296",167,129,18,"11",7,0.0419,0.0853,0.0608
"2890",237330,2007,"618",335,283,115,"49",66,0.197,0.1731,0.1861
"2891",237358,2007,"120",70,50,21,"9",12,0.1714,0.18,0.175
"2892",237367,2007,"632",331,301,87,"37",50,0.1511,0.1229,0.1377
"2893",237792,2007,"691",366,325,124,"48",76,0.2077,0.1477,0.1795
"2894",237899,2007,"364",170,194,14,"5",9,0.0529,0.0258,0.0385
"2895",237932,2007,"499",264,235,110,"27",83,0.3144,0.1149,0.2204
"2896",237969,2007,"401",203,198,174,"71",103,0.5074,0.3586,0.4339
"2897",238032,2007,"4664",2156,2508,1561,"696",865,0.4012,0.2775,0.3347
"2898",238333,2007,"325",183,142,229,"99",130,0.7104,0.6972,0.7046
"2899",238430,2007,"173",115,58,25,"6",19,0.1652,0.1034,0.1445
"2900",238458,2007,"652",440,212,277,"88",189,0.4295,0.4151,0.4248
"2901",238476,2007,"683",350,333,371,"145",226,0.6457,0.4354,0.5432
"2902",238616,2007,"422",232,190,143,"46",97,0.4181,0.2421,0.3389
"2903",238661,2007,"302",202,100,98,"28",70,0.3465,0.28,0.3245
"2904",239080,2007,"266",191,75,80,"8",72,0.377,0.1067,0.3008
"2905",239105,2007,"1811",966,845,1038,"442",596,0.617,0.5231,0.5732
"2906",239628,2007,"262",124,138,158,"78",80,0.6452,0.5652,0.6031
"2907",239716,2007,"542",328,214,372,"130",242,0.7378,0.6075,0.6863
"2908",240107,2007,"361",252,109,108,"26",82,0.3254,0.2385,0.2992
"2909",240189,2007,"2048",993,1055,564,"258",306,0.3082,0.2445,0.2754
"2910",240277,2007,"987",644,343,201,"42",159,0.2469,0.1224,0.2036
"2911",240329,2007,"1750",1084,666,621,"196",425,0.3921,0.2943,0.3549
"2912",240338,2007,"181",97,84,82,"34",48,0.4948,0.4048,0.453
"2913",240365,2007,"1723",1018,705,300,"96",204,0.2004,0.1362,0.1741
"2914",240374,2007,"833",418,415,75,"38",37,0.0885,0.0916,0.09
"2915",240417,2007,"1489",763,726,309,"108",201,0.2634,0.1488,0.2075
"2916",240426,2007,"343",197,146,47,"14",33,0.1675,0.0959,0.137
"2917",240444,2007,"5980",3197,2783,3291,"1332",1959,0.6128,0.4786,0.5503
"2918",240453,2007,"4465",2228,2237,585,"259",326,0.1463,0.1158,0.131
"2919",240462,2007,"1466",500,966,275,"127",148,0.296,0.1315,0.1876
"2920",240471,2007,"1276",743,533,297,"103",194,0.2611,0.1932,0.2328
"2921",240480,2007,"1611",892,719,358,"145",213,0.2388,0.2017,0.2222
"2922",240727,2007,"1614",831,783,389,"132",257,0.3093,0.1686,0.241
"2923",243443,2007,"690",422,268,41,"10",31,0.0735,0.0373,0.0594
"2924",243780,2007,"6830",2882,3948,2702,"1260",1442,0.5003,0.3191,0.3956
"2925",100654,2006,"1133",584,549,110,"29",81,0.1387,0.0528,0.0971
"2926",100663,2006,"1485",895,590,378,"124",254,0.2838,0.2102,0.2545
"2927",100751,2006,"4275",2377,1898,1757,"660",1097,0.4615,0.3477,0.411
"2928",100858,2006,"4072",2168,1904,1556,"549",1007,0.4645,0.2883,0.3821
"2929",101435,2006,"214",85,129,72,"36",36,0.4235,0.2791,0.3364
"2930",101480,2006,"1106",626,480,106,"23",83,0.1326,0.0479,0.0958
"2931",101675,2006,"352",159,193,15,"3",12,0.0755,0.0155,0.0426
"2932",101879,2006,"1019",575,444,112,"26",86,0.1496,0.0586,0.1099
"2933",102049,2006,"644",392,252,326,"99",227,0.5791,0.3929,0.5062
"2934",102094,2006,"1355",777,578,190,"55",135,0.1737,0.0952,0.1402
"2935",102234,2006,"345",226,119,189,"62",127,0.5619,0.521,0.5478
"2936",102368,2006,"1666",964,702,238,"77",161,0.167,0.1097,0.1429
"2937",102377,2006,"688",395,293,151,"33",118,0.2987,0.1126,0.2195
"2938",104151,2006,"8533",4556,3977,2837,"1145",1692,0.3714,0.2879,0.3325
"2939",104179,2006,"5788",3092,2696,2085,"813",1272,0.4114,0.3016,0.3602
"2940",105330,2006,"2527",1488,1039,756,"224",532,0.3575,0.2156,0.2992
"2941",106245,2006,"603",317,286,40,"19",21,0.0662,0.0664,0.0663
"2942",106342,2006,"128",61,67,56,"27",29,0.4754,0.403,0.4375
"2943",106397,2006,"2719",1346,1373,945,"398",547,0.4064,0.2899,0.3476
"2944",106412,2006,"688",340,348,55,"18",37,0.1088,0.0517,0.0799
"2945",106458,2006,"1659",946,713,345,"124",221,0.2336,0.1739,0.208
"2946",106467,2006,"1426",711,715,234,"83",151,0.2124,0.1161,0.1641
"2947",106485,2006,"630",335,295,71,"28",43,0.1284,0.0949,0.1127
"2948",106704,2006,"2352",1340,1012,538,"187",351,0.2619,0.1848,0.2287
"2949",107044,2006,"901",477,424,365,"134",231,0.4843,0.316,0.4051
"2950",107080,2006,"396",222,174,251,"99",152,0.6847,0.569,0.6338
"2951",107141,2006,"326",168,158,190,"78",112,0.6667,0.4937,0.5828
"2952",107512,2006,"367",190,177,185,"73",112,0.5895,0.4124,0.5041
"2953",107558,2006,"164",80,84,59,"29",30,0.375,0.3452,0.3598
"2954",110097,2006,"799",521,278,364,"102",262,0.5029,0.3669,0.4556
"2955",110404,2006,"210",60,150,166,"113",53,0.8833,0.7533,0.7905
"2956",110422,2006,"3761",1648,2113,1044,"362",682,0.4138,0.1713,0.2776
"2957",110486,2006,"854",553,301,120,"29",91,0.1646,0.0963,0.1405
"2958",110495,2006,"846",570,276,148,"37",111,0.1947,0.1341,0.1749
"2959",110510,2006,"1774",1157,617,201,"55",146,0.1262,0.0891,0.1133
"2960",110529,2006,"3138",1357,1781,341,"128",213,0.157,0.0719,0.1087
"2961",110538,2006,"2430",1326,1104,420,"103",317,0.2391,0.0933,0.1728
"2962",110547,2006,"984",716,268,41,"8",33,0.0461,0.0299,0.0417
"2963",110556,2006,"2528",1501,1027,344,"108",236,0.1572,0.1052,0.1361
"2964",110565,2006,"3736",2262,1474,500,"122",378,0.1671,0.0828,0.1338
"2965",110574,2006,"881",506,375,131,"48",83,0.164,0.128,0.1487
"2966",110583,2006,"4334",2757,1577,550,"175",375,0.136,0.111,0.1269
"2967",110592,2006,"1542",961,581,113,"36",77,0.0801,0.062,0.0733
"2968",110617,2006,"2590",1570,1020,263,"79",184,0.1172,0.0775,0.1015
"2969",113698,2006,"263",193,70,100,"18",82,0.4249,0.2571,0.3802
"2970",115755,2006,"966",550,416,132,"46",86,0.1564,0.1106,0.1366
"2971",119173,2006,"345",336,9,76,"1",75,0.2232,0.1111,0.2203
"2972",120184,2006,"134",93,41,51,"15",36,0.3871,0.3659,0.3806
"2973",121309,2006,"537",342,195,352,"118",234,0.6842,0.6051,0.6555
"2974",121345,2006,"378",190,188,337,"162",175,0.9211,0.8617,0.8915
"2975",122409,2006,"4109",2458,1651,1309,"382",927,0.3771,0.2314,0.3186
"2976",122436,2006,"1103",703,400,714,"214",500,0.7112,0.535,0.6473
"2977",122597,2006,"3117",2017,1100,418,"128",290,0.1438,0.1164,0.1341
"2978",122612,2006,"1073",733,340,582,"166",416,0.5675,0.4882,0.5424
"2979",122931,2006,"1340",740,600,1055,"448",607,0.8203,0.7467,0.7873
"2980",123554,2006,"600",384,216,292,"105",187,0.487,0.4861,0.4867
"2981",123572,2006,"1513",1033,480,410,"104",306,0.2962,0.2167,0.271
"2982",126562,2006,"885",510,375,155,"52",103,0.202,0.1387,0.1751
"2983",126580,2006,"914",531,383,216,"75",141,0.2655,0.1958,0.2363
"2984",126614,2006,"5606",2688,2918,2336,"1016",1320,0.4911,0.3482,0.4167
"2985",126818,2006,"3825",2166,1659,1448,"441",1007,0.4649,0.2658,0.3786
"2986",127060,2006,"1135",615,520,692,"290",402,0.6537,0.5577,0.6097
"2987",127185,2006,"821",367,454,161,"59",102,0.2779,0.13,0.1961
"2988",127565,2006,"1711",925,786,102,"33",69,0.0746,0.042,0.0596
"2989",127741,2006,"2491",1442,1049,659,"204",455,0.3155,0.1945,0.2646
"2990",128106,2006,"628",350,278,112,"42",70,0.2,0.1511,0.1783
"2991",128744,2006,"303",176,127,70,"20",50,0.2841,0.1575,0.231
"2992",128771,2006,"1282",603,679,272,"117",155,0.257,0.1723,0.2122
"2993",129020,2006,"3222",1631,1591,2148,"962",1186,0.7272,0.6047,0.6667
"2994",129242,2006,"896",534,362,696,"269",427,0.7996,0.7431,0.7768
"2995",129941,2006,"690",325,365,305,"157",148,0.4554,0.4301,0.442
"2996",130253,2006,"931",603,328,536,"172",364,0.6036,0.5244,0.5757
"2997",130314,2006,"133",133,0,50,"0",50,0.3759,NA,0.3759
"2998",130493,2006,"1516",987,529,262,"54",208,0.2107,0.1021,0.1728
"2999",130590,2006,"608",294,314,466,"229",237,0.8061,0.7293,0.7664
"3000",130697,2006,"716",352,364,624,"316",308,0.875,0.8681,0.8715
"3001",130776,2006,"843",413,430,167,"64",103,0.2494,0.1488,0.1981
"3002",130794,2006,"1313",654,659,1169,"578",591,0.9037,0.8771,0.8903
"3003",130934,2006,"818",463,355,126,"37",89,0.1922,0.1042,0.154
"3004",130943,2006,"3563",2127,1436,2175,"777",1398,0.6573,0.5411,0.6104
"3005",131159,2006,"1385",923,462,1007,"321",686,0.7432,0.6948,0.7271
"3006",131283,2006,"856",459,397,527,"219",308,0.671,0.5516,0.6157
"3007",131450,2006,"209",96,113,15,"5",10,0.1042,0.0442,0.0718
"3008",131469,2006,"2440",1348,1092,1804,"756",1048,0.7774,0.6923,0.7393
"3009",131496,2006,"1588",877,711,1419,"630",789,0.8997,0.8861,0.8936
"3010",131520,2006,"1512",1022,490,629,"155",474,0.4638,0.3163,0.416
"3011",132471,2006,"387",255,132,82,"24",58,0.2275,0.1818,0.2119
"3012",132602,2006,"901",497,404,142,"64",78,0.1569,0.1584,0.1576
"3013",132903,2006,"6389",3389,3000,2257,"754",1503,0.4435,0.2513,0.3533
"3014",133492,2006,"544",315,229,308,"113",195,0.619,0.4934,0.5662
"3015",133553,2006,"1101",161,940,363,"290",73,0.4534,0.3085,0.3297
"3016",133650,2006,"1614",925,689,156,"36",120,0.1297,0.0522,0.0967
"3017",133669,2006,"2193",1208,985,339,"115",224,0.1854,0.1168,0.1546
"3018",133711,2006,"463",284,179,235,"77",158,0.5563,0.4302,0.5076
"3019",133881,2006,"597",160,437,222,"144",78,0.4875,0.3295,0.3719
"3020",133951,2006,"3889",2099,1790,736,"243",493,0.2349,0.1358,0.1893
"3021",134079,2006,"420",267,153,198,"59",139,0.5206,0.3856,0.4714
"3022",134097,2006,"6191",3597,2594,3310,"1201",2109,0.5863,0.463,0.5346
"3023",134130,2006,"6674",3783,2891,4294,"1572",2722,0.7195,0.5438,0.6434
"3024",134945,2006,"493",213,280,134,"62",72,0.338,0.2214,0.2718
"3025",135726,2006,"2046",1055,991,1421,"644",777,0.7365,0.6498,0.6945
"3026",136172,2006,"2304",1301,1003,462,"131",331,0.2544,0.1306,0.2005
"3027",136950,2006,"501",287,214,312,"119",193,0.6725,0.5561,0.6228
"3028",137546,2006,"565",338,227,317,"113",204,0.6036,0.4978,0.5611
"3029",138354,2006,"861",495,366,209,"65",144,0.2909,0.1776,0.2427
"3030",138716,2006,"702",467,235,74,"14",60,0.1285,0.0596,0.1054
"3031",138789,2006,"757",472,285,63,"14",49,0.1038,0.0491,0.0832
"3032",139144,2006,"427",302,125,221,"56",165,0.5464,0.448,0.5176
"3033",139366,2006,"1054",640,414,139,"37",102,0.1594,0.0894,0.1319
"3034",139393,2006,"297",166,131,163,"62",101,0.6084,0.4733,0.5488
"3035",139658,2006,"1648",938,710,1108,"477",631,0.6727,0.6718,0.6723
"3036",139719,2006,"486",253,233,51,"9",42,0.166,0.0386,0.1049
"3037",139755,2006,"2838",890,1948,953,"548",405,0.4551,0.2813,0.3358
"3038",139764,2006,"399",236,163,52,"11",41,0.1737,0.0675,0.1303
"3039",139861,2006,"1137",707,430,403,"101",302,0.4272,0.2349,0.3544
"3040",139931,2006,"2731",1294,1437,617,"214",403,0.3114,0.1489,0.2259
"3041",139940,2006,"2174",1313,861,439,"135",304,0.2315,0.1568,0.2019
"3042",139959,2006,"5059",3161,1898,2732,"900",1832,0.5796,0.4742,0.54
"3043",140447,2006,"582",300,282,253,"98",155,0.5167,0.3475,0.4347
"3044",140960,2006,"697",377,320,60,"12",48,0.1273,0.0375,0.0861
"3045",140988,2006,"311",138,173,104,"42",62,0.4493,0.2428,0.3344
"3046",141185,2006,"190",104,86,62,"18",44,0.4231,0.2093,0.3263
"3047",141264,2006,"2015",1195,820,300,"78",222,0.1858,0.0951,0.1489
"3048",141334,2006,"1694",1002,692,254,"67",187,0.1866,0.0968,0.1499
"3049",141486,2006,"264",185,79,54,"17",37,0.2,0.2152,0.2045
"3050",141565,2006,"448",267,181,48,"9",39,0.1461,0.0497,0.1071
"3051",141574,2006,"1679",922,757,293,"107",186,0.2017,0.1413,0.1745
"3052",142276,2006,"994",525,469,85,"23",62,0.1181,0.049,0.0855
"3053",142285,2006,"1582",749,833,369,"150",219,0.2924,0.1801,0.2332
"3054",142461,2006,"247",128,119,86,"37",49,0.3828,0.3109,0.3482
"3055",143084,2006,"692",392,300,505,"216",289,0.7372,0.72,0.7298
"3056",143288,2006,"177",111,66,63,"17",46,0.4144,0.2576,0.3559
"3057",144005,2006,"359",254,105,16,"2",14,0.0551,0.019,0.0446
"3058",144281,2006,"1972",1025,947,547,"247",300,0.2927,0.2608,0.2774
"3059",144740,2006,"2531",1428,1103,1280,"482",798,0.5588,0.437,0.5057
"3060",144892,2006,"1760",1062,698,583,"164",419,0.3945,0.235,0.3312
"3061",144962,2006,"484",296,188,275,"100",175,0.5912,0.5319,0.5682
"3062",144971,2006,"137",74,63,54,"26",28,0.3784,0.4127,0.3942
"3063",145600,2006,"2830",1554,1276,878,"380",498,0.3205,0.2978,0.3102
"3064",145619,2006,"379",189,190,139,"57",82,0.4339,0.3,0.3668
"3065",145637,2006,"7152",3518,3634,4881,"2256",2625,0.7462,0.6208,0.6825
"3066",145691,2006,"293",154,139,148,"49",99,0.6429,0.3525,0.5051
"3067",145813,2006,"3188",1915,1273,1496,"471",1025,0.5352,0.37,0.4693
"3068",146481,2006,"386",224,162,241,"96",145,0.6473,0.5926,0.6244
"3069",146612,2006,"568",323,245,223,"94",129,0.3994,0.3837,0.3926
"3070",146719,2006,"2134",1426,708,1104,"357",747,0.5238,0.5042,0.5173
"3071",146825,2006,"166",86,80,41,"14",27,0.314,0.175,0.247
"3072",147013,2006,"343",162,181,114,"40",74,0.4568,0.221,0.3324
"3073",147244,2006,"475",261,214,214,"89",125,0.4789,0.4159,0.4505
"3074",147341,2006,"392",215,177,172,"64",108,0.5023,0.3616,0.4388
"3075",147703,2006,"3260",1641,1619,903,"427",476,0.2901,0.2637,0.277
"3076",147767,2006,"2060",1089,971,1768,"799",969,0.8898,0.8229,0.8583
"3077",147776,2006,"1022",600,422,40,"18",22,0.0367,0.0427,0.0391
"3078",147828,2006,"751",414,337,332,"126",206,0.4976,0.3739,0.4421
"3079",148131,2006,"161",88,73,67,"27",40,0.4545,0.3699,0.4161
"3080",148496,2006,"362",256,106,203,"52",151,0.5898,0.4906,0.5608
"3081",148584,2006,"181",104,77,62,"21",41,0.3942,0.2727,0.3425
"3082",148627,2006,"525",370,155,172,"47",125,0.3378,0.3032,0.3276
"3083",149222,2006,"2278",1005,1273,586,"266",320,0.3184,0.209,0.2572
"3084",149231,2006,"1770",1025,745,527,"163",364,0.3551,0.2188,0.2977
"3085",149772,2006,"1907",909,998,583,"303",280,0.308,0.3036,0.3057
"3086",149781,2006,"572",278,294,435,"219",216,0.777,0.7449,0.7605
"3087",150066,2006,"447",245,202,206,"83",123,0.502,0.4109,0.4609
"3088",150136,2006,"3947",2027,1920,1155,"425",730,0.3601,0.2214,0.2926
"3089",150145,2006,"303",190,113,136,"41",95,0.5,0.3628,0.4488
"3090",150163,2006,"965",604,361,479,"150",329,0.5447,0.4155,0.4964
"3091",150400,2006,"595",334,261,442,"186",256,0.7665,0.7126,0.7429
"3092",150534,2006,"643",379,264,359,"139",220,0.5805,0.5265,0.5583
"3093",150668,2006,"206",122,84,114,"44",70,0.5738,0.5238,0.5534
"3094",150941,2006,"250",140,110,126,"52",74,0.5286,0.4727,0.504
"3095",151102,2006,"1608",859,749,61,"20",41,0.0477,0.0267,0.0379
"3096",151111,2006,"2516",1549,967,317,"109",208,0.1343,0.1127,0.126
"3097",151306,2006,"2021",1253,768,321,"70",251,0.2003,0.0911,0.1588
"3098",151324,2006,"1657",827,830,335,"125",210,0.2539,0.1506,0.2022
"3099",151333,2006,"329",210,119,26,"6",20,0.0952,0.0504,0.079
"3100",151342,2006,"772",427,345,31,"16",15,0.0351,0.0464,0.0402
"3101",151351,2006,"7208",3875,3333,3949,"1681",2268,0.5853,0.5044,0.5479
"3102",151360,2006,"561",352,209,31,"8",23,0.0653,0.0383,0.0553
"3103",151379,2006,"727",430,297,63,"24",39,0.0907,0.0808,0.0867
"3104",151388,2006,"225",135,90,9,"3",6,0.0444,0.0333,0.04
"3105",151777,2006,"311",137,174,136,"62",74,0.5401,0.3563,0.4373
"3106",151786,2006,"277",148,129,108,"32",76,0.5135,0.2481,0.3899
"3107",152080,2006,"2029",928,1101,1800,"962",838,0.903,0.8738,0.8871
"3108",152248,2006,"1036",546,490,52,"19",33,0.0604,0.0388,0.0502
"3109",152363,2006,"251",111,140,100,"49",51,0.4595,0.35,0.3984
"3110",152530,2006,"492",266,226,341,"146",195,0.7331,0.646,0.6931
"3111",152600,2006,"760",394,366,469,"206",263,0.6675,0.5628,0.6171
"3112",153001,2006,"265",133,132,111,"51",60,0.4511,0.3864,0.4189
"3113",153108,2006,"413",218,195,256,"103",153,0.7018,0.5282,0.6199
"3114",153269,2006,"779",470,309,429,"173",256,0.5447,0.5599,0.5507
"3115",153384,2006,"405",206,199,348,"166",182,0.8835,0.8342,0.8593
"3116",153603,2006,"3933",1780,2153,1525,"649",876,0.4921,0.3014,0.3877
"3117",153834,2006,"610",350,260,417,"180",237,0.6771,0.6923,0.6836
"3118",154095,2006,"1684",1010,674,648,"200",448,0.4436,0.2967,0.3848
"3119",155089,2006,"139",64,75,12,"8",4,0.0625,0.1067,0.0863
"3120",155317,2006,"4092",2092,2000,1500,"607",893,0.4269,0.3035,0.3666
"3121",155335,2006,"167",96,71,48,"18",30,0.3125,0.2535,0.2874
"3122",155399,2006,"3140",1602,1538,832,"288",544,0.3396,0.1873,0.265
"3123",155520,2006,"239",118,121,82,"36",46,0.3898,0.2975,0.3431
"3124",155627,2006,"90",38,52,19,"6",13,0.3421,0.1154,0.2111
"3125",155937,2006,"197",79,118,40,"10",30,0.3797,0.0847,0.203
"3126",156213,2006,"276",161,115,178,"67",111,0.6894,0.5826,0.6449
"3127",156286,2006,"429",279,150,206,"60",146,0.5233,0.4,0.4802
"3128",156295,2006,"388",220,168,185,"78",107,0.4864,0.4643,0.4768
"3129",156365,2006,"346",182,164,81,"32",49,0.2692,0.1951,0.2341
"3130",156541,2006,"349",177,172,99,"34",65,0.3672,0.1977,0.2837
"3131",156745,2006,"363",226,137,185,"53",132,0.5841,0.3869,0.5096
"3132",157058,2006,"569",277,292,21,"6",15,0.0542,0.0205,0.0369
"3133",157076,2006,"326",127,199,82,"41",41,0.3228,0.206,0.2515
"3134",157085,2006,"4113",2201,1912,1253,"443",810,0.368,0.2317,0.3046
"3135",157289,2006,"2380",1230,1150,628,"257",371,0.3016,0.2235,0.2639
"3136",157386,2006,"1330",741,589,201,"65",136,0.1835,0.1104,0.1511
"3137",157401,2006,"1390",822,568,391,"123",268,0.326,0.2165,0.2813
"3138",157447,2006,"1908",1069,839,230,"83",147,0.1375,0.0989,0.1205
"3139",157535,2006,"220",105,115,26,"4",22,0.2095,0.0348,0.1182
"3140",157951,2006,"3118",1768,1350,649,"217",432,0.2443,0.1607,0.2081
"3141",158477,2006,"241",136,105,104,"45",59,0.4338,0.4286,0.4315
"3142",159009,2006,"1119",609,510,108,"33",75,0.1232,0.0647,0.0965
"3143",159391,2006,"4503",2449,2054,1530,"584",946,0.3863,0.2843,0.3398
"3144",159647,2006,"1625",753,872,426,"185",241,0.3201,0.2122,0.2622
"3145",159717,2006,"1272",741,531,195,"60",135,0.1822,0.113,0.1533
"3146",159966,2006,"1069",650,419,170,"44",126,0.1938,0.105,0.159
"3147",160038,2006,"1324",854,470,214,"62",152,0.178,0.1319,0.1616
"3148",160612,2006,"2665",1604,1061,320,"93",227,0.1415,0.0877,0.1201
"3149",160621,2006,"1136",659,477,132,"33",99,0.1502,0.0692,0.1162
"3150",160658,2006,"2799",1604,1195,362,"108",254,0.1584,0.0904,0.1293
"3151",161004,2006,"474",253,221,430,"193",237,0.9368,0.8733,0.9072
"3152",161226,2006,"511",351,160,209,"49",160,0.4558,0.3062,0.409
"3153",161235,2006,"116",67,49,2,"1",1,0.0149,0.0204,0.0172
"3154",161244,2006,"99",59,40,10,"6",4,0.0678,0.15,0.101
"3155",161253,2006,"1807",875,932,648,"296",352,0.4023,0.3176,0.3586
"3156",161554,2006,"888",511,377,84,"25",59,0.1155,0.0663,0.0946
"3157",162007,2006,"765",475,290,83,"20",63,0.1326,0.069,0.1085
"3158",162210,2006,"144",84,60,18,"5",13,0.1548,0.0833,0.125
"3159",162283,2006,"494",390,104,28,"3",25,0.0641,0.0288,0.0567
"3160",162584,2006,"1011",459,552,175,"65",110,0.2397,0.1178,0.1731
"3161",162654,2006,"450",303,147,255,"70",185,0.6106,0.4762,0.5667
"3162",162760,2006,"278",185,93,137,"38",99,0.5351,0.4086,0.4928
"3163",162928,2006,"1304",643,661,1127,"563",564,0.8771,0.8517,0.8643
"3164",163046,2006,"946",596,350,749,"263",486,0.8154,0.7514,0.7918
"3165",163268,2006,"1419",626,793,523,"233",290,0.4633,0.2938,0.3686
"3166",163286,2006,"3944",1896,2048,2493,"1179",1314,0.693,0.5757,0.6321
"3167",163453,2006,"1368",773,595,165,"46",119,0.1539,0.0773,0.1206
"3168",163462,2006,"426",244,182,265,"97",168,0.6885,0.533,0.6221
"3169",163851,2006,"1028",588,440,502,"171",331,0.5629,0.3886,0.4883
"3170",163912,2006,"428",249,179,309,"118",191,0.7671,0.6592,0.722
"3171",164076,2006,"2688",1697,991,1047,"307",740,0.4361,0.3098,0.3895
"3172",164173,2006,"643",454,189,315,"85",230,0.5066,0.4497,0.4899
"3173",164216,2006,"312",179,133,202,"80",122,0.6816,0.6015,0.6474
"3174",164270,2006,"476",260,216,324,"126",198,0.7615,0.5833,0.6807
"3175",164447,2006,"282",148,134,81,"29",52,0.3514,0.2164,0.2872
"3176",164492,2006,"181",105,76,71,"24",47,0.4476,0.3158,0.3923
"3177",164562,2006,"675",397,278,484,"183",301,0.7582,0.6583,0.717
"3178",165015,2006,"764",416,348,656,"291",365,0.8774,0.8362,0.8586
"3179",165024,2006,"1321",737,584,368,"135",233,0.3161,0.2312,0.2786
"3180",165334,2006,"563",345,218,425,"159",266,0.771,0.7294,0.7549
"3181",165662,2006,"728",409,319,578,"254",324,0.7922,0.7962,0.794
"3182",165671,2006,"467",344,123,233,"55",178,0.5174,0.4472,0.4989
"3183",165820,2006,"728",383,345,172,"63",109,0.2846,0.1826,0.2363
"3184",165866,2006,"714",496,218,242,"57",185,0.373,0.2615,0.3389
"3185",165936,2006,"380",250,130,225,"71",154,0.616,0.5462,0.5921
"3186",166027,2006,"1679",878,801,1448,"664",784,0.8929,0.829,0.8624
"3187",166124,2006,"751",415,336,675,"293",382,0.9205,0.872,0.8988
"3188",166513,2006,"1208",451,757,355,"190",165,0.3659,0.251,0.2939
"3189",166629,2006,"4265",2174,2091,2259,"1002",1257,0.5782,0.4792,0.5297
"3190",166638,2006,"846",484,362,109,"29",80,0.1653,0.0801,0.1288
"3191",166683,2006,"1001",447,554,837,"457",380,0.8501,0.8249,0.8362
"3192",167288,2006,"299",175,124,94,"33",61,0.3486,0.2661,0.3144
"3193",167987,2006,"1763",866,897,559,"248",311,0.3591,0.2765,0.3171
"3194",167996,2006,"594",363,231,469,"173",296,0.8154,0.7489,0.7896
"3195",168005,2006,"1286",735,551,520,"197",323,0.4395,0.3575,0.4044
"3196",168148,2006,"1280",648,632,1120,"543",577,0.8904,0.8592,0.875
"3197",168254,2006,"719",259,460,367,"211",156,0.6023,0.4587,0.5104
"3198",168281,2006,"410",239,171,317,"125",192,0.8033,0.731,0.7732
"3199",168342,2006,"533",280,253,484,"223",261,0.9321,0.8814,0.9081
"3200",168546,2006,"480",260,220,297,"118",179,0.6885,0.5364,0.6188
"3201",168786,2006,"387",252,135,192,"67",125,0.496,0.4963,0.4961
"3202",169080,2006,"1020",551,469,615,"268",347,0.6298,0.5714,0.6029
"3203",169798,2006,"2272",1315,957,276,"97",179,0.1361,0.1014,0.1215
"3204",169910,2006,"1895",860,1035,167,"82",85,0.0988,0.0792,0.0881
"3205",170082,2006,"3556",2276,1280,1116,"346",770,0.3383,0.2703,0.3138
"3206",170301,2006,"778",461,317,524,"189",335,0.7267,0.5962,0.6735
"3207",170532,2006,"379",211,168,279,"110",169,0.8009,0.6548,0.7361
"3208",170639,2006,"454",232,222,58,"23",35,0.1509,0.1036,0.1278
"3209",170976,2006,"5356",2704,2652,4072,"1880",2192,0.8107,0.7089,0.7603
"3210",171100,2006,"7306",4103,3203,3800,"1448",2352,0.5732,0.4521,0.5201
"3211",171128,2006,"1163",283,880,328,"221",107,0.3781,0.2511,0.282
"3212",171137,2006,"761",394,367,136,"56",80,0.203,0.1526,0.1787
"3213",171146,2006,"483",274,209,46,"14",32,0.1168,0.067,0.0952
"3214",171599,2006,"195",73,122,52,"28",24,0.3288,0.2295,0.2667
"3215",172051,2006,"1434",840,594,123,"36",87,0.1036,0.0606,0.0858
"3216",172699,2006,"3531",1800,1731,852,"359",493,0.2739,0.2074,0.2413
"3217",173160,2006,"629",351,278,392,"157",235,0.6695,0.5647,0.6232
"3218",173258,2006,"504",272,232,458,"209",249,0.9154,0.9009,0.9087
"3219",173328,2006,"199",108,91,51,"19",32,0.2963,0.2088,0.2563
"3220",173647,2006,"684",396,288,553,"226",327,0.8258,0.7847,0.8085
"3221",173902,2006,"501",281,220,429,"181",248,0.8826,0.8227,0.8563
"3222",174066,2006,"5418",2970,2448,2734,"1150",1584,0.5333,0.4698,0.5046
"3223",174233,2006,"2283",1105,1178,629,"270",359,0.3249,0.2292,0.2755
"3224",174251,2006,"377",214,163,179,"66",113,0.528,0.4049,0.4748
"3225",174491,2006,"498",302,196,256,"89",167,0.553,0.4541,0.5141
"3226",174792,2006,"506",0,506,347,"347",0,NA,0.6858,0.6858
"3227",174844,2006,"792",436,356,660,"288",372,0.8532,0.809,0.8333
"3228",174899,2006,"493",331,162,283,"79",204,0.6163,0.4877,0.574
"3229",174914,2006,"1298",644,654,816,"392",424,0.6584,0.5994,0.6287
"3230",175342,2006,"545",302,243,79,"34",45,0.149,0.1399,0.145
"3231",175421,2006,"248",133,115,76,"31",45,0.3383,0.2696,0.3065
"3232",175616,2006,"468",288,180,85,"33",52,0.1806,0.1833,0.1816
"3233",175856,2006,"889",513,376,191,"57",134,0.2612,0.1516,0.2148
"3234",175980,2006,"225",122,103,149,"63",86,0.7049,0.6117,0.6622
"3235",176017,2006,"2521",1320,1201,920,"352",568,0.4303,0.2931,0.3649
"3236",176035,2006,"256",243,13,53,"3",50,0.2058,0.2308,0.207
"3237",176044,2006,"443",216,227,55,"14",41,0.1898,0.0617,0.1242
"3238",176080,2006,"1897",947,950,575,"233",342,0.3611,0.2453,0.3031
"3239",176406,2006,"243",172,71,74,"15",59,0.343,0.2113,0.3045
"3240",176628,2006,"138",78,60,34,"11",23,0.2949,0.1833,0.2464
"3241",176947,2006,"207",111,96,81,"28",53,0.4775,0.2917,0.3913
"3242",176965,2006,"1505",871,634,416,"134",282,0.3238,0.2114,0.2764
"3243",177418,2006,"187",98,89,30,"11",19,0.1939,0.1236,0.1604
"3244",178059,2006,"290",237,53,152,"26",126,0.5316,0.4906,0.5241
"3245",178341,2006,"851",484,367,106,"40",66,0.1364,0.109,0.1246
"3246",178387,2006,"936",516,420,102,"39",63,0.1221,0.0929,0.109
"3247",178396,2006,"4783",2562,2221,2234,"835",1399,0.5461,0.376,0.4671
"3248",178402,2006,"928",545,383,220,"86",134,0.2459,0.2245,0.2371
"3249",178411,2006,"929",216,713,258,"176",82,0.3796,0.2468,0.2777
"3250",178420,2006,"476",273,203,106,"33",73,0.2674,0.1626,0.2227
"3251",178615,2006,"1365",826,539,781,"258",523,0.6332,0.4787,0.5722
"3252",179043,2006,"396",260,136,237,"73",164,0.6308,0.5368,0.5985
"3253",179159,2006,"1567",940,627,946,"358",588,0.6255,0.571,0.6037
"3254",179557,2006,"1383",853,530,318,"92",226,0.2649,0.1736,0.2299
"3255",179566,2006,"2732",1622,1110,854,"306",548,0.3379,0.2757,0.3126
"3256",179867,2006,"1456",714,742,1284,"628",656,0.9188,0.8464,0.8819
"3257",179894,2006,"418",240,178,198,"69",129,0.5375,0.3876,0.4737
"3258",179946,2006,"278",139,139,163,"73",90,0.6475,0.5252,0.5863
"3259",180179,2006,"646",339,307,59,"17",42,0.1239,0.0554,0.0913
"3260",180461,2006,"1940",814,1126,381,"173",208,0.2555,0.1536,0.1964
"3261",180522,2006,"193",66,127,12,"5",7,0.1061,0.0394,0.0622
"3262",180984,2006,"302",153,149,114,"43",71,0.4641,0.2886,0.3775
"3263",181002,2006,"965",591,374,653,"257",396,0.6701,0.6872,0.6767
"3264",181020,2006,"247",147,100,149,"54",95,0.6463,0.54,0.6032
"3265",181127,2006,"262",111,151,122,"57",65,0.5856,0.3775,0.4656
"3266",181215,2006,"937",521,416,202,"80",122,0.2342,0.1923,0.2156
"3267",181394,2006,"1637",864,773,231,"95",136,0.1574,0.1229,0.1411
"3268",181446,2006,"413",212,201,212,"94",118,0.5566,0.4677,0.5133
"3269",181464,2006,"3828",1805,2023,1126,"503",623,0.3452,0.2486,0.2941
"3270",181534,2006,"204",95,109,37,"17",20,0.2105,0.156,0.1814
"3271",181783,2006,"606",335,271,166,"53",113,0.3373,0.1956,0.2739
"3272",182281,2006,"2532",1410,1122,368,"130",238,0.1688,0.1159,0.1453
"3273",182290,2006,"2358",1300,1058,407,"146",261,0.2008,0.138,0.1726
"3274",182634,2006,"220",151,69,95,"22",73,0.4834,0.3188,0.4318
"3275",182795,2006,"553",260,293,226,"103",123,0.4731,0.3515,0.4087
"3276",183062,2006,"1139",718,421,559,"194",365,0.5084,0.4608,0.4908
"3277",183080,2006,"1008",446,562,402,"191",211,0.4731,0.3399,0.3988
"3278",183239,2006,"568",343,225,410,"151",259,0.7551,0.6711,0.7218
"3279",183822,2006,"316",183,133,47,"18",29,0.1585,0.1353,0.1487
"3280",183974,2006,"303",211,92,147,"41",106,0.5024,0.4457,0.4851
"3281",184348,2006,"479",316,163,315,"103",212,0.6709,0.6319,0.6576
"3282",184603,2006,"452",254,198,119,"37",82,0.3228,0.1869,0.2633
"3283",184612,2006,"251",172,79,58,"20",38,0.2209,0.2532,0.2311
"3284",184782,2006,"1216",602,614,593,"271",322,0.5349,0.4414,0.4877
"3285",185129,2006,"646",379,267,45,"13",32,0.0844,0.0487,0.0697
"3286",185572,2006,"959",535,424,425,"168",257,0.4804,0.3962,0.4432
"3287",185590,2006,"2018",1197,821,702,"214",488,0.4077,0.2607,0.3479
"3288",185828,2006,"795",146,649,150,"102",48,0.3288,0.1572,0.1887
"3289",186131,2006,"1228",576,652,1078,"561",517,0.8976,0.8604,0.8779
"3290",186201,2006,"811",475,336,488,"182",306,0.6442,0.5417,0.6017
"3291",186283,2006,"1016",619,397,576,"206",370,0.5977,0.5189,0.5669
"3292",186584,2006,"1054",602,452,574,"231",343,0.5698,0.5111,0.5446
"3293",186876,2006,"791",425,366,319,"123",196,0.4612,0.3361,0.4033
"3294",187134,2006,"1270",756,514,919,"339",580,0.7672,0.6595,0.7236
"3295",187444,2006,"1218",669,549,170,"62",108,0.1614,0.1129,0.1396
"3296",187985,2006,"2955",1619,1336,356,"124",232,0.1433,0.0928,0.1205
"3297",188030,2006,"2073",1105,968,286,"80",206,0.1864,0.0826,0.138
"3298",188429,2006,"826",587,239,446,"108",338,0.5758,0.4519,0.54
"3299",188641,2006,"490",257,233,229,"86",143,0.5564,0.3691,0.4673
"3300",190044,2006,"646",176,470,354,"246",108,0.6136,0.5234,0.548
"3301",190099,2006,"743",417,326,630,"278",352,0.8441,0.8528,0.8479
"3302",190150,2006,"1353",646,707,1191,"604",587,0.9087,0.8543,0.8803
"3303",190248,2006,"171",90,81,57,"26",31,0.3444,0.321,0.3333
"3304",190415,2006,"3186",1538,1648,2779,"1375",1404,0.9129,0.8343,0.8723
"3305",190512,2006,"1493",650,843,497,"248",249,0.3831,0.2942,0.3329
"3306",190549,2006,"1354",766,588,355,"120",235,0.3068,0.2041,0.2622
"3307",190558,2006,"2072",1124,948,108,"41",67,0.0596,0.0432,0.0521
"3308",190567,2006,"1529",760,769,114,"43",71,0.0934,0.0559,0.0746
"3309",190594,2006,"1813",1202,611,349,"86",263,0.2188,0.1408,0.1925
"3310",190637,2006,"911",674,237,131,"24",107,0.1588,0.1013,0.1438
"3311",190664,2006,"1627",991,636,418,"113",305,0.3078,0.1777,0.2569
"3312",190691,2006,"668",428,240,27,"10",17,0.0397,0.0417,0.0404
"3313",190725,2006,"368",284,84,100,"22",78,0.2746,0.2619,0.2717
"3314",191241,2006,"1697",929,768,1300,"578",722,0.7772,0.7526,0.7661
"3315",191515,2006,"501",267,234,424,"195",229,0.8577,0.8333,0.8463
"3316",191533,2006,"464",270,194,235,"88",147,0.5444,0.4536,0.5065
"3317",191630,2006,"597",319,278,428,"182",246,0.7712,0.6547,0.7169
"3318",191649,2006,"1706",865,841,768,"335",433,0.5006,0.3983,0.4502
"3319",191676,2006,"306",195,111,177,"58",119,0.6103,0.5225,0.5784
"3320",191931,2006,"903",504,399,506,"181",325,0.6448,0.4536,0.5604
"3321",191968,2006,"1519",819,700,1059,"466",593,0.7241,0.6657,0.6972
"3322",192192,2006,"232",147,85,106,"44",62,0.4218,0.5176,0.4569
"3323",192323,2006,"544",330,214,329,"120",209,0.6333,0.5607,0.6048
"3324",192439,2006,"1079",730,349,56,"14",42,0.0575,0.0401,0.0519
"3325",192703,2006,"710",353,357,466,"234",232,0.6572,0.6555,0.6563
"3326",192749,2006,"507",329,178,274,"91",183,0.5562,0.5112,0.5404
"3327",192819,2006,"1038",573,465,737,"309",428,0.7469,0.6645,0.71
"3328",192925,2006,"320",198,122,87,"38",49,0.2475,0.3115,0.2719
"3329",193016,2006,"614",390,224,79,"22",57,0.1462,0.0982,0.1287
"3330",193292,2006,"269",196,73,90,"22",68,0.3469,0.3014,0.3346
"3331",193353,2006,"400",295,105,162,"41",121,0.4102,0.3905,0.405
"3332",193399,2006,"390",294,96,159,"37",122,0.415,0.3854,0.4077
"3333",193584,2006,"481",364,117,293,"62",231,0.6346,0.5299,0.6091
"3334",193645,2006,"821",757,64,133,"6",127,0.1678,0.0938,0.162
"3335",193654,2006,"883",622,261,409,"110",299,0.4807,0.4215,0.4632
"3336",193900,2006,"4704",2895,1809,2879,"1141",1738,0.6003,0.6307,0.612
"3337",193973,2006,"705",421,284,437,"169",268,0.6366,0.5951,0.6199
"3338",194161,2006,"308",178,130,85,"30",55,0.309,0.2308,0.276
"3339",194310,2006,"1131",738,393,441,"126",315,0.4268,0.3206,0.3899
"3340",194824,2006,"1269",362,907,766,"544",222,0.6133,0.5998,0.6036
"3341",195003,2006,"2355",675,1680,589,"315",274,0.4059,0.1875,0.2501
"3342",195030,2006,"1219",561,658,906,"467",439,0.7825,0.7097,0.7432
"3343",195164,2006,"459",234,225,235,"105",130,0.5556,0.4667,0.512
"3344",195173,2006,"474",253,221,137,"61",76,0.3004,0.276,0.289
"3345",195216,2006,"608",325,283,463,"210",253,0.7785,0.742,0.7615
"3346",195234,2006,"630",423,207,328,"88",240,0.5674,0.4251,0.5206
"3347",195243,2006,"323",185,138,113,"39",74,0.4,0.2826,0.3498
"3348",195304,2006,"381",286,95,261,"62",199,0.6958,0.6526,0.685
"3349",195474,2006,"688",393,295,478,"190",288,0.7328,0.6441,0.6948
"3350",195526,2006,"672",388,284,565,"231",334,0.8608,0.8134,0.8408
"3351",195544,2006,"597",424,173,309,"68",241,0.5684,0.3931,0.5176
"3352",195809,2006,"3260",1713,1547,1198,"494",704,0.411,0.3193,0.3675
"3353",196413,2006,"3045",1686,1359,2099,"839",1260,0.7473,0.6174,0.6893
"3354",196592,2006,"1479",988,491,60,"25",35,0.0354,0.0509,0.0406
"3355",197045,2006,"495",277,218,164,"62",102,0.3682,0.2844,0.3313
"3356",197133,2006,"668",412,256,534,"173",361,0.8762,0.6758,0.7994
"3357",197869,2006,"2707",1403,1304,1080,"402",678,0.4833,0.3083,0.399
"3358",197984,2006,"279",142,137,94,"34",60,0.4225,0.2482,0.3369
"3359",198385,2006,"461",233,228,410,"197",213,0.9142,0.864,0.8894
"3360",198464,2006,"3784",2331,1453,1240,"347",893,0.3831,0.2388,0.3277
"3361",198507,2006,"534",313,221,90,"20",70,0.2236,0.0905,0.1685
"3362",198516,2006,"1283",740,543,991,"378",613,0.8284,0.6961,0.7724
"3363",198835,2006,"347",195,152,117,"40",77,0.3949,0.2632,0.3372
"3364",198969,2006,"449",135,314,75,"31",44,0.3259,0.0987,0.167
"3365",199102,2006,"2068",1102,966,340,"81",259,0.235,0.0839,0.1644
"3366",199111,2006,"567",328,239,180,"57",123,0.375,0.2385,0.3175
"3367",199120,2006,"3796",2276,1520,2893,"1107",1786,0.7847,0.7283,0.7621
"3368",199139,2006,"2764",1475,1289,728,"280",448,0.3037,0.2172,0.2634
"3369",199148,2006,"2400",1698,702,706,"128",578,0.3404,0.1823,0.2942
"3370",199157,2006,"975",631,344,145,"30",115,0.1823,0.0872,0.1487
"3371",199193,2006,"4667",2067,2600,1781,"761",1020,0.4935,0.2927,0.3816
"3372",199218,2006,"1980",1140,840,973,"335",638,0.5596,0.3988,0.4914
"3373",199281,2006,"929",475,454,148,"54",94,0.1979,0.1189,0.1593
"3374",199306,2006,"196",85,111,72,"38",34,0.4,0.3423,0.3673
"3375",199412,2006,"235",173,62,104,"22",82,0.474,0.3548,0.4426
"3376",199582,2006,"363",146,217,58,"23",35,0.2397,0.106,0.1598
"3377",199643,2006,"674",423,251,82,"23",59,0.1395,0.0916,0.1217
"3378",199847,2006,"1119",576,543,927,"432",495,0.8594,0.7956,0.8284
"3379",199962,2006,"385",198,187,152,"57",95,0.4798,0.3048,0.3948
"3380",199999,2006,"976",692,284,144,"36",108,0.1561,0.1268,0.1475
"3381",200004,2006,"1558",784,774,434,"163",271,0.3457,0.2106,0.2786
"3382",200059,2006,"333",160,173,50,"22",28,0.175,0.1272,0.1502
"3383",200156,2006,"238",129,109,75,"21",54,0.4186,0.1927,0.3151
"3384",200217,2006,"343",187,156,19,"10",9,0.0481,0.0641,0.0554
"3385",200226,2006,"137",59,78,29,"7",22,0.3729,0.0897,0.2117
"3386",200253,2006,"461",263,198,58,"13",45,0.1711,0.0657,0.1258
"3387",200280,2006,"1868",869,999,438,"199",239,0.275,0.1992,0.2345
"3388",200332,2006,"2040",920,1120,486,"221",265,0.288,0.1973,0.2382
"3389",200572,2006,"177",70,107,44,"20",24,0.3429,0.1869,0.2486
"3390",201104,2006,"554",313,241,238,"78",160,0.5112,0.3237,0.4296
"3391",201371,2006,"241",122,119,119,"50",69,0.5656,0.4202,0.4938
"3392",201548,2006,"690",410,280,342,"130",212,0.5171,0.4643,0.4957
"3393",201645,2006,"1015",441,574,636,"325",311,0.7052,0.5662,0.6266
"3394",201690,2006,"535",266,269,65,"21",44,0.1654,0.0781,0.1215
"3395",202134,2006,"947",520,427,95,"31",64,0.1231,0.0726,0.1003
"3396",202480,2006,"1738",864,874,1041,"450",591,0.684,0.5149,0.599
"3397",202523,2006,"573",335,238,481,"190",291,0.8687,0.7983,0.8394
"3398",202763,2006,"616",441,175,243,"58",185,0.4195,0.3314,0.3945
"3399",203085,2006,"267",131,136,105,"38",67,0.5115,0.2794,0.3933
"3400",203128,2006,"298",143,155,174,"80",94,0.6573,0.5161,0.5839
"3401",203368,2006,"712",385,327,469,"205",264,0.6857,0.6269,0.6587
"3402",203517,2006,"3610",2214,1396,977,"295",682,0.308,0.2113,0.2706
"3403",203535,2006,"457",226,231,397,"190",207,0.9159,0.8225,0.8687
"3404",203580,2006,"131",89,42,48,"13",35,0.3933,0.3095,0.3664
"3405",203775,2006,"341",208,133,159,"58",101,0.4856,0.4361,0.4663
"3406",203845,2006,"385",191,194,206,"83",123,0.644,0.4278,0.5351
"3407",204024,2006,"3630",2017,1613,2472,"1010",1462,0.7248,0.6262,0.681
"3408",204185,2006,"636",284,352,343,"149",194,0.6831,0.4233,0.5393
"3409",204194,2006,"346",201,145,160,"66",94,0.4677,0.4552,0.4624
"3410",204617,2006,"354",177,177,107,"51",56,0.3164,0.2881,0.3023
"3411",204796,2006,"6262",3104,3158,3295,"1373",1922,0.6192,0.4348,0.5262
"3412",204857,2006,"4009",2063,1946,1766,"693",1073,0.5201,0.3561,0.4405
"3413",206330,2006,"238",91,147,61,"19",42,0.4615,0.1293,0.2563
"3414",206589,2006,"494",242,252,345,"163",182,0.7521,0.6468,0.6984
"3415",206604,2006,"2178",1211,967,422,"155",267,0.2205,0.1603,0.1938
"3416",206622,2006,"812",459,353,574,"244",330,0.719,0.6912,0.7069
"3417",206695,2006,"2169",1095,1074,187,"74",113,0.1032,0.0689,0.0862
"3418",206914,2006,"686",402,284,40,"16",24,0.0597,0.0563,0.0583
"3419",207209,2006,"533",271,262,32,"8",24,0.0886,0.0305,0.06
"3420",207306,2006,"243",121,122,29,"9",20,0.1653,0.0738,0.1193
"3421",207324,2006,"512",260,252,166,"76",90,0.3462,0.3016,0.3242
"3422",207388,2006,"3132",1658,1474,1068,"383",685,0.4131,0.2598,0.341
"3423",207500,2006,"3285",1732,1553,1190,"457",733,0.4232,0.2943,0.3623
"3424",207722,2006,"208",139,69,58,"16",42,0.3022,0.2319,0.2788
"3425",207847,2006,"586",313,273,67,"26",41,0.131,0.0952,0.1143
"3426",207865,2006,"844",485,359,129,"31",98,0.2021,0.0864,0.1528
"3427",208822,2006,"415",262,153,223,"81",142,0.542,0.5294,0.5373
"3428",209056,2006,"508",318,190,349,"129",220,0.6918,0.6789,0.687
"3429",209065,2006,"445",243,202,265,"104",161,0.6626,0.5149,0.5955
"3430",209542,2006,"2898",1413,1485,872,"341",531,0.3758,0.2296,0.3009
"3431",209551,2006,"3349",1821,1528,1468,"575",893,0.4904,0.3763,0.4383
"3432",209612,2006,"360",206,154,194,"72",122,0.5922,0.4675,0.5389
"3433",209807,2006,"1283",695,588,200,"67",133,0.1914,0.1139,0.1559
"3434",209922,2006,"371",207,164,222,"91",131,0.6329,0.5549,0.5984
"3435",210146,2006,"707",401,306,110,"31",79,0.197,0.1013,0.1556
"3436",210401,2006,"482",260,222,333,"139",194,0.7462,0.6261,0.6909
"3437",210429,2006,"750",485,265,150,"40",110,0.2268,0.1509,0.2
"3438",210571,2006,"458",233,225,210,"87",123,0.5279,0.3867,0.4585
"3439",210669,2006,"570",322,248,398,"159",239,0.7422,0.6411,0.6982
"3440",210775,2006,"300",188,112,114,"43",71,0.3777,0.3839,0.38
"3441",211088,2006,"572",452,120,336,"72",264,0.5841,0.6,0.5874
"3442",211158,2006,"1630",987,643,696,"221",475,0.4813,0.3437,0.427
"3443",211291,2006,"921",458,463,792,"383",409,0.893,0.8272,0.8599
"3444",211352,2006,"529",337,192,232,"63",169,0.5015,0.3281,0.4386
"3445",211361,2006,"1260",685,575,313,"124",189,0.2759,0.2157,0.2484
"3446",211431,2006,"262",250,12,114,"3",111,0.444,0.25,0.4351
"3447",211440,2006,"1421",552,869,1033,"630",403,0.7301,0.725,0.727
"3448",211468,2006,"254",251,3,124,"1",123,0.49,0.3333,0.4882
"3449",211556,2006,"147",147,0,75,"0",75,0.5102,NA,0.5102
"3450",211583,2006,"214",155,59,78,"22",56,0.3613,0.3729,0.3645
"3451",211608,2006,"437",238,199,47,"15",32,0.1345,0.0754,0.1076
"3452",211644,2006,"1295",758,537,323,"110",213,0.281,0.2048,0.2494
"3453",211981,2006,"447",264,183,220,"68",152,0.5758,0.3716,0.4922
"3454",212009,2006,"617",360,257,499,"199",300,0.8333,0.7743,0.8088
"3455",212054,2006,"2256",930,1326,598,"219",379,0.4075,0.1652,0.2651
"3456",212106,2006,"1321",779,542,700,"268",432,0.5546,0.4945,0.5299
"3457",212115,2006,"1239",716,523,454,"147",307,0.4288,0.2811,0.3664
"3458",212133,2006,"494",336,158,230,"70",160,0.4762,0.443,0.4656
"3459",212160,2006,"1212",671,541,230,"63",167,0.2489,0.1165,0.1898
"3460",212197,2006,"528",345,183,372,"125",247,0.7159,0.6831,0.7045
"3461",212577,2006,"523",274,249,413,"196",217,0.792,0.7871,0.7897
"3462",212601,2006,"600",352,248,280,"97",183,0.5199,0.3911,0.4667
"3463",212832,2006,"272",202,70,54,"19",35,0.1733,0.2714,0.1985
"3464",212911,2006,"314",174,140,281,"123",158,0.908,0.8786,0.8949
"3465",213020,2006,"2538",1400,1138,726,"225",501,0.3579,0.1977,0.2861
"3466",213251,2006,"362",195,167,257,"111",146,0.7487,0.6647,0.7099
"3467",213321,2006,"478",202,276,295,"153",142,0.703,0.5543,0.6172
"3468",213349,2006,"1930",1177,753,612,"163",449,0.3815,0.2165,0.3171
"3469",213358,2006,"259",164,95,92,"32",60,0.3659,0.3368,0.3552
"3470",213367,2006,"884",512,372,467,"180",287,0.5605,0.4839,0.5283
"3471",213385,2006,"629",290,339,561,"299",262,0.9034,0.882,0.8919
"3472",213507,2006,"447",241,206,300,"114",186,0.7718,0.5534,0.6711
"3473",213543,2006,"1217",511,706,950,"523",427,0.8356,0.7408,0.7806
"3474",213613,2006,"1079",608,471,266,"106",160,0.2632,0.2251,0.2465
"3475",213668,2006,"375",193,182,213,"87",126,0.6528,0.478,0.568
"3476",213783,2006,"603",356,247,172,"53",119,0.3343,0.2146,0.2852
"3477",213826,2006,"383",278,105,197,"42",155,0.5576,0.4,0.5144
"3478",213996,2006,"735",471,264,529,"179",350,0.7431,0.678,0.7197
"3479",214041,2006,"1342",792,550,482,"154",328,0.4141,0.28,0.3592
"3480",214069,2006,"308",192,116,165,"57",108,0.5625,0.4914,0.5357
"3481",214157,2006,"375",223,152,268,"108",160,0.7175,0.7105,0.7147
"3482",214175,2006,"615",376,239,503,"185",318,0.8457,0.7741,0.8179
"3483",214272,2006,"544",325,219,160,"46",114,0.3508,0.21,0.2941
"3484",214777,2006,"8016",3790,4226,5243,"2460",2783,0.7343,0.5821,0.6541
"3485",215062,2006,"2334",1193,1141,2036,"952",1084,0.9086,0.8344,0.8723
"3486",215743,2006,"384",234,150,194,"66",128,0.547,0.44,0.5052
"3487",215798,2006,"437",217,220,272,"133",139,0.6406,0.6045,0.6224
"3488",215929,2006,"980",585,395,740,"289",451,0.7709,0.7316,0.7551
"3489",216010,2006,"1496",778,718,601,"215",386,0.4961,0.2994,0.4017
"3490",216038,2006,"1416",832,584,545,"185",360,0.4327,0.3168,0.3849
"3491",216287,2006,"370",193,177,318,"143",175,0.9067,0.8079,0.8595
"3492",216339,2006,"3848",2105,1743,1377,"578",799,0.3796,0.3316,0.3578
"3493",216524,2006,"405",217,188,287,"126",161,0.7419,0.6702,0.7086
"3494",216694,2006,"322",172,150,174,"69",105,0.6105,0.46,0.5404
"3495",216764,2006,"1883",1200,683,803,"196",607,0.5058,0.287,0.4264
"3496",216807,2006,"311",180,131,225,"87",138,0.7667,0.6641,0.7235
"3497",216852,2006,"740",354,386,317,"135",182,0.5141,0.3497,0.4284
"3498",216931,2006,"570",285,285,279,"133",146,0.5123,0.4667,0.4895
"3499",217059,2006,"1092",536,556,452,"207",245,0.4571,0.3723,0.4139
"3500",217156,2006,"1464",740,724,1215,"590",625,0.8446,0.8149,0.8299
"3501",217402,2006,"1023",585,438,860,"351",509,0.8701,0.8014,0.8407
"3502",217536,2006,"568",394,174,390,"113",277,0.703,0.6494,0.6866
"3503",217776,2006,"150",86,64,61,"28",33,0.3837,0.4375,0.4067
"3504",217819,2006,"1959",1332,627,1132,"315",817,0.6134,0.5024,0.5778
"3505",217882,2006,"2755",1363,1392,1575,"604",971,0.7124,0.4339,0.5717
"3506",217998,2006,"178",100,78,101,"34",67,0.67,0.4359,0.5674
"3507",218061,2006,"795",519,276,142,"34",108,0.2081,0.1232,0.1786
"3508",218229,2006,"578",379,199,127,"29",98,0.2586,0.1457,0.2197
"3509",218238,2006,"206",87,119,39,"17",22,0.2529,0.1429,0.1893
"3510",218399,2006,"249",144,105,39,"11",28,0.1944,0.1048,0.1566
"3511",218414,2006,"264",116,148,65,"24",41,0.3534,0.1622,0.2462
"3512",218663,2006,"3646",2084,1562,1932,"702",1230,0.5902,0.4494,0.5299
"3513",218724,2006,"1466",810,656,420,"144",276,0.3407,0.2195,0.2865
"3514",218733,2006,"870",458,412,134,"49",85,0.1856,0.1189,0.154
"3515",218742,2006,"781",497,284,166,"42",124,0.2495,0.1479,0.2125
"3516",218973,2006,"377",191,186,299,"139",160,0.8377,0.7473,0.7931
"3517",219000,2006,"442",282,160,228,"64",164,0.5816,0.4,0.5158
"3518",219046,2006,"595",353,242,122,"28",94,0.2663,0.1157,0.205
"3519",219082,2006,"295",137,158,41,"23",18,0.1314,0.1456,0.139
"3520",219198,2006,"127",92,35,57,"14",43,0.4674,0.4,0.4488
"3521",219259,2006,"367",178,189,50,"14",36,0.2022,0.0741,0.1362
"3522",219356,2006,"1833",922,911,484,"173",311,0.3373,0.1899,0.264
"3523",219471,2006,"1109",674,435,237,"88",149,0.2211,0.2023,0.2137
"3524",219602,2006,"1210",731,479,188,"56",132,0.1806,0.1169,0.1554
"3525",219709,2006,"763",439,324,422,"160",262,0.5968,0.4938,0.5531
"3526",219718,2006,"243",94,149,26,"13",13,0.1383,0.0872,0.107
"3527",219949,2006,"189",75,114,34,"8",26,0.3467,0.0702,0.1799
"3528",220075,2006,"1712",966,746,279,"106",173,0.1791,0.1421,0.163
"3529",220215,2006,"358",206,152,145,"48",97,0.4709,0.3158,0.405
"3530",220613,2006,"810",473,337,270,"77",193,0.408,0.2285,0.3333
"3531",220631,2006,"219",135,84,3,"0",3,0.0222,0,0.0137
"3532",220710,2006,"298",163,135,123,"49",74,0.454,0.363,0.4128
"3533",221351,2006,"451",272,179,363,"141",222,0.8162,0.7877,0.8049
"3534",221519,2006,"412",202,210,305,"150",155,0.7673,0.7143,0.7403
"3535",221731,2006,"160",88,72,42,"10",32,0.3636,0.1389,0.2625
"3536",221847,2006,"1515",653,862,301,"127",174,0.2665,0.1473,0.1987
"3537",221892,2006,"240",147,93,97,"32",65,0.4422,0.3441,0.4042
"3538",222178,2006,"961",526,435,394,"147",247,0.4696,0.3379,0.41
"3539",222983,2006,"340",175,165,251,"113",138,0.7886,0.6848,0.7382
"3540",223232,2006,"2775",1713,1062,1550,"494",1056,0.6165,0.4652,0.5586
"3541",224004,2006,"191",89,102,37,"16",21,0.236,0.1569,0.1937
"3542",224323,2006,"315",169,146,189,"82",107,0.6331,0.5616,0.6
"3543",225432,2006,"840",452,388,12,"7",5,0.0111,0.018,0.0143
"3544",225548,2006,"318",130,188,109,"46",63,0.4846,0.2447,0.3428
"3545",225627,2006,"613",439,174,119,"23",96,0.2187,0.1322,0.1941
"3546",226231,2006,"309",88,221,130,"75",55,0.625,0.3394,0.4207
"3547",226833,2006,"657",355,302,108,"33",75,0.2113,0.1093,0.1644
"3548",227216,2006,"3599",2039,1560,784,"252",532,0.2609,0.1615,0.2178
"3549",227331,2006,"262",195,67,27,"6",21,0.1077,0.0896,0.1031
"3550",227526,2006,"1231",689,542,121,"28",93,0.135,0.0517,0.0983
"3551",227757,2006,"713",357,356,597,"282",315,0.8824,0.7921,0.8373
"3552",227845,2006,"698",423,275,372,"144",228,0.539,0.5236,0.533
"3553",227863,2006,"291",187,104,93,"26",67,0.3583,0.25,0.3196
"3554",228042,2006,"243",128,115,57,"20",37,0.2891,0.1739,0.2346
"3555",228149,2006,"548",347,201,187,"39",148,0.4265,0.194,0.3412
"3556",228246,2006,"1369",753,616,937,"377",560,0.7437,0.612,0.6844
"3557",228343,2006,"345",221,124,231,"74",157,0.7104,0.5968,0.6696
"3558",228431,2006,"2305",1420,885,538,"132",406,0.2859,0.1492,0.2334
"3559",228459,2006,"2975",1746,1229,815,"250",565,0.3236,0.2034,0.2739
"3560",228501,2006,"192",73,119,22,"8",14,0.1918,0.0672,0.1146
"3561",228529,2006,"1256",667,589,230,"94",136,0.2039,0.1596,0.1831
"3562",228705,2006,"731",297,434,95,"32",63,0.2121,0.0737,0.13
"3563",228723,2006,"7472",3774,3698,3636,"1358",2278,0.6036,0.3672,0.4866
"3564",228769,2006,"1974",984,990,340,"124",216,0.2195,0.1253,0.1722
"3565",228778,2006,"7369",4008,3361,3731,"1482",2249,0.5611,0.4409,0.5063
"3566",228787,2006,"1053",394,659,470,"252",218,0.5533,0.3824,0.4463
"3567",228796,2006,"2446",1256,1190,269,"95",174,0.1385,0.0798,0.11
"3568",228875,2006,"1654",985,669,950,"328",622,0.6315,0.4903,0.5744
"3569",228981,2006,"387",197,190,105,"39",66,0.335,0.2053,0.2713
"3570",229018,2006,"315",178,137,55,"18",37,0.2079,0.1314,0.1746
"3571",229027,2006,"4687",2389,2298,424,"155",269,0.1126,0.0674,0.0905
"3572",229115,2006,"3862",1844,2018,1427,"601",826,0.4479,0.2978,0.3695
"3573",229780,2006,"211",103,108,46,"21",25,0.2427,0.1944,0.218
"3574",229814,2006,"920",489,431,223,"73",150,0.3067,0.1694,0.2424
"3575",230603,2006,"832",594,238,164,"23",141,0.2374,0.0966,0.1971
"3576",230728,2006,"2429",1574,855,498,"102",396,0.2516,0.1193,0.205
"3577",230764,2006,"2037",1167,870,457,"149",308,0.2639,0.1713,0.2243
"3578",230782,2006,"1289",755,534,114,"28",86,0.1139,0.0524,0.0884
"3579",231059,2006,"576",333,243,446,"192",254,0.7628,0.7901,0.7743
"3580",231174,2006,"2175",1251,924,1417,"551",866,0.6922,0.5963,0.6515
"3581",231420,2006,"160",60,100,45,"19",26,0.4333,0.19,0.2812
"3582",231554,2006,"106",59,47,19,"5",14,0.2373,0.1064,0.1792
"3583",231624,2006,"1341",693,648,1107,"497",610,0.8802,0.767,0.8255
"3584",231712,2006,"1172",644,528,594,"203",391,0.6071,0.3845,0.5068
"3585",232025,2006,"267",115,152,84,"36",48,0.4174,0.2368,0.3146
"3586",232043,2006,"205",119,86,93,"31",62,0.521,0.3605,0.4537
"3587",232089,2006,"417",156,261,126,"65",61,0.391,0.249,0.3022
"3588",232186,2006,"2390",1335,1055,992,"355",637,0.4772,0.3365,0.4151
"3589",232265,2006,"1098",700,398,447,"119",328,0.4686,0.299,0.4071
"3590",232423,2006,"3745",2431,1314,2357,"713",1644,0.6763,0.5426,0.6294
"3591",232557,2006,"2028",1022,1006,489,"209",280,0.274,0.2078,0.2411
"3592",232566,2006,"985",627,358,411,"111",300,0.4785,0.3101,0.4173
"3593",232609,2006,"552",305,247,259,"88",171,0.5607,0.3563,0.4692
"3594",232681,2006,"909",614,295,625,"180",445,0.7248,0.6102,0.6876
"3595",232706,2006,"365",268,97,136,"28",108,0.403,0.2887,0.3726
"3596",232937,2006,"1023",638,385,130,"34",96,0.1505,0.0883,0.1271
"3597",232982,2006,"2059",1108,951,507,"159",348,0.3141,0.1672,0.2462
"3598",233277,2006,"1730",1045,685,730,"252",478,0.4574,0.3679,0.422
"3599",233374,2006,"757",387,370,585,"267",318,0.8217,0.7216,0.7728
"3600",233426,2006,"503",296,207,285,"104",181,0.6115,0.5024,0.5666
"3601",233541,2006,"304",157,147,75,"29",46,0.293,0.1973,0.2467
"3602",233897,2006,"401",187,214,98,"45",53,0.2834,0.2103,0.2444
"3603",233921,2006,"5078",2273,2805,2953,"1367",1586,0.6978,0.4873,0.5815
"3604",234030,2006,"3445",1986,1459,1018,"346",672,0.3384,0.2371,0.2955
"3605",234085,2006,"387",34,353,216,"200",16,0.4706,0.5666,0.5581
"3606",234155,2006,"869",540,329,209,"54",155,0.287,0.1641,0.2405
"3607",234164,2006,"325",160,165,58,"13",45,0.2812,0.0788,0.1785
"3608",235097,2006,"1412",855,557,280,"84",196,0.2292,0.1508,0.1983
"3609",235167,2006,"577",300,277,227,"103",124,0.4133,0.3718,0.3934
"3610",236230,2006,"668",418,250,401,"142",259,0.6196,0.568,0.6003
"3611",236328,2006,"677",406,271,464,"173",291,0.7167,0.6384,0.6854
"3612",236577,2006,"622",413,209,350,"111",239,0.5787,0.5311,0.5627
"3613",236595,2006,"731",463,268,455,"165",290,0.6263,0.6157,0.6224
"3614",236896,2006,"323",164,159,62,"28",34,0.2073,0.1761,0.192
"3615",236939,2006,"2676",1349,1327,1040,"417",623,0.4618,0.3142,0.3886
"3616",236948,2006,"5284",2800,2484,2939,"1245",1694,0.605,0.5012,0.5562
"3617",237011,2006,"2425",1397,1028,850,"293",557,0.3987,0.285,0.3505
"3618",237057,2006,"367",219,148,294,"109",185,0.8447,0.7365,0.8011
"3619",237066,2006,"469",285,184,303,"115",188,0.6596,0.625,0.6461
"3620",237215,2006,"253",134,119,28,"19",9,0.0672,0.1597,0.1107
"3621",237330,2006,"593",306,287,102,"37",65,0.2124,0.1289,0.172
"3622",237358,2006,"119",65,54,30,"14",16,0.2462,0.2593,0.2521
"3623",237367,2006,"642",345,297,84,"35",49,0.142,0.1178,0.1308
"3624",237792,2006,"688",395,293,135,"40",95,0.2405,0.1365,0.1962
"3625",237899,2006,"341",170,171,24,"8",16,0.0941,0.0468,0.0704
"3626",237932,2006,"476",269,207,84,"28",56,0.2082,0.1353,0.1765
"3627",237969,2006,"291",167,124,117,"39",78,0.4671,0.3145,0.4021
"3628",238032,2006,"4777",2151,2626,1596,"746",850,0.3952,0.2841,0.3341
"3629",238333,2006,"347",207,140,243,"94",149,0.7198,0.6714,0.7003
"3630",238430,2006,"245",168,77,19,"6",13,0.0774,0.0779,0.0776
"3631",238458,2006,"675",485,190,284,"58",226,0.466,0.3053,0.4207
"3632",238476,2006,"653",368,285,337,"136",201,0.5462,0.4772,0.5161
"3633",238616,2006,"391",214,177,135,"53",82,0.3832,0.2994,0.3453
"3634",238661,2006,"293",220,73,101,"21",80,0.3636,0.2877,0.3447
"3635",239080,2006,"245",172,73,61,"15",46,0.2674,0.2055,0.249
"3636",239105,2006,"1842",1025,817,1096,"445",651,0.6351,0.5447,0.595
"3637",239628,2006,"264",154,110,153,"57",96,0.6234,0.5182,0.5795
"3638",239716,2006,"551",305,246,356,"140",216,0.7082,0.5691,0.6461
"3639",240107,2006,"308",223,85,100,"21",79,0.3543,0.2471,0.3247
"3640",240189,2006,"1780",836,944,533,"233",300,0.3589,0.2468,0.2994
"3641",240277,2006,"1019",667,352,226,"63",163,0.2444,0.179,0.2218
"3642",240329,2006,"1751",1098,653,633,"190",443,0.4035,0.291,0.3615
"3643",240338,2006,"198",116,82,81,"31",50,0.431,0.378,0.4091
"3644",240365,2006,"1726",1024,702,272,"83",189,0.1846,0.1182,0.1576
"3645",240374,2006,"814",442,372,60,"18",42,0.095,0.0484,0.0737
"3646",240417,2006,"1507",792,715,275,"90",185,0.2336,0.1259,0.1825
"3647",240426,2006,"293",143,150,53,"26",27,0.1888,0.1733,0.1809
"3648",240444,2006,"5633",3033,2600,2965,"1202",1763,0.5813,0.4623,0.5264
"3649",240453,2006,"3977",2064,1913,554,"247",307,0.1487,0.1291,0.1393
"3650",240462,2006,"1387",467,920,259,"145",114,0.2441,0.1576,0.1867
"3651",240471,2006,"1289",773,516,281,"77",204,0.2639,0.1492,0.218
"3652",240480,2006,"1640",888,752,395,"153",242,0.2725,0.2035,0.2409
"3653",240727,2006,"1543",761,782,359,"118",241,0.3167,0.1509,0.2327
"3654",243443,2006,"764",532,232,66,"13",53,0.0996,0.056,0.0864
"3655",243780,2006,"7430",3019,4411,2764,"1350",1414,0.4684,0.3061,0.372
"3656",100654,2005,"1088",572,516,116,"27",89,0.1556,0.0523,0.1066
"3657",100663,2005,"1515",895,620,350,"110",240,0.2682,0.1774,0.231
"3658",100751,2005,"3642",2038,1604,1373,"491",882,0.4328,0.3061,0.377
"3659",100858,2005,"4179",2180,1999,1491,"511",980,0.4495,0.2556,0.3568
"3660",101435,2005,"185",90,95,78,"34",44,0.4889,0.3579,0.4216
"3661",101480,2005,"1120",595,525,120,"37",83,0.1395,0.0705,0.1071
"3662",101675,2005,"389",177,212,25,"4",21,0.1186,0.0189,0.0643
"3663",101879,2005,"982",526,456,2,"1",1,0.0019,0.0022,0.002
"3664",102049,2005,"699",457,242,358,"93",265,0.5799,0.3843,0.5122
"3665",102094,2005,"1198",689,509,199,"62",137,0.1988,0.1218,0.1661
"3666",102234,2005,"274",173,101,139,"49",90,0.5202,0.4851,0.5073
"3667",102368,2005,"1434",789,645,201,"64",137,0.1736,0.0992,0.1402
"3668",102377,2005,"730",385,345,112,"30",82,0.213,0.087,0.1534
"3669",104151,2005,"7927",4267,3660,2561,"996",1565,0.3668,0.2721,0.3231
"3670",104179,2005,"5785",3115,2670,2104,"820",1284,0.4122,0.3071,0.3637
"3671",105330,2005,"2101",1268,833,645,"174",471,0.3715,0.2089,0.307
"3672",106245,2005,"762",445,317,64,"24",40,0.0899,0.0757,0.084
"3673",106342,2005,"111",61,50,45,"20",25,0.4098,0.4,0.4054
"3674",106397,2005,"2662",1324,1338,913,"375",538,0.4063,0.2803,0.343
"3675",106412,2005,"714",349,365,74,"24",50,0.1433,0.0658,0.1036
"3676",106458,2005,"1483",826,657,288,"108",180,0.2179,0.1644,0.1942
"3677",106467,2005,"1457",714,743,253,"104",149,0.2087,0.14,0.1736
"3678",106485,2005,"625",337,288,55,"20",35,0.1039,0.0694,0.088
"3679",106704,2005,"2429",1376,1053,467,"136",331,0.2406,0.1292,0.1923
"3680",107044,2005,"955",527,428,396,"132",264,0.5009,0.3084,0.4147
"3681",107080,2005,"280",156,124,179,"73",106,0.6795,0.5887,0.6393
"3682",107141,2005,"262",132,130,143,"71",72,0.5455,0.5462,0.5458
"3683",107512,2005,"365",213,152,181,"66",115,0.5399,0.4342,0.4959
"3684",107558,2005,"168",89,79,48,"19",29,0.3258,0.2405,0.2857
"3685",110097,2005,"670",416,254,337,"111",226,0.5433,0.437,0.503
"3686",110404,2005,"233",69,164,178,"127",51,0.7391,0.7744,0.7639
"3687",110422,2005,"3318",1599,1719,1021,"345",676,0.4228,0.2007,0.3077
"3688",110486,2005,"766",503,263,114,"21",93,0.1849,0.0798,0.1488
"3689",110495,2005,"741",511,230,151,"31",120,0.2348,0.1348,0.2038
"3690",110510,2005,"1645",1092,553,212,"75",137,0.1255,0.1356,0.1289
"3691",110529,2005,"3089",1296,1793,380,"157",223,0.1721,0.0876,0.123
"3692",110538,2005,"2300",1237,1063,439,"118",321,0.2595,0.111,0.1909
"3693",110547,2005,"705",476,229,42,"9",33,0.0693,0.0393,0.0596
"3694",110556,2005,"2356",1403,953,323,"106",217,0.1547,0.1112,0.1371
"3695",110565,2005,"3816",2241,1575,524,"134",390,0.174,0.0851,0.1373
"3696",110574,2005,"686",414,272,110,"39",71,0.1715,0.1434,0.1603
"3697",110583,2005,"4241",2666,1575,524,"153",371,0.1392,0.0971,0.1236
"3698",110592,2005,"1253",823,430,111,"31",80,0.0972,0.0721,0.0886
"3699",110617,2005,"2436",1483,953,256,"73",183,0.1234,0.0766,0.1051
"3700",113698,2005,"227",168,59,98,"22",76,0.4524,0.3729,0.4317
"3701",115755,2005,"813",461,352,99,"32",67,0.1453,0.0909,0.1218
"3702",119173,2005,"393",378,15,68,"3",65,0.172,0.2,0.173
"3703",120184,2005,"144",95,49,59,"14",45,0.4737,0.2857,0.4097
"3704",121309,2005,"562",339,223,348,"125",223,0.6578,0.5605,0.6192
"3705",121345,2005,"382",193,189,347,"169",178,0.9223,0.8942,0.9084
"3706",122409,2005,"3439",2039,1400,1011,"323",688,0.3374,0.2307,0.294
"3707",122436,2005,"1131",710,421,726,"238",488,0.6873,0.5653,0.6419
"3708",122597,2005,"2999",1942,1057,360,"105",255,0.1313,0.0993,0.12
"3709",122612,2005,"932",665,267,542,"131",411,0.618,0.4906,0.5815
"3710",122931,2005,"1197",667,530,917,"384",533,0.7991,0.7245,0.7661
"3711",123554,2005,"659",399,260,313,"107",206,0.5163,0.4115,0.475
"3712",123572,2005,"1043",697,346,309,"69",240,0.3443,0.1994,0.2963
"3713",126562,2005,"744",414,330,108,"30",78,0.1884,0.0909,0.1452
"3714",126580,2005,"947",595,352,210,"50",160,0.2689,0.142,0.2218
"3715",126614,2005,"5007",2364,2643,2007,"900",1107,0.4683,0.3405,0.4008
"3716",126818,2005,"3622",2036,1586,1278,"406",872,0.4283,0.256,0.3528
"3717",127060,2005,"1089",608,481,655,"251",404,0.6645,0.5218,0.6015
"3718",127185,2005,"860",386,474,161,"70",91,0.2358,0.1477,0.1872
"3719",127565,2005,"1840",939,901,79,"32",47,0.0501,0.0355,0.0429
"3720",127741,2005,"2483",1479,1004,620,"173",447,0.3022,0.1723,0.2497
"3721",128106,2005,"665",361,304,125,"54",71,0.1967,0.1776,0.188
"3722",128744,2005,"352",212,140,64,"20",44,0.2075,0.1429,0.1818
"3723",128771,2005,"1333",663,670,188,"82",106,0.1599,0.1224,0.141
"3724",129020,2005,"3239",1789,1450,2176,"881",1295,0.7239,0.6076,0.6718
"3725",129242,2005,"940",551,389,744,"297",447,0.8113,0.7635,0.7915
"3726",129941,2005,"653",322,331,256,"117",139,0.4317,0.3535,0.392
"3727",130253,2005,"886",542,344,544,"186",358,0.6605,0.5407,0.614
"3728",130314,2005,"206",206,0,88,"0",88,0.4272,NA,0.4272
"3729",130493,2005,"1313",866,447,192,"43",149,0.1721,0.0962,0.1462
"3730",130590,2005,"573",289,284,469,"221",248,0.8581,0.7782,0.8185
"3731",130697,2005,"705",360,345,614,"305",309,0.8583,0.8841,0.8709
"3732",130776,2005,"773",396,377,124,"52",72,0.1818,0.1379,0.1604
"3733",130794,2005,"1320",651,669,1172,"574",598,0.9186,0.858,0.8879
"3734",130934,2005,"885",514,371,164,"40",124,0.2412,0.1078,0.1853
"3735",130943,2005,"3830",2252,1578,2250,"803",1447,0.6425,0.5089,0.5875
"3736",131159,2005,"1216",778,438,898,"319",579,0.7442,0.7283,0.7385
"3737",131283,2005,"786",455,331,482,"187",295,0.6484,0.565,0.6132
"3738",131450,2005,"280",151,129,28,"7",21,0.1391,0.0543,0.1
"3739",131469,2005,"2408",1375,1033,1823,"732",1091,0.7935,0.7086,0.7571
"3740",131496,2005,"1530",774,756,1378,"669",709,0.916,0.8849,0.9007
"3741",131520,2005,"1410",944,466,635,"166",469,0.4968,0.3562,0.4504
"3742",132471,2005,"563",356,207,117,"35",82,0.2303,0.1691,0.2078
"3743",132602,2005,"913",525,388,140,"52",88,0.1676,0.134,0.1533
"3744",132903,2005,"6041",3216,2825,2025,"720",1305,0.4058,0.2549,0.3352
"3745",133492,2005,"501",297,204,275,"102",173,0.5825,0.5,0.5489
"3746",133553,2005,"975",152,823,307,"246",61,0.4013,0.2989,0.3149
"3747",133650,2005,"1636",925,711,183,"61",122,0.1319,0.0858,0.1119
"3748",133669,2005,"2080",1111,969,363,"126",237,0.2133,0.13,0.1745
"3749",133711,2005,"459",283,176,216,"77",139,0.4912,0.4375,0.4706
"3750",133881,2005,"603",154,449,242,"172",70,0.4545,0.3831,0.4013
"3751",133951,2005,"3967",2261,1706,634,"188",446,0.1973,0.1102,0.1598
"3752",134079,2005,"462",274,188,190,"60",130,0.4745,0.3191,0.4113
"3753",134097,2005,"6052",3554,2498,2995,"1066",1929,0.5428,0.4267,0.4949
"3754",134130,2005,"7217",4080,3137,4230,"1533",2697,0.661,0.4887,0.5861
"3755",134945,2005,"544",252,292,127,"59",68,0.2698,0.2021,0.2335
"3756",135726,2005,"2258",1168,1090,1480,"670",810,0.6935,0.6147,0.6554
"3757",136172,2005,"2288",1296,992,518,"179",339,0.2616,0.1804,0.2264
"3758",136950,2005,"463",275,188,284,"105",179,0.6509,0.5585,0.6134
"3759",137546,2005,"547",312,235,308,"135",173,0.5545,0.5745,0.5631
"3760",138354,2005,"830",490,340,194,"65",129,0.2633,0.1912,0.2337
"3761",138716,2005,"596",388,208,93,"16",77,0.1985,0.0769,0.156
"3762",138789,2005,"700",453,247,70,"14",56,0.1236,0.0567,0.1
"3763",139144,2005,"513",316,197,226,"65",161,0.5095,0.3299,0.4405
"3764",139366,2005,"1067",641,426,129,"33",96,0.1498,0.0775,0.1209
"3765",139393,2005,"270",138,132,122,"48",74,0.5362,0.3636,0.4519
"3766",139658,2005,"1631",933,698,1032,"450",582,0.6238,0.6447,0.6327
"3767",139719,2005,"317",169,148,48,"11",37,0.2189,0.0743,0.1514
"3768",139755,2005,"2415",714,1701,756,"431",325,0.4552,0.2534,0.313
"3769",139764,2005,"358",200,158,36,"9",27,0.135,0.057,0.1006
"3770",139861,2005,"1032",631,401,342,"101",241,0.3819,0.2519,0.3314
"3771",139931,2005,"3123",1472,1651,623,"195",428,0.2908,0.1181,0.1995
"3772",139940,2005,"2325",1322,1003,408,"164",244,0.1846,0.1635,0.1755
"3773",139959,2005,"4654",2812,1842,2505,"845",1660,0.5903,0.4587,0.5382
"3774",140447,2005,"666",408,258,267,"86",181,0.4436,0.3333,0.4009
"3775",140960,2005,"806",427,379,73,"16",57,0.1335,0.0422,0.0906
"3776",140988,2005,"291",133,158,101,"40",61,0.4586,0.2532,0.3471
"3777",141185,2005,"223",135,88,84,"27",57,0.4222,0.3068,0.3767
"3778",141264,2005,"1775",1072,703,299,"69",230,0.2146,0.0982,0.1685
"3779",141334,2005,"1640",966,674,212,"47",165,0.1708,0.0697,0.1293
"3780",141486,2005,"260",182,78,57,"12",45,0.2473,0.1538,0.2192
"3781",141565,2005,"409",215,194,50,"15",35,0.1628,0.0773,0.1222
"3782",141574,2005,"1923",1060,863,354,"128",226,0.2132,0.1483,0.1841
"3783",142276,2005,"909",519,390,74,"22",52,0.1002,0.0564,0.0814
"3784",142285,2005,"1673",823,850,386,"156",230,0.2795,0.1835,0.2307
"3785",142461,2005,"249",168,81,88,"24",64,0.381,0.2963,0.3534
"3786",143084,2005,"679",383,296,474,"193",281,0.7337,0.652,0.6981
"3787",143288,2005,"183",92,91,66,"30",36,0.3913,0.3297,0.3607
"3788",144005,2005,"405",268,137,15,"4",11,0.041,0.0292,0.037
"3789",144281,2005,"1795",933,862,504,"219",285,0.3055,0.2541,0.2808
"3790",144740,2005,"2392",1411,981,1168,"450",718,0.5089,0.4587,0.4883
"3791",144892,2005,"1645",967,678,521,"168",353,0.365,0.2478,0.3167
"3792",144962,2005,"466",282,184,252,"84",168,0.5957,0.4565,0.5408
"3793",144971,2005,"138",74,64,66,"29",37,0.5,0.4531,0.4783
"3794",145600,2005,"2759",1534,1225,742,"294",448,0.292,0.24,0.2689
"3795",145619,2005,"308",163,145,97,"42",55,0.3374,0.2897,0.3149
"3796",145637,2005,"7565",3511,4054,4966,"2375",2591,0.738,0.5858,0.6564
"3797",145691,2005,"256",117,139,124,"60",64,0.547,0.4317,0.4844
"3798",145813,2005,"3167",1970,1197,1388,"419",969,0.4919,0.35,0.4383
"3799",146481,2005,"358",202,156,213,"78",135,0.6683,0.5,0.595
"3800",146612,2005,"557",321,236,232,"92",140,0.4361,0.3898,0.4165
"3801",146719,2005,"2080",1365,715,1053,"346",707,0.5179,0.4839,0.5062
"3802",146825,2005,"159",77,82,35,"10",25,0.3247,0.122,0.2201
"3803",147013,2005,"273",126,147,94,"39",55,0.4365,0.2653,0.3443
"3804",147244,2005,"572",313,259,311,"119",192,0.6134,0.4595,0.5437
"3805",147341,2005,"367",180,187,140,"50",90,0.5,0.2674,0.3815
"3806",147703,2005,"3171",1637,1534,826,"360",466,0.2847,0.2347,0.2605
"3807",147767,2005,"1952",1018,934,1669,"756",913,0.8969,0.8094,0.855
"3808",147776,2005,"960",570,390,51,"16",35,0.0614,0.041,0.0531
"3809",147828,2005,"669",404,265,294,"94",200,0.495,0.3547,0.4395
"3810",148131,2005,"202",99,103,69,"28",41,0.4141,0.2718,0.3416
"3811",148496,2005,"266",178,88,147,"46",101,0.5674,0.5227,0.5526
"3812",148584,2005,"190",116,74,85,"27",58,0.5,0.3649,0.4474
"3813",148627,2005,"410",236,174,133,"50",83,0.3517,0.2874,0.3244
"3814",149222,2005,"2382",1034,1348,560,"261",299,0.2892,0.1936,0.2351
"3815",149231,2005,"1721",994,727,487,"166",321,0.3229,0.2283,0.283
"3816",149772,2005,"1802",885,917,549,"265",284,0.3209,0.289,0.3047
"3817",149781,2005,"578",287,291,458,"220",238,0.8293,0.756,0.7924
"3818",150066,2005,"565",348,217,272,"93",179,0.5144,0.4286,0.4814
"3819",150136,2005,"3660",1892,1768,1063,"367",696,0.3679,0.2076,0.2904
"3820",150145,2005,"310",207,103,122,"41",81,0.3913,0.3981,0.3935
"3821",150163,2005,"864",536,328,391,"119",272,0.5075,0.3628,0.4525
"3822",150400,2005,"586",337,249,470,"197",273,0.8101,0.7912,0.802
"3823",150534,2005,"670",416,254,337,"105",232,0.5577,0.4134,0.503
"3824",150668,2005,"194",108,86,113,"44",69,0.6389,0.5116,0.5825
"3825",150941,2005,"232",133,99,113,"45",68,0.5113,0.4545,0.4871
"3826",151102,2005,"1534",850,684,82,"31",51,0.06,0.0453,0.0535
"3827",151111,2005,"2396",1414,982,234,"88",146,0.1033,0.0896,0.0977
"3828",151306,2005,"2042",1195,847,306,"90",216,0.1808,0.1063,0.1499
"3829",151324,2005,"1622",810,812,311,"122",189,0.2333,0.1502,0.1917
"3830",151333,2005,"382",251,131,31,"6",25,0.0996,0.0458,0.0812
"3831",151342,2005,"805",466,339,34,"16",18,0.0386,0.0472,0.0422
"3832",151351,2005,"6903",3785,3118,3425,"1383",2042,0.5395,0.4436,0.4962
"3833",151360,2005,"471",280,191,33,"19",14,0.05,0.0995,0.0701
"3834",151379,2005,"664",409,255,53,"12",41,0.1002,0.0471,0.0798
"3835",151388,2005,"284",179,105,13,"2",11,0.0615,0.019,0.0458
"3836",151777,2005,"329",170,159,140,"50",90,0.5294,0.3145,0.4255
"3837",151786,2005,"189",127,62,64,"17",47,0.3701,0.2742,0.3386
"3838",152080,2005,"1990",935,1055,1800,"942",858,0.9176,0.8929,0.9045
"3839",152248,2005,"1093",599,494,57,"23",34,0.0568,0.0466,0.0522
"3840",152363,2005,"266",145,121,128,"41",87,0.6,0.3388,0.4812
"3841",152530,2005,"459",271,188,342,"142",200,0.738,0.7553,0.7451
"3842",152600,2005,"672",332,340,421,"183",238,0.7169,0.5382,0.6265
"3843",153001,2005,"286",143,143,121,"50",71,0.4965,0.3497,0.4231
"3844",153108,2005,"366",203,163,213,"93",120,0.5911,0.5706,0.582
"3845",153269,2005,"809",465,344,438,"173",265,0.5699,0.5029,0.5414
"3846",153384,2005,"385",206,179,320,"148",172,0.835,0.8268,0.8312
"3847",153603,2005,"3737",1629,2108,1248,"535",713,0.4377,0.2538,0.334
"3848",153834,2005,"629",354,275,367,"140",227,0.6412,0.5091,0.5835
"3849",154095,2005,"1693",1062,631,618,"184",434,0.4087,0.2916,0.365
"3850",155089,2005,"151",72,79,16,"7",9,0.125,0.0886,0.106
"3851",155317,2005,"4106",2115,1991,1332,"518",814,0.3849,0.2602,0.3244
"3852",155335,2005,"181",84,97,31,"12",19,0.2262,0.1237,0.1713
"3853",155399,2005,"3105",1561,1544,697,"255",442,0.2832,0.1652,0.2245
"3854",155520,2005,"216",109,107,61,"21",40,0.367,0.1963,0.2824
"3855",155627,2005,"113",47,66,36,"19",17,0.3617,0.2879,0.3186
"3856",155937,2005,"126",57,69,38,"16",22,0.386,0.2319,0.3016
"3857",156213,2005,"276",173,103,168,"64",104,0.6012,0.6214,0.6087
"3858",156286,2005,"435",282,153,224,"69",155,0.5496,0.451,0.5149
"3859",156295,2005,"378",219,159,161,"67",94,0.4292,0.4214,0.4259
"3860",156365,2005,"345",174,171,83,"29",54,0.3103,0.1696,0.2406
"3861",156541,2005,"424",192,232,111,"48",63,0.3281,0.2069,0.2618
"3862",156745,2005,"416",216,200,209,"83",126,0.5833,0.415,0.5024
"3863",157058,2005,"408",223,185,17,"4",13,0.0583,0.0216,0.0417
"3864",157076,2005,"209",100,109,67,"22",45,0.45,0.2018,0.3206
"3865",157085,2005,"3824",2045,1779,1291,"502",789,0.3858,0.2822,0.3376
"3866",157289,2005,"2255",1144,1111,497,"205",292,0.2552,0.1845,0.2204
"3867",157386,2005,"1310",745,565,162,"55",107,0.1436,0.0973,0.1237
"3868",157401,2005,"1442",841,601,532,"180",352,0.4185,0.2995,0.3689
"3869",157447,2005,"1759",1000,759,185,"50",135,0.135,0.0659,0.1052
"3870",157535,2005,"206",98,108,31,"8",23,0.2347,0.0741,0.1505
"3871",157951,2005,"3002",1680,1322,539,"189",350,0.2083,0.143,0.1795
"3872",158477,2005,"232",145,87,104,"33",71,0.4897,0.3793,0.4483
"3873",159009,2005,"1129",568,561,82,"22",60,0.1056,0.0392,0.0726
"3874",159391,2005,"4966",2653,2313,1440,"576",864,0.3257,0.249,0.29
"3875",159647,2005,"1653",762,891,446,"177",269,0.353,0.1987,0.2698
"3876",159717,2005,"1311",743,568,177,"52",125,0.1682,0.0915,0.135
"3877",159966,2005,"1171",703,468,163,"62",101,0.1437,0.1325,0.1392
"3878",160038,2005,"1417",869,548,218,"71",147,0.1692,0.1296,0.1538
"3879",160612,2005,"2228",1388,840,252,"74",178,0.1282,0.0881,0.1131
"3880",160621,2005,"1434",797,637,290,"93",197,0.2472,0.146,0.2022
"3881",160658,2005,"2730",1538,1192,329,"102",227,0.1476,0.0856,0.1205
"3882",161004,2005,"477",257,220,420,"189",231,0.8988,0.8591,0.8805
"3883",161226,2005,"559",387,172,229,"60",169,0.4367,0.3488,0.4097
"3884",161235,2005,"129",69,60,22,"9",13,0.1884,0.15,0.1705
"3885",161244,2005,"106",71,35,17,"5",12,0.169,0.1429,0.1604
"3886",161253,2005,"1703",842,861,615,"262",353,0.4192,0.3043,0.3611
"3887",161554,2005,"911",518,393,88,"31",57,0.11,0.0789,0.0966
"3888",162007,2005,"923",567,356,203,"53",150,0.2646,0.1489,0.2199
"3889",162210,2005,"172",113,59,23,"9",14,0.1239,0.1525,0.1337
"3890",162283,2005,"661",502,159,24,"4",20,0.0398,0.0252,0.0363
"3891",162584,2005,"928",448,480,181,"60",121,0.2701,0.125,0.195
"3892",162654,2005,"340",217,123,210,"68",142,0.6544,0.5528,0.6176
"3893",162760,2005,"236",156,80,142,"44",98,0.6282,0.55,0.6017
"3894",162928,2005,"1228",587,641,1036,"523",513,0.8739,0.8159,0.8436
"3895",163046,2005,"898",526,372,711,"291",420,0.7985,0.7823,0.7918
"3896",163268,2005,"1414",584,830,466,"237",229,0.3921,0.2855,0.3296
"3897",163286,2005,"4192",2081,2111,2769,"1273",1496,0.7189,0.603,0.6605
"3898",163453,2005,"764",408,356,89,"22",67,0.1642,0.0618,0.1165
"3899",163462,2005,"437",267,170,315,"127",188,0.7041,0.7471,0.7208
"3900",163851,2005,"952",525,427,442,"146",296,0.5638,0.3419,0.4643
"3901",163912,2005,"488",295,193,341,"130",211,0.7153,0.6736,0.6988
"3902",164076,2005,"2314",1455,859,910,"270",640,0.4399,0.3143,0.3933
"3903",164173,2005,"537",373,164,236,"61",175,0.4692,0.372,0.4395
"3904",164216,2005,"345",201,144,247,"90",157,0.7811,0.625,0.7159
"3905",164270,2005,"447",246,201,314,"136",178,0.7236,0.6766,0.7025
"3906",164447,2005,"328",160,168,65,"32",33,0.2062,0.1905,0.1982
"3907",164492,2005,"156",79,77,58,"27",31,0.3924,0.3506,0.3718
"3908",164562,2005,"565",328,237,369,"132",237,0.7226,0.557,0.6531
"3909",165015,2005,"737",397,340,647,"287",360,0.9068,0.8441,0.8779
"3910",165024,2005,"1314",746,568,339,"113",226,0.3029,0.1989,0.258
"3911",165334,2005,"557",338,219,422,"161",261,0.7722,0.7352,0.7576
"3912",165662,2005,"715",417,298,571,"243",328,0.7866,0.8154,0.7986
"3913",165671,2005,"438",327,111,237,"63",174,0.5321,0.5676,0.5411
"3914",165820,2005,"599",297,302,125,"54",71,0.2391,0.1788,0.2087
"3915",165866,2005,"666",461,205,210,"44",166,0.3601,0.2146,0.3153
"3916",165936,2005,"414",259,155,254,"79",175,0.6757,0.5097,0.6135
"3917",166027,2005,"1637",819,818,1421,"698",723,0.8828,0.8533,0.8681
"3918",166124,2005,"723",399,324,645,"281",364,0.9123,0.8673,0.8921
"3919",166513,2005,"1062",390,672,318,"160",158,0.4051,0.2381,0.2994
"3920",166629,2005,"4510",2316,2194,2268,"970",1298,0.5604,0.4421,0.5029
"3921",166638,2005,"723",419,304,100,"34",66,0.1575,0.1118,0.1383
"3922",166683,2005,"995",465,530,847,"436",411,0.8839,0.8226,0.8513
"3923",167288,2005,"271",177,94,104,"36",68,0.3842,0.383,0.3838
"3924",167987,2005,"1703",816,887,505,"212",293,0.3591,0.239,0.2965
"3925",167996,2005,"616",354,262,478,"190",288,0.8136,0.7252,0.776
"3926",168005,2005,"1127",682,445,416,"143",273,0.4003,0.3213,0.3691
"3927",168148,2005,"1364",682,682,1159,"559",600,0.8798,0.8196,0.8497
"3928",168254,2005,"662",244,418,341,"188",153,0.627,0.4498,0.5151
"3929",168281,2005,"467",301,166,341,"119",222,0.7375,0.7169,0.7302
"3930",168342,2005,"536",280,256,477,"226",251,0.8964,0.8828,0.8899
"3931",168546,2005,"571",315,256,372,"160",212,0.673,0.625,0.6515
"3932",168786,2005,"364",240,124,160,"49",111,0.4625,0.3952,0.4396
"3933",169080,2005,"1000",564,436,598,"232",366,0.6489,0.5321,0.598
"3934",169798,2005,"2301",1416,885,297,"89",208,0.1469,0.1006,0.1291
"3935",169910,2005,"2189",1003,1186,140,"59",81,0.0808,0.0497,0.064
"3936",170082,2005,"3407",2220,1187,1011,"308",703,0.3167,0.2595,0.2967
"3937",170301,2005,"774",463,311,531,"194",337,0.7279,0.6238,0.686
"3938",170532,2005,"377",196,181,286,"134",152,0.7755,0.7403,0.7586
"3939",170639,2005,"474",216,258,62,"31",31,0.1435,0.1202,0.1308
"3940",170976,2005,"6080",3071,3009,4431,"2061",2370,0.7717,0.6849,0.7288
"3941",171100,2005,"7303",4147,3156,3470,"1232",2238,0.5397,0.3904,0.4751
"3942",171128,2005,"1321",236,1085,327,"243",84,0.3559,0.224,0.2475
"3943",171137,2005,"798",381,417,128,"47",81,0.2126,0.1127,0.1604
"3944",171146,2005,"509",293,216,48,"18",30,0.1024,0.0833,0.0943
"3945",171599,2005,"257",103,154,77,"33",44,0.4272,0.2143,0.2996
"3946",172051,2005,"1233",742,491,102,"26",76,0.1024,0.053,0.0827
"3947",172699,2005,"3702",1917,1785,919,"374",545,0.2843,0.2095,0.2482
"3948",173160,2005,"683",425,258,436,"149",287,0.6753,0.5775,0.6384
"3949",173258,2005,"542",278,264,478,"226",252,0.9065,0.8561,0.8819
"3950",173328,2005,"163",84,79,53,"21",32,0.381,0.2658,0.3252
"3951",173647,2005,"739",439,300,588,"208",380,0.8656,0.6933,0.7957
"3952",173902,2005,"491",287,204,405,"158",247,0.8606,0.7745,0.8248
"3953",174066,2005,"5274",2856,2418,2488,"1023",1465,0.513,0.4231,0.4717
"3954",174233,2005,"2111",1025,1086,565,"243",322,0.3141,0.2238,0.2676
"3955",174251,2005,"353",207,146,171,"63",108,0.5217,0.4315,0.4844
"3956",174491,2005,"476",295,181,221,"76",145,0.4915,0.4199,0.4643
"3957",174792,2005,"447",0,447,325,"325",0,NA,0.7271,0.7271
"3958",174844,2005,"764",426,338,617,"270",347,0.8146,0.7988,0.8076
"3959",174899,2005,"490",350,140,265,"70",195,0.5571,0.5,0.5408
"3960",174914,2005,"1325",706,619,812,"342",470,0.6657,0.5525,0.6128
"3961",175342,2005,"526",274,252,100,"44",56,0.2044,0.1746,0.1901
"3962",175421,2005,"201",105,96,68,"16",52,0.4952,0.1667,0.3383
"3963",175616,2005,"393",222,171,67,"25",42,0.1892,0.1462,0.1705
"3964",175856,2005,"1131",690,441,221,"64",157,0.2275,0.1451,0.1954
"3965",175980,2005,"258",118,140,158,"76",82,0.6949,0.5429,0.6124
"3966",176017,2005,"2131",1139,992,800,"280",520,0.4565,0.2823,0.3754
"3967",176035,2005,"238",204,34,53,"5",48,0.2353,0.1471,0.2227
"3968",176044,2005,"398",197,201,43,"13",30,0.1523,0.0647,0.108
"3969",176080,2005,"1951",1010,941,585,"215",370,0.3663,0.2285,0.2998
"3970",176406,2005,"207",146,61,61,"15",46,0.3151,0.2459,0.2947
"3971",176628,2005,"154",95,59,38,"11",27,0.2842,0.1864,0.2468
"3972",176947,2005,"223",96,127,73,"29",44,0.4583,0.2283,0.3274
"3973",176965,2005,"1484",810,674,410,"164",246,0.3037,0.2433,0.2763
"3974",177418,2005,"187",136,51,44,"9",35,0.2574,0.1765,0.2353
"3975",178059,2005,"322",232,90,182,"42",140,0.6034,0.4667,0.5652
"3976",178341,2005,"836",466,370,106,"32",74,0.1588,0.0865,0.1268
"3977",178387,2005,"1005",557,448,111,"42",69,0.1239,0.0938,0.1104
"3978",178396,2005,"4662",2513,2149,2087,"810",1277,0.5082,0.3769,0.4477
"3979",178402,2005,"1007",574,433,173,"61",112,0.1951,0.1409,0.1718
"3980",178411,2005,"877",168,709,224,"154",70,0.4167,0.2172,0.2554
"3981",178420,2005,"497",288,209,124,"41",83,0.2882,0.1962,0.2495
"3982",178615,2005,"1441",830,611,626,"232",394,0.4747,0.3797,0.4344
"3983",179043,2005,"370",203,167,237,"110",127,0.6256,0.6587,0.6405
"3984",179159,2005,"1521",859,662,925,"377",548,0.638,0.5695,0.6082
"3985",179557,2005,"1538",918,620,369,"102",267,0.2908,0.1645,0.2399
"3986",179566,2005,"2575",1490,1085,822,"273",549,0.3685,0.2516,0.3192
"3987",179867,2005,"1372",715,657,1186,"544",642,0.8979,0.828,0.8644
"3988",179894,2005,"394",224,170,175,"76",99,0.442,0.4471,0.4442
"3989",179946,2005,"287",125,162,143,"65",78,0.624,0.4012,0.4983
"3990",180179,2005,"796",463,333,79,"26",53,0.1145,0.0781,0.0992
"3991",180461,2005,"1980",843,1137,412,"198",214,0.2539,0.1741,0.2081
"3992",180522,2005,"192",55,137,15,"10",5,0.0909,0.073,0.0781
"3993",180984,2005,"289",146,143,113,"33",80,0.5479,0.2308,0.391
"3994",181002,2005,"970",562,408,640,"257",383,0.6815,0.6299,0.6598
"3995",181020,2005,"256",146,110,153,"56",97,0.6644,0.5091,0.5977
"3996",181127,2005,"312",133,179,143,"69",74,0.5564,0.3855,0.4583
"3997",181215,2005,"1013",584,429,228,"71",157,0.2688,0.1655,0.2251
"3998",181394,2005,"1690",911,779,259,"105",154,0.169,0.1348,0.1533
"3999",181446,2005,"406",237,169,236,"82",154,0.6498,0.4852,0.5813
"4000",181464,2005,"3533",1671,1862,1118,"505",613,0.3668,0.2712,0.3164
"4001",181534,2005,"213",112,101,26,"7",19,0.1696,0.0693,0.1221
"4002",181783,2005,"587",320,267,162,"71",91,0.2844,0.2659,0.276
"4003",182281,2005,"2964",1694,1270,402,"134",268,0.1582,0.1055,0.1356
"4004",182290,2005,"2362",1300,1062,383,"136",247,0.19,0.1281,0.1622
"4005",182634,2005,"280",179,101,130,"42",88,0.4916,0.4158,0.4643
"4006",182795,2005,"532",270,262,2,"0",2,0.0074,0,0.0038
"4007",183062,2005,"1001",565,436,434,"172",262,0.4637,0.3945,0.4336
"4008",183080,2005,"999",473,526,401,"193",208,0.4397,0.3669,0.4014
"4009",183239,2005,"519",296,223,372,"145",227,0.7669,0.6502,0.7168
"4010",183822,2005,"367",210,157,37,"15",22,0.1048,0.0955,0.1008
"4011",183974,2005,"240",160,80,115,"35",80,0.5,0.4375,0.4792
"4012",184348,2005,"391",218,173,240,"103",137,0.6284,0.5954,0.6138
"4013",184603,2005,"425",269,156,100,"31",69,0.2565,0.1987,0.2353
"4014",184612,2005,"236",163,73,38,"13",25,0.1534,0.1781,0.161
"4015",184782,2005,"1239",607,632,554,"270",284,0.4679,0.4272,0.4471
"4016",185129,2005,"601",334,267,39,"17",22,0.0659,0.0637,0.0649
"4017",185572,2005,"942",503,439,436,"176",260,0.5169,0.4009,0.4628
"4018",185590,2005,"1868",1065,803,635,"188",447,0.4197,0.2341,0.3399
"4019",185828,2005,"746",129,617,126,"101",25,0.1938,0.1637,0.1689
"4020",186131,2005,"1224",558,666,1066,"562",504,0.9032,0.8438,0.8709
"4021",186201,2005,"746",460,286,445,"137",308,0.6696,0.479,0.5965
"4022",186283,2005,"934",526,408,482,"183",299,0.5684,0.4485,0.5161
"4023",186584,2005,"1115",582,533,576,"236",340,0.5842,0.4428,0.5166
"4024",186876,2005,"808",460,348,346,"104",242,0.5261,0.2989,0.4282
"4025",187134,2005,"1236",685,551,914,"383",531,0.7752,0.6951,0.7395
"4026",187444,2005,"1296",652,644,235,"89",146,0.2239,0.1382,0.1813
"4027",187985,2005,"3010",1717,1293,372,"130",242,0.1409,0.1005,0.1236
"4028",188030,2005,"1945",1092,853,289,"96",193,0.1767,0.1125,0.1486
"4029",188429,2005,"754",505,249,416,"121",295,0.5842,0.4859,0.5517
"4030",188641,2005,"429",188,241,186,"85",101,0.5372,0.3527,0.4336
"4031",190044,2005,"630",173,457,380,"274",106,0.6127,0.5996,0.6032
"4032",190099,2005,"729",368,361,640,"311",329,0.894,0.8615,0.8779
"4033",190150,2005,"1403",660,743,1189,"621",568,0.8606,0.8358,0.8475
"4034",190248,2005,"140",83,57,49,"12",37,0.4458,0.2105,0.35
"4035",190415,2005,"3071",1541,1530,2664,"1286",1378,0.8942,0.8405,0.8675
"4036",190512,2005,"1625",784,841,577,"266",311,0.3967,0.3163,0.3551
"4037",190549,2005,"1372",757,615,294,"109",185,0.2444,0.1772,0.2143
"4038",190558,2005,"1888",1048,840,62,"31",31,0.0296,0.0369,0.0328
"4039",190567,2005,"1278",592,686,78,"39",39,0.0659,0.0569,0.061
"4040",190594,2005,"1776",1199,577,356,"97",259,0.216,0.1681,0.2005
"4041",190637,2005,"788",551,237,110,"33",77,0.1397,0.1392,0.1396
"4042",190664,2005,"1470",884,586,381,"101",280,0.3167,0.1724,0.2592
"4043",190691,2005,"746",481,265,27,"5",22,0.0457,0.0189,0.0362
"4044",190725,2005,"366",288,78,91,"12",79,0.2743,0.1538,0.2486
"4045",191241,2005,"1734",983,751,1282,"548",734,0.7467,0.7297,0.7393
"4046",191515,2005,"496",248,248,417,"198",219,0.8831,0.7984,0.8407
"4047",191533,2005,"405",212,193,182,"77",105,0.4953,0.399,0.4494
"4048",191630,2005,"545",283,262,377,"159",218,0.7703,0.6069,0.6917
"4049",191649,2005,"1759",961,798,763,"281",482,0.5016,0.3521,0.4338
"4050",191676,2005,"321",211,110,180,"57",123,0.5829,0.5182,0.5607
"4051",191931,2005,"776",419,357,375,"150",225,0.537,0.4202,0.4832
"4052",191968,2005,"1679",885,794,1117,"521",596,0.6734,0.6562,0.6653
"4053",192192,2005,"268",179,89,111,"31",80,0.4469,0.3483,0.4142
"4054",192323,2005,"519",308,211,320,"123",197,0.6396,0.5829,0.6166
"4055",192439,2005,"959",643,316,51,"10",41,0.0638,0.0316,0.0532
"4056",192703,2005,"700",368,332,456,"198",258,0.7011,0.5964,0.6514
"4057",192749,2005,"506",327,179,264,"73",191,0.5841,0.4078,0.5217
"4058",192819,2005,"1017",585,432,697,"258",439,0.7504,0.5972,0.6853
"4059",192925,2005,"203",126,77,62,"27",35,0.2778,0.3506,0.3054
"4060",193016,2005,"485",324,161,53,"11",42,0.1296,0.0683,0.1093
"4061",193292,2005,"274",190,84,109,"31",78,0.4105,0.369,0.3978
"4062",193353,2005,"356",247,109,154,"45",109,0.4413,0.4128,0.4326
"4063",193399,2005,"343",247,96,136,"32",104,0.4211,0.3333,0.3965
"4064",193584,2005,"451",342,109,303,"56",247,0.7222,0.5138,0.6718
"4065",193645,2005,"943",883,60,168,"1",167,0.1891,0.0167,0.1782
"4066",193654,2005,"789",558,231,355,"86",269,0.4821,0.3723,0.4499
"4067",193900,2005,"4639",2853,1786,2941,"1168",1773,0.6215,0.654,0.634
"4068",193973,2005,"730",444,286,435,"160",275,0.6194,0.5594,0.5959
"4069",194161,2005,"256",137,119,60,"21",39,0.2847,0.1765,0.2344
"4070",194310,2005,"1474",954,520,584,"186",398,0.4172,0.3577,0.3962
"4071",194824,2005,"1236",283,953,745,"550",195,0.689,0.5771,0.6028
"4072",195003,2005,"2184",656,1528,587,"289",298,0.4543,0.1891,0.2688
"4073",195030,2005,"1106",563,543,808,"376",432,0.7673,0.6924,0.7306
"4074",195164,2005,"477",225,252,239,"112",127,0.5644,0.4444,0.501
"4075",195173,2005,"497",224,273,140,"68",72,0.3214,0.2491,0.2817
"4076",195216,2005,"534",268,266,407,"190",217,0.8097,0.7143,0.7622
"4077",195234,2005,"595",411,184,330,"75",255,0.6204,0.4076,0.5546
"4078",195243,2005,"327",188,139,119,"43",76,0.4043,0.3094,0.3639
"4079",195304,2005,"376",285,91,237,"50",187,0.6561,0.5495,0.6303
"4080",195474,2005,"763",443,320,531,"225",306,0.6907,0.7031,0.6959
"4081",195526,2005,"694",433,261,567,"202",365,0.843,0.7739,0.817
"4082",195544,2005,"605",446,159,291,"57",234,0.5247,0.3585,0.481
"4083",195809,2005,"3153",1742,1411,1098,"435",663,0.3806,0.3083,0.3482
"4084",196413,2005,"3243",1849,1394,2261,"903",1358,0.7345,0.6478,0.6972
"4085",196592,2005,"1839",1261,578,40,"13",27,0.0214,0.0225,0.0218
"4086",197045,2005,"468",264,204,139,"52",87,0.3295,0.2549,0.297
"4087",197133,2005,"647",374,273,572,"238",334,0.893,0.8718,0.8841
"4088",197869,2005,"2536",1265,1271,974,"391",583,0.4609,0.3076,0.3841
"4089",197984,2005,"224",109,115,75,"23",52,0.4771,0.2,0.3348
"4090",198385,2005,"459",234,225,400,"182",218,0.9316,0.8089,0.8715
"4091",198464,2005,"3220",1973,1247,1048,"345",703,0.3563,0.2767,0.3255
"4092",198507,2005,"556",328,228,99,"28",71,0.2165,0.1228,0.1781
"4093",198516,2005,"1237",748,489,959,"370",589,0.7874,0.7566,0.7753
"4094",198835,2005,"326",203,123,122,"37",85,0.4187,0.3008,0.3742
"4095",198969,2005,"387",143,244,59,"22",37,0.2587,0.0902,0.1525
"4096",199102,2005,"2237",1178,1059,369,"116",253,0.2148,0.1095,0.165
"4097",199111,2005,"471",291,180,154,"51",103,0.354,0.2833,0.327
"4098",199120,2005,"3747",2270,1477,2819,"1050",1769,0.7793,0.7109,0.7523
"4099",199139,2005,"2859",1498,1361,741,"273",468,0.3124,0.2006,0.2592
"4100",199148,2005,"2399",1690,709,670,"125",545,0.3225,0.1763,0.2793
"4101",199157,2005,"1195",800,395,181,"45",136,0.17,0.1139,0.1515
"4102",199193,2005,"4364",1918,2446,1732,"716",1016,0.5297,0.2927,0.3969
"4103",199218,2005,"1933",1133,800,842,"302",540,0.4766,0.3775,0.4356
"4104",199281,2005,"961",528,433,142,"50",92,0.1742,0.1155,0.1478
"4105",199306,2005,"198",90,108,74,"28",46,0.5111,0.2593,0.3737
"4106",199412,2005,"238",171,67,116,"30",86,0.5029,0.4478,0.4874
"4107",199582,2005,"261",129,132,34,"16",18,0.1395,0.1212,0.1303
"4108",199643,2005,"573",307,266,75,"29",46,0.1498,0.109,0.1309
"4109",199847,2005,"1114",565,549,918,"431",487,0.8619,0.7851,0.8241
"4110",199962,2005,"371",183,188,154,"54",100,0.5464,0.2872,0.4151
"4111",199999,2005,"1050",701,349,167,"42",125,0.1783,0.1203,0.159
"4112",200004,2005,"1549",775,774,453,"181",272,0.351,0.2339,0.2924
"4113",200059,2005,"317",162,155,29,"11",18,0.1111,0.071,0.0915
"4114",200156,2005,"270",139,131,67,"24",43,0.3094,0.1832,0.2481
"4115",200217,2005,"392",220,172,103,"28",75,0.3409,0.1628,0.2628
"4116",200226,2005,"144",63,81,28,"10",18,0.2857,0.1235,0.1944
"4117",200253,2005,"431",240,191,64,"19",45,0.1875,0.0995,0.1485
"4118",200280,2005,"1851",858,993,425,"198",227,0.2646,0.1994,0.2296
"4119",200332,2005,"1970",940,1030,457,"191",266,0.283,0.1854,0.232
"4120",200572,2005,"171",73,98,40,"16",24,0.3288,0.1633,0.2339
"4121",201104,2005,"573",357,216,271,"86",185,0.5182,0.3981,0.4729
"4122",201371,2005,"228",141,87,123,"45",78,0.5532,0.5172,0.5395
"4123",201548,2005,"599",363,236,310,"109",201,0.5537,0.4619,0.5175
"4124",201645,2005,"1162",456,706,702,"386",316,0.693,0.5467,0.6041
"4125",201690,2005,"343",156,187,31,"15",16,0.1026,0.0802,0.0904
"4126",202134,2005,"955",507,448,87,"31",56,0.1105,0.0692,0.0911
"4127",202480,2005,"1970",1004,966,1149,"475",674,0.6713,0.4917,0.5832
"4128",202523,2005,"620",337,283,473,"211",262,0.7774,0.7456,0.7629
"4129",202763,2005,"584",399,185,240,"64",176,0.4411,0.3459,0.411
"4130",203085,2005,"324",135,189,174,"85",89,0.6593,0.4497,0.537
"4131",203128,2005,"208",101,107,125,"57",68,0.6733,0.5327,0.601
"4132",203368,2005,"786",401,385,504,"217",287,0.7157,0.5636,0.6412
"4133",203517,2005,"3727",2325,1402,970,"294",676,0.2908,0.2097,0.2603
"4134",203535,2005,"439",239,200,364,"165",199,0.8326,0.825,0.8292
"4135",203580,2005,"116",88,28,49,"8",41,0.4659,0.2857,0.4224
"4136",203775,2005,"357",199,158,165,"61",104,0.5226,0.3861,0.4622
"4137",203845,2005,"387",179,208,162,"68",94,0.5251,0.3269,0.4186
"4138",204024,2005,"3150",1708,1442,2198,"902",1296,0.7588,0.6255,0.6978
"4139",204185,2005,"503",260,243,274,"104",170,0.6538,0.428,0.5447
"4140",204194,2005,"380",241,139,149,"49",100,0.4149,0.3525,0.3921
"4141",204617,2005,"372",172,200,129,"65",64,0.3721,0.325,0.3468
"4142",204796,2005,"5929",3005,2924,3032,"1219",1813,0.6033,0.4169,0.5114
"4143",204857,2005,"4078",2148,1930,1788,"697",1091,0.5079,0.3611,0.4385
"4144",206330,2005,"240",74,166,51,"27",24,0.3243,0.1627,0.2125
"4145",206589,2005,"536",267,269,362,"158",204,0.764,0.5874,0.6754
"4146",206604,2005,"2302",1331,971,413,"141",272,0.2044,0.1452,0.1794
"4147",206622,2005,"765",430,335,523,"206",317,0.7372,0.6149,0.6837
"4148",206695,2005,"2012",1029,983,177,"61",116,0.1127,0.0621,0.088
"4149",206914,2005,"714",430,284,37,"22",15,0.0349,0.0775,0.0518
"4150",207209,2005,"670",316,354,31,"3",28,0.0886,0.0085,0.0463
"4151",207306,2005,"279",150,129,37,"10",27,0.18,0.0775,0.1326
"4152",207324,2005,"523",270,253,144,"57",87,0.3222,0.2253,0.2753
"4153",207388,2005,"3221",1662,1559,1106,"436",670,0.4031,0.2797,0.3434
"4154",207500,2005,"3189",1695,1494,1107,"418",689,0.4065,0.2798,0.3471
"4155",207722,2005,"233",122,111,61,"30",31,0.2541,0.2703,0.2618
"4156",207847,2005,"587",298,289,62,"22",40,0.1342,0.0761,0.1056
"4157",207865,2005,"766",403,363,127,"43",84,0.2084,0.1185,0.1658
"4158",208822,2005,"460",287,173,241,"86",155,0.5401,0.4971,0.5239
"4159",209056,2005,"490",294,196,324,"125",199,0.6769,0.6378,0.6612
"4160",209065,2005,"481",260,221,293,"113",180,0.6923,0.5113,0.6091
"4161",209542,2005,"2817",1385,1432,819,"306",513,0.3704,0.2137,0.2907
"4162",209551,2005,"3138",1721,1417,1282,"506",776,0.4509,0.3571,0.4085
"4163",209612,2005,"324",204,120,165,"52",113,0.5539,0.4333,0.5093
"4164",209807,2005,"1200",636,564,172,"66",106,0.1667,0.117,0.1433
"4165",209922,2005,"348",197,151,204,"80",124,0.6294,0.5298,0.5862
"4166",210146,2005,"707",417,290,110,"30",80,0.1918,0.1034,0.1556
"4167",210401,2005,"440",240,200,307,"130",177,0.7375,0.65,0.6977
"4168",210429,2005,"849",511,338,132,"36",96,0.1879,0.1065,0.1555
"4169",210571,2005,"450",254,196,234,"85",149,0.5866,0.4337,0.52
"4170",210669,2005,"561",311,250,424,"181",243,0.7814,0.724,0.7558
"4171",210775,2005,"262",149,113,100,"35",65,0.4362,0.3097,0.3817
"4172",211088,2005,"432",315,117,232,"59",173,0.5492,0.5043,0.537
"4173",211158,2005,"1690",1050,640,693,"207",486,0.4629,0.3234,0.4101
"4174",211291,2005,"920",504,416,804,"352",452,0.8968,0.8462,0.8739
"4175",211352,2005,"526",385,141,257,"60",197,0.5117,0.4255,0.4886
"4176",211361,2005,"1247",640,607,298,"119",179,0.2797,0.196,0.239
"4177",211431,2005,"273",264,9,102,"3",99,0.375,0.3333,0.3736
"4178",211440,2005,"1408",533,875,1000,"611",389,0.7298,0.6983,0.7102
"4179",211468,2005,"203",202,1,82,"1",81,0.401,1,0.4039
"4180",211556,2005,"116",116,0,57,"0",57,0.4914,NA,0.4914
"4181",211583,2005,"219",150,69,73,"23",50,0.3333,0.3333,0.3333
"4182",211608,2005,"397",219,178,51,"21",30,0.137,0.118,0.1285
"4183",211644,2005,"1173",731,442,288,"92",196,0.2681,0.2081,0.2455
"4184",211981,2005,"448",271,177,206,"54",152,0.5609,0.3051,0.4598
"4185",212009,2005,"647",359,288,530,"227",303,0.844,0.7882,0.8192
"4186",212054,2005,"2346",916,1430,663,"274",389,0.4247,0.1916,0.2826
"4187",212106,2005,"1325",811,514,711,"244",467,0.5758,0.4747,0.5366
"4188",212115,2005,"1087",634,453,392,"110",282,0.4448,0.2428,0.3606
"4189",212133,2005,"445",300,145,239,"70",169,0.5633,0.4828,0.5371
"4190",212160,2005,"1268",719,549,297,"82",215,0.299,0.1494,0.2342
"4191",212197,2005,"500",337,163,356,"104",252,0.7478,0.638,0.712
"4192",212577,2005,"581",298,283,468,"211",257,0.8624,0.7456,0.8055
"4193",212601,2005,"619",375,244,292,"104",188,0.5013,0.4262,0.4717
"4194",212832,2005,"280",210,70,21,"15",6,0.0286,0.2143,0.075
"4195",212911,2005,"316",168,148,287,"131",156,0.9286,0.8851,0.9082
"4196",213020,2005,"2462",1335,1127,713,"245",468,0.3506,0.2174,0.2896
"4197",213251,2005,"387",212,175,279,"120",159,0.75,0.6857,0.7209
"4198",213321,2005,"479",198,281,282,"149",133,0.6717,0.5302,0.5887
"4199",213349,2005,"1905",1105,800,621,"190",431,0.39,0.2375,0.326
"4200",213358,2005,"302",203,99,103,"32",71,0.3498,0.3232,0.3411
"4201",213367,2005,"803",440,363,400,"160",240,0.5455,0.4408,0.4981
"4202",213385,2005,"596",275,321,508,"268",240,0.8727,0.8349,0.8523
"4203",213507,2005,"454",223,231,304,"138",166,0.7444,0.5974,0.6696
"4204",213543,2005,"1223",512,711,956,"521",435,0.8496,0.7328,0.7817
"4205",213613,2005,"1215",695,520,314,"110",204,0.2935,0.2115,0.2584
"4206",213668,2005,"357",219,138,216,"74",142,0.6484,0.5362,0.605
"4207",213783,2005,"662",406,256,216,"62",154,0.3793,0.2422,0.3263
"4208",213826,2005,"301",230,71,153,"30",123,0.5348,0.4225,0.5083
"4209",213996,2005,"707",439,268,500,"177",323,0.7358,0.6604,0.7072
"4210",214041,2005,"1306",774,532,501,"172",329,0.4251,0.3233,0.3836
"4211",214069,2005,"324",222,102,181,"52",129,0.5811,0.5098,0.5586
"4212",214157,2005,"382",204,178,280,"123",157,0.7696,0.691,0.733
"4213",214175,2005,"576",322,254,454,"180",274,0.8509,0.7087,0.7882
"4214",214272,2005,"522",334,188,163,"46",117,0.3503,0.2447,0.3123
"4215",214777,2005,"6499",2976,3523,4096,"1969",2127,0.7147,0.5589,0.6303
"4216",215062,2005,"2479",1260,1219,2162,"1033",1129,0.896,0.8474,0.8721
"4217",215743,2005,"364",220,144,190,"59",131,0.5955,0.4097,0.522
"4218",215798,2005,"481",254,227,308,"141",167,0.6575,0.6211,0.6403
"4219",215929,2005,"943",551,392,629,"248",381,0.6915,0.6327,0.667
"4220",216010,2005,"1495",775,720,622,"233",389,0.5019,0.3236,0.4161
"4221",216038,2005,"1457",800,657,556,"216",340,0.425,0.3288,0.3816
"4222",216287,2005,"389",198,191,355,"171",184,0.9293,0.8953,0.9126
"4223",216339,2005,"3841",2175,1666,1247,"483",764,0.3513,0.2899,0.3247
"4224",216524,2005,"411",222,189,309,"136",173,0.7793,0.7196,0.7518
"4225",216694,2005,"340",208,132,171,"58",113,0.5433,0.4394,0.5029
"4226",216764,2005,"1898",1219,679,812,"216",596,0.4889,0.3181,0.4278
"4227",216807,2005,"360",231,129,223,"75",148,0.6407,0.5814,0.6194
"4228",216852,2005,"646",332,314,258,"98",160,0.4819,0.3121,0.3994
"4229",216931,2005,"562",297,265,270,"114",156,0.5253,0.4302,0.4804
"4230",217059,2005,"1078",591,487,442,"175",267,0.4518,0.3593,0.41
"4231",217156,2005,"1439",735,704,1197,"577",620,0.8435,0.8196,0.8318
"4232",217402,2005,"1064",593,471,857,"367",490,0.8263,0.7792,0.8055
"4233",217536,2005,"562",418,144,382,"82",300,0.7177,0.5694,0.6797
"4234",217776,2005,"176",110,66,46,"18",28,0.2545,0.2727,0.2614
"4235",217819,2005,"1984",1342,642,1031,"291",740,0.5514,0.4533,0.5197
"4236",217882,2005,"2893",1426,1467,1565,"611",954,0.669,0.4165,0.541
"4237",217998,2005,"181",90,91,82,"33",49,0.5444,0.3626,0.453
"4238",218061,2005,"797",517,280,158,"40",118,0.2282,0.1429,0.1982
"4239",218229,2005,"555",369,186,110,"34",76,0.206,0.1828,0.1982
"4240",218238,2005,"201",99,102,40,"10",30,0.303,0.098,0.199
"4241",218399,2005,"207",130,77,30,"9",21,0.1615,0.1169,0.1449
"4242",218414,2005,"275",96,179,67,"34",33,0.3438,0.1899,0.2436
"4243",218663,2005,"3677",2087,1590,1881,"682",1199,0.5745,0.4289,0.5116
"4244",218724,2005,"1493",775,718,375,"130",245,0.3161,0.1811,0.2512
"4245",218733,2005,"1002",544,458,140,"50",90,0.1654,0.1092,0.1397
"4246",218742,2005,"718",469,249,153,"41",112,0.2388,0.1647,0.2131
"4247",218973,2005,"320",144,176,241,"123",118,0.8194,0.6989,0.7531
"4248",219000,2005,"390",256,134,192,"54",138,0.5391,0.403,0.4923
"4249",219046,2005,"584",353,231,74,"22",52,0.1473,0.0952,0.1267
"4250",219082,2005,"280",135,145,29,"14",15,0.1111,0.0966,0.1036
"4251",219198,2005,"139",91,48,54,"15",39,0.4286,0.3125,0.3885
"4252",219259,2005,"368",197,171,47,"13",34,0.1726,0.076,0.1277
"4253",219356,2005,"1784",893,891,528,"213",315,0.3527,0.2391,0.296
"4254",219471,2005,"1030",621,409,236,"74",162,0.2609,0.1809,0.2291
"4255",219602,2005,"1226",708,518,175,"70",105,0.1483,0.1351,0.1427
"4256",219709,2005,"791",488,303,483,"180",303,0.6209,0.5941,0.6106
"4257",219718,2005,"234",108,126,29,"9",20,0.1852,0.0714,0.1239
"4258",219949,2005,"217",107,110,44,"17",27,0.2523,0.1545,0.2028
"4259",220075,2005,"1565",897,668,308,"102",206,0.2297,0.1527,0.1968
"4260",220215,2005,"373",203,170,139,"61",78,0.3842,0.3588,0.3727
"4261",220613,2005,"755",454,301,297,"99",198,0.4361,0.3289,0.3934
"4262",220631,2005,"139",90,49,25,"6",19,0.2111,0.1224,0.1799
"4263",220710,2005,"333",163,170,158,"67",91,0.5583,0.3941,0.4745
"4264",221351,2005,"440",255,185,313,"131",182,0.7137,0.7081,0.7114
"4265",221519,2005,"420",241,179,337,"144",193,0.8008,0.8045,0.8024
"4266",221731,2005,"167",100,67,52,"14",38,0.38,0.209,0.3114
"4267",221847,2005,"1409",623,786,321,"121",200,0.321,0.1539,0.2278
"4268",221892,2005,"239",124,115,95,"40",55,0.4435,0.3478,0.3975
"4269",222178,2005,"1030",560,470,393,"150",243,0.4339,0.3191,0.3816
"4270",222983,2005,"347",171,176,239,"103",136,0.7953,0.5852,0.6888
"4271",223232,2005,"3158",1867,1291,1641,"582",1059,0.5672,0.4508,0.5196
"4272",224004,2005,"196",96,100,40,"12",28,0.2917,0.12,0.2041
"4273",224323,2005,"256",165,91,160,"53",107,0.6485,0.5824,0.625
"4274",225432,2005,"889",487,402,20,"8",12,0.0246,0.0199,0.0225
"4275",225548,2005,"281",146,135,104,"41",63,0.4315,0.3037,0.3701
"4276",225627,2005,"571",394,177,114,"23",91,0.231,0.1299,0.1996
"4277",226231,2005,"317",74,243,95,"66",29,0.3919,0.2716,0.2997
"4278",226833,2005,"818",447,371,100,"27",73,0.1633,0.0728,0.1222
"4279",227216,2005,"3557",2008,1549,760,"214",546,0.2719,0.1382,0.2137
"4280",227331,2005,"269",204,65,1,"1",0,0,0.0154,0.0037
"4281",227526,2005,"1155",668,487,126,"39",87,0.1302,0.0801,0.1091
"4282",227757,2005,"722",337,385,571,"279",292,0.8665,0.7247,0.7909
"4283",227845,2005,"646",401,245,333,"109",224,0.5586,0.4449,0.5155
"4284",227863,2005,"289",185,104,75,"27",48,0.2595,0.2596,0.2595
"4285",228042,2005,"167",92,75,50,"19",31,0.337,0.2533,0.2994
"4286",228149,2005,"494",314,180,147,"38",109,0.3471,0.2111,0.2976
"4287",228246,2005,"1401",754,647,846,"345",501,0.6645,0.5332,0.6039
"4288",228343,2005,"327",192,135,223,"87",136,0.7083,0.6444,0.682
"4289",228431,2005,"1967",1199,768,441,"125",316,0.2636,0.1628,0.2242
"4290",228459,2005,"3053",1786,1267,825,"235",590,0.3303,0.1855,0.2702
"4291",228501,2005,"329",127,202,31,"19",12,0.0945,0.0941,0.0942
"4292",228529,2005,"1188",678,510,212,"65",147,0.2168,0.1275,0.1785
"4293",228705,2005,"606",244,362,83,"40",43,0.1762,0.1105,0.137
"4294",228723,2005,"6713",3406,3307,3352,"1259",2093,0.6145,0.3807,0.4993
"4295",228769,2005,"2075",1069,1006,347,"130",217,0.203,0.1292,0.1672
"4296",228778,2005,"6783",3630,3153,3572,"1419",2153,0.5931,0.45,0.5266
"4297",228787,2005,"1058",403,655,433,"235",198,0.4913,0.3588,0.4093
"4298",228796,2005,"2154",1085,1069,210,"74",136,0.1253,0.0692,0.0975
"4299",228875,2005,"1610",977,633,875,"284",591,0.6049,0.4487,0.5435
"4300",228981,2005,"379",182,197,106,"35",71,0.3901,0.1777,0.2797
"4301",229018,2005,"300",173,127,53,"18",35,0.2023,0.1417,0.1767
"4302",229027,2005,"4360",2240,2120,348,"127",221,0.0987,0.0599,0.0798
"4303",229115,2005,"3743",1829,1914,1323,"530",793,0.4336,0.2769,0.3535
"4304",229780,2005,"222",124,98,44,"11",33,0.2661,0.1122,0.1982
"4305",229814,2005,"768",409,359,171,"66",105,0.2567,0.1838,0.2227
"4306",230603,2005,"784",527,257,137,"30",107,0.203,0.1167,0.1747
"4307",230728,2005,"1618",1065,553,415,"75",340,0.3192,0.1356,0.2565
"4308",230764,2005,"1997",1106,891,415,"138",277,0.2505,0.1549,0.2078
"4309",230782,2005,"1626",879,747,68,"23",45,0.0512,0.0308,0.0418
"4310",231059,2005,"592",331,261,454,"188",266,0.8036,0.7203,0.7669
"4311",231174,2005,"2378",1287,1091,1367,"568",799,0.6208,0.5206,0.5749
"4312",231420,2005,"229",84,145,59,"33",26,0.3095,0.2276,0.2576
"4313",231554,2005,"103",57,46,32,"15",17,0.2982,0.3261,0.3107
"4314",231624,2005,"1339",714,625,1134,"489",645,0.9034,0.7824,0.8469
"4315",231712,2005,"1245",667,578,578,"203",375,0.5622,0.3512,0.4643
"4316",232025,2005,"338",155,183,177,"80",97,0.6258,0.4372,0.5237
"4317",232043,2005,"202",123,79,116,"40",76,0.6179,0.5063,0.5743
"4318",232089,2005,"330",110,220,53,"18",35,0.3182,0.0818,0.1606
"4319",232186,2005,"2454",1339,1115,999,"348",651,0.4862,0.3121,0.4071
"4320",232265,2005,"1099",701,398,445,"114",331,0.4722,0.2864,0.4049
"4321",232423,2005,"3796",2421,1375,2465,"803",1662,0.6865,0.584,0.6494
"4322",232557,2005,"1915",982,933,488,"204",284,0.2892,0.2186,0.2548
"4323",232566,2005,"938",632,306,379,"88",291,0.4604,0.2876,0.4041
"4324",232609,2005,"553",321,232,246,"84",162,0.5047,0.3621,0.4448
"4325",232681,2005,"877",581,296,552,"159",393,0.6764,0.5372,0.6294
"4326",232706,2005,"422",310,112,152,"34",118,0.3806,0.3036,0.3602
"4327",232937,2005,"957",551,406,138,"39",99,0.1797,0.0961,0.1442
"4328",232982,2005,"2054",1160,894,474,"145",329,0.2836,0.1622,0.2308
"4329",233277,2005,"1890",1101,789,725,"254",471,0.4278,0.3219,0.3836
"4330",233374,2005,"775",401,374,593,"268",325,0.8105,0.7166,0.7652
"4331",233426,2005,"534",310,224,316,"120",196,0.6323,0.5357,0.5918
"4332",233541,2005,"369",211,158,123,"44",79,0.3744,0.2785,0.3333
"4333",233897,2005,"366",186,180,94,"27",67,0.3602,0.15,0.2568
"4334",233921,2005,"5026",2190,2836,2797,"1296",1501,0.6854,0.457,0.5565
"4335",234030,2005,"3432",2052,1380,904,"306",598,0.2914,0.2217,0.2634
"4336",234085,2005,"363",40,323,209,"187",22,0.55,0.5789,0.5758
"4337",234155,2005,"1176",775,401,234,"48",186,0.24,0.1197,0.199
"4338",234164,2005,"356",197,159,57,"14",43,0.2183,0.0881,0.1601
"4339",235097,2005,"1610",992,618,340,"120",220,0.2218,0.1942,0.2112
"4340",235167,2005,"590",296,294,243,"114",129,0.4358,0.3878,0.4119
"4341",236230,2005,"687",432,255,340,"106",234,0.5417,0.4157,0.4949
"4342",236328,2005,"669",385,284,446,"180",266,0.6909,0.6338,0.6667
"4343",236577,2005,"710",490,220,425,"123",302,0.6163,0.5591,0.5986
"4344",236595,2005,"739",454,285,422,"156",266,0.5859,0.5474,0.571
"4345",236896,2005,"292",132,160,62,"34",28,0.2121,0.2125,0.2123
"4346",236939,2005,"2855",1418,1437,1072,"413",659,0.4647,0.2874,0.3755
"4347",236948,2005,"4892",2622,2270,2883,"1209",1674,0.6384,0.5326,0.5893
"4348",237011,2005,"2365",1364,1001,943,"302",641,0.4699,0.3017,0.3987
"4349",237057,2005,"360",180,180,288,"140",148,0.8222,0.7778,0.8
"4350",237066,2005,"451",266,185,304,"125",179,0.6729,0.6757,0.6741
"4351",237215,2005,"246",133,113,5,"3",2,0.015,0.0265,0.0203
"4352",237330,2005,"639",352,287,104,"35",69,0.196,0.122,0.1628
"4353",237358,2005,"109",67,42,25,"5",20,0.2985,0.119,0.2294
"4354",237367,2005,"653",367,286,97,"35",62,0.1689,0.1224,0.1485
"4355",237792,2005,"657",352,305,134,"52",82,0.233,0.1705,0.204
"4356",237899,2005,"306",152,154,21,"11",10,0.0658,0.0714,0.0686
"4357",237932,2005,"416",234,182,94,"25",69,0.2949,0.1374,0.226
"4358",237969,2005,"307",161,146,129,"38",91,0.5652,0.2603,0.4202
"4359",238032,2005,"4524",2126,2398,1457,"639",818,0.3848,0.2665,0.3221
"4360",238333,2005,"326",198,128,216,"71",145,0.7323,0.5547,0.6626
"4361",238430,2005,"182",139,43,19,"4",15,0.1079,0.093,0.1044
"4362",238458,2005,"598",383,215,231,"63",168,0.4386,0.293,0.3863
"4363",238476,2005,"593",315,278,281,"120",161,0.5111,0.4317,0.4739
"4364",238616,2005,"386",207,179,134,"52",82,0.3961,0.2905,0.3472
"4365",238661,2005,"281",210,71,77,"21",56,0.2667,0.2958,0.274
"4366",239080,2005,"262",190,72,78,"17",61,0.3211,0.2361,0.2977
"4367",239105,2005,"1775",967,808,1083,"448",635,0.6567,0.5545,0.6101
"4368",239628,2005,"261",119,142,148,"70",78,0.6555,0.493,0.567
"4369",239716,2005,"504",282,222,328,"147",181,0.6418,0.6622,0.6508
"4370",240107,2005,"289",207,82,82,"11",71,0.343,0.1341,0.2837
"4371",240189,2005,"1701",823,878,437,"196",241,0.2928,0.2232,0.2569
"4372",240277,2005,"904",587,317,198,"45",153,0.2606,0.142,0.219
"4373",240329,2005,"1755",1056,699,579,"176",403,0.3816,0.2518,0.3299
"4374",240338,2005,"180",110,70,81,"33",48,0.4364,0.4714,0.45
"4375",240365,2005,"1617",982,635,234,"81",153,0.1558,0.1276,0.1447
"4376",240374,2005,"783",442,341,61,"27",34,0.0769,0.0792,0.0779
"4377",240417,2005,"1699",863,836,322,"103",219,0.2538,0.1232,0.1895
"4378",240426,2005,"336",208,128,61,"11",50,0.2404,0.0859,0.1815
"4379",240444,2005,"6118",3434,2684,3174,"1255",1919,0.5588,0.4676,0.5188
"4380",240453,2005,"4218",2233,1985,604,"258",346,0.1549,0.13,0.1432
"4381",240462,2005,"1218",426,792,187,"83",104,0.2441,0.1048,0.1535
"4382",240471,2005,"1192",734,458,268,"80",188,0.2561,0.1747,0.2248
"4383",240480,2005,"1521",832,689,365,"136",229,0.2752,0.1974,0.24
"4384",240727,2005,"1399",739,660,320,"107",213,0.2882,0.1621,0.2287
"4385",243443,2005,"796",500,296,66,"8",58,0.116,0.027,0.0829
"4386",243780,2005,"7167",2860,4307,2547,"1189",1358,0.4748,0.2761,0.3554
"4387",100654,2004,"1198",611,587,146,"31",115,0.1882,0.0528,0.1219
"4388",100663,2004,"1536",973,563,284,"82",202,0.2076,0.1456,0.1849
"4389",100751,2004,"3290",1853,1437,1248,"426",822,0.4436,0.2965,0.3793
"4390",100858,2004,"3579",1849,1730,1279,"445",834,0.4511,0.2572,0.3574
"4391",101435,2004,"192",72,120,71,"38",33,0.4583,0.3167,0.3698
"4392",101480,2004,"1017",555,462,91,"20",71,0.1279,0.0433,0.0895
"4393",101675,2004,"427",203,224,49,"9",40,0.197,0.0402,0.1148
"4394",101879,2004,"856",469,387,107,"27",80,0.1706,0.0698,0.125
"4395",102049,2004,"665",423,242,359,"111",248,0.5863,0.4587,0.5398
"4396",102094,2004,"1278",725,553,180,"60",120,0.1655,0.1085,0.1408
"4397",102234,2004,"309",203,106,156,"44",112,0.5517,0.4151,0.5049
"4398",102368,2004,"1450",788,662,230,"67",163,0.2069,0.1012,0.1586
"4399",102377,2004,"701",389,312,123,"35",88,0.2262,0.1122,0.1755
"4400",104151,2004,"7293",3998,3295,2324,"816",1508,0.3772,0.2476,0.3187
"4401",104179,2004,"5566",3008,2558,1880,"723",1157,0.3846,0.2826,0.3378
"4402",105330,2004,"2274",1309,965,652,"190",462,0.3529,0.1969,0.2867
"4403",106245,2004,"759",452,307,54,"18",36,0.0796,0.0586,0.0711
"4404",106342,2004,"141",66,75,62,"37",25,0.3788,0.4933,0.4397
"4405",106397,2004,"2420",1222,1198,835,"329",506,0.4141,0.2746,0.345
"4406",106412,2004,"690",365,325,47,"14",33,0.0904,0.0431,0.0681
"4407",106458,2004,"1296",749,547,212,"71",141,0.1883,0.1298,0.1636
"4408",106467,2004,"1398",728,670,199,"72",127,0.1745,0.1075,0.1423
"4409",106485,2004,"629",327,302,60,"25",35,0.107,0.0828,0.0954
"4410",106704,2004,"2216",1313,903,468,"131",337,0.2567,0.1451,0.2112
"4411",107044,2004,"961",516,445,387,"161",226,0.438,0.3618,0.4027
"4412",107080,2004,"295",165,130,159,"69",90,0.5455,0.5308,0.539
"4413",107141,2004,"296",156,140,155,"67",88,0.5641,0.4786,0.5236
"4414",107512,2004,"380",223,157,170,"49",121,0.5426,0.3121,0.4474
"4415",107558,2004,"134",74,60,44,"18",26,0.3514,0.3,0.3284
"4416",110097,2004,"691",443,248,346,"120",226,0.5102,0.4839,0.5007
"4417",110404,2004,"207",59,148,167,"117",50,0.8475,0.7905,0.8068
"4418",110422,2004,"2900",1169,1731,767,"304",463,0.3961,0.1756,0.2645
"4419",110486,2004,"745",483,262,128,"32",96,0.1988,0.1221,0.1718
"4420",110495,2004,"653",456,197,153,"41",112,0.2456,0.2081,0.2343
"4421",110510,2004,"1587",1099,488,208,"53",155,0.141,0.1086,0.1311
"4422",110529,2004,"2115",921,1194,412,"188",224,0.2432,0.1575,0.1948
"4423",110538,2004,"2198",1266,932,436,"102",334,0.2638,0.1094,0.1984
"4424",110547,2004,"673",459,214,35,"10",25,0.0545,0.0467,0.052
"4425",110556,2004,"2243",1351,892,378,"102",276,0.2043,0.1143,0.1685
"4426",110565,2004,"3539",2094,1445,583,"148",435,0.2077,0.1024,0.1647
"4427",110574,2004,"840",516,324,122,"38",84,0.1628,0.1173,0.1452
"4428",110583,2004,"3300",2222,1078,406,"103",303,0.1364,0.0955,0.123
"4429",110592,2004,"1087",687,400,87,"22",65,0.0946,0.055,0.08
"4430",110617,2004,"2268",1375,893,240,"57",183,0.1331,0.0638,0.1058
"4431",113698,2004,"276",205,71,119,"24",95,0.4634,0.338,0.4312
"4432",115755,2004,"760",427,333,66,"18",48,0.1124,0.0541,0.0868
"4433",119173,2004,"364",352,12,93,"4",89,0.2528,0.3333,0.2555
"4434",120184,2004,"161",108,53,68,"19",49,0.4537,0.3585,0.4224
"4435",121309,2004,"535",339,196,395,"141",254,0.7493,0.7194,0.7383
"4436",121345,2004,"393",196,197,356,"181",175,0.8929,0.9188,0.9059
"4437",122409,2004,"3527",2128,1399,1073,"307",766,0.36,0.2194,0.3042
"4438",122436,2004,"1174",705,469,706,"259",447,0.634,0.5522,0.6014
"4439",122597,2004,"2739",1770,969,390,"114",276,0.1559,0.1176,0.1424
"4440",122612,2004,"929",614,315,518,"151",367,0.5977,0.4794,0.5576
"4441",122931,2004,"1171",658,513,941,"392",549,0.8343,0.7641,0.8036
"4442",123554,2004,"603",388,215,319,"102",217,0.5593,0.4744,0.529
"4443",123572,2004,"1102",713,389,344,"76",268,0.3759,0.1954,0.3122
"4444",126562,2004,"686",387,299,101,"34",67,0.1731,0.1137,0.1472
"4445",126580,2004,"939",562,377,198,"54",144,0.2562,0.1432,0.2109
"4446",126614,2004,"5124",2484,2640,2093,"909",1184,0.4767,0.3443,0.4085
"4447",126818,2004,"4047",2216,1831,1484,"522",962,0.4341,0.2851,0.3667
"4448",127060,2004,"1124",588,536,633,"286",347,0.5901,0.5336,0.5632
"4449",127185,2004,"930",448,482,181,"67",114,0.2545,0.139,0.1946
"4450",127565,2004,"1815",937,878,86,"34",52,0.0555,0.0387,0.0474
"4451",127741,2004,"2412",1459,953,648,"190",458,0.3139,0.1994,0.2687
"4452",128106,2004,"753",423,330,118,"34",84,0.1986,0.103,0.1567
"4453",128744,2004,"241",134,107,47,"19",28,0.209,0.1776,0.195
"4454",128771,2004,"1278",596,682,213,"80",133,0.2232,0.1173,0.1667
"4455",129020,2004,"3229",1789,1440,2104,"830",1274,0.7121,0.5764,0.6516
"4456",129242,2004,"856",475,381,679,"282",397,0.8358,0.7402,0.7932
"4457",129941,2004,"571",264,307,197,"111",86,0.3258,0.3616,0.345
"4458",130253,2004,"876",521,355,528,"196",332,0.6372,0.5521,0.6027
"4459",130314,2004,"189",189,0,56,"0",56,0.2963,NA,0.2963
"4460",130493,2004,"1396",899,497,219,"46",173,0.1924,0.0926,0.1569
"4461",130590,2004,"569",283,286,442,"213",229,0.8092,0.7448,0.7768
"4462",130697,2004,"728",385,343,649,"300",349,0.9065,0.8746,0.8915
"4463",130776,2004,"755",382,373,120,"53",67,0.1754,0.1421,0.1589
"4464",130794,2004,"1306",632,674,1161,"589",572,0.9051,0.8739,0.889
"4465",130934,2004,"687",400,287,133,"23",110,0.275,0.0801,0.1936
"4466",130943,2004,"3769",2173,1596,2131,"776",1355,0.6236,0.4862,0.5654
"4467",131159,2004,"1210",776,434,902,"306",596,0.768,0.7051,0.7455
"4468",131283,2004,"719",387,332,429,"182",247,0.6382,0.5482,0.5967
"4469",131450,2004,"227",121,106,18,"8",10,0.0826,0.0755,0.0793
"4470",131469,2004,"2623",1441,1182,1957,"830",1127,0.7821,0.7022,0.7461
"4471",131496,2004,"1523",855,668,1358,"574",784,0.917,0.8593,0.8917
"4472",131520,2004,"1445",987,458,691,"151",540,0.5471,0.3297,0.4782
"4473",132471,2004,"553",349,204,101,"29",72,0.2063,0.1422,0.1826
"4474",132602,2004,"818",503,315,118,"29",89,0.1769,0.0921,0.1443
"4475",132903,2004,"5710",3041,2669,1986,"723",1263,0.4153,0.2709,0.3478
"4476",133492,2004,"471",272,199,297,"119",178,0.6544,0.598,0.6306
"4477",133553,2004,"933",139,794,282,"231",51,0.3669,0.2909,0.3023
"4478",133650,2004,"2105",1242,863,268,"73",195,0.157,0.0846,0.1273
"4479",133669,2004,"2278",1231,1047,364,"122",242,0.1966,0.1165,0.1598
"4480",133711,2004,"500",296,204,250,"98",152,0.5135,0.4804,0.5
"4481",133881,2004,"551",181,370,218,"132",86,0.4751,0.3568,0.3956
"4482",133951,2004,"3370",1906,1464,647,"198",449,0.2356,0.1352,0.192
"4483",134079,2004,"553",342,211,227,"70",157,0.4591,0.3318,0.4105
"4484",134097,2004,"6198",3727,2471,3112,"1029",2083,0.5589,0.4164,0.5021
"4485",134130,2004,"6621",3706,2915,3933,"1418",2515,0.6786,0.4864,0.594
"4486",134945,2004,"462",197,265,118,"59",59,0.2995,0.2226,0.2554
"4487",135726,2004,"2025",1157,868,1381,"551",830,0.7174,0.6348,0.682
"4488",136172,2004,"2199",1252,947,447,"116",331,0.2644,0.1225,0.2033
"4489",136950,2004,"486",284,202,285,"116",169,0.5951,0.5743,0.5864
"4490",137546,2004,"598",354,244,303,"100",203,0.5734,0.4098,0.5067
"4491",138354,2004,"859",475,384,168,"57",111,0.2337,0.1484,0.1956
"4492",138716,2004,"602",399,203,98,"22",76,0.1905,0.1084,0.1628
"4493",138789,2004,"776",449,327,70,"21",49,0.1091,0.0642,0.0902
"4494",139144,2004,"514",349,165,261,"76",185,0.5301,0.4606,0.5078
"4495",139366,2004,"972",584,388,116,"31",85,0.1455,0.0799,0.1193
"4496",139393,2004,"260",156,104,123,"41",82,0.5256,0.3942,0.4731
"4497",139658,2004,"1587",911,676,1044,"436",608,0.6674,0.645,0.6578
"4498",139719,2004,"456",227,229,66,"18",48,0.2115,0.0786,0.1447
"4499",139755,2004,"2572",766,1806,845,"514",331,0.4321,0.2846,0.3285
"4500",139764,2004,"359",247,112,40,"6",34,0.1377,0.0536,0.1114
"4501",139861,2004,"918",582,336,322,"90",232,0.3986,0.2679,0.3508
"4502",139931,2004,"2982",1393,1589,546,"158",388,0.2785,0.0994,0.1831
"4503",139940,2004,"2272",1338,934,389,"132",257,0.1921,0.1413,0.1712
"4504",139959,2004,"4500",2724,1776,2335,"774",1561,0.5731,0.4358,0.5189
"4505",140447,2004,"632",373,259,270,"90",180,0.4826,0.3475,0.4272
"4506",140960,2004,"568",316,252,73,"22",51,0.1614,0.0873,0.1285
"4507",140988,2004,"226",128,98,95,"31",64,0.5,0.3163,0.4204
"4508",141185,2004,"161",98,63,67,"20",47,0.4796,0.3175,0.4161
"4509",141264,2004,"1690",969,721,279,"78",201,0.2074,0.1082,0.1651
"4510",141334,2004,"1702",976,726,202,"67",135,0.1383,0.0923,0.1187
"4511",141486,2004,"247",167,80,62,"21",41,0.2455,0.2625,0.251
"4512",141565,2004,"412",225,187,50,"18",32,0.1422,0.0963,0.1214
"4513",141574,2004,"1892",1039,853,325,"109",216,0.2079,0.1278,0.1718
"4514",142276,2004,"983",522,461,63,"18",45,0.0862,0.039,0.0641
"4515",142285,2004,"1602",755,847,383,"147",236,0.3126,0.1736,0.2391
"4516",142461,2004,"247",159,88,99,"28",71,0.4465,0.3182,0.4008
"4517",143084,2004,"599",321,278,426,"178",248,0.7726,0.6403,0.7112
"4518",143288,2004,"176",87,89,55,"23",32,0.3678,0.2584,0.3125
"4519",144005,2004,"563",367,196,17,"13",4,0.0109,0.0663,0.0302
"4520",144281,2004,"1744",873,871,449,"217",232,0.2658,0.2491,0.2575
"4521",144740,2004,"2304",1367,937,1097,"377",720,0.5267,0.4023,0.4761
"4522",144892,2004,"1725",1032,693,594,"177",417,0.4041,0.2554,0.3443
"4523",144962,2004,"386",225,161,215,"66",149,0.6622,0.4099,0.557
"4524",144971,2004,"116",57,59,35,"15",20,0.3509,0.2542,0.3017
"4525",145600,2004,"2671",1488,1183,681,"278",403,0.2708,0.235,0.255
"4526",145619,2004,"301",151,150,121,"53",68,0.4503,0.3533,0.402
"4527",145637,2004,"7225",3555,3670,4848,"2215",2633,0.7406,0.6035,0.671
"4528",145691,2004,"258",136,122,135,"49",86,0.6324,0.4016,0.5233
"4529",145813,2004,"2824",1739,1085,1280,"392",888,0.5106,0.3613,0.4533
"4530",146481,2004,"405",247,158,257,"83",174,0.7045,0.5253,0.6346
"4531",146612,2004,"509",275,234,186,"81",105,0.3818,0.3462,0.3654
"4532",146719,2004,"1787",1176,611,856,"296",560,0.4762,0.4845,0.479
"4533",146825,2004,"152",74,78,37,"17",20,0.2703,0.2179,0.2434
"4534",147013,2004,"337",134,203,122,"55",67,0.5,0.2709,0.362
"4535",147244,2004,"530",302,228,268,"99",169,0.5596,0.4342,0.5057
"4536",147341,2004,"389",227,162,169,"59",110,0.4846,0.3642,0.4344
"4537",147703,2004,"2933",1585,1348,807,"334",473,0.2984,0.2478,0.2751
"4538",147767,2004,"1914",1030,884,1652,"728",924,0.8971,0.8235,0.8631
"4539",147776,2004,"972",580,392,37,"7",30,0.0517,0.0179,0.0381
"4540",147828,2004,"699",427,272,338,"97",241,0.5644,0.3566,0.4835
"4541",148131,2004,"228",124,104,75,"27",48,0.3871,0.2596,0.3289
"4542",148496,2004,"271",181,90,156,"41",115,0.6354,0.4556,0.5756
"4543",148584,2004,"157",94,63,64,"21",43,0.4574,0.3333,0.4076
"4544",148627,2004,"406",259,147,130,"44",86,0.332,0.2993,0.3202
"4545",149222,2004,"2545",1053,1492,646,"308",338,0.321,0.2064,0.2538
"4546",149231,2004,"1695",986,709,485,"162",323,0.3276,0.2285,0.2861
"4547",149772,2004,"2056",1025,1031,681,"301",380,0.3707,0.2919,0.3312
"4548",149781,2004,"595",318,277,469,"202",267,0.8396,0.7292,0.7882
"4549",150066,2004,"579",340,239,248,"92",156,0.4588,0.3849,0.4283
"4550",150136,2004,"3662",1951,1711,1141,"390",751,0.3849,0.2279,0.3116
"4551",150145,2004,"306",174,132,125,"38",87,0.5,0.2879,0.4085
"4552",150163,2004,"925",571,354,458,"143",315,0.5517,0.404,0.4951
"4553",150400,2004,"661",367,294,546,"229",317,0.8638,0.7789,0.826
"4554",150534,2004,"634",382,252,357,"131",226,0.5916,0.5198,0.5631
"4555",150668,2004,"168",95,73,84,"38",46,0.4842,0.5205,0.5
"4556",150941,2004,"203",123,80,108,"44",64,0.5203,0.55,0.532
"4557",151102,2004,"1553",859,694,103,"29",74,0.0861,0.0418,0.0663
"4558",151111,2004,"2294",1371,923,226,"80",146,0.1065,0.0867,0.0985
"4559",151306,2004,"2004",1196,808,269,"71",198,0.1656,0.0879,0.1342
"4560",151324,2004,"1813",901,912,341,"128",213,0.2364,0.1404,0.1881
"4561",151333,2004,"356",237,119,18,"5",13,0.0549,0.042,0.0506
"4562",151342,2004,"704",432,272,29,"11",18,0.0417,0.0404,0.0412
"4563",151351,2004,"6300",3407,2893,3110,"1273",1837,0.5392,0.44,0.4937
"4564",151360,2004,"604",375,229,28,"10",18,0.048,0.0437,0.0464
"4565",151379,2004,"714",420,294,63,"12",51,0.1214,0.0408,0.0882
"4566",151388,2004,"270",182,88,14,"3",11,0.0604,0.0341,0.0519
"4567",151777,2004,"278",154,124,113,"34",79,0.513,0.2742,0.4065
"4568",151786,2004,"245",166,79,84,"26",58,0.3494,0.3291,0.3429
"4569",152080,2004,"1987",947,1040,1789,"914",875,0.924,0.8788,0.9004
"4570",152248,2004,"954",492,462,55,"24",31,0.063,0.0519,0.0577
"4571",152363,2004,"246",145,101,128,"37",91,0.6276,0.3663,0.5203
"4572",152530,2004,"476",265,211,334,"134",200,0.7547,0.6351,0.7017
"4573",152600,2004,"746",376,370,446,"201",245,0.6516,0.5432,0.5979
"4574",153001,2004,"331",173,158,150,"63",87,0.5029,0.3987,0.4532
"4575",153108,2004,"441",223,218,260,"118",142,0.6368,0.5413,0.5896
"4576",153269,2004,"782",462,320,408,"162",246,0.5325,0.5062,0.5217
"4577",153384,2004,"434",237,197,363,"155",208,0.8776,0.7868,0.8364
"4578",153603,2004,"3674",1618,2056,1348,"572",776,0.4796,0.2782,0.3669
"4579",153834,2004,"661",387,274,435,"183",252,0.6512,0.6679,0.6581
"4580",154095,2004,"1652",995,657,581,"172",409,0.4111,0.2618,0.3517
"4581",155089,2004,"207",112,95,27,"14",13,0.1161,0.1474,0.1304
"4582",155317,2004,"4182",2148,2034,1345,"527",818,0.3808,0.2591,0.3216
"4583",155335,2004,"216",112,104,43,"17",26,0.2321,0.1635,0.1991
"4584",155399,2004,"3282",1691,1591,823,"270",553,0.327,0.1697,0.2508
"4585",155520,2004,"249",117,132,84,"40",44,0.3761,0.303,0.3373
"4586",155627,2004,"79",30,49,23,"11",12,0.4,0.2245,0.2911
"4587",155937,2004,"136",52,84,36,"19",17,0.3269,0.2262,0.2647
"4588",156213,2004,"302",183,119,160,"68",92,0.5027,0.5714,0.5298
"4589",156286,2004,"407",271,136,225,"58",167,0.6162,0.4265,0.5528
"4590",156295,2004,"400",209,191,201,"84",117,0.5598,0.4398,0.5025
"4591",156365,2004,"381",178,203,102,"39",63,0.3539,0.1921,0.2677
"4592",156541,2004,"418",190,228,104,"36",68,0.3579,0.1579,0.2488
"4593",156745,2004,"354",192,162,205,"73",132,0.6875,0.4506,0.5791
"4594",157058,2004,"346",196,150,37,"8",29,0.148,0.0533,0.1069
"4595",157076,2004,"210",93,117,64,"25",39,0.4194,0.2137,0.3048
"4596",157085,2004,"3935",2097,1838,1276,"486",790,0.3767,0.2644,0.3243
"4597",157289,2004,"2303",1197,1106,489,"164",325,0.2715,0.1483,0.2123
"4598",157386,2004,"1307",737,570,125,"39",86,0.1167,0.0684,0.0956
"4599",157401,2004,"1414",804,610,531,"176",355,0.4415,0.2885,0.3755
"4600",157447,2004,"1915",1123,792,151,"43",108,0.0962,0.0543,0.0789
"4601",157535,2004,"175",103,72,31,"8",23,0.2233,0.1111,0.1771
"4602",157951,2004,"2918",1647,1271,456,"155",301,0.1828,0.122,0.1563
"4603",158477,2004,"282",190,92,145,"42",103,0.5421,0.4565,0.5142
"4604",159009,2004,"1132",675,457,115,"33",82,0.1215,0.0722,0.1016
"4605",159391,2004,"5692",3099,2593,1492,"539",953,0.3075,0.2079,0.2621
"4606",159647,2004,"1644",730,914,432,"189",243,0.3329,0.2068,0.2628
"4607",159717,2004,"1603",923,680,196,"61",135,0.1463,0.0897,0.1223
"4608",159966,2004,"1574",939,635,146,"44",102,0.1086,0.0693,0.0928
"4609",160038,2004,"1793",1084,709,187,"55",132,0.1218,0.0776,0.1043
"4610",160612,2004,"2137",1250,887,210,"68",142,0.1136,0.0767,0.0983
"4611",160621,2004,"1575",931,644,115,"30",85,0.0913,0.0466,0.073
"4612",160658,2004,"2643",1517,1126,345,"101",244,0.1608,0.0897,0.1305
"4613",161004,2004,"470",235,235,421,"212",209,0.8894,0.9021,0.8957
"4614",161226,2004,"510",342,168,196,"46",150,0.4386,0.2738,0.3843
"4615",161235,2004,"166",85,81,17,"2",15,0.1765,0.0247,0.1024
"4616",161244,2004,"80",54,26,14,"3",11,0.2037,0.1154,0.175
"4617",161253,2004,"1607",777,830,550,"236",314,0.4041,0.2843,0.3423
"4618",161554,2004,"871",524,347,146,"39",107,0.2042,0.1124,0.1676
"4619",162007,2004,"627",408,219,94,"16",78,0.1912,0.0731,0.1499
"4620",162210,2004,"208",130,78,26,"4",22,0.1692,0.0513,0.125
"4621",162283,2004,"588",446,142,27,"5",22,0.0493,0.0352,0.0459
"4622",162584,2004,"955",427,528,207,"78",129,0.3021,0.1477,0.2168
"4623",162654,2004,"401",270,131,241,"62",179,0.663,0.4733,0.601
"4624",162760,2004,"242",189,53,160,"31",129,0.6825,0.5849,0.6612
"4625",162928,2004,"1127",525,602,928,"480",448,0.8533,0.7973,0.8234
"4626",163046,2004,"951",579,372,726,"277",449,0.7755,0.7446,0.7634
"4627",163268,2004,"1403",560,843,472,"249",223,0.3982,0.2954,0.3364
"4628",163286,2004,"4174",2055,2119,2607,"1173",1434,0.6978,0.5536,0.6246
"4629",163453,2004,"1336",750,586,153,"32",121,0.1613,0.0546,0.1145
"4630",163462,2004,"391",243,148,270,"99",171,0.7037,0.6689,0.6905
"4631",163851,2004,"981",536,445,457,"148",309,0.5765,0.3326,0.4659
"4632",163912,2004,"431",233,198,303,"122",181,0.7768,0.6162,0.703
"4633",164076,2004,"2082",1376,706,835,"229",606,0.4404,0.3244,0.4011
"4634",164173,2004,"561",378,183,252,"81",171,0.4524,0.4426,0.4492
"4635",164216,2004,"304",185,119,205,"71",134,0.7243,0.5966,0.6743
"4636",164270,2004,"357",196,161,237,"100",137,0.699,0.6211,0.6639
"4637",164447,2004,"321",167,154,83,"35",48,0.2874,0.2273,0.2586
"4638",164492,2004,"189",107,82,69,"32",37,0.3458,0.3902,0.3651
"4639",164562,2004,"633",364,269,447,"170",277,0.761,0.632,0.7062
"4640",165015,2004,"761",417,344,655,"287",368,0.8825,0.8343,0.8607
"4641",165024,2004,"1266",713,553,306,"99",207,0.2903,0.179,0.2417
"4642",165334,2004,"523",328,195,383,"137",246,0.75,0.7026,0.7323
"4643",165662,2004,"700",402,298,533,"242",291,0.7239,0.8121,0.7614
"4644",165671,2004,"455",332,123,237,"58",179,0.5392,0.4715,0.5209
"4645",165820,2004,"713",386,327,153,"52",101,0.2617,0.159,0.2146
"4646",165866,2004,"642",434,208,187,"49",138,0.318,0.2356,0.2913
"4647",165936,2004,"401",264,137,235,"75",160,0.6061,0.5474,0.586
"4648",166027,2004,"1638",823,815,1427,"688",739,0.8979,0.8442,0.8712
"4649",166124,2004,"703",389,314,635,"274",361,0.928,0.8726,0.9033
"4650",166513,2004,"996",333,663,286,"134",152,0.4565,0.2021,0.2871
"4651",166629,2004,"4311",2126,2185,2196,"968",1228,0.5776,0.443,0.5094
"4652",166638,2004,"543",323,220,61,"12",49,0.1517,0.0545,0.1123
"4653",166683,2004,"1076",457,619,909,"507",402,0.8796,0.8191,0.8448
"4654",167288,2004,"263",161,102,99,"28",71,0.441,0.2745,0.3764
"4655",167987,2004,"1456",715,741,416,"147",269,0.3762,0.1984,0.2857
"4656",167996,2004,"614",384,230,494,"171",323,0.8411,0.7435,0.8046
"4657",168005,2004,"1014",589,425,350,"123",227,0.3854,0.2894,0.3452
"4658",168148,2004,"1273",635,638,1101,"537",564,0.8882,0.8417,0.8649
"4659",168254,2004,"798",302,496,353,"197",156,0.5166,0.3972,0.4424
"4660",168281,2004,"443",280,163,310,"114",196,0.7,0.6994,0.6998
"4661",168342,2004,"532",272,260,484,"234",250,0.9191,0.9,0.9098
"4662",168546,2004,"559",310,249,358,"149",209,0.6742,0.5984,0.6404
"4663",168786,2004,"316",199,117,119,"45",74,0.3719,0.3846,0.3766
"4664",169080,2004,"899",467,432,524,"245",279,0.5974,0.5671,0.5829
"4665",169798,2004,"2281",1329,952,280,"85",195,0.1467,0.0893,0.1228
"4666",169910,2004,"1924",834,1090,127,"60",67,0.0803,0.055,0.066
"4667",170082,2004,"3324",2123,1201,875,"270",605,0.285,0.2248,0.2632
"4668",170301,2004,"780",463,317,531,"194",337,0.7279,0.612,0.6808
"4669",170532,2004,"310",188,122,240,"86",154,0.8191,0.7049,0.7742
"4670",170639,2004,"527",242,285,67,"27",40,0.1653,0.0947,0.1271
"4671",170976,2004,"6016",3033,2983,4334,"1990",2344,0.7728,0.6671,0.7204
"4672",171100,2004,"7426",4073,3353,3531,"1334",2197,0.5394,0.3979,0.4755
"4673",171128,2004,"1219",243,976,327,"221",106,0.4362,0.2264,0.2683
"4674",171137,2004,"656",311,345,106,"45",61,0.1961,0.1304,0.1616
"4675",171146,2004,"474",293,181,53,"17",36,0.1229,0.0939,0.1118
"4676",171599,2004,"198",72,126,51,"26",25,0.3472,0.2063,0.2576
"4677",172051,2004,"1209",720,489,129,"32",97,0.1347,0.0654,0.1067
"4678",172699,2004,"3725",1872,1853,802,"301",501,0.2676,0.1624,0.2153
"4679",173160,2004,"669",386,283,385,"160",225,0.5829,0.5654,0.5755
"4680",173258,2004,"487",263,224,432,"195",237,0.9011,0.8705,0.8871
"4681",173328,2004,"176",102,74,64,"24",40,0.3922,0.3243,0.3636
"4682",173647,2004,"651",361,290,468,"221",247,0.6842,0.7621,0.7189
"4683",173902,2004,"485",284,201,410,"164",246,0.8662,0.8159,0.8454
"4684",174066,2004,"5562",3081,2481,2549,"994",1555,0.5047,0.4006,0.4583
"4685",174233,2004,"2205",1153,1052,568,"208",360,0.3122,0.1977,0.2576
"4686",174251,2004,"383",235,148,205,"73",132,0.5617,0.4932,0.5352
"4687",174491,2004,"409",245,164,194,"67",127,0.5184,0.4085,0.4743
"4688",174792,2004,"512",0,512,338,"338",0,NA,0.6602,0.6602
"4689",174844,2004,"777",446,331,631,"258",373,0.8363,0.7795,0.8121
"4690",174899,2004,"437",300,137,227,"66",161,0.5367,0.4818,0.5195
"4691",174914,2004,"1161",608,553,710,"312",398,0.6546,0.5642,0.6115
"4692",175342,2004,"572",309,263,116,"33",83,0.2686,0.1255,0.2028
"4693",175421,2004,"237",144,93,94,"28",66,0.4583,0.3011,0.3966
"4694",175616,2004,"381",211,170,76,"24",52,0.2464,0.1412,0.1995
"4695",175856,2004,"995",587,408,200,"50",150,0.2555,0.1225,0.201
"4696",175980,2004,"278",136,142,170,"83",87,0.6397,0.5845,0.6115
"4697",176017,2004,"2248",1185,1063,761,"292",469,0.3958,0.2747,0.3385
"4698",176035,2004,"242",207,35,55,"1",54,0.2609,0.0286,0.2273
"4699",176044,2004,"372",184,188,51,"15",36,0.1957,0.0798,0.1371
"4700",176080,2004,"1735",829,906,492,"193",299,0.3607,0.213,0.2836
"4701",176406,2004,"278",190,88,68,"16",52,0.2737,0.1818,0.2446
"4702",176628,2004,"129",88,41,39,"3",36,0.4091,0.0732,0.3023
"4703",176947,2004,"193",86,107,64,"21",43,0.5,0.1963,0.3316
"4704",176965,2004,"1434",798,636,369,"120",249,0.312,0.1887,0.2573
"4705",177418,2004,"190",132,58,52,"16",36,0.2727,0.2759,0.2737
"4706",178059,2004,"313",248,65,160,"29",131,0.5282,0.4462,0.5112
"4707",178341,2004,"695",368,327,97,"33",64,0.1739,0.1009,0.1396
"4708",178387,2004,"1021",573,448,109,"26",83,0.1449,0.058,0.1068
"4709",178396,2004,"4625",2442,2183,1993,"765",1228,0.5029,0.3504,0.4309
"4710",178402,2004,"904",540,364,160,"50",110,0.2037,0.1374,0.177
"4711",178411,2004,"836",169,667,211,"162",49,0.2899,0.2429,0.2524
"4712",178420,2004,"398",235,163,82,"25",57,0.2426,0.1534,0.206
"4713",178615,2004,"1477",872,605,631,"228",403,0.4622,0.3769,0.4272
"4714",179043,2004,"305",176,129,184,"76",108,0.6136,0.5891,0.6033
"4715",179159,2004,"1456",864,592,892,"336",556,0.6435,0.5676,0.6126
"4716",179557,2004,"1386",823,563,334,"98",236,0.2868,0.1741,0.241
"4717",179566,2004,"2663",1572,1091,755,"234",521,0.3314,0.2145,0.2835
"4718",179867,2004,"1436",725,711,1233,"592",641,0.8841,0.8326,0.8586
"4719",179894,2004,"448",256,192,229,"89",140,0.5469,0.4635,0.5112
"4720",179946,2004,"231",108,123,105,"54",51,0.4722,0.439,0.4545
"4721",180179,2004,"502",338,164,64,"18",46,0.1361,0.1098,0.1275
"4722",180461,2004,"1998",836,1162,341,"159",182,0.2177,0.1368,0.1707
"4723",180522,2004,"175",57,118,19,"12",7,0.1228,0.1017,0.1086
"4724",180984,2004,"278",146,132,103,"28",75,0.5137,0.2121,0.3705
"4725",181002,2004,"968",584,384,633,"246",387,0.6627,0.6406,0.6539
"4726",181020,2004,"303",172,131,162,"67",95,0.5523,0.5115,0.5347
"4727",181127,2004,"289",140,149,152,"60",92,0.6571,0.4027,0.526
"4728",181215,2004,"1061",589,472,238,"85",153,0.2598,0.1801,0.2243
"4729",181394,2004,"1577",878,699,201,"78",123,0.1401,0.1116,0.1275
"4730",181446,2004,"428",238,190,223,"101",122,0.5126,0.5316,0.521
"4731",181464,2004,"3236",1559,1677,950,"394",556,0.3566,0.2349,0.2936
"4732",181534,2004,"217",114,103,21,"5",16,0.1404,0.0485,0.0968
"4733",181783,2004,"552",310,242,128,"39",89,0.2871,0.1612,0.2319
"4734",182281,2004,"3108",1760,1348,428,"134",294,0.167,0.0994,0.1377
"4735",182290,2004,"2132",1157,975,289,"104",185,0.1599,0.1067,0.1356
"4736",182634,2004,"263",179,84,140,"42",98,0.5475,0.5,0.5323
"4737",182795,2004,"568",285,283,232,"97",135,0.4737,0.3428,0.4085
"4738",183062,2004,"1068",649,419,425,"148",277,0.4268,0.3532,0.3979
"4739",183080,2004,"1052",524,528,356,"156",200,0.3817,0.2955,0.3384
"4740",183239,2004,"516",284,232,370,"149",221,0.7782,0.6422,0.7171
"4741",183822,2004,"361",233,128,32,"14",18,0.0773,0.1094,0.0886
"4742",183974,2004,"258",169,89,123,"38",85,0.503,0.427,0.4767
"4743",184348,2004,"418",243,175,264,"98",166,0.6831,0.56,0.6316
"4744",184603,2004,"504",282,222,150,"61",89,0.3156,0.2748,0.2976
"4745",184612,2004,"232",170,62,38,"13",25,0.1471,0.2097,0.1638
"4746",184782,2004,"1247",622,625,546,"255",291,0.4678,0.408,0.4379
"4747",185129,2004,"512",300,212,40,"12",28,0.0933,0.0566,0.0781
"4748",185572,2004,"946",514,432,341,"120",221,0.43,0.2778,0.3605
"4749",185590,2004,"1737",1015,722,534,"164",370,0.3645,0.2271,0.3074
"4750",185828,2004,"663",130,533,108,"74",34,0.2615,0.1388,0.1629
"4751",186131,2004,"1170",548,622,1054,"549",505,0.9215,0.8826,0.9009
"4752",186201,2004,"746",451,295,486,"165",321,0.7118,0.5593,0.6515
"4753",186283,2004,"890",514,376,456,"190",266,0.5175,0.5053,0.5124
"4754",186584,2004,"1234",672,562,626,"269",357,0.5312,0.4786,0.5073
"4755",186876,2004,"819",435,384,331,"127",204,0.469,0.3307,0.4042
"4756",187134,2004,"1230",681,549,876,"357",519,0.7621,0.6503,0.7122
"4757",187444,2004,"1430",801,629,245,"85",160,0.1998,0.1351,0.1713
"4758",187985,2004,"3018",1720,1298,370,"98",272,0.1581,0.0755,0.1226
"4759",188030,2004,"2061",1125,936,260,"92",168,0.1493,0.0983,0.1262
"4760",188429,2004,"801",549,252,463,"119",344,0.6266,0.4722,0.578
"4761",188641,2004,"505",226,279,218,"99",119,0.5265,0.3548,0.4317
"4762",190044,2004,"658",142,516,364,"275",89,0.6268,0.5329,0.5532
"4763",190099,2004,"738",396,342,616,"277",339,0.8561,0.8099,0.8347
"4764",190150,2004,"1366",632,734,1133,"604",529,0.837,0.8229,0.8294
"4765",190248,2004,"143",61,82,38,"13",25,0.4098,0.1585,0.2657
"4766",190415,2004,"3051",1494,1557,2621,"1289",1332,0.8916,0.8279,0.8591
"4767",190512,2004,"1693",865,828,569,"233",336,0.3884,0.2814,0.3361
"4768",190549,2004,"1170",653,517,268,"90",178,0.2726,0.1741,0.2291
"4769",190558,2004,"2020",1147,873,67,"12",55,0.048,0.0137,0.0332
"4770",190567,2004,"1168",531,637,106,"45",61,0.1149,0.0706,0.0908
"4771",190594,2004,"1824",1235,589,312,"81",231,0.187,0.1375,0.1711
"4772",190637,2004,"852",571,281,100,"27",73,0.1278,0.0961,0.1174
"4773",190664,2004,"1352",815,537,352,"102",250,0.3067,0.1899,0.2604
"4774",190691,2004,"727",453,274,27,"8",19,0.0419,0.0292,0.0371
"4775",190725,2004,"264",198,66,62,"11",51,0.2576,0.1667,0.2348
"4776",191241,2004,"1674",997,677,1269,"486",783,0.7854,0.7179,0.7581
"4777",191515,2004,"457",236,221,385,"180",205,0.8686,0.8145,0.8425
"4778",191533,2004,"409",219,190,189,"80",109,0.4977,0.4211,0.4621
"4779",191630,2004,"482",255,227,337,"142",195,0.7647,0.6256,0.6992
"4780",191649,2004,"1713",885,828,750,"303",447,0.5051,0.3659,0.4378
"4781",191676,2004,"320",212,108,186,"56",130,0.6132,0.5185,0.5812
"4782",191931,2004,"854",458,396,448,"175",273,0.5961,0.4419,0.5246
"4783",191968,2004,"1458",831,627,1013,"411",602,0.7244,0.6555,0.6948
"4784",192192,2004,"245",170,75,120,"29",91,0.5353,0.3867,0.4898
"4785",192323,2004,"473",277,196,305,"115",190,0.6859,0.5867,0.6448
"4786",192439,2004,"912",629,283,39,"12",27,0.0429,0.0424,0.0428
"4787",192703,2004,"657",343,314,420,"182",238,0.6939,0.5796,0.6393
"4788",192749,2004,"450",312,138,261,"78",183,0.5865,0.5652,0.58
"4789",192819,2004,"955",536,419,699,"282",417,0.778,0.673,0.7319
"4790",192925,2004,"296",179,117,85,"36",49,0.2737,0.3077,0.2872
"4791",193016,2004,"649",421,228,79,"18",61,0.1449,0.0789,0.1217
"4792",193292,2004,"311",231,80,105,"17",88,0.381,0.2125,0.3376
"4793",193353,2004,"419",314,105,180,"45",135,0.4299,0.4286,0.4296
"4794",193399,2004,"355",229,126,166,"53",113,0.4934,0.4206,0.4676
"4795",193584,2004,"449",335,114,285,"60",225,0.6716,0.5263,0.6347
"4796",193645,2004,"952",815,137,152,"11",141,0.173,0.0803,0.1597
"4797",193654,2004,"815",612,203,371,"86",285,0.4657,0.4236,0.4552
"4798",193900,2004,"4568",2792,1776,2860,"1121",1739,0.6229,0.6312,0.6261
"4799",193973,2004,"725",467,258,443,"141",302,0.6467,0.5465,0.611
"4800",194161,2004,"260",162,98,78,"29",49,0.3025,0.2959,0.3
"4801",194310,2004,"1437",900,537,577,"194",383,0.4256,0.3613,0.4015
"4802",194824,2004,"1079",259,820,696,"521",175,0.6757,0.6354,0.645
"4803",195003,2004,"2233",562,1671,577,"316",261,0.4644,0.1891,0.2584
"4804",195030,2004,"1083",496,587,808,"409",399,0.8044,0.6968,0.7461
"4805",195164,2004,"574",304,270,305,"134",171,0.5625,0.4963,0.5314
"4806",195173,2004,"473",228,245,148,"67",81,0.3553,0.2735,0.3129
"4807",195216,2004,"566",298,268,444,"203",241,0.8087,0.7575,0.7845
"4808",195234,2004,"563",408,155,387,"91",296,0.7255,0.5871,0.6874
"4809",195243,2004,"349",168,181,112,"56",56,0.3333,0.3094,0.3209
"4810",195304,2004,"329",253,76,233,"50",183,0.7233,0.6579,0.7082
"4811",195474,2004,"715",412,303,532,"212",320,0.7767,0.6997,0.7441
"4812",195526,2004,"676",383,293,539,"229",310,0.8094,0.7816,0.7973
"4813",195544,2004,"593",420,173,311,"68",243,0.5786,0.3931,0.5245
"4814",195809,2004,"2996",1696,1300,1035,"384",651,0.3838,0.2954,0.3455
"4815",196413,2004,"2662",1505,1157,1907,"766",1141,0.7581,0.6621,0.7164
"4816",196592,2004,"1863",1278,585,246,"86",160,0.1252,0.147,0.132
"4817",197045,2004,"484",248,236,143,"68",75,0.3024,0.2881,0.2955
"4818",197133,2004,"654",419,235,586,"198",388,0.926,0.8426,0.896
"4819",197869,2004,"2507",1247,1260,941,"357",584,0.4683,0.2833,0.3753
"4820",197984,2004,"174",96,78,47,"20",27,0.2812,0.2564,0.2701
"4821",198385,2004,"462",238,224,410,"192",218,0.916,0.8571,0.8874
"4822",198464,2004,"3451",2143,1308,1009,"294",715,0.3336,0.2248,0.2924
"4823",198507,2004,"554",295,259,107,"30",77,0.261,0.1158,0.1931
"4824",198516,2004,"1230",775,455,918,"319",599,0.7729,0.7011,0.7463
"4825",198835,2004,"322",196,126,123,"35",88,0.449,0.2778,0.382
"4826",198969,2004,"435",143,292,71,"25",46,0.3217,0.0856,0.1632
"4827",199102,2004,"2212",1147,1065,335,"86",249,0.2171,0.0808,0.1514
"4828",199111,2004,"694",418,276,208,"59",149,0.3565,0.2138,0.2997
"4829",199120,2004,"3584",2099,1485,2685,"1027",1658,0.7899,0.6916,0.7492
"4830",199139,2004,"2599",1416,1183,707,"249",458,0.3234,0.2105,0.272
"4831",199148,2004,"2159",1525,634,625,"124",501,0.3285,0.1956,0.2895
"4832",199157,2004,"1138",732,406,205,"51",154,0.2104,0.1256,0.1801
"4833",199193,2004,"3935",1702,2233,1585,"682",903,0.5306,0.3054,0.4028
"4834",199218,2004,"1891",1154,737,841,"272",569,0.4931,0.3691,0.4447
"4835",199281,2004,"741",393,348,113,"44",69,0.1756,0.1264,0.1525
"4836",199306,2004,"191",88,103,54,"17",37,0.4205,0.165,0.2827
"4837",199412,2004,"223",154,69,98,"28",70,0.4545,0.4058,0.4395
"4838",199582,2004,"324",140,184,45,"15",30,0.2143,0.0815,0.1389
"4839",199643,2004,"417",227,190,61,"16",45,0.1982,0.0842,0.1463
"4840",199847,2004,"1109",552,557,921,"438",483,0.875,0.7864,0.8305
"4841",199962,2004,"358",174,184,155,"66",89,0.5115,0.3587,0.433
"4842",199999,2004,"891",619,272,117,"35",82,0.1325,0.1287,0.1313
"4843",200004,2004,"1571",805,766,447,"154",293,0.364,0.201,0.2845
"4844",200059,2004,"332",170,162,37,"15",22,0.1294,0.0926,0.1114
"4845",200156,2004,"229",135,94,63,"33",30,0.2222,0.3511,0.2751
"4846",200217,2004,"430",251,179,156,"46",110,0.4382,0.257,0.3628
"4847",200226,2004,"162",72,90,25,"5",20,0.2778,0.0556,0.1543
"4848",200253,2004,"431",254,177,72,"20",52,0.2047,0.113,0.1671
"4849",200280,2004,"2178",1016,1162,459,"216",243,0.2392,0.1859,0.2107
"4850",200332,2004,"2089",949,1140,481,"220",261,0.275,0.193,0.2303
"4851",200572,2004,"167",71,96,39,"16",23,0.3239,0.1667,0.2335
"4852",201104,2004,"571",340,231,245,"70",175,0.5147,0.303,0.4291
"4853",201371,2004,"266",130,136,136,"61",75,0.5769,0.4485,0.5113
"4854",201548,2004,"517",298,219,253,"96",157,0.5268,0.4384,0.4894
"4855",201645,2004,"782",306,476,508,"282",226,0.7386,0.5924,0.6496
"4856",201690,2004,"583",270,313,46,"11",35,0.1296,0.0351,0.0789
"4857",202134,2004,"922",463,459,79,"31",48,0.1037,0.0675,0.0857
"4858",202480,2004,"1805",905,900,1048,"437",611,0.6751,0.4856,0.5806
"4859",202523,2004,"616",362,254,501,"200",301,0.8315,0.7874,0.8133
"4860",202763,2004,"580",387,193,248,"60",188,0.4858,0.3109,0.4276
"4861",203085,2004,"354",159,195,132,"47",85,0.5346,0.241,0.3729
"4862",203128,2004,"220",106,114,137,"62",75,0.7075,0.5439,0.6227
"4863",203368,2004,"734",383,351,466,"207",259,0.6762,0.5897,0.6349
"4864",203517,2004,"3841",2428,1413,969,"271",698,0.2875,0.1918,0.2523
"4865",203535,2004,"467",237,230,396,"189",207,0.8734,0.8217,0.848
"4866",203580,2004,"141",104,37,48,"10",38,0.3654,0.2703,0.3404
"4867",203775,2004,"400",239,161,181,"53",128,0.5356,0.3292,0.4525
"4868",203845,2004,"439",215,224,200,"78",122,0.5674,0.3482,0.4556
"4869",204024,2004,"3475",1950,1525,2354,"961",1393,0.7144,0.6302,0.6774
"4870",204185,2004,"547",256,291,292,"128",164,0.6406,0.4399,0.5338
"4871",204194,2004,"303",184,119,130,"44",86,0.4674,0.3697,0.429
"4872",204617,2004,"415",202,213,143,"57",86,0.4257,0.2676,0.3446
"4873",204796,2004,"6031",2891,3140,2930,"1241",1689,0.5842,0.3952,0.4858
"4874",204857,2004,"3734",2050,1684,1703,"616",1087,0.5302,0.3658,0.4561
"4875",206330,2004,"177",70,107,38,"18",20,0.2857,0.1682,0.2147
"4876",206589,2004,"478",239,239,334,"147",187,0.7824,0.6151,0.6987
"4877",206604,2004,"2289",1302,987,418,"156",262,0.2012,0.1581,0.1826
"4878",206622,2004,"878",470,408,611,"268",343,0.7298,0.6569,0.6959
"4879",206695,2004,"2025",1081,944,247,"91",156,0.1443,0.0964,0.122
"4880",206914,2004,"762",409,353,31,"10",21,0.0513,0.0283,0.0407
"4881",207209,2004,"530",245,285,16,"6",10,0.0408,0.0211,0.0302
"4882",207306,2004,"292",156,136,40,"12",28,0.1795,0.0882,0.137
"4883",207324,2004,"545",291,254,117,"50",67,0.2302,0.1969,0.2147
"4884",207388,2004,"3126",1601,1525,991,"360",631,0.3941,0.2361,0.317
"4885",207500,2004,"3537",1876,1661,1122,"397",725,0.3865,0.239,0.3172
"4886",207722,2004,"244",148,96,45,"13",32,0.2162,0.1354,0.1844
"4887",207847,2004,"609",310,299,59,"29",30,0.0968,0.097,0.0969
"4888",207865,2004,"941",493,448,130,"41",89,0.1805,0.0915,0.1382
"4889",208822,2004,"397",259,138,235,"79",156,0.6023,0.5725,0.5919
"4890",209056,2004,"537",329,208,366,"143",223,0.6778,0.6875,0.6816
"4891",209065,2004,"432",222,210,249,"106",143,0.6441,0.5048,0.5764
"4892",209542,2004,"2803",1367,1436,860,"320",540,0.395,0.2228,0.3068
"4893",209551,2004,"3138",1734,1404,1377,"539",838,0.4833,0.3839,0.4388
"4894",209612,2004,"294",181,113,164,"62",102,0.5635,0.5487,0.5578
"4895",209807,2004,"1173",627,546,167,"51",116,0.185,0.0934,0.1424
"4896",209922,2004,"333",186,147,199,"78",121,0.6505,0.5306,0.5976
"4897",210146,2004,"744",409,335,100,"30",70,0.1711,0.0896,0.1344
"4898",210401,2004,"510",284,226,361,"155",206,0.7254,0.6858,0.7078
"4899",210429,2004,"795",447,348,138,"55",83,0.1857,0.158,0.1736
"4900",210571,2004,"505",319,186,268,"86",182,0.5705,0.4624,0.5307
"4901",210669,2004,"647",341,306,465,"206",259,0.7595,0.6732,0.7187
"4902",210775,2004,"310",197,113,123,"29",94,0.4772,0.2566,0.3968
"4903",211088,2004,"476",343,133,247,"67",180,0.5248,0.5038,0.5189
"4904",211158,2004,"1533",947,586,631,"198",433,0.4572,0.3379,0.4116
"4905",211291,2004,"906",447,459,813,"397",416,0.9306,0.8649,0.8974
"4906",211352,2004,"390",257,133,155,"45",110,0.428,0.3383,0.3974
"4907",211361,2004,"1038",519,519,293,"127",166,0.3198,0.2447,0.2823
"4908",211431,2004,"231",226,5,87,"1",86,0.3805,0.2,0.3766
"4909",211440,2004,"1359",510,849,940,"579",361,0.7078,0.682,0.6917
"4910",211468,2004,"237",237,0,114,"0",114,0.481,NA,0.481
"4911",211556,2004,"90",90,0,50,"0",50,0.5556,NA,0.5556
"4912",211583,2004,"197",115,82,62,"24",38,0.3304,0.2927,0.3147
"4913",211608,2004,"422",225,197,56,"20",36,0.16,0.1015,0.1327
"4914",211644,2004,"1203",683,520,296,"103",193,0.2826,0.1981,0.2461
"4915",211981,2004,"450",257,193,186,"48",138,0.537,0.2487,0.4133
"4916",212009,2004,"605",329,276,472,"197",275,0.8359,0.7138,0.7802
"4917",212054,2004,"2069",732,1337,477,"193",284,0.388,0.1444,0.2305
"4918",212106,2004,"1208",700,508,656,"251",405,0.5786,0.4941,0.543
"4919",212115,2004,"1165",709,456,420,"122",298,0.4203,0.2675,0.3605
"4920",212133,2004,"450",294,156,243,"82",161,0.5476,0.5256,0.54
"4921",212160,2004,"1232",712,520,272,"81",191,0.2683,0.1558,0.2208
"4922",212197,2004,"535",344,191,385,"125",260,0.7558,0.6545,0.7196
"4923",212577,2004,"529",241,288,424,"219",205,0.8506,0.7604,0.8015
"4924",212601,2004,"522",317,205,248,"84",164,0.5174,0.4098,0.4751
"4925",212832,2004,"280",218,62,87,"23",64,0.2936,0.371,0.3107
"4926",212911,2004,"330",179,151,291,"130",161,0.8994,0.8609,0.8818
"4927",213020,2004,"2645",1567,1078,768,"234",534,0.3408,0.2171,0.2904
"4928",213251,2004,"390",213,177,273,"129",144,0.6761,0.7288,0.7
"4929",213321,2004,"449",178,271,268,"139",129,0.7247,0.5129,0.5969
"4930",213349,2004,"2049",1217,832,680,"191",489,0.4018,0.2296,0.3319
"4931",213358,2004,"214",141,73,46,"10",36,0.2553,0.137,0.215
"4932",213367,2004,"829",419,410,441,"195",246,0.5871,0.4756,0.532
"4933",213385,2004,"609",315,294,529,"249",280,0.8889,0.8469,0.8686
"4934",213507,2004,"416",221,195,287,"121",166,0.7511,0.6205,0.6899
"4935",213543,2004,"1054",463,591,814,"417",397,0.8575,0.7056,0.7723
"4936",213613,2004,"1191",702,489,348,"129",219,0.312,0.2638,0.2922
"4937",213668,2004,"399",217,182,249,"109",140,0.6452,0.5989,0.6241
"4938",213783,2004,"689",402,287,168,"54",114,0.2836,0.1882,0.2438
"4939",213826,2004,"332",262,70,149,"24",125,0.4771,0.3429,0.4488
"4940",213996,2004,"690",453,237,484,"159",325,0.7174,0.6709,0.7014
"4941",214041,2004,"1396",791,605,512,"177",335,0.4235,0.2926,0.3668
"4942",214069,2004,"317",225,92,171,"41",130,0.5778,0.4457,0.5394
"4943",214157,2004,"382",215,167,261,"103",158,0.7349,0.6168,0.6832
"4944",214175,2004,"559",337,222,456,"178",278,0.8249,0.8018,0.8157
"4945",214272,2004,"462",304,158,135,"41",94,0.3092,0.2595,0.2922
"4946",214777,2004,"5905",2884,3021,3681,"1674",2007,0.6959,0.5541,0.6234
"4947",215062,2004,"2359",1191,1168,2090,"999",1091,0.916,0.8553,0.886
"4948",215743,2004,"321",198,123,175,"48",127,0.6414,0.3902,0.5452
"4949",215798,2004,"331",186,145,226,"93",133,0.7151,0.6414,0.6828
"4950",215929,2004,"965",559,406,658,"248",410,0.7335,0.6108,0.6819
"4951",216010,2004,"1458",748,710,629,"251",378,0.5053,0.3535,0.4314
"4952",216038,2004,"1530",890,640,551,"196",355,0.3989,0.3062,0.3601
"4953",216287,2004,"365",189,176,324,"153",171,0.9048,0.8693,0.8877
"4954",216339,2004,"3788",2184,1604,1216,"468",748,0.3425,0.2918,0.321
"4955",216524,2004,"393",200,193,303,"142",161,0.805,0.7358,0.771
"4956",216694,2004,"367",189,178,175,"70",105,0.5556,0.3933,0.4768
"4957",216764,2004,"1870",1214,656,734,"177",557,0.4588,0.2698,0.3925
"4958",216807,2004,"378",235,143,225,"72",153,0.6511,0.5035,0.5952
"4959",216852,2004,"736",342,394,247,"97",150,0.4386,0.2462,0.3356
"4960",216931,2004,"550",296,254,287,"128",159,0.5372,0.5039,0.5218
"4961",217059,2004,"1037",612,425,423,"151",272,0.4444,0.3553,0.4079
"4962",217156,2004,"1429",744,685,1224,"580",644,0.8656,0.8467,0.8565
"4963",217402,2004,"1036",549,487,859,"406",453,0.8251,0.8337,0.8292
"4964",217536,2004,"558",397,161,358,"99",259,0.6524,0.6149,0.6416
"4965",217776,2004,"161",98,63,40,"15",25,0.2551,0.2381,0.2484
"4966",217819,2004,"1940",1323,617,1039,"268",771,0.5828,0.4344,0.5356
"4967",217882,2004,"2994",1369,1625,1488,"597",891,0.6508,0.3674,0.497
"4968",217998,2004,"179",106,73,97,"39",58,0.5472,0.5342,0.5419
"4969",218061,2004,"745",463,282,139,"34",105,0.2268,0.1206,0.1866
"4970",218229,2004,"647",440,207,140,"32",108,0.2455,0.1546,0.2164
"4971",218238,2004,"203",95,108,41,"15",26,0.2737,0.1389,0.202
"4972",218399,2004,"232",141,91,19,"3",16,0.1135,0.033,0.0819
"4973",218414,2004,"231",90,141,73,"28",45,0.5,0.1986,0.316
"4974",218663,2004,"3330",1841,1489,1524,"593",931,0.5057,0.3983,0.4577
"4975",218724,2004,"1320",669,651,288,"104",184,0.275,0.1598,0.2182
"4976",218733,2004,"945",523,422,164,"41",123,0.2352,0.0972,0.1735
"4977",218742,2004,"643",398,245,145,"51",94,0.2362,0.2082,0.2255
"4978",218973,2004,"323",144,179,253,"129",124,0.8611,0.7207,0.7833
"4979",219000,2004,"392",231,161,197,"70",127,0.5498,0.4348,0.5026
"4980",219046,2004,"581",350,231,46,"11",35,0.1,0.0476,0.0792
"4981",219082,2004,"249",114,135,44,"18",26,0.2281,0.1333,0.1767
"4982",219198,2004,"150",111,39,51,"13",38,0.3423,0.3333,0.34
"4983",219259,2004,"384",238,146,53,"12",41,0.1723,0.0822,0.138
"4984",219356,2004,"1993",1011,982,485,"194",291,0.2878,0.1976,0.2434
"4985",219471,2004,"945",538,407,220,"80",140,0.2602,0.1966,0.2328
"4986",219602,2004,"1196",714,482,173,"64",109,0.1527,0.1328,0.1446
"4987",219709,2004,"727",442,285,429,"168",261,0.5905,0.5895,0.5901
"4988",219718,2004,"252",97,155,40,"15",25,0.2577,0.0968,0.1587
"4989",219949,2004,"203",104,99,37,"15",22,0.2115,0.1515,0.1823
"4990",220075,2004,"1479",846,633,259,"76",183,0.2163,0.1201,0.1751
"4991",220215,2004,"371",205,166,145,"54",91,0.4439,0.3253,0.3908
"4992",220613,2004,"723",430,293,223,"67",156,0.3628,0.2287,0.3084
"4993",220631,2004,"201",138,63,50,"18",32,0.2319,0.2857,0.2488
"4994",220710,2004,"317",169,148,155,"56",99,0.5858,0.3784,0.489
"4995",221351,2004,"474",269,205,360,"144",216,0.803,0.7024,0.7595
"4996",221519,2004,"397",207,190,309,"142",167,0.8068,0.7474,0.7783
"4997",221731,2004,"163",102,61,49,"11",38,0.3725,0.1803,0.3006
"4998",221847,2004,"1476",611,865,312,"122",190,0.311,0.141,0.2114
"4999",221892,2004,"237",119,118,84,"38",46,0.3866,0.322,0.3544
"5000",222178,2004,"1018",553,465,377,"127",250,0.4521,0.2731,0.3703
"5001",222983,2004,"370",193,177,274,"121",153,0.7927,0.6836,0.7405
"5002",223232,2004,"2772",1674,1098,1398,"488",910,0.5436,0.4444,0.5043
"5003",224004,2004,"149",84,65,21,"10",11,0.131,0.1538,0.1409
"5004",224323,2004,"243",126,117,153,"65",88,0.6984,0.5556,0.6296
"5005",225432,2004,"964",541,423,10,"5",5,0.0092,0.0118,0.0104
"5006",225548,2004,"285",126,159,62,"29",33,0.2619,0.1824,0.2175
"5007",225627,2004,"474",331,143,61,"12",49,0.148,0.0839,0.1287
"5008",226231,2004,"327",92,235,98,"58",40,0.4348,0.2468,0.2997
"5009",226833,2004,"611",301,310,35,"13",22,0.0731,0.0419,0.0573
"5010",227216,2004,"3216",1872,1344,611,"180",431,0.2302,0.1339,0.19
"5011",227331,2004,"216",171,45,30,"3",27,0.1579,0.0667,0.1389
"5012",227526,2004,"1573",823,750,156,"56",100,0.1215,0.0747,0.0992
"5013",227757,2004,"725",380,345,574,"259",315,0.8289,0.7507,0.7917
"5014",227845,2004,"600",371,229,291,"97",194,0.5229,0.4236,0.485
"5015",227863,2004,"297",189,108,80,"24",56,0.2963,0.2222,0.2694
"5016",228042,2004,"204",122,82,53,"20",33,0.2705,0.2439,0.2598
"5017",228149,2004,"463",277,186,159,"51",108,0.3899,0.2742,0.3434
"5018",228246,2004,"1313",717,596,789,"310",479,0.6681,0.5201,0.6009
"5019",228343,2004,"366",221,145,228,"68",160,0.724,0.469,0.623
"5020",228431,2004,"1736",1091,645,381,"95",286,0.2621,0.1473,0.2195
"5021",228459,2004,"2783",1616,1167,691,"187",504,0.3119,0.1602,0.2483
"5022",228501,2004,"275",113,162,25,"11",14,0.1239,0.0679,0.0909
"5023",228529,2004,"1178",655,523,200,"59",141,0.2153,0.1128,0.1698
"5024",228705,2004,"741",328,413,80,"29",51,0.1555,0.0702,0.108
"5025",228723,2004,"6645",3465,3180,3071,"1049",2022,0.5835,0.3299,0.4622
"5026",228769,2004,"2009",1068,941,325,"115",210,0.1966,0.1222,0.1618
"5027",228778,2004,"6741",3693,3048,3540,"1426",2114,0.5724,0.4678,0.5251
"5028",228787,2004,"1129",429,700,473,"255",218,0.5082,0.3643,0.419
"5029",228796,2004,"2296",1205,1091,174,"58",116,0.0963,0.0532,0.0758
"5030",228875,2004,"1605",988,617,866,"276",590,0.5972,0.4473,0.5396
"5031",228981,2004,"399",202,197,105,"40",65,0.3218,0.203,0.2632
"5032",229018,2004,"258",136,122,39,"16",23,0.1691,0.1311,0.1512
"5033",229027,2004,"4193",2129,2064,315,"103",212,0.0996,0.0499,0.0751
"5034",229115,2004,"3833",1894,1939,1419,"554",865,0.4567,0.2857,0.3702
"5035",229780,2004,"212",109,103,59,"26",33,0.3028,0.2524,0.2783
"5036",229814,2004,"790",424,366,151,"42",109,0.2571,0.1148,0.1911
"5037",230603,2004,"656",445,211,130,"18",112,0.2517,0.0853,0.1982
"5038",230728,2004,"1591",1048,543,433,"70",363,0.3464,0.1289,0.2722
"5039",230764,2004,"1997",1133,864,453,"152",301,0.2657,0.1759,0.2268
"5040",230782,2004,"1559",882,677,94,"28",66,0.0748,0.0414,0.0603
"5041",231059,2004,"518",280,238,378,"165",213,0.7607,0.6933,0.7297
"5042",231174,2004,"1953",1079,874,1188,"476",712,0.6599,0.5446,0.6083
"5043",231420,2004,"191",68,123,53,"25",28,0.4118,0.2033,0.2775
"5044",231554,2004,"135",82,53,38,"14",24,0.2927,0.2642,0.2815
"5045",231624,2004,"1335",683,652,1097,"494",603,0.8829,0.7577,0.8217
"5046",231712,2004,"1174",638,536,498,"151",347,0.5439,0.2817,0.4242
"5047",232025,2004,"260",142,118,125,"48",77,0.5423,0.4068,0.4808
"5048",232043,2004,"207",134,73,91,"33",58,0.4328,0.4521,0.4396
"5049",232089,2004,"287",114,173,53,"21",32,0.2807,0.1214,0.1847
"5050",232186,2004,"2210",1203,1007,869,"311",558,0.4638,0.3088,0.3932
"5051",232265,2004,"1345",863,482,514,"131",383,0.4438,0.2718,0.3822
"5052",232423,2004,"3281",2112,1169,2216,"690",1526,0.7225,0.5902,0.6754
"5053",232557,2004,"2173",1178,995,647,"251",396,0.3362,0.2523,0.2977
"5054",232566,2004,"972",631,341,386,"111",275,0.4358,0.3255,0.3971
"5055",232609,2004,"568",328,240,275,"87",188,0.5732,0.3625,0.4842
"5056",232681,2004,"869",569,300,590,"183",407,0.7153,0.61,0.6789
"5057",232706,2004,"414",310,104,180,"45",135,0.4355,0.4327,0.4348
"5058",232937,2004,"970",580,390,103,"20",83,0.1431,0.0513,0.1062
"5059",232982,2004,"1917",1053,864,474,"136",338,0.321,0.1574,0.2473
"5060",233277,2004,"1828",1135,693,708,"209",499,0.4396,0.3016,0.3873
"5061",233374,2004,"763",391,372,620,"298",322,0.8235,0.8011,0.8126
"5062",233426,2004,"483",288,195,314,"114",200,0.6944,0.5846,0.6501
"5063",233541,2004,"325",160,165,98,"39",59,0.3688,0.2364,0.3015
"5064",233897,2004,"373",180,193,130,"61",69,0.3833,0.3161,0.3485
"5065",233921,2004,"4923",2042,2881,2599,"1252",1347,0.6596,0.4346,0.5279
"5066",234030,2004,"3271",1960,1311,749,"220",529,0.2699,0.1678,0.229
"5067",234085,2004,"363",24,339,216,"205",11,0.4583,0.6047,0.595
"5068",234155,2004,"1025",656,369,250,"54",196,0.2988,0.1463,0.2439
"5069",234164,2004,"431",247,184,78,"17",61,0.247,0.0924,0.181
"5070",235097,2004,"1403",813,590,297,"102",195,0.2399,0.1729,0.2117
"5071",235167,2004,"479",250,229,185,"87",98,0.392,0.3799,0.3862
"5072",236230,2004,"697",462,235,327,"96",231,0.5,0.4085,0.4692
"5073",236328,2004,"671",390,281,471,"190",281,0.7205,0.6762,0.7019
"5074",236577,2004,"633",414,219,341,"115",226,0.5459,0.5251,0.5387
"5075",236595,2004,"719",447,272,407,"138",269,0.6018,0.5074,0.5661
"5076",236896,2004,"352",173,179,83,"33",50,0.289,0.1844,0.2358
"5077",236939,2004,"3089",1622,1467,1251,"495",756,0.4661,0.3374,0.405
"5078",236948,2004,"4867",2639,2228,2625,"1075",1550,0.5873,0.4825,0.5393
"5079",237011,2004,"2425",1405,1020,876,"287",589,0.4192,0.2814,0.3612
"5080",237057,2004,"385",222,163,308,"124",184,0.8288,0.7607,0.8
"5081",237066,2004,"469",266,203,308,"127",181,0.6805,0.6256,0.6567
"5082",237215,2004,"244",138,106,14,"8",6,0.0435,0.0755,0.0574
"5083",237330,2004,"488",262,226,75,"30",45,0.1718,0.1327,0.1537
"5084",237358,2004,"142",77,65,57,"26",31,0.4026,0.4,0.4014
"5085",237367,2004,"602",321,281,90,"27",63,0.1963,0.0961,0.1495
"5086",237792,2004,"774",427,347,119,"44",75,0.1756,0.1268,0.1537
"5087",237899,2004,"331",175,156,18,"8",10,0.0571,0.0513,0.0544
"5088",237932,2004,"459",238,221,92,"35",57,0.2395,0.1584,0.2004
"5089",237969,2004,"348",181,167,148,"59",89,0.4917,0.3533,0.4253
"5090",238032,2004,"4308",2032,2276,1416,"571",845,0.4158,0.2509,0.3287
"5091",238333,2004,"323",176,147,218,"97",121,0.6875,0.6599,0.6749
"5092",238430,2004,"157",120,37,63,"8",55,0.4583,0.2162,0.4013
"5093",238458,2004,"616",405,211,234,"61",173,0.4272,0.2891,0.3799
"5094",238476,2004,"579",344,235,277,"101",176,0.5116,0.4298,0.4784
"5095",238616,2004,"363",198,165,145,"57",88,0.4444,0.3455,0.3994
"5096",238661,2004,"298",214,84,95,"20",75,0.3505,0.2381,0.3188
"5097",239080,2004,"270",191,79,84,"16",68,0.356,0.2025,0.3111
"5098",239105,2004,"1802",979,823,1118,"454",664,0.6782,0.5516,0.6204
"5099",239628,2004,"202",114,88,115,"53",62,0.5439,0.6023,0.5693
"5100",239716,2004,"520",298,222,364,"138",226,0.7584,0.6216,0.7
"5101",240107,2004,"308",210,98,82,"19",63,0.3,0.1939,0.2662
"5102",240189,2004,"1745",836,909,427,"193",234,0.2799,0.2123,0.2447
"5103",240277,2004,"989",636,353,228,"71",157,0.2469,0.2011,0.2305
"5104",240329,2004,"1539",958,581,498,"157",341,0.3559,0.2702,0.3236
"5105",240338,2004,"186",112,74,79,"28",51,0.4554,0.3784,0.4247
"5106",240365,2004,"1708",1033,675,250,"78",172,0.1665,0.1156,0.1464
"5107",240374,2004,"890",491,399,87,"34",53,0.1079,0.0852,0.0978
"5108",240417,2004,"1277",649,628,254,"67",187,0.2881,0.1067,0.1989
"5109",240426,2004,"329",190,139,54,"20",34,0.1789,0.1439,0.1641
"5110",240444,2004,"5617",3124,2493,2792,"1096",1696,0.5429,0.4396,0.4971
"5111",240453,2004,"3714",2000,1714,555,"216",339,0.1695,0.126,0.1494
"5112",240462,2004,"1164",398,766,205,"90",115,0.2889,0.1175,0.1761
"5113",240471,2004,"1197",722,475,311,"109",202,0.2798,0.2295,0.2598
"5114",240480,2004,"1525",857,668,322,"118",204,0.238,0.1766,0.2111
"5115",240727,2004,"1496",754,742,336,"133",203,0.2692,0.1792,0.2246
"5116",243443,2004,"519",340,179,50,"11",39,0.1147,0.0615,0.0963
"5117",243780,2004,"6766",2781,3985,2419,"1066",1353,0.4865,0.2675,0.3575
"5118",100654,2003,"1287",673,614,112,"30",82,0.1218,0.0489,0.087
"5119",100663,2003,"1607",1042,565,266,"61",205,0.1967,0.108,0.1655
"5120",100751,2003,"2982",1685,1297,1121,"364",757,0.4493,0.2806,0.3759
"5121",100858,2003,"3692",1965,1727,1352,"444",908,0.4621,0.2571,0.3662
"5122",101435,2003,"203",76,127,72,"30",42,0.5526,0.2362,0.3547
"5123",101480,2003,"1044",561,483,139,"45",94,0.1676,0.0932,0.1331
"5124",101675,2003,"347",179,168,24,"6",18,0.1006,0.0357,0.0692
"5125",101879,2003,"789",479,310,142,"37",105,0.2192,0.1194,0.18
"5126",102049,2003,"682",426,256,362,"123",239,0.561,0.4805,0.5308
"5127",102094,2003,"1218",704,514,155,"42",113,0.1605,0.0817,0.1273
"5128",102234,2003,"308",193,115,157,"61",96,0.4974,0.5304,0.5097
"5129",102368,2003,"1229",672,557,215,"66",149,0.2217,0.1185,0.1749
"5130",102377,2003,"528",272,256,82,"32",50,0.1838,0.125,0.1553
"5131",104151,2003,"6815",3652,3163,1997,"730",1267,0.3469,0.2308,0.293
"5132",104179,2003,"5780",3154,2626,1870,"708",1162,0.3684,0.2696,0.3235
"5133",105330,2003,"2114",1249,865,644,"196",448,0.3587,0.2266,0.3046
"5134",106245,2003,"691",405,286,29,"9",20,0.0494,0.0315,0.042
"5135",106342,2003,"120",67,53,53,"23",30,0.4478,0.434,0.4417
"5136",106397,2003,"2260",1175,1085,775,"318",457,0.3889,0.2931,0.3429
"5137",106412,2003,"731",333,398,47,"12",35,0.1051,0.0302,0.0643
"5138",106458,2003,"1426",798,628,233,"70",163,0.2043,0.1115,0.1634
"5139",106467,2003,"1445",723,722,248,"96",152,0.2102,0.133,0.1716
"5140",106485,2003,"674",371,303,57,"25",32,0.0863,0.0825,0.0846
"5141",106704,2003,"2414",1450,964,527,"165",362,0.2497,0.1712,0.2183
"5142",107044,2003,"966",543,423,369,"132",237,0.4365,0.3121,0.382
"5143",107080,2003,"267",155,112,157,"63",94,0.6065,0.5625,0.588
"5144",107141,2003,"274",140,134,145,"68",77,0.55,0.5075,0.5292
"5145",107512,2003,"343",195,148,140,"52",88,0.4513,0.3514,0.4082
"5146",107558,2003,"206",113,93,63,"20",43,0.3805,0.2151,0.3058
"5147",110097,2003,"685",459,226,348,"104",244,0.5316,0.4602,0.508
"5148",110404,2003,"190",64,126,138,"90",48,0.75,0.7143,0.7263
"5149",110422,2003,"2798",1239,1559,673,"264",409,0.3301,0.1693,0.2405
"5150",110486,2003,"714",476,238,92,"23",69,0.145,0.0966,0.1289
"5151",110495,2003,"551",365,186,119,"37",82,0.2247,0.1989,0.216
"5152",110510,2003,"1335",918,417,178,"45",133,0.1449,0.1079,0.1333
"5153",110529,2003,"2558",1107,1451,384,"172",212,0.1915,0.1185,0.1501
"5154",110538,2003,"1970",1140,830,322,"71",251,0.2202,0.0855,0.1635
"5155",110547,2003,"639",458,181,31,"5",26,0.0568,0.0276,0.0485
"5156",110556,2003,"2485",1503,982,353,"101",252,0.1677,0.1029,0.1421
"5157",110565,2003,"3098",1873,1225,481,"107",374,0.1997,0.0873,0.1553
"5158",110574,2003,"672",415,257,111,"32",79,0.1904,0.1245,0.1652
"5159",110583,2003,"3339",2236,1103,432,"103",329,0.1471,0.0934,0.1294
"5160",110592,2003,"1305",845,460,115,"32",83,0.0982,0.0696,0.0881
"5161",110617,2003,"2347",1415,932,227,"62",165,0.1166,0.0665,0.0967
"5162",113698,2003,"244",188,56,98,"24",74,0.3936,0.4286,0.4016
"5163",115755,2003,"853",481,372,97,"26",71,0.1476,0.0699,0.1137
"5164",119173,2003,"339",330,9,84,"4",80,0.2424,0.4444,0.2478
"5165",120184,2003,"190",106,84,90,"36",54,0.5094,0.4286,0.4737
"5166",121309,2003,"566",356,210,353,"119",234,0.6573,0.5667,0.6237
"5167",121345,2003,"398",202,196,354,"170",184,0.9109,0.8673,0.8894
"5168",122409,2003,"3418",2106,1312,973,"286",687,0.3262,0.218,0.2847
"5169",122436,2003,"1059",718,341,695,"208",487,0.6783,0.61,0.6563
"5170",122597,2003,"2291",1474,817,267,"69",198,0.1343,0.0845,0.1165
"5171",122612,2003,"914",632,282,452,"131",321,0.5079,0.4645,0.4945
"5172",122931,2003,"892",509,383,690,"284",406,0.7976,0.7415,0.7735
"5173",123554,2003,"562",317,245,285,"106",179,0.5647,0.4327,0.5071
"5174",123572,2003,"1287",838,449,341,"80",261,0.3115,0.1782,0.265
"5175",126562,2003,"624",353,271,104,"36",68,0.1926,0.1328,0.1667
"5176",126580,2003,"892",552,340,193,"43",150,0.2717,0.1265,0.2164
"5177",126614,2003,"5515",2761,2754,2267,"966",1301,0.4712,0.3508,0.4111
"5178",126818,2003,"3730",2012,1718,1319,"483",836,0.4155,0.2811,0.3536
"5179",127060,2003,"1010",549,461,540,"216",324,0.5902,0.4685,0.5347
"5180",127185,2003,"899",422,477,138,"51",87,0.2062,0.1069,0.1535
"5181",127565,2003,"1809",931,878,82,"26",56,0.0602,0.0296,0.0453
"5182",127741,2003,"2118",1337,781,598,"169",429,0.3209,0.2164,0.2823
"5183",128106,2003,"686",372,314,93,"35",58,0.1559,0.1115,0.1356
"5184",128744,2003,"286",158,128,61,"14",47,0.2975,0.1094,0.2133
"5185",128771,2003,"1176",571,605,166,"59",107,0.1874,0.0975,0.1412
"5186",129020,2003,"3182",1733,1449,1912,"757",1155,0.6665,0.5224,0.6009
"5187",129242,2003,"789",459,330,636,"260",376,0.8192,0.7879,0.8061
"5188",129941,2003,"618",301,317,223,"85",138,0.4585,0.2681,0.3608
"5189",130253,2003,"816",497,319,462,"144",318,0.6398,0.4514,0.5662
"5190",130314,2003,"190",190,0,59,"0",59,0.3105,NA,0.3105
"5191",130493,2003,"1310",802,508,7,"2",5,0.0062,0.0039,0.0053
"5192",130590,2003,"548",257,291,421,"212",209,0.8132,0.7285,0.7682
"5193",130697,2003,"713",376,337,631,"291",340,0.9043,0.8635,0.885
"5194",130776,2003,"808",444,364,105,"40",65,0.1464,0.1099,0.13
"5195",130794,2003,"1350",680,670,1221,"582",639,0.9397,0.8687,0.9044
"5196",130934,2003,"597",355,242,89,"13",76,0.2141,0.0537,0.1491
"5197",130943,2003,"3794",2157,1637,2016,"761",1255,0.5818,0.4649,0.5314
"5198",131159,2003,"1238",832,406,882,"286",596,0.7163,0.7044,0.7124
"5199",131283,2003,"646",362,284,423,"167",256,0.7072,0.588,0.6548
"5200",131450,2003,"236",124,112,25,"8",17,0.1371,0.0714,0.1059
"5201",131469,2003,"2260",1333,927,1726,"683",1043,0.7824,0.7368,0.7637
"5202",131496,2003,"1504",827,677,1321,"575",746,0.9021,0.8493,0.8783
"5203",131520,2003,"1446",992,454,679,"155",524,0.5282,0.3414,0.4696
"5204",132471,2003,"517",336,181,91,"33",58,0.1726,0.1823,0.176
"5205",132602,2003,"827",492,335,112,"24",88,0.1789,0.0716,0.1354
"5206",132903,2003,"5653",2956,2697,1923,"673",1250,0.4229,0.2495,0.3402
"5207",133492,2003,"434",248,186,250,"101",149,0.6008,0.543,0.576
"5208",133553,2003,"1012",164,848,292,"238",54,0.3293,0.2807,0.2885
"5209",133650,2003,"2403",1391,1012,289,"79",210,0.151,0.0781,0.1203
"5210",133669,2003,"2038",1143,895,335,"109",226,0.1977,0.1218,0.1644
"5211",133711,2003,"556",318,238,220,"84",136,0.4277,0.3529,0.3957
"5212",133881,2003,"549",174,375,219,"136",83,0.477,0.3627,0.3989
"5213",133951,2003,"3038",1756,1282,597,"185",412,0.2346,0.1443,0.1965
"5214",134079,2003,"436",250,186,163,"51",112,0.448,0.2742,0.3739
"5215",134097,2003,"6059",3522,2537,2847,"987",1860,0.5281,0.389,0.4699
"5216",134130,2003,"6499",3790,2709,3779,"1253",2526,0.6665,0.4625,0.5815
"5217",134945,2003,"430",192,238,137,"57",80,0.4167,0.2395,0.3186
"5218",135726,2003,"2066",1142,924,1374,"582",792,0.6935,0.6299,0.6651
"5219",136172,2003,"1919",1115,804,444,"120",324,0.2906,0.1493,0.2314
"5220",136950,2003,"496",298,198,291,"102",189,0.6342,0.5152,0.5867
"5221",137546,2003,"523",284,239,260,"109",151,0.5317,0.4561,0.4971
"5222",138354,2003,"816",469,347,169,"48",121,0.258,0.1383,0.2071
"5223",138716,2003,"537",322,215,78,"21",57,0.177,0.0977,0.1453
"5224",138789,2003,"719",433,286,47,"8",39,0.0901,0.028,0.0654
"5225",139144,2003,"504",321,183,240,"76",164,0.5109,0.4153,0.4762
"5226",139366,2003,"1037",619,418,114,"32",82,0.1325,0.0766,0.1099
"5227",139393,2003,"236",146,90,108,"32",76,0.5205,0.3556,0.4576
"5228",139658,2003,"1595",895,700,1060,"453",607,0.6782,0.6471,0.6646
"5229",139719,2003,"496",260,236,64,"17",47,0.1808,0.072,0.129
"5230",139755,2003,"2224",607,1617,683,"427",256,0.4217,0.2641,0.3071
"5231",139764,2003,"326",222,104,48,"13",35,0.1577,0.125,0.1472
"5232",139861,2003,"1027",611,416,254,"69",185,0.3028,0.1659,0.2473
"5233",139931,2003,"2735",1305,1430,466,"145",321,0.246,0.1014,0.1704
"5234",139940,2003,"1920",1159,761,349,"114",235,0.2028,0.1498,0.1818
"5235",139959,2003,"5157",3146,2011,2535,"807",1728,0.5493,0.4013,0.4916
"5236",140447,2003,"663",381,282,292,"88",204,0.5354,0.3121,0.4404
"5237",140960,2003,"607",354,253,76,"12",64,0.1808,0.0474,0.1252
"5238",140988,2003,"184",96,88,80,"33",47,0.4896,0.375,0.4348
"5239",141185,2003,"165",107,58,83,"22",61,0.5701,0.3793,0.503
"5240",141264,2003,"1756",1007,749,262,"73",189,0.1877,0.0975,0.1492
"5241",141334,2003,"1738",1020,718,215,"47",168,0.1647,0.0655,0.1237
"5242",141486,2003,"254",174,80,54,"18",36,0.2069,0.225,0.2126
"5243",141565,2003,"423",274,149,54,"17",37,0.135,0.1141,0.1277
"5244",141574,2003,"1878",1035,843,307,"92",215,0.2077,0.1091,0.1635
"5245",142276,2003,"787",499,288,53,"10",43,0.0862,0.0347,0.0673
"5246",142285,2003,"1590",748,842,393,"163",230,0.3075,0.1936,0.2472
"5247",142461,2003,"241",153,88,89,"22",67,0.4379,0.25,0.3693
"5248",143084,2003,"614",369,245,443,"153",290,0.7859,0.6245,0.7215
"5249",143288,2003,"176",82,94,49,"19",30,0.3659,0.2021,0.2784
"5250",144005,2003,"476",336,140,12,"4",8,0.0238,0.0286,0.0252
"5251",144281,2003,"1446",777,669,389,"166",223,0.287,0.2481,0.269
"5252",144740,2003,"2249",1351,898,966,"341",625,0.4626,0.3797,0.4295
"5253",144892,2003,"1892",1098,794,563,"185",378,0.3443,0.233,0.2976
"5254",144962,2003,"366",230,136,194,"54",140,0.6087,0.3971,0.5301
"5255",144971,2003,"92",44,48,15,"5",10,0.2273,0.1042,0.163
"5256",145600,2003,"2880",1573,1307,702,"275",427,0.2715,0.2104,0.2438
"5257",145619,2003,"302",169,133,116,"49",67,0.3964,0.3684,0.3841
"5258",145637,2003,"6807",3268,3539,4390,"2070",2320,0.7099,0.5849,0.6449
"5259",145691,2003,"318",180,138,157,"59",98,0.5444,0.4275,0.4937
"5260",145813,2003,"3088",1934,1154,1294,"411",883,0.4566,0.3562,0.419
"5261",146481,2003,"347",194,153,203,"86",117,0.6031,0.5621,0.585
"5262",146612,2003,"458",224,234,179,"86",93,0.4152,0.3675,0.3908
"5263",146719,2003,"1915",1292,623,924,"296",628,0.4861,0.4751,0.4825
"5264",146825,2003,"162",79,83,48,"17",31,0.3924,0.2048,0.2963
"5265",147013,2003,"287",124,163,113,"55",58,0.4677,0.3374,0.3937
"5266",147244,2003,"595",299,296,317,"132",185,0.6187,0.4459,0.5328
"5267",147341,2003,"355",175,180,215,"97",118,0.6743,0.5389,0.6056
"5268",147703,2003,"3229",1635,1594,737,"300",437,0.2673,0.1882,0.2282
"5269",147767,2003,"1941",1035,906,1694,"753",941,0.9092,0.8311,0.8727
"5270",147776,2003,"1046",657,389,36,"12",24,0.0365,0.0308,0.0344
"5271",147828,2003,"578",339,239,252,"93",159,0.469,0.3891,0.436
"5272",148131,2003,"222",108,114,68,"32",36,0.3333,0.2807,0.3063
"5273",148496,2003,"240",176,64,146,"40",106,0.6023,0.625,0.6083
"5274",148584,2003,"190",110,80,62,"27",35,0.3182,0.3375,0.3263
"5275",148627,2003,"371",231,140,107,"32",75,0.3247,0.2286,0.2884
"5276",149222,2003,"2532",1089,1443,595,"280",315,0.2893,0.194,0.235
"5277",149231,2003,"1699",982,717,399,"129",270,0.2749,0.1799,0.2348
"5278",149772,2003,"1938",939,999,675,"322",353,0.3759,0.3223,0.3483
"5279",149781,2003,"576",288,288,462,"223",239,0.8299,0.7743,0.8021
"5280",150066,2003,"559",337,222,246,"81",165,0.4896,0.3649,0.4401
"5281",150136,2003,"3963",2139,1824,1329,"507",822,0.3843,0.278,0.3354
"5282",150145,2003,"291",175,116,117,"39",78,0.4457,0.3362,0.4021
"5283",150163,2003,"972",612,360,550,"184",366,0.598,0.5111,0.5658
"5284",150400,2003,"580",305,275,456,"202",254,0.8328,0.7345,0.7862
"5285",150534,2003,"662",418,244,346,"119",227,0.5431,0.4877,0.5227
"5286",150668,2003,"181",99,82,101,"41",60,0.6061,0.5,0.558
"5287",150941,2003,"190",103,87,94,"45",49,0.4757,0.5172,0.4947
"5288",151102,2003,"1366",757,609,76,"29",47,0.0621,0.0476,0.0556
"5289",151111,2003,"2336",1361,975,210,"79",131,0.0963,0.081,0.0899
"5290",151306,2003,"1953",1151,802,271,"78",193,0.1677,0.0973,0.1388
"5291",151324,2003,"1974",974,1000,351,"128",223,0.229,0.128,0.1778
"5292",151333,2003,"382",264,118,27,"5",22,0.0833,0.0424,0.0707
"5293",151342,2003,"707",417,290,42,"18",24,0.0576,0.0621,0.0594
"5294",151351,2003,"6739",3773,2966,3490,"1419",2071,0.5489,0.4784,0.5179
"5295",151360,2003,"660",417,243,49,"14",35,0.0839,0.0576,0.0742
"5296",151379,2003,"674",400,274,53,"15",38,0.095,0.0547,0.0786
"5297",151388,2003,"318",203,115,20,"7",13,0.064,0.0609,0.0629
"5298",151777,2003,"335",168,167,127,"53",74,0.4405,0.3174,0.3791
"5299",151786,2003,"239",162,77,71,"27",44,0.2716,0.3506,0.2971
"5300",152080,2003,"1995",928,1067,1797,"955",842,0.9073,0.895,0.9008
"5301",152248,2003,"997",527,470,56,"21",35,0.0664,0.0447,0.0562
"5302",152363,2003,"306",159,147,134,"66",68,0.4277,0.449,0.4379
"5303",152530,2003,"468",270,198,331,"137",194,0.7185,0.6919,0.7073
"5304",152600,2003,"791",400,391,501,"229",272,0.68,0.5857,0.6334
"5305",153001,2003,"377",193,184,172,"74",98,0.5078,0.4022,0.4562
"5306",153108,2003,"416",227,189,231,"87",144,0.6344,0.4603,0.5553
"5307",153269,2003,"809",474,335,410,"151",259,0.5464,0.4507,0.5068
"5308",153384,2003,"403",214,189,315,"138",177,0.8271,0.7302,0.7816
"5309",153603,2003,"3860",1683,2177,1364,"577",787,0.4676,0.265,0.3534
"5310",153834,2003,"667",397,270,436,"172",264,0.665,0.637,0.6537
"5311",154095,2003,"1739",1088,651,613,"182",431,0.3961,0.2796,0.3525
"5312",155089,2003,"201",102,99,38,"14",24,0.2353,0.1414,0.1891
"5313",155317,2003,"3971",2126,1845,1261,"480",781,0.3674,0.2602,0.3176
"5314",155335,2003,"200",118,82,57,"19",38,0.322,0.2317,0.285
"5315",155399,2003,"3098",1529,1569,855,"303",552,0.361,0.1931,0.276
"5316",155520,2003,"260",125,135,103,"41",62,0.496,0.3037,0.3962
"5317",155627,2003,"114",47,67,28,"6",22,0.4681,0.0896,0.2456
"5318",155937,2003,"124",57,67,44,"16",28,0.4912,0.2388,0.3548
"5319",156213,2003,"258",146,112,148,"68",80,0.5479,0.6071,0.5736
"5320",156286,2003,"450",289,161,235,"79",156,0.5398,0.4907,0.5222
"5321",156295,2003,"396",240,156,203,"83",120,0.5,0.5321,0.5126
"5322",156365,2003,"351",162,189,86,"37",49,0.3025,0.1958,0.245
"5323",156541,2003,"401",191,210,98,"33",65,0.3403,0.1571,0.2444
"5324",156745,2003,"368",213,155,181,"54",127,0.5962,0.3484,0.4918
"5325",157058,2003,"309",162,147,23,"9",14,0.0864,0.0612,0.0744
"5326",157076,2003,"165",91,74,58,"19",39,0.4286,0.2568,0.3515
"5327",157085,2003,"3678",1951,1727,1160,"460",700,0.3588,0.2664,0.3154
"5328",157289,2003,"2197",1118,1079,468,"173",295,0.2639,0.1603,0.213
"5329",157386,2003,"1555",867,688,185,"60",125,0.1442,0.0872,0.119
"5330",157401,2003,"1500",876,624,477,"160",317,0.3619,0.2564,0.318
"5331",157447,2003,"1962",1108,854,155,"35",120,0.1083,0.041,0.079
"5332",157535,2003,"147",67,80,27,"10",17,0.2537,0.125,0.1837
"5333",157951,2003,"3034",1782,1252,541,"169",372,0.2088,0.135,0.1783
"5334",158477,2003,"197",113,84,101,"34",67,0.5929,0.4048,0.5127
"5335",159009,2003,"1022",570,452,124,"29",95,0.1667,0.0642,0.1213
"5336",159391,2003,"5359",2938,2421,1396,"468",928,0.3159,0.1933,0.2605
"5337",159647,2003,"1948",958,990,485,"190",295,0.3079,0.1919,0.249
"5338",159717,2003,"1506",843,663,176,"51",125,0.1483,0.0769,0.1169
"5339",159966,2003,"1391",813,578,121,"36",85,0.1046,0.0623,0.087
"5340",160038,2003,"1826",1117,709,227,"71",156,0.1397,0.1001,0.1243
"5341",160612,2003,"2539",1451,1088,221,"72",149,0.1027,0.0662,0.087
"5342",160621,2003,"1351",782,569,77,"16",61,0.078,0.0281,0.057
"5343",160658,2003,"2576",1437,1139,333,"86",247,0.1719,0.0755,0.1293
"5344",161004,2003,"464",236,228,412,"202",210,0.8898,0.886,0.8879
"5345",161226,2003,"482",339,143,221,"59",162,0.4779,0.4126,0.4585
"5346",161235,2003,"126",62,64,19,"4",15,0.2419,0.0625,0.1508
"5347",161244,2003,"142",92,50,17,"1",16,0.1739,0.02,0.1197
"5348",161253,2003,"1599",812,787,538,"235",303,0.3732,0.2986,0.3365
"5349",161554,2003,"851",496,355,106,"24",82,0.1653,0.0676,0.1246
"5350",162007,2003,"762",479,283,98,"18",80,0.167,0.0636,0.1286
"5351",162210,2003,"187",120,67,24,"6",18,0.15,0.0896,0.1283
"5352",162283,2003,"571",432,139,29,"9",20,0.0463,0.0647,0.0508
"5353",162584,2003,"988",450,538,216,"85",131,0.2911,0.158,0.2186
"5354",162654,2003,"342",207,135,207,"60",147,0.7101,0.4444,0.6053
"5355",162760,2003,"181",143,38,110,"20",90,0.6294,0.5263,0.6077
"5356",162928,2003,"1122",499,623,919,"488",431,0.8637,0.7833,0.8191
"5357",163046,2003,"915",545,370,704,"277",427,0.7835,0.7486,0.7694
"5358",163268,2003,"1487",657,830,506,"215",291,0.4429,0.259,0.3403
"5359",163286,2003,"4045",2031,2014,2539,"1158",1381,0.68,0.575,0.6277
"5360",163453,2003,"1220",699,521,138,"34",104,0.1488,0.0653,0.1131
"5361",163462,2003,"395",237,158,279,"110",169,0.7131,0.6962,0.7063
"5362",163851,2003,"947",531,416,433,"142",291,0.548,0.3413,0.4572
"5363",163912,2003,"421",249,172,300,"106",194,0.7791,0.6163,0.7126
"5364",164076,2003,"1756",1192,564,763,"181",582,0.4883,0.3209,0.4345
"5365",164173,2003,"539",384,155,247,"63",184,0.4792,0.4065,0.4583
"5366",164216,2003,"361",228,133,272,"93",179,0.7851,0.6992,0.7535
"5367",164270,2003,"451",249,202,274,"94",180,0.7229,0.4653,0.6075
"5368",164447,2003,"327",174,153,105,"45",60,0.3448,0.2941,0.3211
"5369",164492,2003,"154",102,52,76,"19",57,0.5588,0.3654,0.4935
"5370",164562,2003,"640",408,232,409,"140",269,0.6593,0.6034,0.6391
"5371",165015,2003,"824",486,338,692,"285",407,0.8374,0.8432,0.8398
"5372",165024,2003,"1285",745,540,320,"93",227,0.3047,0.1722,0.249
"5373",165334,2003,"537",324,213,391,"150",241,0.7438,0.7042,0.7281
"5374",165662,2003,"706",413,293,525,"229",296,0.7167,0.7816,0.7436
"5375",165671,2003,"406",299,107,222,"47",175,0.5853,0.4393,0.5468
"5376",165820,2003,"585",320,265,144,"50",94,0.2938,0.1887,0.2462
"5377",165866,2003,"617",441,176,202,"45",157,0.356,0.2557,0.3274
"5378",165936,2003,"427",274,153,260,"86",174,0.635,0.5621,0.6089
"5379",166027,2003,"1633",782,851,1433,"726",707,0.9041,0.8531,0.8775
"5380",166124,2003,"698",378,320,607,"270",337,0.8915,0.8438,0.8696
"5381",166513,2003,"1008",393,615,291,"145",146,0.3715,0.2358,0.2887
"5382",166629,2003,"4149",2060,2089,1958,"850",1108,0.5379,0.4069,0.4719
"5383",166638,2003,"602",353,249,60,"21",39,0.1105,0.0843,0.0997
"5384",166683,2003,"1018",459,559,842,"450",392,0.854,0.805,0.8271
"5385",167288,2003,"244",149,95,91,"28",63,0.4228,0.2947,0.373
"5386",167987,2003,"1510",764,746,489,"187",302,0.3953,0.2507,0.3238
"5387",167996,2003,"565",307,258,451,"193",258,0.8404,0.7481,0.7982
"5388",168005,2003,"914",542,372,320,"117",203,0.3745,0.3145,0.3501
"5389",168148,2003,"1281",664,617,1087,"507",580,0.8735,0.8217,0.8486
"5390",168254,2003,"672",279,393,275,"148",127,0.4552,0.3766,0.4092
"5391",168281,2003,"445",286,159,324,"104",220,0.7692,0.6541,0.7281
"5392",168342,2003,"533",272,261,497,"245",252,0.9265,0.9387,0.9325
"5393",168546,2003,"486",263,223,306,"118",188,0.7148,0.5291,0.6296
"5394",168786,2003,"284",182,102,94,"31",63,0.3462,0.3039,0.331
"5395",169080,2003,"1041",577,464,572,"230",342,0.5927,0.4957,0.5495
"5396",169798,2003,"2479",1510,969,295,"85",210,0.1391,0.0877,0.119
"5397",169910,2003,"2205",960,1245,137,"67",70,0.0729,0.0538,0.0621
"5398",170082,2003,"3270",2096,1174,851,"257",594,0.2834,0.2189,0.2602
"5399",170301,2003,"810",515,295,531,"167",364,0.7068,0.5661,0.6556
"5400",170532,2003,"382",220,162,275,"118",157,0.7136,0.7284,0.7199
"5401",170639,2003,"551",243,308,42,"17",25,0.1029,0.0552,0.0762
"5402",170976,2003,"5538",2903,2635,4025,"1840",2185,0.7527,0.6983,0.7268
"5403",171100,2003,"6938",3932,3006,3315,"1201",2114,0.5376,0.3995,0.4778
"5404",171128,2003,"1168",238,930,251,"177",74,0.3109,0.1903,0.2149
"5405",171137,2003,"704",313,391,123,"62",61,0.1949,0.1586,0.1747
"5406",171146,2003,"420",252,168,57,"17",40,0.1587,0.1012,0.1357
"5407",171599,2003,"271",99,172,101,"53",48,0.4848,0.3081,0.3727
"5408",172051,2003,"1156",667,489,104,"32",72,0.1079,0.0654,0.09
"5409",172699,2003,"4218",2191,2027,915,"388",527,0.2405,0.1914,0.2169
"5410",173160,2003,"690",419,271,427,"172",255,0.6086,0.6347,0.6188
"5411",173258,2003,"488",241,247,435,"215",220,0.9129,0.8704,0.8914
"5412",173328,2003,"167",83,84,59,"25",34,0.4096,0.2976,0.3533
"5413",173647,2003,"623",331,292,514,"235",279,0.8429,0.8048,0.825
"5414",173902,2003,"513",300,213,422,"168",254,0.8467,0.7887,0.8226
"5415",174066,2003,"5160",2820,2340,2341,"902",1439,0.5103,0.3855,0.4537
"5416",174233,2003,"2155",1073,1082,514,"218",296,0.2759,0.2015,0.2385
"5417",174251,2003,"412",249,163,179,"60",119,0.4779,0.3681,0.4345
"5418",174491,2003,"431",291,140,191,"55",136,0.4674,0.3929,0.4432
"5419",174792,2003,"490",0,490,346,"346",0,NA,0.7061,0.7061
"5420",174844,2003,"719",422,297,593,"234",359,0.8507,0.7879,0.8248
"5421",174899,2003,"411",299,112,256,"75",181,0.6054,0.6696,0.6229
"5422",174914,2003,"1038",547,491,584,"244",340,0.6216,0.4969,0.5626
"5423",175342,2003,"495",271,224,108,"32",76,0.2804,0.1429,0.2182
"5424",175421,2003,"170",96,74,53,"15",38,0.3958,0.2027,0.3118
"5425",175616,2003,"327",191,136,55,"19",36,0.1885,0.1397,0.1682
"5426",175856,2003,"883",470,413,141,"43",98,0.2085,0.1041,0.1597
"5427",175980,2003,"259",141,118,152,"63",89,0.6312,0.5339,0.5869
"5428",176017,2003,"2377",1297,1080,851,"286",565,0.4356,0.2648,0.358
"5429",176035,2003,"202",178,24,48,"3",45,0.2528,0.125,0.2376
"5430",176044,2003,"325",187,138,57,"16",41,0.2193,0.1159,0.1754
"5431",176080,2003,"1659",822,837,509,"185",324,0.3942,0.221,0.3068
"5432",176406,2003,"221",166,55,53,"9",44,0.2651,0.1636,0.2398
"5433",176628,2003,"152",93,59,36,"5",31,0.3333,0.0847,0.2368
"5434",176947,2003,"223",93,130,64,"25",39,0.4194,0.1923,0.287
"5435",176965,2003,"1355",737,618,323,"115",208,0.2822,0.1861,0.2384
"5436",177418,2003,"194",143,51,61,"14",47,0.3287,0.2745,0.3144
"5437",178059,2003,"318",236,82,163,"39",124,0.5254,0.4756,0.5126
"5438",178341,2003,"568",319,249,76,"25",51,0.1599,0.1004,0.1338
"5439",178387,2003,"994",572,422,111,"27",84,0.1469,0.064,0.1117
"5440",178396,2003,"4605",2443,2162,1985,"737",1248,0.5108,0.3409,0.4311
"5441",178402,2003,"758",455,303,124,"38",86,0.189,0.1254,0.1636
"5442",178411,2003,"870",181,689,217,"154",63,0.3481,0.2235,0.2494
"5443",178420,2003,"464",280,184,97,"26",71,0.2536,0.1413,0.2091
"5444",178615,2003,"1310",787,523,612,"198",414,0.526,0.3786,0.4672
"5445",179043,2003,"244",130,114,141,"60",81,0.6231,0.5263,0.5779
"5446",179159,2003,"1377",752,625,832,"338",494,0.6569,0.5408,0.6042
"5447",179557,2003,"1410",826,584,336,"98",238,0.2881,0.1678,0.2383
"5448",179566,2003,"2645",1495,1150,1044,"382",662,0.4428,0.3322,0.3947
"5449",179867,2003,"1349",699,650,1138,"517",621,0.8884,0.7954,0.8436
"5450",179894,2003,"419",260,159,201,"62",139,0.5346,0.3899,0.4797
"5451",179946,2003,"240",93,147,96,"56",40,0.4301,0.381,0.4
"5452",180179,2003,"588",380,208,54,"13",41,0.1079,0.0625,0.0918
"5453",180461,2003,"2004",837,1167,383,"193",190,0.227,0.1654,0.1911
"5454",180522,2003,"214",108,106,36,"20",16,0.1481,0.1887,0.1682
"5455",180984,2003,"222",138,84,77,"25",52,0.3768,0.2976,0.3468
"5456",181002,2003,"933",567,366,601,"223",378,0.6667,0.6093,0.6442
"5457",181020,2003,"288",152,136,173,"75",98,0.6447,0.5515,0.6007
"5458",181127,2003,"338",143,195,185,"87",98,0.6853,0.4462,0.5473
"5459",181215,2003,"1012",588,424,229,"73",156,0.2653,0.1722,0.2263
"5460",181394,2003,"1465",787,678,189,"85",104,0.1321,0.1254,0.129
"5461",181446,2003,"417",241,176,216,"83",133,0.5519,0.4716,0.518
"5462",181464,2003,"3639",1825,1814,904,"341",563,0.3085,0.188,0.2484
"5463",181534,2003,"188",89,99,29,"9",20,0.2247,0.0909,0.1543
"5464",181783,2003,"598",342,256,163,"59",104,0.3041,0.2305,0.2726
"5465",182281,2003,"2827",1596,1231,338,"107",231,0.1447,0.0869,0.1196
"5466",182290,2003,"2047",1154,893,254,"76",178,0.1542,0.0851,0.1241
"5467",182634,2003,"304",207,97,158,"34",124,0.599,0.3505,0.5197
"5468",182795,2003,"514",244,270,172,"74",98,0.4016,0.2741,0.3346
"5469",183062,2003,"991",598,393,369,"126",243,0.4064,0.3206,0.3724
"5470",183080,2003,"900",469,431,310,"134",176,0.3753,0.3109,0.3444
"5471",183239,2003,"587",336,251,418,"172",246,0.7321,0.6853,0.7121
"5472",183822,2003,"341",215,126,39,"6",33,0.1535,0.0476,0.1144
"5473",183974,2003,"221",126,95,112,"47",65,0.5159,0.4947,0.5068
"5474",184348,2003,"419",247,172,289,"109",180,0.7287,0.6337,0.6897
"5475",184603,2003,"540",303,237,105,"40",65,0.2145,0.1688,0.1944
"5476",184612,2003,"218",158,60,33,"10",23,0.1456,0.1667,0.1514
"5477",184782,2003,"1243",600,643,588,"265",323,0.5383,0.4121,0.473
"5478",185129,2003,"652",380,272,49,"15",34,0.0895,0.0551,0.0752
"5479",185572,2003,"904",484,420,358,"125",233,0.4814,0.2976,0.396
"5480",185590,2003,"1594",934,660,471,"134",337,0.3608,0.203,0.2955
"5481",185828,2003,"685",119,566,118,"92",26,0.2185,0.1625,0.1723
"5482",186131,2003,"1161",539,622,1044,"549",495,0.9184,0.8826,0.8992
"5483",186201,2003,"719",423,296,439,"165",274,0.6478,0.5574,0.6106
"5484",186283,2003,"944",575,369,443,"154",289,0.5026,0.4173,0.4693
"5485",186584,2003,"1241",616,625,620,"301",319,0.5179,0.4816,0.4996
"5486",186876,2003,"816",439,377,319,"119",200,0.4556,0.3156,0.3909
"5487",187134,2003,"1176",679,497,855,"327",528,0.7776,0.6579,0.727
"5488",187444,2003,"1269",711,558,262,"86",176,0.2475,0.1541,0.2065
"5489",187985,2003,"2940",1660,1280,300,"76",224,0.1349,0.0594,0.102
"5490",188030,2003,"2016",1087,929,257,"90",167,0.1536,0.0969,0.1275
"5491",188429,2003,"772",514,258,402,"117",285,0.5545,0.4535,0.5207
"5492",188641,2003,"472",250,222,237,"89",148,0.592,0.4009,0.5021
"5493",190044,2003,"720",193,527,372,"257",115,0.5959,0.4877,0.5167
"5494",190099,2003,"725",355,370,615,"301",314,0.8845,0.8135,0.8483
"5495",190150,2003,"1355",626,729,1131,"606",525,0.8387,0.8313,0.8347
"5496",190248,2003,"137",85,52,37,"12",25,0.2941,0.2308,0.2701
"5497",190415,2003,"3131",1533,1598,2672,"1322",1350,0.8806,0.8273,0.8534
"5498",190512,2003,"1659",819,840,544,"214",330,0.4029,0.2548,0.3279
"5499",190549,2003,"1296",679,617,220,"73",147,0.2165,0.1183,0.1698
"5500",190558,2003,"1885",1013,872,67,"17",50,0.0494,0.0195,0.0355
"5501",190567,2003,"1124",547,577,62,"20",42,0.0768,0.0347,0.0552
"5502",190594,2003,"1661",1113,548,280,"63",217,0.195,0.115,0.1686
"5503",190637,2003,"790",529,261,85,"20",65,0.1229,0.0766,0.1076
"5504",190664,2003,"1290",790,500,327,"88",239,0.3025,0.176,0.2535
"5505",190691,2003,"565",366,199,30,"8",22,0.0601,0.0402,0.0531
"5506",190725,2003,"356",252,104,108,"23",85,0.3373,0.2212,0.3034
"5507",191241,2003,"1687",961,726,1265,"547",718,0.7471,0.7534,0.7499
"5508",191515,2003,"464",234,230,383,"185",198,0.8462,0.8043,0.8254
"5509",191533,2003,"447",236,211,210,"77",133,0.5636,0.3649,0.4698
"5510",191630,2003,"516",267,249,383,"176",207,0.7753,0.7068,0.7422
"5511",191649,2003,"1855",979,876,768,"290",478,0.4883,0.3311,0.414
"5512",191676,2003,"299",203,96,179,"53",126,0.6207,0.5521,0.5987
"5513",191931,2003,"811",434,377,409,"152",257,0.5922,0.4032,0.5043
"5514",191968,2003,"1581",912,669,1118,"456",662,0.7259,0.6816,0.7071
"5515",192192,2003,"239",168,71,107,"29",78,0.4643,0.4085,0.4477
"5516",192323,2003,"503",310,193,323,"115",208,0.671,0.5959,0.6421
"5517",192439,2003,"680",480,200,45,"10",35,0.0729,0.05,0.0662
"5518",192703,2003,"638",342,296,400,"173",227,0.6637,0.5845,0.627
"5519",192749,2003,"422",295,127,223,"68",155,0.5254,0.5354,0.5284
"5520",192819,2003,"961",528,433,732,"310",422,0.7992,0.7159,0.7617
"5521",192925,2003,"241",146,95,100,"42",58,0.3973,0.4421,0.4149
"5522",193016,2003,"611",379,232,58,"10",48,0.1266,0.0431,0.0949
"5523",193292,2003,"262",185,77,89,"29",60,0.3243,0.3766,0.3397
"5524",193353,2003,"347",246,101,137,"31",106,0.4309,0.3069,0.3948
"5525",193399,2003,"336",272,64,136,"13",123,0.4522,0.2031,0.4048
"5526",193584,2003,"383",284,99,236,"54",182,0.6408,0.5455,0.6162
"5527",193645,2003,"769",668,101,121,"5",116,0.1737,0.0495,0.1573
"5528",193654,2003,"581",409,172,288,"81",207,0.5061,0.4709,0.4957
"5529",193900,2003,"4203",2563,1640,2664,"1069",1595,0.6223,0.6518,0.6338
"5530",193973,2003,"686",417,269,403,"152",251,0.6019,0.5651,0.5875
"5531",194161,2003,"267",166,101,79,"26",53,0.3193,0.2574,0.2959
"5532",194310,2003,"1553",997,556,653,"214",439,0.4403,0.3849,0.4205
"5533",194824,2003,"1341",320,1021,856,"626",230,0.7188,0.6131,0.6383
"5534",195003,2003,"2121",567,1554,538,"286",252,0.4444,0.184,0.2537
"5535",195030,2003,"1086",508,578,747,"368",379,0.7461,0.6367,0.6878
"5536",195164,2003,"595",292,303,296,"135",161,0.5514,0.4455,0.4975
"5537",195173,2003,"428",224,204,71,"18",53,0.2366,0.0882,0.1659
"5538",195216,2003,"565",296,269,444,"196",248,0.8378,0.7286,0.7858
"5539",195234,2003,"531",397,134,277,"52",225,0.5668,0.3881,0.5217
"5540",195243,2003,"343",188,155,97,"39",58,0.3085,0.2516,0.2828
"5541",195304,2003,"322",234,88,218,"63",155,0.6624,0.7159,0.677
"5542",195474,2003,"759",438,321,519,"204",315,0.7192,0.6355,0.6838
"5543",195526,2003,"642",377,265,527,"208",319,0.8462,0.7849,0.8209
"5544",195544,2003,"96",80,16,67,"10",57,0.7125,0.625,0.6979
"5545",195809,2003,"2966",1749,1217,1058,"381",677,0.3871,0.3131,0.3567
"5546",196413,2003,"2628",1501,1127,1914,"755",1159,0.7722,0.6699,0.7283
"5547",196592,2003,"1967",1343,624,247,"74",173,0.1288,0.1186,0.1256
"5548",197045,2003,"447",254,193,169,"70",99,0.3898,0.3627,0.3781
"5549",197133,2003,"631",367,264,554,"226",328,0.8937,0.8561,0.878
"5550",197869,2003,"2462",1216,1246,920,"360",560,0.4605,0.2889,0.3737
"5551",197984,2003,"147",70,77,48,"25",23,0.3286,0.3247,0.3265
"5552",198385,2003,"489",237,252,435,"218",217,0.9156,0.8651,0.8896
"5553",198464,2003,"3458",2117,1341,1035,"293",742,0.3505,0.2185,0.2993
"5554",198507,2003,"459",258,201,104,"36",68,0.2636,0.1791,0.2266
"5555",198516,2003,"1227",775,452,875,"294",581,0.7497,0.6504,0.7131
"5556",198835,2003,"308",178,130,124,"45",79,0.4438,0.3462,0.4026
"5557",198969,2003,"384",120,264,58,"26",32,0.2667,0.0985,0.151
"5558",199102,2003,"2221",1176,1045,389,"104",285,0.2423,0.0995,0.1751
"5559",199111,2003,"590",332,258,170,"45",125,0.3765,0.1744,0.2881
"5560",199120,2003,"3511",2068,1443,2535,"945",1590,0.7689,0.6549,0.722
"5561",199139,2003,"2472",1291,1181,630,"244",386,0.299,0.2066,0.2549
"5562",199148,2003,"2039",1422,617,577,"123",454,0.3193,0.1994,0.283
"5563",199157,2003,"1025",679,346,190,"32",158,0.2327,0.0925,0.1854
"5564",199193,2003,"3915",1665,2250,1595,"734",861,0.5171,0.3262,0.4074
"5565",199218,2003,"1764",1133,631,783,"227",556,0.4907,0.3597,0.4439
"5566",199281,2003,"792",415,377,130,"45",85,0.2048,0.1194,0.1641
"5567",199306,2003,"158",86,72,56,"20",36,0.4186,0.2778,0.3544
"5568",199412,2003,"252",186,66,127,"34",93,0.5,0.5152,0.504
"5569",199582,2003,"542",238,304,46,"15",31,0.1303,0.0493,0.0849
"5570",199643,2003,"469",249,220,79,"31",48,0.1928,0.1409,0.1684
"5571",199847,2003,"984",507,477,834,"386",448,0.8836,0.8092,0.8476
"5572",199962,2003,"372",198,174,160,"55",105,0.5303,0.3161,0.4301
"5573",199999,2003,"883",580,303,124,"25",99,0.1707,0.0825,0.1404
"5574",200004,2003,"1485",739,746,394,"138",256,0.3464,0.185,0.2653
"5575",200059,2003,"383",201,182,42,"14",28,0.1393,0.0769,0.1097
"5576",200156,2003,"261",142,119,82,"27",55,0.3873,0.2269,0.3142
"5577",200217,2003,"390",226,164,147,"36",111,0.4912,0.2195,0.3769
"5578",200226,2003,"135",70,65,26,"9",17,0.2429,0.1385,0.1926
"5579",200253,2003,"435",252,183,70,"16",54,0.2143,0.0874,0.1609
"5580",200280,2003,"2213",1039,1174,511,"244",267,0.257,0.2078,0.2309
"5581",200332,2003,"1944",902,1042,423,"178",245,0.2716,0.1708,0.2176
"5582",200572,2003,"159",71,88,36,"15",21,0.2958,0.1705,0.2264
"5583",201104,2003,"605",379,226,275,"76",199,0.5251,0.3363,0.4545
"5584",201371,2003,"236",143,93,133,"51",82,0.5734,0.5484,0.5636
"5585",201548,2003,"565",352,213,284,"100",184,0.5227,0.4695,0.5027
"5586",201645,2003,"874",350,524,552,"292",260,0.7429,0.5573,0.6316
"5587",201690,2003,"542",277,265,43,"10",33,0.1191,0.0377,0.0793
"5588",202134,2003,"925",463,462,65,"34",31,0.067,0.0736,0.0703
"5589",202480,2003,"1858",956,902,1084,"431",653,0.6831,0.4778,0.5834
"5590",202523,2003,"629",358,271,502,"199",303,0.8464,0.7343,0.7981
"5591",202763,2003,"671",441,230,260,"72",188,0.4263,0.313,0.3875
"5592",203085,2003,"298",142,156,116,"43",73,0.5141,0.2756,0.3893
"5593",203128,2003,"236",127,109,151,"59",92,0.7244,0.5413,0.6398
"5594",203368,2003,"859",453,406,543,"226",317,0.6998,0.5567,0.6321
"5595",203517,2003,"3746",2293,1453,895,"266",629,0.2743,0.1831,0.2389
"5596",203535,2003,"453",247,206,386,"176",210,0.8502,0.8544,0.8521
"5597",203580,2003,"120",86,34,41,"13",28,0.3256,0.3824,0.3417
"5598",203775,2003,"389",238,151,173,"48",125,0.5252,0.3179,0.4447
"5599",203845,2003,"376",168,208,160,"70",90,0.5357,0.3365,0.4255
"5600",204024,2003,"3362",1844,1518,2371,"1002",1369,0.7424,0.6601,0.7052
"5601",204185,2003,"579",276,303,287,"114",173,0.6268,0.3762,0.4957
"5602",204194,2003,"373",221,152,137,"51",86,0.3891,0.3355,0.3673
"5603",204617,2003,"296",191,105,88,"27",61,0.3194,0.2571,0.2973
"5604",204796,2003,"6347",3201,3146,2938,"1132",1806,0.5642,0.3598,0.4629
"5605",204857,2003,"3587",2026,1561,1722,"638",1084,0.535,0.4087,0.4801
"5606",206330,2003,"216",72,144,27,"6",21,0.2917,0.0417,0.125
"5607",206589,2003,"552",281,271,373,"169",204,0.726,0.6236,0.6757
"5608",206604,2003,"2272",1312,960,78,"16",62,0.0473,0.0167,0.0343
"5609",206622,2003,"786",428,358,526,"230",296,0.6916,0.6425,0.6692
"5610",206695,2003,"1976",1048,928,207,"73",134,0.1279,0.0787,0.1048
"5611",206914,2003,"667",375,292,34,"15",19,0.0507,0.0514,0.051
"5612",207209,2003,"553",256,297,23,"9",14,0.0547,0.0303,0.0416
"5613",207306,2003,"308",139,169,45,"20",25,0.1799,0.1183,0.1461
"5614",207324,2003,"356",199,157,99,"38",61,0.3065,0.242,0.2781
"5615",207388,2003,"3128",1666,1462,958,"336",622,0.3733,0.2298,0.3063
"5616",207500,2003,"3729",1921,1808,1100,"406",694,0.3613,0.2246,0.295
"5617",207722,2003,"282",172,110,54,"11",43,0.25,0.1,0.1915
"5618",207847,2003,"651",339,312,70,"27",43,0.1268,0.0865,0.1075
"5619",207865,2003,"980",492,488,119,"38",81,0.1646,0.0779,0.1214
"5620",208822,2003,"336",203,133,177,"73",104,0.5123,0.5489,0.5268
"5621",209056,2003,"493",308,185,352,"127",225,0.7305,0.6865,0.714
"5622",209065,2003,"448",243,205,286,"101",185,0.7613,0.4927,0.6384
"5623",209542,2003,"2862",1371,1491,811,"321",490,0.3574,0.2153,0.2834
"5624",209551,2003,"2826",1594,1232,1300,"519",781,0.49,0.4213,0.46
"5625",209612,2003,"303",174,129,158,"58",100,0.5747,0.4496,0.5215
"5626",209807,2003,"1264",668,596,159,"55",104,0.1557,0.0923,0.1258
"5627",209922,2003,"297",153,144,169,"74",95,0.6209,0.5139,0.569
"5628",210146,2003,"896",497,399,158,"51",107,0.2153,0.1278,0.1763
"5629",210401,2003,"541",312,229,383,"143",240,0.7692,0.6245,0.7079
"5630",210429,2003,"903",555,348,144,"37",107,0.1928,0.1063,0.1595
"5631",210571,2003,"456",259,197,252,"96",156,0.6023,0.4873,0.5526
"5632",210669,2003,"478",234,244,317,"143",174,0.7436,0.5861,0.6632
"5633",210775,2003,"278",165,113,99,"32",67,0.4061,0.2832,0.3561
"5634",211088,2003,"489",360,129,259,"77",182,0.5056,0.5969,0.5297
"5635",211158,2003,"1665",1000,665,677,"201",476,0.476,0.3023,0.4066
"5636",211291,2003,"906",462,444,794,"374",420,0.9091,0.8423,0.8764
"5637",211352,2003,"401",270,131,184,"55",129,0.4778,0.4198,0.4589
"5638",211361,2003,"982",520,462,251,"105",146,0.2808,0.2273,0.2556
"5639",211431,2003,"236",229,7,71,"3",68,0.2969,0.4286,0.3008
"5640",211440,2003,"1338",528,810,903,"532",371,0.7027,0.6568,0.6749
"5641",211468,2003,"233",233,0,105,"0",105,0.4506,NA,0.4506
"5642",211556,2003,"74",74,0,38,"0",38,0.5135,NA,0.5135
"5643",211583,2003,"188",125,63,66,"19",47,0.376,0.3016,0.3511
"5644",211608,2003,"378",208,170,51,"13",38,0.1827,0.0765,0.1349
"5645",211644,2003,"1219",729,490,366,"113",253,0.3471,0.2306,0.3002
"5646",211981,2003,"438",198,240,164,"70",94,0.4747,0.2917,0.3744
"5647",212009,2003,"624",356,268,496,"205",291,0.8174,0.7649,0.7949
"5648",212054,2003,"1980",768,1212,486,"176",310,0.4036,0.1452,0.2455
"5649",212106,2003,"1485",899,586,774,"283",491,0.5462,0.4829,0.5212
"5650",212115,2003,"1076",650,426,394,"107",287,0.4415,0.2512,0.3662
"5651",212133,2003,"438",298,140,242,"74",168,0.5638,0.5286,0.5525
"5652",212160,2003,"1392",818,574,304,"103",201,0.2457,0.1794,0.2184
"5653",212197,2003,"495",326,169,328,"100",228,0.6994,0.5917,0.6626
"5654",212577,2003,"503",233,270,398,"198",200,0.8584,0.7333,0.7913
"5655",212601,2003,"587",339,248,246,"91",155,0.4572,0.3669,0.4191
"5656",212832,2003,"322",245,77,105,"26",79,0.3224,0.3377,0.3261
"5657",212911,2003,"313",164,149,275,"132",143,0.872,0.8859,0.8786
"5658",213020,2003,"2847",1669,1178,822,"242",580,0.3475,0.2054,0.2887
"5659",213251,2003,"381",200,181,284,"135",149,0.745,0.7459,0.7454
"5660",213321,2003,"448",166,282,284,"164",120,0.7229,0.5816,0.6339
"5661",213349,2003,"1825",1035,790,549,"158",391,0.3778,0.2,0.3008
"5662",213358,2003,"174",124,50,58,"13",45,0.3629,0.26,0.3333
"5663",213367,2003,"809",423,386,461,"204",257,0.6076,0.5285,0.5698
"5664",213385,2003,"584",268,316,502,"267",235,0.8769,0.8449,0.8596
"5665",213507,2003,"429",231,198,292,"119",173,0.7489,0.601,0.6807
"5666",213543,2003,"1124",448,676,854,"487",367,0.8192,0.7204,0.7598
"5667",213613,2003,"1145",657,488,316,"104",212,0.3227,0.2131,0.276
"5668",213668,2003,"381",226,155,254,"97",157,0.6947,0.6258,0.6667
"5669",213783,2003,"690",403,287,179,"74",105,0.2605,0.2578,0.2594
"5670",213826,2003,"277",199,78,152,"34",118,0.593,0.4359,0.5487
"5671",213996,2003,"735",463,272,529,"189",340,0.7343,0.6949,0.7197
"5672",214041,2003,"1334",754,580,478,"159",319,0.4231,0.2741,0.3583
"5673",214069,2003,"313",233,80,206,"49",157,0.6738,0.6125,0.6581
"5674",214157,2003,"379",239,140,270,"90",180,0.7531,0.6429,0.7124
"5675",214175,2003,"589",354,235,485,"179",306,0.8644,0.7617,0.8234
"5676",214272,2003,"510",327,183,209,"72",137,0.419,0.3934,0.4098
"5677",214777,2003,"6035",3058,2977,3747,"1598",2149,0.7027,0.5368,0.6209
"5678",215062,2003,"2378",1221,1157,2082,"992",1090,0.8927,0.8574,0.8755
"5679",215743,2003,"332",200,132,174,"63",111,0.555,0.4773,0.5241
"5680",215798,2003,"362",196,166,221,"91",130,0.6633,0.5482,0.6105
"5681",215929,2003,"974",538,436,716,"307",409,0.7602,0.7041,0.7351
"5682",216010,2003,"1485",742,743,666,"271",395,0.5323,0.3647,0.4485
"5683",216038,2003,"1465",803,662,455,"158",297,0.3699,0.2387,0.3106
"5684",216287,2003,"368",198,170,316,"141",175,0.8838,0.8294,0.8587
"5685",216339,2003,"3590",2106,1484,1232,"459",773,0.367,0.3093,0.3432
"5686",216524,2003,"453",233,220,356,"163",193,0.8283,0.7409,0.7859
"5687",216694,2003,"327",157,170,157,"70",87,0.5541,0.4118,0.4801
"5688",216764,2003,"1723",1119,604,685,"152",533,0.4763,0.2517,0.3976
"5689",216807,2003,"337",206,131,200,"61",139,0.6748,0.4656,0.5935
"5690",216852,2003,"578",286,292,237,"90",147,0.514,0.3082,0.41
"5691",216931,2003,"509",235,274,254,"107",147,0.6255,0.3905,0.499
"5692",217059,2003,"1013",541,472,425,"171",254,0.4695,0.3623,0.4195
"5693",217156,2003,"1392",736,656,1192,"539",653,0.8872,0.8216,0.8563
"5694",217402,2003,"975",561,414,823,"339",484,0.8627,0.8188,0.8441
"5695",217536,2003,"571",401,170,361,"91",270,0.6733,0.5353,0.6322
"5696",217776,2003,"160",100,60,41,"17",24,0.24,0.2833,0.2562
"5697",217819,2003,"1868",1229,639,896,"251",645,0.5248,0.3928,0.4797
"5698",217882,2003,"2748",1293,1455,1379,"535",844,0.6527,0.3677,0.5018
"5699",217998,2003,"176",102,74,111,"43",68,0.6667,0.5811,0.6307
"5700",218061,2003,"765",447,318,153,"48",105,0.2349,0.1509,0.2
"5701",218229,2003,"541",356,185,139,"30",109,0.3062,0.1622,0.2569
"5702",218238,2003,"176",98,78,35,"15",20,0.2041,0.1923,0.1989
"5703",218399,2003,"276",168,108,46,"9",37,0.2202,0.0833,0.1667
"5704",218414,2003,"203",69,134,64,"36",28,0.4058,0.2687,0.3153
"5705",218663,2003,"3441",1949,1492,1578,"586",992,0.509,0.3928,0.4586
"5706",218724,2003,"1266",618,648,283,"109",174,0.2816,0.1682,0.2235
"5707",218733,2003,"794",453,341,106,"33",73,0.1611,0.0968,0.1335
"5708",218742,2003,"684",450,234,139,"35",104,0.2311,0.1496,0.2032
"5709",218973,2003,"330",163,167,255,"127",128,0.7853,0.7605,0.7727
"5710",219000,2003,"424",281,143,217,"61",156,0.5552,0.4266,0.5118
"5711",219046,2003,"653",409,244,62,"17",45,0.11,0.0697,0.0949
"5712",219082,2003,"290",120,170,43,"18",25,0.2083,0.1059,0.1483
"5713",219198,2003,"158",113,45,33,"11",22,0.1947,0.2444,0.2089
"5714",219259,2003,"380",210,170,59,"16",43,0.2048,0.0941,0.1553
"5715",219356,2003,"1993",957,1036,427,"176",251,0.2623,0.1699,0.2142
"5716",219471,2003,"982",539,443,186,"76",110,0.2041,0.1716,0.1894
"5717",219602,2003,"967",609,358,118,"33",85,0.1396,0.0922,0.122
"5718",219709,2003,"599",360,239,312,"110",202,0.5611,0.4603,0.5209
"5719",219718,2003,"129",59,70,27,"10",17,0.2881,0.1429,0.2093
"5720",219949,2003,"149",76,73,24,"9",15,0.1974,0.1233,0.1611
"5721",220075,2003,"1563",921,642,301,"99",202,0.2193,0.1542,0.1926
"5722",220215,2003,"374",211,163,138,"53",85,0.4028,0.3252,0.369
"5723",220613,2003,"646",393,253,197,"66",131,0.3333,0.2609,0.305
"5724",220631,2003,"183",129,54,33,"7",26,0.2016,0.1296,0.1803
"5725",220710,2003,"293",140,153,133,"51",82,0.5857,0.3333,0.4539
"5726",221351,2003,"456",274,182,343,"140",203,0.7409,0.7692,0.7522
"5727",221519,2003,"426",239,187,318,"142",176,0.7364,0.7594,0.7465
"5728",221731,2003,"106",63,43,33,"4",29,0.4603,0.093,0.3113
"5729",221847,2003,"1374",577,797,300,"133",167,0.2894,0.1669,0.2183
"5730",221892,2003,"219",126,93,82,"31",51,0.4048,0.3333,0.3744
"5731",222178,2003,"948",489,459,369,"125",244,0.499,0.2723,0.3892
"5732",222983,2003,"338",193,145,228,"86",142,0.7358,0.5931,0.6746
"5733",223232,2003,"2667",1673,994,1266,"347",919,0.5493,0.3491,0.4747
"5734",224004,2003,"154",83,71,26,"13",13,0.1566,0.1831,0.1688
"5735",224323,2003,"299",189,110,185,"58",127,0.672,0.5273,0.6187
"5736",225432,2003,"1012",559,453,16,"5",11,0.0197,0.011,0.0158
"5737",225548,2003,"293",136,157,76,"27",49,0.3603,0.172,0.2594
"5738",225627,2003,"396",280,116,70,"18",52,0.1857,0.1552,0.1768
"5739",226231,2003,"333",94,239,93,"52",41,0.4362,0.2176,0.2793
"5740",226833,2003,"613",302,311,41,"18",23,0.0762,0.0579,0.0669
"5741",227216,2003,"3320",1945,1375,632,"194",438,0.2252,0.1411,0.1904
"5742",227331,2003,"322",238,84,60,"10",50,0.2101,0.119,0.1863
"5743",227526,2003,"1553",820,733,175,"71",104,0.1268,0.0969,0.1127
"5744",227757,2003,"716",364,352,591,"279",312,0.8571,0.7926,0.8254
"5745",227845,2003,"544",327,217,239,"78",161,0.4924,0.3594,0.4393
"5746",227863,2003,"292",172,120,87,"33",54,0.314,0.275,0.2979
"5747",228042,2003,"168",88,80,40,"14",26,0.2955,0.175,0.2381
"5748",228149,2003,"470",292,178,147,"41",106,0.363,0.2303,0.3128
"5749",228246,2003,"1383",772,611,853,"324",529,0.6852,0.5303,0.6168
"5750",228343,2003,"343",196,147,234,"80",154,0.7857,0.5442,0.6822
"5751",228431,2003,"1839",1148,691,348,"88",260,0.2265,0.1274,0.1892
"5752",228459,2003,"2818",1681,1137,667,"195",472,0.2808,0.1715,0.2367
"5753",228501,2003,"357",163,194,30,"11",19,0.1166,0.0567,0.084
"5754",228529,2003,"1277",686,591,201,"62",139,0.2026,0.1049,0.1574
"5755",228705,2003,"828",370,458,60,"24",36,0.0973,0.0524,0.0725
"5756",228723,2003,"6389",3358,3031,2898,"981",1917,0.5709,0.3237,0.4536
"5757",228769,2003,"2431",1182,1249,364,"144",220,0.1861,0.1153,0.1497
"5758",228778,2003,"6477",3537,2940,3300,"1309",1991,0.5629,0.4452,0.5095
"5759",228787,2003,"1043",420,623,446,"242",204,0.4857,0.3884,0.4276
"5760",228796,2003,"2386",1237,1149,111,"46",65,0.0525,0.04,0.0465
"5761",228875,2003,"1598",1005,593,877,"273",604,0.601,0.4604,0.5488
"5762",228981,2003,"375",212,163,117,"38",79,0.3726,0.2331,0.312
"5763",229018,2003,"292",160,132,52,"19",33,0.2062,0.1439,0.1781
"5764",229027,2003,"4091",2070,2021,310,"107",203,0.0981,0.0529,0.0758
"5765",229115,2003,"4312",2039,2273,1372,"547",825,0.4046,0.2407,0.3182
"5766",229780,2003,"205",112,93,41,"13",28,0.25,0.1398,0.2
"5767",229814,2003,"774",404,370,125,"31",94,0.2327,0.0838,0.1615
"5768",230603,2003,"478",338,140,103,"17",86,0.2544,0.1214,0.2155
"5769",230728,2003,"1829",1229,600,491,"86",405,0.3295,0.1433,0.2685
"5770",230764,2003,"1870",1073,797,405,"129",276,0.2572,0.1619,0.2166
"5771",230782,2003,"1688",944,744,90,"31",59,0.0625,0.0417,0.0533
"5772",231059,2003,"512",263,249,362,"158",204,0.7757,0.6345,0.707
"5773",231174,2003,"1916",1089,827,1087,"439",648,0.595,0.5308,0.5673
"5774",231420,2003,"219",83,136,78,"34",44,0.5301,0.25,0.3562
"5775",231554,2003,"83",50,33,27,"10",17,0.34,0.303,0.3253
"5776",231624,2003,"1319",736,583,1098,"439",659,0.8954,0.753,0.8324
"5777",231712,2003,"1205",619,586,475,"176",299,0.483,0.3003,0.3942
"5778",232025,2003,"223",106,117,96,"43",53,0.5,0.3675,0.4305
"5779",232043,2003,"195",121,74,94,"32",62,0.5124,0.4324,0.4821
"5780",232089,2003,"301",106,195,71,"37",34,0.3208,0.1897,0.2359
"5781",232186,2003,"2191",1166,1025,847,"284",563,0.4828,0.2771,0.3866
"5782",232265,2003,"1379",873,506,506,"131",375,0.4296,0.2589,0.3669
"5783",232423,2003,"3386",2167,1219,2220,"697",1523,0.7028,0.5718,0.6556
"5784",232557,2003,"1811",1024,787,506,"190",316,0.3086,0.2414,0.2794
"5785",232566,2003,"872",576,296,340,"91",249,0.4323,0.3074,0.3899
"5786",232609,2003,"589",342,247,316,"116",200,0.5848,0.4696,0.5365
"5787",232681,2003,"879",572,307,590,"181",409,0.715,0.5896,0.6712
"5788",232706,2003,"379",290,89,158,"30",128,0.4414,0.3371,0.4169
"5789",232937,2003,"1080",593,487,123,"41",82,0.1383,0.0842,0.1139
"5790",232982,2003,"2001",1139,862,457,"136",321,0.2818,0.1578,0.2284
"5791",233277,2003,"1800",1097,703,719,"214",505,0.4603,0.3044,0.3994
"5792",233374,2003,"835",440,395,688,"313",375,0.8523,0.7924,0.824
"5793",233426,2003,"519",282,237,301,"130",171,0.6064,0.5485,0.58
"5794",233541,2003,"328",185,143,106,"34",72,0.3892,0.2378,0.3232
"5795",233897,2003,"349",177,172,109,"39",70,0.3955,0.2267,0.3123
"5796",233921,2003,"4923",2092,2831,2588,"1213",1375,0.6573,0.4285,0.5257
"5797",234030,2003,"3230",1912,1318,779,"218",561,0.2934,0.1654,0.2412
"5798",234085,2003,"384",36,348,246,"223",23,0.6389,0.6408,0.6406
"5799",234155,2003,"959",563,396,240,"62",178,0.3162,0.1566,0.2503
"5800",234164,2003,"512",318,194,99,"16",83,0.261,0.0825,0.1934
"5801",235097,2003,"1374",843,531,295,"81",214,0.2539,0.1525,0.2147
"5802",235167,2003,"454",246,208,193,"98",95,0.3862,0.4712,0.4251
"5803",236230,2003,"693",426,267,361,"118",243,0.5704,0.4419,0.5209
"5804",236328,2003,"639",358,281,438,"164",274,0.7654,0.5836,0.6854
"5805",236577,2003,"683",485,198,410,"105",305,0.6289,0.5303,0.6003
"5806",236595,2003,"619",418,201,323,"75",248,0.5933,0.3731,0.5218
"5807",236896,2003,"326",157,169,66,"31",35,0.2229,0.1834,0.2025
"5808",236939,2003,"2997",1613,1384,1204,"417",787,0.4879,0.3013,0.4017
"5809",236948,2003,"4948",2654,2294,2665,"1106",1559,0.5874,0.4821,0.5386
"5810",237011,2003,"2194",1266,928,778,"233",545,0.4305,0.2511,0.3546
"5811",237057,2003,"362",182,180,294,"144",150,0.8242,0.8,0.8122
"5812",237066,2003,"438",259,179,267,"105",162,0.6255,0.5866,0.6096
"5813",237215,2003,"273",155,118,15,"7",8,0.0516,0.0593,0.0549
"5814",237330,2003,"508",286,222,98,"29",69,0.2413,0.1306,0.1929
"5815",237358,2003,"104",60,44,27,"8",19,0.3167,0.1818,0.2596
"5816",237367,2003,"631",317,314,85,"31",54,0.1703,0.0987,0.1347
"5817",237792,2003,"768",440,328,134,"48",86,0.1955,0.1463,0.1745
"5818",237899,2003,"333",187,146,20,"6",14,0.0749,0.0411,0.0601
"5819",237932,2003,"453",248,205,69,"16",53,0.2137,0.078,0.1523
"5820",237969,2003,"457",257,200,197,"64",133,0.5175,0.32,0.4311
"5821",238032,2003,"4366",2104,2262,1387,"583",804,0.3821,0.2577,0.3177
"5822",238333,2003,"346",217,129,251,"88",163,0.7512,0.6822,0.7254
"5823",238430,2003,"205",136,69,28,"11",17,0.125,0.1594,0.1366
"5824",238458,2003,"501",329,172,220,"62",158,0.4802,0.3605,0.4391
"5825",238476,2003,"575",307,268,249,"103",146,0.4756,0.3843,0.433
"5826",238616,2003,"352",192,160,111,"35",76,0.3958,0.2188,0.3153
"5827",238661,2003,"307",229,78,85,"14",71,0.31,0.1795,0.2769
"5828",239080,2003,"251",170,81,72,"17",55,0.3235,0.2099,0.2869
"5829",239105,2003,"1882",1042,840,1125,"462",663,0.6363,0.55,0.5978
"5830",239628,2003,"259",130,129,156,"72",84,0.6462,0.5581,0.6023
"5831",239716,2003,"529",289,240,336,"128",208,0.7197,0.5333,0.6352
"5832",240107,2003,"355",261,94,107,"18",89,0.341,0.1915,0.3014
"5833",240189,2003,"1825",975,850,459,"199",260,0.2667,0.2341,0.2515
"5834",240277,2003,"960",640,320,241,"70",171,0.2672,0.2188,0.251
"5835",240329,2003,"1506",984,522,507,"153",354,0.3598,0.2931,0.3367
"5836",240338,2003,"207",126,81,110,"31",79,0.627,0.3827,0.5314
"5837",240365,2003,"1765",1077,688,261,"67",194,0.1801,0.0974,0.1479
"5838",240374,2003,"863",469,394,68,"27",41,0.0874,0.0685,0.0788
"5839",240417,2003,"1267",654,613,244,"75",169,0.2584,0.1223,0.1926
"5840",240426,2003,"336",213,123,66,"14",52,0.2441,0.1138,0.1964
"5841",240444,2003,"5553",2968,2585,2689,"1114",1575,0.5307,0.4309,0.4842
"5842",240453,2003,"3716",2023,1693,552,"217",335,0.1656,0.1282,0.1485
"5843",240462,2003,"1116",406,710,203,"105",98,0.2414,0.1479,0.1819
"5844",240471,2003,"1220",757,463,305,"98",207,0.2734,0.2117,0.25
"5845",240480,2003,"1498",853,645,335,"101",234,0.2743,0.1566,0.2236
"5846",240727,2003,"1388",709,679,310,"102",208,0.2934,0.1502,0.2233
"5847",243443,2003,"425",274,151,10,"3",7,0.0255,0.0199,0.0235
"5848",243780,2003,"6459",2559,3900,2254,"1121",1133,0.4428,0.2874,0.349
"5849",100654,2002,"1043",506,537,118,"37",81,0.1601,0.0689,0.1131
"5850",100663,2002,"1398",820,578,228,"86",142,0.1732,0.1488,0.1631
"5851",100751,2002,"2585",1441,1144,932,"318",614,0.4261,0.278,0.3605
"5852",100858,2002,"4148",2184,1964,1424,"498",926,0.424,0.2536,0.3433
"5853",101435,2002,"165",108,57,76,"21",55,0.5093,0.3684,0.4606
"5854",101480,2002,"1059",567,492,146,"41",105,0.1852,0.0833,0.1379
"5855",101675,2002,"391",195,196,24,"7",17,0.0872,0.0357,0.0614
"5856",101879,2002,"786",457,329,104,"27",77,0.1685,0.0821,0.1323
"5857",102049,2002,"652",428,224,5,"0",5,0.0117,0,0.0077
"5858",102094,2002,"1004",597,407,135,"42",93,0.1558,0.1032,0.1345
"5859",102234,2002,"289",168,121,151,"60",91,0.5417,0.4959,0.5225
"5860",102368,2002,"1353",730,623,288,"101",187,0.2562,0.1621,0.2129
"5861",102377,2002,"738",426,312,168,"36",132,0.3099,0.1154,0.2276
"5862",104151,2002,"6094",3323,2771,1813,"661",1152,0.3467,0.2385,0.2975
"5863",104179,2002,"5613",3008,2605,1805,"703",1102,0.3664,0.2699,0.3216
"5864",105330,2002,"2153",1327,826,681,"173",508,0.3828,0.2094,0.3163
"5865",106245,2002,"739",456,283,72,"19",53,0.1162,0.0671,0.0974
"5866",106342,2002,"113",47,66,62,"33",29,0.617,0.5,0.5487
"5867",106397,2002,"2137",1106,1031,707,"284",423,0.3825,0.2755,0.3308
"5868",106412,2002,"712",358,354,63,"16",47,0.1313,0.0452,0.0885
"5869",106458,2002,"1539",813,726,291,"109",182,0.2239,0.1501,0.1891
"5870",106467,2002,"1169",624,545,207,"80",127,0.2035,0.1468,0.1771
"5871",106485,2002,"645",368,277,46,"14",32,0.087,0.0505,0.0713
"5872",106704,2002,"1766",1062,704,389,"108",281,0.2646,0.1534,0.2203
"5873",107044,2002,"1011",580,431,383,"138",245,0.4224,0.3202,0.3788
"5874",107080,2002,"317",184,133,199,"73",126,0.6848,0.5489,0.6278
"5875",107141,2002,"303",186,117,176,"64",112,0.6022,0.547,0.5809
"5876",107512,2002,"396",229,167,166,"64",102,0.4454,0.3832,0.4192
"5877",107558,2002,"200",97,103,60,"28",32,0.3299,0.2718,0.3
"5878",110097,2002,"656",414,242,345,"108",237,0.5725,0.4463,0.5259
"5879",110404,2002,"252",73,179,203,"138",65,0.8904,0.7709,0.8056
"5880",110422,2002,"2565",1158,1407,587,"209",378,0.3264,0.1485,0.2288
"5881",110486,2002,"679",408,271,99,"28",71,0.174,0.1033,0.1458
"5882",110495,2002,"550",360,190,116,"20",96,0.2667,0.1053,0.2109
"5883",110510,2002,"1161",751,410,142,"32",110,0.1465,0.078,0.1223
"5884",110529,2002,"2674",1080,1594,345,"161",184,0.1704,0.101,0.129
"5885",110538,2002,"1995",1125,870,372,"95",277,0.2462,0.1092,0.1865
"5886",110547,2002,"630",466,164,28,"6",22,0.0472,0.0366,0.0444
"5887",110556,2002,"2189",1274,915,346,"109",237,0.186,0.1191,0.1581
"5888",110565,2002,"3291",2039,1252,481,"111",370,0.1815,0.0887,0.1462
"5889",110574,2002,"746",473,273,119,"43",76,0.1607,0.1575,0.1595
"5890",110583,2002,"2912",1871,1041,365,"91",274,0.1464,0.0874,0.1253
"5891",110592,2002,"1404",906,498,116,"34",82,0.0905,0.0683,0.0826
"5892",110617,2002,"2378",1395,983,221,"56",165,0.1183,0.057,0.0929
"5893",113698,2002,"202",145,57,75,"19",56,0.3862,0.3333,0.3713
"5894",115755,2002,"836",505,331,97,"28",69,0.1366,0.0846,0.116
"5895",119173,2002,"127",123,4,64,"1",63,0.5122,0.25,0.5039
"5896",120184,2002,"97",57,40,42,"12",30,0.5263,0.3,0.433
"5897",121309,2002,"535",324,211,321,"111",210,0.6481,0.5261,0.6
"5898",121345,2002,"374",191,183,338,"158",180,0.9424,0.8634,0.9037
"5899",122409,2002,"3662",2217,1445,879,"237",642,0.2896,0.164,0.24
"5900",122436,2002,"1049",681,368,672,"219",453,0.6652,0.5951,0.6406
"5901",122597,2002,"2130",1378,752,211,"52",159,0.1154,0.0691,0.0991
"5902",122612,2002,"839",582,257,431,"132",299,0.5137,0.5136,0.5137
"5903",122931,2002,"1116",659,457,873,"342",531,0.8058,0.7484,0.7823
"5904",123554,2002,"663",408,255,381,"141",240,0.5882,0.5529,0.5747
"5905",123572,2002,"1210",816,394,289,"53",236,0.2892,0.1345,0.2388
"5906",126562,2002,"580",326,254,86,"26",60,0.184,0.1024,0.1483
"5907",126580,2002,"834",501,333,211,"66",145,0.2894,0.1982,0.253
"5908",126614,2002,"5377",2607,2770,2218,"1001",1217,0.4668,0.3614,0.4125
"5909",126818,2002,"3783",2121,1662,1340,"442",898,0.4234,0.2659,0.3542
"5910",127060,2002,"988",527,461,571,"235",336,0.6376,0.5098,0.5779
"5911",127185,2002,"1035",467,568,147,"59",88,0.1884,0.1039,0.142
"5912",127565,2002,"1655",852,803,73,"25",48,0.0563,0.0311,0.0441
"5913",127741,2002,"1938",1253,685,548,"116",432,0.3448,0.1693,0.2828
"5914",128106,2002,"642",329,313,105,"39",66,0.2006,0.1246,0.1636
"5915",128744,2002,"234",144,90,66,"23",43,0.2986,0.2556,0.2821
"5916",128771,2002,"1473",735,738,192,"61",131,0.1782,0.0827,0.1303
"5917",129020,2002,"3157",1722,1435,1766,"674",1092,0.6341,0.4697,0.5594
"5918",129242,2002,"813",461,352,609,"240",369,0.8004,0.6818,0.7491
"5919",129941,2002,"529",240,289,166,"67",99,0.4125,0.2318,0.3138
"5920",130253,2002,"797",457,340,445,"171",274,0.5996,0.5029,0.5583
"5921",130314,2002,"201",201,0,69,"0",69,0.3433,NA,0.3433
"5922",130493,2002,"1276",719,557,144,"46",98,0.1363,0.0826,0.1129
"5923",130590,2002,"548",286,262,445,"207",238,0.8322,0.7901,0.812
"5924",130697,2002,"716",377,339,634,"288",346,0.9178,0.8496,0.8855
"5925",130776,2002,"794",434,360,113,"32",81,0.1866,0.0889,0.1423
"5926",130794,2002,"1299",643,656,1164,"576",588,0.9145,0.878,0.8961
"5927",130934,2002,"761",439,322,1,"0",1,0.0023,0,0.0013
"5928",130943,2002,"3712",2222,1490,2282,"777",1505,0.6773,0.5215,0.6148
"5929",131159,2002,"1303",811,492,917,"329",588,0.725,0.6687,0.7038
"5930",131283,2002,"700",406,294,438,"170",268,0.6601,0.5782,0.6257
"5931",131450,2002,"235",122,113,12,"6",6,0.0492,0.0531,0.0511
"5932",131469,2002,"2283",1359,924,1735,"660",1075,0.791,0.7143,0.76
"5933",131496,2002,"1477",795,682,1324,"608",716,0.9006,0.8915,0.8964
"5934",131520,2002,"1366",931,435,621,"125",496,0.5328,0.2874,0.4546
"5935",132471,2002,"446",273,173,110,"34",76,0.2784,0.1965,0.2466
"5936",132602,2002,"607",351,256,161,"59",102,0.2906,0.2305,0.2652
"5937",132903,2002,"5330",2851,2479,1736,"578",1158,0.4062,0.2332,0.3257
"5938",133492,2002,"442",239,203,261,"117",144,0.6025,0.5764,0.5905
"5939",133553,2002,"872",148,724,315,"244",71,0.4797,0.337,0.3612
"5940",133650,2002,"2097",1249,848,280,"77",203,0.1625,0.0908,0.1335
"5941",133669,2002,"1994",1102,892,323,"115",208,0.1887,0.1289,0.162
"5942",133711,2002,"481",308,173,231,"70",161,0.5227,0.4046,0.4802
"5943",133881,2002,"518",139,379,218,"142",76,0.5468,0.3747,0.4208
"5944",133951,2002,"2801",1617,1184,566,"176",390,0.2412,0.1486,0.2021
"5945",134079,2002,"491",322,169,184,"41",143,0.4441,0.2426,0.3747
"5946",134097,2002,"6258",3742,2516,2927,"959",1968,0.5259,0.3812,0.4677
"5947",134130,2002,"6406",3674,2732,3586,"1215",2371,0.6453,0.4447,0.5598
"5948",134945,2002,"389",165,224,105,"52",53,0.3212,0.2321,0.2699
"5949",135726,2002,"2046",1197,849,1311,"497",814,0.68,0.5854,0.6408
"5950",136172,2002,"1865",1067,798,395,"129",266,0.2493,0.1617,0.2118
"5951",136950,2002,"466",280,186,278,"97",181,0.6464,0.5215,0.5966
"5952",137546,2002,"542",325,217,299,"104",195,0.6,0.4793,0.5517
"5953",138354,2002,"760",443,317,172,"52",120,0.2709,0.164,0.2263
"5954",138716,2002,"470",300,170,88,"22",66,0.22,0.1294,0.1872
"5955",138789,2002,"581",350,231,48,"13",35,0.1,0.0563,0.0826
"5956",139144,2002,"565",353,212,276,"94",182,0.5156,0.4434,0.4885
"5957",139366,2002,"943",548,395,91,"18",73,0.1332,0.0456,0.0965
"5958",139393,2002,"231",141,90,129,"44",85,0.6028,0.4889,0.5584
"5959",139658,2002,"1558",903,655,1061,"444",617,0.6833,0.6779,0.681
"5960",139719,2002,"386",192,194,59,"12",47,0.2448,0.0619,0.1528
"5961",139755,2002,"2275",636,1639,711,"445",266,0.4182,0.2715,0.3125
"5962",139764,2002,"331",216,115,46,"15",31,0.1435,0.1304,0.139
"5963",139861,2002,"984",612,372,199,"45",154,0.2516,0.121,0.2022
"5964",139931,2002,"2597",1232,1365,434,"138",296,0.2403,0.1011,0.1671
"5965",139940,2002,"2469",1419,1050,423,"107",316,0.2227,0.1019,0.1713
"5966",139959,2002,"4282",2570,1712,2155,"713",1442,0.5611,0.4165,0.5033
"5967",140447,2002,"687",387,300,275,"93",182,0.4703,0.31,0.4003
"5968",140960,2002,"496",269,227,52,"7",45,0.1673,0.0308,0.1048
"5969",140988,2002,"218",144,74,80,"23",57,0.3958,0.3108,0.367
"5970",141185,2002,"175",106,69,88,"37",51,0.4811,0.5362,0.5029
"5971",141264,2002,"1584",973,611,239,"54",185,0.1901,0.0884,0.1509
"5972",141334,2002,"1617",921,696,181,"41",140,0.152,0.0589,0.1119
"5973",141486,2002,"212",154,58,23,"8",15,0.0974,0.1379,0.1085
"5974",141565,2002,"404",238,166,57,"17",40,0.1681,0.1024,0.1411
"5975",141574,2002,"1726",970,756,251,"74",177,0.1825,0.0979,0.1454
"5976",142276,2002,"704",474,230,59,"5",54,0.1139,0.0217,0.0838
"5977",142285,2002,"1619",784,835,371,"153",218,0.2781,0.1832,0.2292
"5978",142461,2002,"276",169,107,87,"38",49,0.2899,0.3551,0.3152
"5979",143084,2002,"601",349,252,417,"158",259,0.7421,0.627,0.6938
"5980",143288,2002,"147",75,72,44,"16",28,0.3733,0.2222,0.2993
"5981",144005,2002,"438",302,136,11,"2",9,0.0298,0.0147,0.0251
"5982",144281,2002,"1589",854,735,401,"164",237,0.2775,0.2231,0.2524
"5983",144740,2002,"2231",1323,908,985,"346",639,0.483,0.3811,0.4415
"5984",144892,2002,"1984",1143,841,582,"183",399,0.3491,0.2176,0.2933
"5985",144962,2002,"295",185,110,157,"41",116,0.627,0.3727,0.5322
"5986",144971,2002,"136",70,66,50,"16",34,0.4857,0.2424,0.3676
"5987",145600,2002,"2952",1674,1278,607,"248",359,0.2145,0.1941,0.2056
"5988",145619,2002,"303",165,138,150,"56",94,0.5697,0.4058,0.495
"5989",145637,2002,"6354",3120,3234,4027,"1814",2213,0.7093,0.5609,0.6338
"5990",145691,2002,"306",170,136,156,"60",96,0.5647,0.4412,0.5098
"5991",145813,2002,"3097",1933,1164,1279,"366",913,0.4723,0.3144,0.413
"5992",146481,2002,"358",219,139,213,"71",142,0.6484,0.5108,0.595
"5993",146612,2002,"366",161,205,132,"66",66,0.4099,0.322,0.3607
"5994",146719,2002,"1623",1069,554,821,"261",560,0.5239,0.4711,0.5059
"5995",146825,2002,"127",72,55,46,"14",32,0.4444,0.2545,0.3622
"5996",147013,2002,"258",135,123,127,"48",79,0.5852,0.3902,0.4922
"5997",147244,2002,"634",351,283,335,"117",218,0.6211,0.4134,0.5284
"5998",147341,2002,"282",147,135,150,"61",89,0.6054,0.4519,0.5319
"5999",147703,2002,"3015",1585,1430,698,"283",415,0.2618,0.1979,0.2315
"6000",147767,2002,"2000",1075,925,1725,"759",966,0.8986,0.8205,0.8625
"6001",147776,2002,"977",589,388,27,"9",18,0.0306,0.0232,0.0276
"6002",147828,2002,"553",328,225,274,"95",179,0.5457,0.4222,0.4955
"6003",148131,2002,"229",112,117,88,"33",55,0.4911,0.2821,0.3843
"6004",148496,2002,"192",123,69,111,"29",82,0.6667,0.4203,0.5781
"6005",148584,2002,"149",86,63,49,"17",32,0.3721,0.2698,0.3289
"6006",148627,2002,"375",262,113,89,"24",65,0.2481,0.2124,0.2373
"6007",149222,2002,"2395",1037,1358,550,"262",288,0.2777,0.1929,0.2296
"6008",149231,2002,"1629",866,763,356,"126",230,0.2656,0.1651,0.2185
"6009",149772,2002,"1917",941,976,619,"280",339,0.3603,0.2869,0.3229
"6010",149781,2002,"569",286,283,447,"213",234,0.8182,0.7527,0.7856
"6011",150066,2002,"591",335,256,225,"72",153,0.4567,0.2812,0.3807
"6012",150136,2002,"4010",2207,1803,1327,"507",820,0.3715,0.2812,0.3309
"6013",150145,2002,"253",143,110,108,"34",74,0.5175,0.3091,0.4269
"6014",150163,2002,"936",595,341,485,"157",328,0.5513,0.4604,0.5182
"6015",150400,2002,"685",369,316,566,"259",307,0.832,0.8196,0.8263
"6016",150534,2002,"600",369,231,289,"100",189,0.5122,0.4329,0.4817
"6017",150668,2002,"133",81,52,74,"28",46,0.5679,0.5385,0.5564
"6018",150941,2002,"236",145,91,110,"40",70,0.4828,0.4396,0.4661
"6019",151102,2002,"1409",782,627,61,"24",37,0.0473,0.0383,0.0433
"6020",151111,2002,"2235",1286,949,195,"63",132,0.1026,0.0664,0.0872
"6021",151306,2002,"1891",1152,739,217,"50",167,0.145,0.0677,0.1148
"6022",151324,2002,"2083",1065,1018,393,"143",250,0.2347,0.1405,0.1887
"6023",151333,2002,"339",226,113,28,"5",23,0.1018,0.0442,0.0826
"6024",151342,2002,"660",390,270,36,"9",27,0.0692,0.0333,0.0545
"6025",151351,2002,"6987",3895,3092,3546,"1471",2075,0.5327,0.4757,0.5075
"6026",151360,2002,"602",365,237,39,"14",25,0.0685,0.0591,0.0648
"6027",151379,2002,"678",419,259,53,"11",42,0.1002,0.0425,0.0782
"6028",151388,2002,"303",200,103,19,"4",15,0.075,0.0388,0.0627
"6029",151777,2002,"309",178,131,137,"54",83,0.4663,0.4122,0.4434
"6030",151786,2002,"230",153,77,73,"16",57,0.3725,0.2078,0.3174
"6031",152080,2002,"1945",935,1010,1765,"909",856,0.9155,0.9,0.9075
"6032",152248,2002,"927",474,453,36,"16",20,0.0422,0.0353,0.0388
"6033",152363,2002,"276",155,121,108,"34",74,0.4774,0.281,0.3913
"6034",152530,2002,"452",244,208,322,"142",180,0.7377,0.6827,0.7124
"6035",152600,2002,"715",365,350,454,"197",257,0.7041,0.5629,0.635
"6036",153001,2002,"356",192,164,184,"79",105,0.5469,0.4817,0.5169
"6037",153108,2002,"425",234,191,263,"103",160,0.6838,0.5393,0.6188
"6038",153269,2002,"775",459,316,360,"148",212,0.4619,0.4684,0.4645
"6039",153384,2002,"368",202,166,297,"132",165,0.8168,0.7952,0.8071
"6040",153603,2002,"4167",1915,2252,1399,"566",833,0.435,0.2513,0.3357
"6041",153834,2002,"608",365,243,371,"135",236,0.6466,0.5556,0.6102
"6042",154095,2002,"1821",1139,682,610,"194",416,0.3652,0.2845,0.335
"6043",155089,2002,"203",121,82,35,"15",20,0.1653,0.1829,0.1724
"6044",155317,2002,"4013",2181,1832,1227,"477",750,0.3439,0.2604,0.3058
"6045",155335,2002,"143",79,64,37,"17",20,0.2532,0.2656,0.2587
"6046",155399,2002,"3338",1652,1686,828,"278",550,0.3329,0.1649,0.2481
"6047",155520,2002,"306",156,150,128,"46",82,0.5256,0.3067,0.4183
"6048",155627,2002,"112",35,77,32,"15",17,0.4857,0.1948,0.2857
"6049",155937,2002,"98",50,48,43,"14",29,0.58,0.2917,0.4388
"6050",156213,2002,"323",200,123,195,"80",115,0.575,0.6504,0.6037
"6051",156286,2002,"325",214,111,165,"46",119,0.5561,0.4144,0.5077
"6052",156295,2002,"356",206,150,158,"61",97,0.4709,0.4067,0.4438
"6053",156365,2002,"288",138,150,61,"18",43,0.3116,0.12,0.2118
"6054",156541,2002,"386",209,177,93,"31",62,0.2967,0.1751,0.2409
"6055",156745,2002,"328",199,129,150,"53",97,0.4874,0.4109,0.4573
"6056",157058,2002,"373",203,170,34,"6",28,0.1379,0.0353,0.0912
"6057",157076,2002,"150",77,73,44,"13",31,0.4026,0.1781,0.2933
"6058",157085,2002,"3701",1999,1702,1045,"362",683,0.3417,0.2127,0.2824
"6059",157289,2002,"2209",1153,1056,428,"157",271,0.235,0.1487,0.1938
"6060",157386,2002,"1563",882,681,172,"59",113,0.1281,0.0866,0.11
"6061",157401,2002,"1467",879,588,439,"130",309,0.3515,0.2211,0.2993
"6062",157447,2002,"1907",1084,823,185,"66",119,0.1098,0.0802,0.097
"6063",157535,2002,"226",129,97,40,"9",31,0.2403,0.0928,0.177
"6064",157951,2002,"2954",1714,1240,513,"136",377,0.22,0.1097,0.1737
"6065",158477,2002,"272",163,109,122,"42",80,0.4908,0.3853,0.4485
"6066",159009,2002,"850",430,420,107,"44",63,0.1465,0.1048,0.1259
"6067",159391,2002,"5170",2842,2328,1353,"464",889,0.3128,0.1993,0.2617
"6068",159647,2002,"1936",947,989,500,"202",298,0.3147,0.2042,0.2583
"6069",159717,2002,"1358",762,596,179,"67",112,0.147,0.1124,0.1318
"6070",159966,2002,"1404",821,583,120,"27",93,0.1133,0.0463,0.0855
"6071",160038,2002,"1875",1093,782,216,"80",136,0.1244,0.1023,0.1152
"6072",160612,2002,"2382",1370,1012,168,"49",119,0.0869,0.0484,0.0705
"6073",160621,2002,"1176",673,503,77,"14",63,0.0936,0.0278,0.0655
"6074",160658,2002,"2385",1326,1059,293,"77",216,0.1629,0.0727,0.1229
"6075",161004,2002,"457",237,220,384,"196",188,0.7932,0.8909,0.8403
"6076",161226,2002,"453",295,158,156,"40",116,0.3932,0.2532,0.3444
"6077",161235,2002,"130",61,69,30,"15",15,0.2459,0.2174,0.2308
"6078",161244,2002,"132",81,51,19,"9",10,0.1235,0.1765,0.1439
"6079",161253,2002,"1651",808,843,554,"246",308,0.3812,0.2918,0.3356
"6080",161554,2002,"895",519,376,118,"39",79,0.1522,0.1037,0.1318
"6081",162007,2002,"566",352,214,102,"24",78,0.2216,0.1121,0.1802
"6082",162210,2002,"176",104,72,17,"2",15,0.1442,0.0278,0.0966
"6083",162283,2002,"578",430,148,30,"3",27,0.0628,0.0203,0.0519
"6084",162584,2002,"999",492,507,220,"67",153,0.311,0.1321,0.2202
"6085",162654,2002,"365",265,100,208,"48",160,0.6038,0.48,0.5699
"6086",162760,2002,"179",172,7,108,"3",105,0.6105,0.4286,0.6034
"6087",162928,2002,"1203",539,664,960,"501",459,0.8516,0.7545,0.798
"6088",163046,2002,"901",527,374,733,"295",438,0.8311,0.7888,0.8135
"6089",163268,2002,"1356",572,784,437,"210",227,0.3969,0.2679,0.3223
"6090",163286,2002,"3886",1961,1925,2452,"1128",1324,0.6752,0.586,0.631
"6091",163453,2002,"1247",741,506,139,"26",113,0.1525,0.0514,0.1115
"6092",163462,2002,"399",211,188,233,"97",136,0.6445,0.516,0.584
"6093",163851,2002,"908",529,379,417,"121",296,0.5595,0.3193,0.4593
"6094",163912,2002,"425",243,182,286,"113",173,0.7119,0.6209,0.6729
"6095",164076,2002,"2198",1385,813,815,"229",586,0.4231,0.2817,0.3708
"6096",164173,2002,"487",365,122,281,"63",218,0.5973,0.5164,0.577
"6097",164216,2002,"368",243,125,276,"88",188,0.7737,0.704,0.75
"6098",164270,2002,"440",253,187,307,"124",183,0.7233,0.6631,0.6977
"6099",164447,2002,"256",117,139,55,"21",34,0.2906,0.1511,0.2148
"6100",164492,2002,"159",108,51,82,"29",53,0.4907,0.5686,0.5157
"6101",164562,2002,"618",381,237,451,"168",283,0.7428,0.7089,0.7298
"6102",165015,2002,"837",456,381,708,"316",392,0.8596,0.8294,0.8459
"6103",165024,2002,"1272",769,503,277,"72",205,0.2666,0.1431,0.2178
"6104",165334,2002,"576",357,219,387,"148",239,0.6695,0.6758,0.6719
"6105",165662,2002,"656",419,237,473,"179",294,0.7017,0.7553,0.721
"6106",165671,2002,"322",258,64,179,"31",148,0.5736,0.4844,0.5559
"6107",165820,2002,"496",292,204,119,"41",78,0.2671,0.201,0.2399
"6108",165866,2002,"716",500,216,193,"38",155,0.31,0.1759,0.2696
"6109",165936,2002,"400",266,134,248,"77",171,0.6429,0.5746,0.62
"6110",166027,2002,"1619",783,836,1422,"710",712,0.9093,0.8493,0.8783
"6111",166124,2002,"669",348,321,644,"300",344,0.9885,0.9346,0.9626
"6112",166513,2002,"1013",371,642,289,"138",151,0.407,0.215,0.2853
"6113",166629,2002,"3411",1799,1612,1682,"707",975,0.542,0.4386,0.4931
"6114",166638,2002,"534",307,227,64,"16",48,0.1564,0.0705,0.1199
"6115",166683,2002,"977",420,557,806,"446",360,0.8571,0.8007,0.825
"6116",167288,2002,"265",159,106,106,"38",68,0.4277,0.3585,0.4
"6117",167987,2002,"1699",825,874,452,"191",261,0.3164,0.2185,0.266
"6118",167996,2002,"566",342,224,448,"160",288,0.8421,0.7143,0.7915
"6119",168005,2002,"787",481,306,307,"88",219,0.4553,0.2876,0.3901
"6120",168148,2002,"1276",736,540,1094,"455",639,0.8682,0.8426,0.8574
"6121",168254,2002,"682",301,381,298,"151",147,0.4884,0.3963,0.437
"6122",168281,2002,"411",255,156,316,"106",210,0.8235,0.6795,0.7689
"6123",168342,2002,"539",291,248,492,"226",266,0.9141,0.9113,0.9128
"6124",168546,2002,"525",293,232,330,"129",201,0.686,0.556,0.6286
"6125",168786,2002,"346",216,130,85,"25",60,0.2778,0.1923,0.2457
"6126",169080,2002,"1045",577,468,586,"228",358,0.6205,0.4872,0.5608
"6127",169798,2002,"2601",1564,1037,272,"91",181,0.1157,0.0878,0.1046
"6128",169910,2002,"2035",882,1153,138,"67",71,0.0805,0.0581,0.0678
"6129",170082,2002,"2868",1801,1067,634,"188",446,0.2476,0.1762,0.2211
"6130",170301,2002,"725",465,260,457,"139",318,0.6839,0.5346,0.6303
"6131",170532,2002,"335",177,158,239,"105",134,0.7571,0.6646,0.7134
"6132",170639,2002,"574",262,312,53,"29",24,0.0916,0.0929,0.0923
"6133",170976,2002,"5180",2704,2476,3641,"1634",2007,0.7422,0.6599,0.7029
"6134",171100,2002,"6829",3864,2965,3127,"1133",1994,0.516,0.3821,0.4579
"6135",171128,2002,"1186",267,919,306,"210",96,0.3596,0.2285,0.258
"6136",171137,2002,"735",342,393,105,"48",57,0.1667,0.1221,0.1429
"6137",171146,2002,"467",269,198,52,"16",36,0.1338,0.0808,0.1113
"6138",171599,2002,"238",85,153,82,"42",40,0.4706,0.2745,0.3445
"6139",172051,2002,"1109",654,455,97,"27",70,0.107,0.0593,0.0875
"6140",172699,2002,"4442",2318,2124,941,"381",560,0.2416,0.1794,0.2118
"6141",173160,2002,"567",348,219,370,"125",245,0.704,0.5708,0.6526
"6142",173258,2002,"499",264,235,447,"203",244,0.9242,0.8638,0.8958
"6143",173328,2002,"175",89,86,57,"19",38,0.427,0.2209,0.3257
"6144",173647,2002,"645",383,262,521,"216",305,0.7963,0.8244,0.8078
"6145",173902,2002,"440",241,199,370,"169",201,0.834,0.8492,0.8409
"6146",174066,2002,"5162",2762,2400,2118,"869",1249,0.4522,0.3621,0.4103
"6147",174233,2002,"2025",1029,996,476,"183",293,0.2847,0.1837,0.2351
"6148",174251,2002,"475",309,166,219,"71",148,0.479,0.4277,0.4611
"6149",174491,2002,"431",267,164,183,"75",108,0.4045,0.4573,0.4246
"6150",174792,2002,"468",0,468,340,"340",0,NA,0.7265,0.7265
"6151",174844,2002,"777",479,298,645,"235",410,0.8559,0.7886,0.8301
"6152",174899,2002,"382",286,96,218,"43",175,0.6119,0.4479,0.5707
"6153",174914,2002,"1095",577,518,629,"280",349,0.6049,0.5405,0.5744
"6154",175342,2002,"423",249,174,86,"23",63,0.253,0.1322,0.2033
"6155",175421,2002,"266",150,116,68,"19",49,0.3267,0.1638,0.2556
"6156",175616,2002,"336",200,136,58,"13",45,0.225,0.0956,0.1726
"6157",175856,2002,"1014",581,433,206,"49",157,0.2702,0.1132,0.2032
"6158",175980,2002,"251",125,126,159,"75",84,0.672,0.5952,0.6335
"6159",176017,2002,"2230",1150,1080,724,"271",453,0.3939,0.2509,0.3247
"6160",176035,2002,"250",223,27,61,"2",59,0.2646,0.0741,0.244
"6161",176044,2002,"269",129,140,37,"14",23,0.1783,0.1,0.1375
"6162",176080,2002,"1737",833,904,476,"181",295,0.3541,0.2002,0.274
"6163",176406,2002,"209",149,60,55,"12",43,0.2886,0.2,0.2632
"6164",176628,2002,"129",70,59,29,"5",24,0.3429,0.0847,0.2248
"6165",176947,2002,"232",100,132,61,"16",45,0.45,0.1212,0.2629
"6166",176965,2002,"1248",668,580,306,"106",200,0.2994,0.1828,0.2452
"6167",177418,2002,"183",134,49,76,"16",60,0.4478,0.3265,0.4153
"6168",178059,2002,"279",194,85,132,"46",86,0.4433,0.5412,0.4731
"6169",178341,2002,"614",334,280,78,"27",51,0.1527,0.0964,0.127
"6170",178387,2002,"1131",655,476,134,"52",82,0.1252,0.1092,0.1185
"6171",178396,2002,"4379",2284,2095,1813,"669",1144,0.5009,0.3193,0.414
"6172",178402,2002,"747",454,293,128,"41",87,0.1916,0.1399,0.1714
"6173",178411,2002,"785",150,635,175,"128",47,0.3133,0.2016,0.2229
"6174",178420,2002,"426",234,192,96,"29",67,0.2863,0.151,0.2254
"6175",178615,2002,"1441",872,569,654,"227",427,0.4897,0.3989,0.4539
"6176",179043,2002,"214",133,81,119,"44",75,0.5639,0.5432,0.5561
"6177",179159,2002,"1409",762,647,867,"366",501,0.6575,0.5657,0.6153
"6178",179557,2002,"1457",858,599,361,"105",256,0.2984,0.1753,0.2478
"6179",179566,2002,"2702",1609,1093,720,"205",515,0.3201,0.1876,0.2665
"6180",179867,2002,"1329",699,630,1127,"513",614,0.8784,0.8143,0.848
"6181",179894,2002,"385",226,159,178,"67",111,0.4912,0.4214,0.4623
"6182",179946,2002,"207",93,114,100,"48",52,0.5591,0.4211,0.4831
"6183",180179,2002,"542",357,185,48,"9",39,0.1092,0.0486,0.0886
"6184",180461,2002,"1924",833,1091,307,"130",177,0.2125,0.1192,0.1596
"6185",180522,2002,"185",87,98,23,"13",10,0.1149,0.1327,0.1243
"6186",180984,2002,"319",175,144,130,"41",89,0.5086,0.2847,0.4075
"6187",181002,2002,"802",488,314,534,"191",343,0.7029,0.6083,0.6658
"6188",181020,2002,"273",142,131,178,"84",94,0.662,0.6412,0.652
"6189",181127,2002,"276",132,144,148,"57",91,0.6894,0.3958,0.5362
"6190",181215,2002,"1022",574,448,216,"69",147,0.2561,0.154,0.2114
"6191",181394,2002,"1601",851,750,199,"77",122,0.1434,0.1027,0.1243
"6192",181446,2002,"336",187,149,157,"70",87,0.4652,0.4698,0.4673
"6193",181464,2002,"3615",1878,1737,919,"358",561,0.2987,0.2061,0.2542
"6194",181534,2002,"171",85,86,29,"10",19,0.2235,0.1163,0.1696
"6195",181783,2002,"602",325,277,155,"66",89,0.2738,0.2383,0.2575
"6196",182281,2002,"2383",1373,1010,293,"80",213,0.1551,0.0792,0.123
"6197",182290,2002,"2066",1137,929,308,"102",206,0.1812,0.1098,0.1491
"6198",182634,2002,"270",172,98,133,"54",79,0.4593,0.551,0.4926
"6199",182795,2002,"505",252,253,197,"88",109,0.4325,0.3478,0.3901
"6200",183062,2002,"1170",668,502,333,"119",214,0.3204,0.2371,0.2846
"6201",183080,2002,"940",447,493,279,"120",159,0.3557,0.2434,0.2968
"6202",183239,2002,"570",330,240,406,"148",258,0.7818,0.6167,0.7123
"6203",183822,2002,"339",216,123,57,"15",42,0.1944,0.122,0.1681
"6204",183974,2002,"236",147,89,97,"27",70,0.4762,0.3034,0.411
"6205",184348,2002,"396",231,165,281,"110",171,0.7403,0.6667,0.7096
"6206",184603,2002,"474",281,193,87,"34",53,0.1886,0.1762,0.1835
"6207",184612,2002,"208",151,57,45,"8",37,0.245,0.1404,0.2163
"6208",184782,2002,"1257",637,620,542,"224",318,0.4992,0.3613,0.4312
"6209",185129,2002,"566",293,273,34,"9",25,0.0853,0.033,0.0601
"6210",185572,2002,"948",521,427,351,"116",235,0.4511,0.2717,0.3703
"6211",185590,2002,"1470",881,589,410,"117",293,0.3326,0.1986,0.2789
"6212",185828,2002,"658",113,545,106,"81",25,0.2212,0.1486,0.1611
"6213",186131,2002,"1164",557,607,1049,"542",507,0.9102,0.8929,0.9012
"6214",186201,2002,"684",420,264,363,"109",254,0.6048,0.4129,0.5307
"6215",186283,2002,"958",542,416,439,"173",266,0.4908,0.4159,0.4582
"6216",186584,2002,"1157",607,550,523,"232",291,0.4794,0.4218,0.452
"6217",186876,2002,"794",436,358,338,"131",207,0.4748,0.3659,0.4257
"6218",187134,2002,"1231",738,493,834,"288",546,0.7398,0.5842,0.6775
"6219",187444,2002,"1286",715,571,208,"59",149,0.2084,0.1033,0.1617
"6220",187985,2002,"2758",1565,1193,314,"100",214,0.1367,0.0838,0.1139
"6221",188030,2002,"1977",1111,866,257,"78",179,0.1611,0.0901,0.13
"6222",188429,2002,"666",463,203,373,"97",276,0.5961,0.4778,0.5601
"6223",188641,2002,"474",223,251,247,"111",136,0.6099,0.4422,0.5211
"6224",190044,2002,"723",164,559,391,"296",95,0.5793,0.5295,0.5408
"6225",190099,2002,"728",386,342,629,"292",337,0.8731,0.8538,0.864
"6226",190150,2002,"1386",636,750,1168,"630",538,0.8459,0.84,0.8427
"6227",190248,2002,"135",75,60,43,"16",27,0.36,0.2667,0.3185
"6228",190415,2002,"2999",1530,1469,2605,"1253",1352,0.8837,0.853,0.8686
"6229",190512,2002,"1654",830,824,554,"217",337,0.406,0.2633,0.3349
"6230",190549,2002,"1194",679,515,235,"78",157,0.2312,0.1515,0.1968
"6231",190558,2002,"1743",905,838,66,"25",41,0.0453,0.0298,0.0379
"6232",190567,2002,"961",435,526,65,"28",37,0.0851,0.0532,0.0676
"6233",190594,2002,"1445",1010,435,256,"50",206,0.204,0.1149,0.1772
"6234",190637,2002,"729",485,244,73,"21",52,0.1072,0.0861,0.1001
"6235",190664,2002,"1178",693,485,325,"90",235,0.3391,0.1856,0.2759
"6236",190691,2002,"563",385,178,34,"8",26,0.0675,0.0449,0.0604
"6237",190725,2002,"316",246,70,84,"16",68,0.2764,0.2286,0.2658
"6238",191241,2002,"1694",1020,674,1263,"478",785,0.7696,0.7092,0.7456
"6239",191515,2002,"492",252,240,418,"195",223,0.8849,0.8125,0.8496
"6240",191533,2002,"375",224,151,165,"56",109,0.4866,0.3709,0.44
"6241",191630,2002,"532",283,249,367,"151",216,0.7633,0.6064,0.6898
"6242",191649,2002,"1764",912,852,693,"254",439,0.4814,0.2981,0.3929
"6243",191676,2002,"289",201,88,187,"54",133,0.6617,0.6136,0.6471
"6244",191931,2002,"731",379,352,337,"123",214,0.5646,0.3494,0.461
"6245",191968,2002,"1515",896,619,1083,"441",642,0.7165,0.7124,0.7149
"6246",192192,2002,"195",138,57,81,"21",60,0.4348,0.3684,0.4154
"6247",192323,2002,"561",333,228,388,"144",244,0.7327,0.6316,0.6916
"6248",192439,2002,"776",561,215,48,"9",39,0.0695,0.0419,0.0619
"6249",192703,2002,"769",401,368,501,"228",273,0.6808,0.6196,0.6515
"6250",192749,2002,"420",287,133,212,"50",162,0.5645,0.3759,0.5048
"6251",192819,2002,"956",576,380,693,"252",441,0.7656,0.6632,0.7249
"6252",192925,2002,"308",204,104,69,"25",44,0.2157,0.2404,0.224
"6253",193016,2002,"680",425,255,69,"14",55,0.1294,0.0549,0.1015
"6254",193292,2002,"229",168,61,77,"19",58,0.3452,0.3115,0.3362
"6255",193353,2002,"361",261,100,151,"33",118,0.4521,0.33,0.4183
"6256",193399,2002,"326",239,87,128,"21",107,0.4477,0.2414,0.3926
"6257",193584,2002,"385",292,93,230,"49",181,0.6199,0.5269,0.5974
"6258",193645,2002,"850",733,117,151,"12",139,0.1896,0.1026,0.1776
"6259",193654,2002,"605",415,190,328,"89",239,0.5759,0.4684,0.5421
"6260",193900,2002,"4126",2577,1549,2564,"963",1601,0.6213,0.6217,0.6214
"6261",193973,2002,"735",440,295,409,"148",261,0.5932,0.5017,0.5565
"6262",194161,2002,"295",183,112,109,"40",69,0.377,0.3571,0.3695
"6263",194310,2002,"1508",916,592,592,"190",402,0.4389,0.3209,0.3926
"6264",194824,2002,"1047",263,784,672,"490",182,0.692,0.625,0.6418
"6265",195003,2002,"2327",614,1713,563,"299",264,0.43,0.1745,0.2419
"6266",195030,2002,"1055",492,563,776,"392",384,0.7805,0.6963,0.7355
"6267",195164,2002,"584",295,289,300,"136",164,0.5559,0.4706,0.5137
"6268",195173,2002,"454",238,216,153,"61",92,0.3866,0.2824,0.337
"6269",195216,2002,"615",316,299,443,"197",246,0.7785,0.6589,0.7203
"6270",195234,2002,"526",391,135,303,"65",238,0.6087,0.4815,0.576
"6271",195243,2002,"329",191,138,130,"38",92,0.4817,0.2754,0.3951
"6272",195304,2002,"323",249,74,205,"56",149,0.5984,0.7568,0.6347
"6273",195474,2002,"677",405,272,497,"185",312,0.7704,0.6801,0.7341
"6274",195526,2002,"634",383,251,494,"191",303,0.7911,0.761,0.7792
"6275",195544,2002,"109",92,17,78,"11",67,0.7283,0.6471,0.7156
"6276",195809,2002,"2954",1736,1218,1001,"347",654,0.3767,0.2849,0.3389
"6277",196413,2002,"2894",1676,1218,2021,"793",1228,0.7327,0.6511,0.6983
"6278",196592,2002,"1877",1306,571,159,"40",119,0.0911,0.0701,0.0847
"6279",197045,2002,"451",226,225,180,"73",107,0.4735,0.3244,0.3991
"6280",197133,2002,"632",377,255,552,"217",335,0.8886,0.851,0.8734
"6281",197869,2002,"2412",1261,1151,964,"385",579,0.4592,0.3345,0.3997
"6282",197984,2002,"223",136,87,64,"20",44,0.3235,0.2299,0.287
"6283",198385,2002,"468",243,225,430,"201",229,0.9424,0.8933,0.9188
"6284",198464,2002,"3561",2117,1444,968,"294",674,0.3184,0.2036,0.2718
"6285",198507,2002,"458",270,188,108,"16",92,0.3407,0.0851,0.2358
"6286",198516,2002,"1192",736,456,856,"308",548,0.7446,0.6754,0.7181
"6287",198835,2002,"319",161,158,145,"69",76,0.472,0.4367,0.4545
"6288",198969,2002,"395",118,277,58,"20",38,0.322,0.0722,0.1468
"6289",199102,2002,"2025",1043,982,299,"90",209,0.2004,0.0916,0.1477
"6290",199111,2002,"421",250,171,140,"41",99,0.396,0.2398,0.3325
"6291",199120,2002,"3455",2053,1402,2513,"935",1578,0.7686,0.6669,0.7274
"6292",199139,2002,"2383",1234,1149,577,"204",373,0.3023,0.1775,0.2421
"6293",199148,2002,"2071",1420,651,570,"118",452,0.3183,0.1813,0.2752
"6294",199157,2002,"821",542,279,191,"42",149,0.2749,0.1505,0.2326
"6295",199193,2002,"3713",1561,2152,1391,"580",811,0.5195,0.2695,0.3746
"6296",199218,2002,"1629",1014,615,733,"209",524,0.5168,0.3398,0.45
"6297",199281,2002,"709",376,333,101,"38",63,0.1676,0.1141,0.1425
"6298",199306,2002,"166",97,69,71,"29",42,0.433,0.4203,0.4277
"6299",199412,2002,"193",150,43,111,"24",87,0.58,0.5581,0.5751
"6300",199582,2002,"449",183,266,25,"13",12,0.0656,0.0489,0.0557
"6301",199643,2002,"526",240,286,67,"26",41,0.1708,0.0909,0.1274
"6302",199847,2002,"999",509,490,832,"393",439,0.8625,0.802,0.8328
"6303",199962,2002,"374",197,177,167,"62",105,0.533,0.3503,0.4465
"6304",199999,2002,"670",471,199,121,"28",93,0.1975,0.1407,0.1806
"6305",200004,2002,"1216",627,589,344,"127",217,0.3461,0.2156,0.2829
"6306",200059,2002,"368",193,175,32,"8",24,0.1244,0.0457,0.087
"6307",200156,2002,"332",176,156,98,"29",69,0.392,0.1859,0.2952
"6308",200217,2002,"402",240,162,168,"44",124,0.5167,0.2716,0.4179
"6309",200226,2002,"135",79,56,32,"4",28,0.3544,0.0714,0.237
"6310",200253,2002,"476",268,208,62,"11",51,0.1903,0.0529,0.1303
"6311",200280,2002,"1987",935,1052,438,"205",233,0.2492,0.1949,0.2204
"6312",200332,2002,"1803",785,1018,387,"186",201,0.2561,0.1827,0.2146
"6313",200572,2002,"153",72,81,41,"21",20,0.2778,0.2593,0.268
"6314",201104,2002,"559",373,186,258,"60",198,0.5308,0.3226,0.4615
"6315",201371,2002,"262",141,121,135,"55",80,0.5674,0.4545,0.5153
"6316",201548,2002,"563",330,233,296,"104",192,0.5818,0.4464,0.5258
"6317",201645,2002,"835",322,513,482,"264",218,0.677,0.5146,0.5772
"6318",201690,2002,"378",207,171,51,"14",37,0.1787,0.0819,0.1349
"6319",202134,2002,"946",463,483,80,"39",41,0.0886,0.0807,0.0846
"6320",202480,2002,"1644",797,847,944,"390",554,0.6951,0.4604,0.5742
"6321",202523,2002,"633",338,295,469,"192",277,0.8195,0.6508,0.7409
"6322",202763,2002,"651",386,265,276,"98",178,0.4611,0.3698,0.424
"6323",203085,2002,"278",160,118,103,"34",69,0.4312,0.2881,0.3705
"6324",203128,2002,"233",126,107,132,"52",80,0.6349,0.486,0.5665
"6325",203368,2002,"843",456,387,599,"256",343,0.7522,0.6615,0.7106
"6326",203517,2002,"3640",2232,1408,892,"283",609,0.2728,0.201,0.2451
"6327",203535,2002,"440",246,194,376,"158",218,0.8862,0.8144,0.8545
"6328",203580,2002,"133",102,31,38,"4",34,0.3333,0.129,0.2857
"6329",203775,2002,"348",219,129,148,"54",94,0.4292,0.4186,0.4253
"6330",203845,2002,"263",129,134,120,"49",71,0.5504,0.3657,0.4563
"6331",204024,2002,"3614",1998,1616,2461,"1008",1453,0.7272,0.6238,0.681
"6332",204185,2002,"579",299,280,299,"115",184,0.6154,0.4107,0.5164
"6333",204194,2002,"332",203,129,129,"48",81,0.399,0.3721,0.3886
"6334",204617,2002,"251",163,88,94,"34",60,0.3681,0.3864,0.3745
"6335",204796,2002,"5936",2945,2991,2511,"989",1522,0.5168,0.3307,0.423
"6336",204857,2002,"3628",2068,1560,1832,"670",1162,0.5619,0.4295,0.505
"6337",206330,2002,"150",51,99,22,"11",11,0.2157,0.1111,0.1467
"6338",206589,2002,"514",281,233,354,"140",214,0.7616,0.6009,0.6887
"6339",206604,2002,"2169",1225,944,407,"128",279,0.2278,0.1356,0.1876
"6340",206622,2002,"757",424,333,518,"224",294,0.6934,0.6727,0.6843
"6341",206695,2002,"1944",1058,886,234,"76",158,0.1493,0.0858,0.1204
"6342",206914,2002,"583",330,253,39,"17",22,0.0667,0.0672,0.0669
"6343",207209,2002,"492",248,244,31,"8",23,0.0927,0.0328,0.063
"6344",207306,2002,"298",164,134,56,"19",37,0.2256,0.1418,0.1879
"6345",207324,2002,"405",215,190,93,"43",50,0.2326,0.2263,0.2296
"6346",207388,2002,"3206",1698,1508,939,"327",612,0.3604,0.2168,0.2929
"6347",207500,2002,"3749",1940,1809,973,"350",623,0.3211,0.1935,0.2595
"6348",207722,2002,"280",186,94,44,"11",33,0.1774,0.117,0.1571
"6349",207847,2002,"577",287,290,64,"29",35,0.122,0.1,0.1109
"6350",207865,2002,"926",486,440,121,"46",75,0.1543,0.1045,0.1307
"6351",208822,2002,"319",204,115,171,"60",111,0.5441,0.5217,0.5361
"6352",209056,2002,"503",309,194,339,"123",216,0.699,0.634,0.674
"6353",209065,2002,"425",245,180,258,"92",166,0.6776,0.5111,0.6071
"6354",209542,2002,"2864",1437,1427,906,"319",587,0.4085,0.2235,0.3163
"6355",209551,2002,"3272",1834,1438,1353,"500",853,0.4651,0.3477,0.4135
"6356",209612,2002,"275",166,109,171,"64",107,0.6446,0.5872,0.6218
"6357",209807,2002,"1177",632,545,153,"43",110,0.1741,0.0789,0.13
"6358",209922,2002,"307",160,147,182,"79",103,0.6438,0.5374,0.5928
"6359",210146,2002,"787",412,375,166,"56",110,0.267,0.1493,0.2109
"6360",210401,2002,"353",181,172,210,"92",118,0.6519,0.5349,0.5949
"6361",210429,2002,"769",466,303,142,"36",106,0.2275,0.1188,0.1847
"6362",210571,2002,"453",250,203,254,"104",150,0.6,0.5123,0.5607
"6363",210669,2002,"536",271,265,374,"165",209,0.7712,0.6226,0.6978
"6364",210775,2002,"242",153,89,89,"29",60,0.3922,0.3258,0.3678
"6365",211088,2002,"399",308,91,237,"55",182,0.5909,0.6044,0.594
"6366",211158,2002,"1478",938,540,650,"169",481,0.5128,0.313,0.4398
"6367",211291,2002,"914",455,459,764,"371",393,0.8637,0.8083,0.8359
"6368",211352,2002,"408",277,131,191,"53",138,0.4982,0.4046,0.4681
"6369",211361,2002,"893",464,429,224,"95",129,0.278,0.2214,0.2508
"6370",211431,2002,"238",231,7,79,"0",79,0.342,0,0.3319
"6371",211440,2002,"1364",542,822,957,"557",400,0.738,0.6776,0.7016
"6372",211468,2002,"185",185,0,89,"0",89,0.4811,NA,0.4811
"6373",211556,2002,"108",108,0,49,"0",49,0.4537,NA,0.4537
"6374",211583,2002,"105",104,1,27,"0",27,0.2596,0,0.2571
"6375",211608,2002,"247",132,115,25,"5",20,0.1515,0.0435,0.1012
"6376",211644,2002,"1249",745,504,367,"117",250,0.3356,0.2321,0.2938
"6377",211981,2002,"406",204,202,159,"59",100,0.4902,0.2921,0.3916
"6378",212009,2002,"572",328,244,459,"185",274,0.8354,0.7582,0.8024
"6379",212054,2002,"1937",709,1228,374,"150",224,0.3159,0.1221,0.1931
"6380",212106,2002,"1429",875,554,748,"253",495,0.5657,0.4567,0.5234
"6381",212115,2002,"1123",587,536,314,"100",214,0.3646,0.1866,0.2796
"6382",212133,2002,"405",288,117,211,"49",162,0.5625,0.4188,0.521
"6383",212160,2002,"1372",788,584,297,"86",211,0.2678,0.1473,0.2165
"6384",212197,2002,"456",304,152,293,"85",208,0.6842,0.5592,0.6425
"6385",212577,2002,"534",248,286,388,"189",199,0.8024,0.6608,0.7266
"6386",212601,2002,"536",311,225,255,"80",175,0.5627,0.3556,0.4757
"6387",212832,2002,"261",211,50,62,"18",44,0.2085,0.36,0.2375
"6388",212911,2002,"312",168,144,283,"128",155,0.9226,0.8889,0.9071
"6389",213020,2002,"2666",1536,1130,697,"207",490,0.319,0.1832,0.2614
"6390",213251,2002,"375",215,160,285,"119",166,0.7721,0.7438,0.76
"6391",213321,2002,"409",195,214,263,"125",138,0.7077,0.5841,0.643
"6392",213349,2002,"1726",1027,699,498,"141",357,0.3476,0.2017,0.2885
"6393",213358,2002,"295",175,120,117,"43",74,0.4229,0.3583,0.3966
"6394",213367,2002,"837",456,381,445,"173",272,0.5965,0.4541,0.5317
"6395",213385,2002,"580",267,313,498,"263",235,0.8801,0.8403,0.8586
"6396",213507,2002,"422",234,188,266,"99",167,0.7137,0.5266,0.6303
"6397",213543,2002,"1143",442,701,822,"461",361,0.8167,0.6576,0.7192
"6398",213613,2002,"1038",646,392,305,"89",216,0.3344,0.227,0.2938
"6399",213668,2002,"373",195,178,234,"100",134,0.6872,0.5618,0.6273
"6400",213783,2002,"654",381,273,171,"48",123,0.3228,0.1758,0.2615
"6401",213826,2002,"310",238,72,164,"29",135,0.5672,0.4028,0.529
"6402",213996,2002,"763",475,288,526,"168",358,0.7537,0.5833,0.6894
"6403",214041,2002,"1270",748,522,463,"158",305,0.4078,0.3027,0.3646
"6404",214069,2002,"347",239,108,201,"59",142,0.5941,0.5463,0.5793
"6405",214157,2002,"372",214,158,264,"102",162,0.757,0.6456,0.7097
"6406",214175,2002,"547",300,247,445,"191",254,0.8467,0.7733,0.8135
"6407",214272,2002,"363",228,135,114,"25",89,0.3904,0.1852,0.314
"6408",214777,2002,"5935",2911,3024,3558,"1554",2004,0.6884,0.5139,0.5995
"6409",215062,2002,"2373",1183,1190,2096,"1030",1066,0.9011,0.8655,0.8833
"6410",215743,2002,"281",154,127,122,"47",75,0.487,0.3701,0.4342
"6411",215798,2002,"322",159,163,209,"102",107,0.673,0.6258,0.6491
"6412",215929,2002,"958",569,389,702,"258",444,0.7803,0.6632,0.7328
"6413",216010,2002,"1507",831,676,721,"270",451,0.5427,0.3994,0.4784
"6414",216038,2002,"1421",796,625,416,"139",277,0.348,0.2224,0.2928
"6415",216287,2002,"371",189,182,326,"155",171,0.9048,0.8516,0.8787
"6416",216339,2002,"3467",2034,1433,1170,"394",776,0.3815,0.2749,0.3375
"6417",216524,2002,"427",212,215,301,"134",167,0.7877,0.6233,0.7049
"6418",216694,2002,"297",141,156,142,"50",92,0.6525,0.3205,0.4781
"6419",216764,2002,"1766",1104,662,642,"168",474,0.4293,0.2538,0.3635
"6420",216807,2002,"350",235,115,208,"56",152,0.6468,0.487,0.5943
"6421",216852,2002,"716",327,389,284,"119",165,0.5046,0.3059,0.3966
"6422",216931,2002,"471",239,232,224,"101",123,0.5146,0.4353,0.4756
"6423",217059,2002,"921",521,400,373,"138",235,0.4511,0.345,0.405
"6424",217156,2002,"1451",817,634,1213,"505",708,0.8666,0.7965,0.836
"6425",217402,2002,"877",540,337,734,"274",460,0.8519,0.8131,0.8369
"6426",217536,2002,"523",378,145,334,"93",241,0.6376,0.6414,0.6386
"6427",217776,2002,"141",76,65,36,"11",25,0.3289,0.1692,0.2553
"6428",217819,2002,"1991",1333,658,941,"253",688,0.5161,0.3845,0.4726
"6429",217882,2002,"2463",1214,1249,1231,"462",769,0.6334,0.3699,0.4998
"6430",217998,2002,"165",100,65,87,"25",62,0.62,0.3846,0.5273
"6431",218061,2002,"734",431,303,142,"48",94,0.2181,0.1584,0.1935
"6432",218229,2002,"526",335,191,117,"25",92,0.2746,0.1309,0.2224
"6433",218238,2002,"180",83,97,26,"12",14,0.1687,0.1237,0.1444
"6434",218399,2002,"289",175,114,51,"11",40,0.2286,0.0965,0.1765
"6435",218414,2002,"250",94,156,70,"33",37,0.3936,0.2115,0.28
"6436",218663,2002,"3500",1909,1591,1557,"594",963,0.5045,0.3734,0.4449
"6437",218724,2002,"1072",523,549,236,"104",132,0.2524,0.1894,0.2201
"6438",218733,2002,"717",401,316,174,"45",129,0.3217,0.1424,0.2427
"6439",218742,2002,"647",414,233,119,"19",100,0.2415,0.0815,0.1839
"6440",218973,2002,"297",170,127,234,"95",139,0.8176,0.748,0.7879
"6441",219000,2002,"416",259,157,208,"74",134,0.5174,0.4713,0.5
"6442",219046,2002,"537",334,203,43,"11",32,0.0958,0.0542,0.0801
"6443",219082,2002,"273",111,162,45,"22",23,0.2072,0.1358,0.1648
"6444",219198,2002,"137",104,33,44,"7",37,0.3558,0.2121,0.3212
"6445",219259,2002,"376",214,162,51,"12",39,0.1822,0.0741,0.1356
"6446",219356,2002,"1767",864,903,348,"140",208,0.2407,0.155,0.1969
"6447",219471,2002,"976",544,432,186,"74",112,0.2059,0.1713,0.1906
"6448",219602,2002,"986",636,350,126,"37",89,0.1399,0.1057,0.1278
"6449",219709,2002,"524",320,204,264,"91",173,0.5406,0.4461,0.5038
"6450",219718,2002,"139",53,86,16,"5",11,0.2075,0.0581,0.1151
"6451",219949,2002,"164",74,90,35,"6",29,0.3919,0.0667,0.2134
"6452",220075,2002,"1473",831,642,262,"76",186,0.2238,0.1184,0.1779
"6453",220215,2002,"414",231,183,181,"73",108,0.4675,0.3989,0.4372
"6454",220613,2002,"705",423,282,195,"60",135,0.3191,0.2128,0.2766
"6455",220631,2002,"151",109,42,33,"8",25,0.2294,0.1905,0.2185
"6456",220710,2002,"246",127,119,103,"44",59,0.4646,0.3697,0.4187
"6457",221351,2002,"439",238,201,306,"136",170,0.7143,0.6766,0.697
"6458",221519,2002,"368",198,170,270,"116",154,0.7778,0.6824,0.7337
"6459",221731,2002,"128",79,49,34,"5",29,0.3671,0.102,0.2656
"6460",221847,2002,"1376",585,791,251,"99",152,0.2598,0.1252,0.1824
"6461",221892,2002,"198",134,64,75,"24",51,0.3806,0.375,0.3788
"6462",222178,2002,"942",536,406,360,"112",248,0.4627,0.2759,0.3822
"6463",222983,2002,"347",191,156,245,"104",141,0.7382,0.6667,0.7061
"6464",223232,2002,"2601",1558,1043,1323,"439",884,0.5674,0.4209,0.5087
"6465",224004,2002,"166",85,81,12,"9",3,0.0353,0.1111,0.0723
"6466",224323,2002,"307",185,122,142,"52",90,0.4865,0.4262,0.4625
"6467",225432,2002,"905",498,407,14,"4",10,0.0201,0.0098,0.0155
"6468",225548,2002,"325",157,168,78,"24",54,0.3439,0.1429,0.24
"6469",225627,2002,"395",244,151,58,"18",40,0.1639,0.1192,0.1468
"6470",226231,2002,"243",55,188,68,"46",22,0.4,0.2447,0.2798
"6471",226833,2002,"624",327,297,66,"23",43,0.1315,0.0774,0.1058
"6472",227216,2002,"2912",1683,1229,523,"147",376,0.2234,0.1196,0.1796
"6473",227331,2002,"331",241,90,55,"11",44,0.1826,0.1222,0.1662
"6474",227526,2002,"1431",769,662,222,"74",148,0.1925,0.1118,0.1551
"6475",227757,2002,"700",318,382,570,"301",269,0.8459,0.788,0.8143
"6476",227845,2002,"445",255,190,164,"60",104,0.4078,0.3158,0.3685
"6477",227863,2002,"276",174,102,65,"15",50,0.2874,0.1471,0.2355
"6478",228042,2002,"165",80,85,45,"18",27,0.3375,0.2118,0.2727
"6479",228149,2002,"667",397,270,214,"63",151,0.3804,0.2333,0.3208
"6480",228246,2002,"1380",764,616,811,"315",496,0.6492,0.5114,0.5877
"6481",228343,2002,"342",217,125,227,"76",151,0.6959,0.608,0.6637
"6482",228431,2002,"2006",1229,777,314,"83",231,0.188,0.1068,0.1565
"6483",228459,2002,"2674",1665,1009,587,"140",447,0.2685,0.1388,0.2195
"6484",228501,2002,"315",130,185,14,"3",11,0.0846,0.0162,0.0444
"6485",228529,2002,"974",507,467,148,"46",102,0.2012,0.0985,0.152
"6486",228705,2002,"962",401,561,135,"75",60,0.1496,0.1337,0.1403
"6487",228723,2002,"6589",3528,3061,2734,"863",1871,0.5303,0.2819,0.4149
"6488",228769,2002,"2126",1070,1056,269,"112",157,0.1467,0.1061,0.1265
"6489",228778,2002,"7842",4111,3731,3769,"1531",2238,0.5444,0.4103,0.4806
"6490",228787,2002,"903",405,498,325,"141",184,0.4543,0.2831,0.3599
"6491",228796,2002,"2279",1202,1077,101,"41",60,0.0499,0.0381,0.0443
"6492",228875,2002,"1450",904,546,719,"207",512,0.5664,0.3791,0.4959
"6493",228981,2002,"371",181,190,111,"34",77,0.4254,0.1789,0.2992
"6494",229018,2002,"216",126,90,31,"9",22,0.1746,0.1,0.1435
"6495",229027,2002,"3001",1619,1382,234,"76",158,0.0976,0.055,0.078
"6496",229115,2002,"4283",2066,2217,1302,"551",751,0.3635,0.2485,0.304
"6497",229780,2002,"182",104,78,41,"13",28,0.2692,0.1667,0.2253
"6498",229814,2002,"798",425,373,138,"38",100,0.2353,0.1019,0.1729
"6499",230603,2002,"528",383,145,106,"12",94,0.2454,0.0828,0.2008
"6500",230728,2002,"1497",1010,487,423,"81",342,0.3386,0.1663,0.2826
"6501",230764,2002,"1962",1109,853,391,"127",264,0.2381,0.1489,0.1993
"6502",230782,2002,"1675",1019,656,79,"16",63,0.0618,0.0244,0.0472
"6503",231059,2002,"527",301,226,406,"172",234,0.7774,0.7611,0.7704
"6504",231174,2002,"1828",1005,823,1000,"415",585,0.5821,0.5043,0.547
"6505",231420,2002,"187",90,97,59,"20",39,0.4333,0.2062,0.3155
"6506",231554,2002,"131",62,69,36,"17",19,0.3065,0.2464,0.2748
"6507",231624,2002,"1314",721,593,1082,"456",626,0.8682,0.769,0.8234
"6508",231712,2002,"1176",660,516,363,"128",235,0.3561,0.2481,0.3087
"6509",232025,2002,"235",130,105,118,"48",70,0.5385,0.4571,0.5021
"6510",232043,2002,"208",120,88,113,"46",67,0.5583,0.5227,0.5433
"6511",232089,2002,"288",97,191,69,"32",37,0.3814,0.1675,0.2396
"6512",232186,2002,"2161",1180,981,770,"254",516,0.4373,0.2589,0.3563
"6513",232265,2002,"1017",644,373,384,"90",294,0.4565,0.2413,0.3776
"6514",232423,2002,"3283",2116,1167,2220,"690",1530,0.7231,0.5913,0.6762
"6515",232557,2002,"1530",812,718,393,"154",239,0.2943,0.2145,0.2569
"6516",232566,2002,"860",593,267,410,"101",309,0.5211,0.3783,0.4767
"6517",232609,2002,"438",246,192,220,"72",148,0.6016,0.375,0.5023
"6518",232681,2002,"862",618,244,607,"164",443,0.7168,0.6721,0.7042
"6519",232706,2002,"361",261,100,128,"25",103,0.3946,0.25,0.3546
"6520",232937,2002,"1091",634,457,133,"35",98,0.1546,0.0766,0.1219
"6521",232982,2002,"1701",902,799,373,"139",234,0.2594,0.174,0.2193
"6522",233277,2002,"1813",1109,704,754,"244",510,0.4599,0.3466,0.4159
"6523",233374,2002,"775",422,353,634,"279",355,0.8412,0.7904,0.8181
"6524",233426,2002,"460",274,186,256,"95",161,0.5876,0.5108,0.5565
"6525",233541,2002,"323",163,160,115,"42",73,0.4479,0.2625,0.356
"6526",233897,2002,"345",181,164,100,"34",66,0.3646,0.2073,0.2899
"6527",233921,2002,"4714",2002,2712,2437,"1151",1286,0.6424,0.4244,0.517
"6528",234030,2002,"3014",1810,1204,711,"237",474,0.2619,0.1968,0.2359
"6529",234085,2002,"356",24,332,209,"197",12,0.5,0.5934,0.5871
"6530",234155,2002,"1129",650,479,237,"60",177,0.2723,0.1253,0.2099
"6531",234164,2002,"437",259,178,74,"14",60,0.2317,0.0787,0.1693
"6532",235097,2002,"1265",768,497,274,"84",190,0.2474,0.169,0.2166
"6533",235167,2002,"486",236,250,250,"133",117,0.4958,0.532,0.5144
"6534",236230,2002,"625",400,225,325,"98",227,0.5675,0.4356,0.52
"6535",236328,2002,"666",399,267,459,"173",286,0.7168,0.6479,0.6892
"6536",236577,2002,"601",412,189,302,"94",208,0.5049,0.4974,0.5025
"6537",236595,2002,"633",387,246,324,"110",214,0.553,0.4472,0.5118
"6538",236896,2002,"336",172,164,61,"29",32,0.186,0.1768,0.1815
"6539",236939,2002,"2771",1469,1302,1018,"372",646,0.4398,0.2857,0.3674
"6540",236948,2002,"4776",2561,2215,2450,"1039",1411,0.551,0.4691,0.513
"6541",237011,2002,"2213",1290,923,761,"225",536,0.4155,0.2438,0.3439
"6542",237057,2002,"379",230,149,322,"126",196,0.8522,0.8456,0.8496
"6543",237066,2002,"433",232,201,261,"107",154,0.6638,0.5323,0.6028
"6544",237215,2002,"499",265,234,2,"2",0,0,0.0085,0.004
"6545",237330,2002,"587",273,314,74,"34",40,0.1465,0.1083,0.1261
"6546",237358,2002,"122",68,54,29,"18",11,0.1618,0.3333,0.2377
"6547",237367,2002,"682",377,305,80,"30",50,0.1326,0.0984,0.1173
"6548",237792,2002,"705",378,327,92,"24",68,0.1799,0.0734,0.1305
"6549",237899,2002,"351",178,173,28,"8",20,0.1124,0.0462,0.0798
"6550",237932,2002,"445",253,192,107,"23",84,0.332,0.1198,0.2404
"6551",237969,2002,"500",283,217,224,"83",141,0.4982,0.3825,0.448
"6552",238032,2002,"3917",1841,2076,1161,"473",688,0.3737,0.2278,0.2964
"6553",238333,2002,"303",191,112,210,"75",135,0.7068,0.6696,0.6931
"6554",238430,2002,"197",155,42,55,"12",43,0.2774,0.2857,0.2792
"6555",238458,2002,"529",324,205,240,"70",170,0.5247,0.3415,0.4537
"6556",238476,2002,"618",351,267,236,"84",152,0.433,0.3146,0.3819
"6557",238616,2002,"287",139,148,96,"42",54,0.3885,0.2838,0.3345
"6558",238661,2002,"271",205,66,70,"10",60,0.2927,0.1515,0.2583
"6559",239080,2002,"247",176,71,52,"13",39,0.2216,0.1831,0.2105
"6560",239105,2002,"1856",1034,822,1052,"433",619,0.5986,0.5268,0.5668
"6561",239628,2002,"250",116,134,139,"75",64,0.5517,0.5597,0.556
"6562",239716,2002,"495",273,222,345,"134",211,0.7729,0.6036,0.697
"6563",240107,2002,"321",236,85,91,"19",72,0.3051,0.2235,0.2835
"6564",240189,2002,"2004",1095,909,463,"176",287,0.2621,0.1936,0.231
"6565",240277,2002,"896",595,301,204,"55",149,0.2504,0.1827,0.2277
"6566",240329,2002,"1555",1006,549,463,"128",335,0.333,0.2332,0.2977
"6567",240338,2002,"158",88,70,79,"31",48,0.5455,0.4429,0.5
"6568",240365,2002,"1775",1045,730,259,"71",188,0.1799,0.0973,0.1459
"6569",240374,2002,"760",418,342,70,"24",46,0.11,0.0702,0.0921
"6570",240417,2002,"1303",658,645,219,"51",168,0.2553,0.0791,0.1681
"6571",240426,2002,"286",150,136,37,"15",22,0.1467,0.1103,0.1294
"6572",240444,2002,"5488",3016,2472,2729,"1037",1692,0.561,0.4195,0.4973
"6573",240453,2002,"3178",1736,1442,457,"175",282,0.1624,0.1214,0.1438
"6574",240462,2002,"1120",395,725,184,"75",109,0.2759,0.1034,0.1643
"6575",240471,2002,"1045",642,403,277,"81",196,0.3053,0.201,0.2651
"6576",240480,2002,"1464",806,658,286,"109",177,0.2196,0.1657,0.1954
"6577",240727,2002,"1443",733,710,328,"113",215,0.2933,0.1592,0.2273
"6578",243443,2002,"496",320,176,43,"8",35,0.1094,0.0455,0.0867
"6579",243780,2002,"6294",2535,3759,2230,"1046",1184,0.4671,0.2783,0.3543
"6580",100654,2001,"1038",541,497,138,"34",104,0.1922,0.0684,0.1329
"6581",100663,2001,"1224",765,459,175,"57",118,0.1542,0.1242,0.143
"6582",100751,2001,"2384",1342,1042,920,"313",607,0.4523,0.3004,0.3859
"6583",100858,2001,"3739",1949,1790,1284,"468",816,0.4187,0.2615,0.3434
"6584",101435,2001,"146",96,50,58,"13",45,0.4688,0.26,0.3973
"6585",101480,2001,"877",480,397,146,"40",106,0.2208,0.1008,0.1665
"6586",101675,2001,"423",213,210,29,"9",20,0.0939,0.0429,0.0686
"6587",101879,2001,"816",465,351,147,"36",111,0.2387,0.1026,0.1801
"6588",102049,2001,"658",434,224,354,"109",245,0.5645,0.4866,0.538
"6589",102094,2001,"1116",634,482,160,"40",120,0.1893,0.083,0.1434
"6590",102234,2001,"251",137,114,112,"39",73,0.5328,0.3421,0.4462
"6591",102368,2001,"1054",572,482,211,"71",140,0.2448,0.1473,0.2002
"6592",102377,2001,"645",375,270,108,"41",67,0.1787,0.1519,0.1674
"6593",104151,2001,"5950",3157,2793,1649,"599",1050,0.3326,0.2145,0.2771
"6594",104179,2001,"5727",3005,2722,1871,"717",1154,0.384,0.2634,0.3267
"6595",105330,2001,"2146",1299,847,609,"169",440,0.3387,0.1995,0.2838
"6596",106245,2001,"703",410,293,57,"19",38,0.0927,0.0648,0.0811
"6597",106342,2001,"129",80,49,68,"20",48,0.6,0.4082,0.5271
"6598",106397,2001,"2190",1126,1064,718,"290",428,0.3801,0.2726,0.3279
"6599",106412,2001,"700",371,329,97,"21",76,0.2049,0.0638,0.1386
"6600",106458,2001,"1594",921,673,309,"86",223,0.2421,0.1278,0.1939
"6601",106467,2001,"1202",564,638,235,"108",127,0.2252,0.1693,0.1955
"6602",106485,2001,"654",382,272,51,"15",36,0.0942,0.0551,0.078
"6603",106704,2001,"1668",1028,640,367,"102",265,0.2578,0.1594,0.22
"6604",107044,2001,"979",547,432,365,"145",220,0.4022,0.3356,0.3728
"6605",107080,2001,"279",164,115,157,"49",108,0.6585,0.4261,0.5627
"6606",107141,2001,"241",149,92,132,"50",82,0.5503,0.5435,0.5477
"6607",107512,2001,"400",214,186,183,"73",110,0.514,0.3925,0.4575
"6608",107558,2001,"190",116,74,61,"22",39,0.3362,0.2973,0.3211
"6609",110097,2001,"649",426,223,360,"113",247,0.5798,0.5067,0.5547
"6610",110404,2001,"214",78,136,175,"110",65,0.8333,0.8088,0.8178
"6611",110422,2001,"2957",1374,1583,629,"220",409,0.2977,0.139,0.2127
"6612",110486,2001,"610",393,217,86,"20",66,0.1679,0.0922,0.141
"6613",110495,2001,"516",352,164,96,"24",72,0.2045,0.1463,0.186
"6614",110510,2001,"1273",774,499,127,"36",91,0.1176,0.0721,0.0998
"6615",110529,2001,"2412",961,1451,229,"91",138,0.1436,0.0627,0.0949
"6616",110538,2001,"2092",1175,917,314,"64",250,0.2128,0.0698,0.1501
"6617",110547,2001,"561",391,170,26,"6",20,0.0512,0.0353,0.0463
"6618",110556,2001,"1946",1179,767,275,"74",201,0.1705,0.0965,0.1413
"6619",110565,2001,"2772",1673,1099,416,"86",330,0.1973,0.0783,0.1501
"6620",110574,2001,"692",435,257,75,"17",58,0.1333,0.0661,0.1084
"6621",110583,2001,"4324",2751,1573,420,"117",303,0.1101,0.0744,0.0971
"6622",110592,2001,"1223",767,456,117,"26",91,0.1186,0.057,0.0957
"6623",110617,2001,"2278",1387,891,221,"49",172,0.124,0.055,0.097
"6624",113698,2001,"127",90,37,51,"13",38,0.4222,0.3514,0.4016
"6625",115755,2001,"725",416,309,81,"18",63,0.1514,0.0583,0.1117
"6626",119173,2001,"328",325,3,47,"1",46,0.1415,0.3333,0.1433
"6627",120184,2001,"111",85,26,55,"10",45,0.5294,0.3846,0.4955
"6628",121309,2001,"545",346,199,327,"106",221,0.6387,0.5327,0.6
"6629",121345,2001,"393",192,201,339,"173",166,0.8646,0.8607,0.8626
"6630",122409,2001,"3338",1986,1352,664,"178",486,0.2447,0.1317,0.1989
"6631",122436,2001,"1003",646,357,635,"217",418,0.6471,0.6078,0.6331
"6632",122597,2001,"1820",1157,663,209,"58",151,0.1305,0.0875,0.1148
"6633",122612,2001,"840",572,268,411,"114",297,0.5192,0.4254,0.4893
"6634",122931,2001,"1017",556,461,799,"339",460,0.8273,0.7354,0.7856
"6635",123554,2001,"580",352,228,350,"129",221,0.6278,0.5658,0.6034
"6636",123572,2001,"1018",673,345,258,"53",205,0.3046,0.1536,0.2534
"6637",126562,2001,"492",288,204,63,"27",36,0.125,0.1324,0.128
"6638",126580,2001,"785",453,332,171,"54",117,0.2583,0.1627,0.2178
"6639",126614,2001,"4962",2396,2566,2013,"887",1126,0.4699,0.3457,0.4057
"6640",126818,2001,"3683",2061,1622,1285,"420",865,0.4197,0.2589,0.3489
"6641",127060,2001,"933",486,447,561,"249",312,0.642,0.557,0.6013
"6642",127185,2001,"1047",469,578,139,"50",89,0.1898,0.0865,0.1328
"6643",127565,2001,"1596",816,780,97,"42",55,0.0674,0.0538,0.0608
"6644",127741,2001,"2108",1309,799,623,"140",483,0.369,0.1752,0.2955
"6645",128106,2001,"634",343,291,115,"47",68,0.1983,0.1615,0.1814
"6646",128744,2001,"175",97,78,49,"17",32,0.3299,0.2179,0.28
"6647",128771,2001,"1261",623,638,169,"74",95,0.1525,0.116,0.134
"6648",129020,2001,"3122",1648,1474,1671,"682",989,0.6001,0.4627,0.5352
"6649",129242,2001,"831",463,368,646,"265",381,0.8229,0.7201,0.7774
"6650",129941,2001,"503",202,301,123,"54",69,0.3416,0.1794,0.2445
"6651",130253,2001,"766",465,301,457,"172",285,0.6129,0.5714,0.5966
"6652",130314,2001,"165",165,0,75,"0",75,0.4545,NA,0.4545
"6653",130493,2001,"1429",858,571,134,"37",97,0.1131,0.0648,0.0938
"6654",130590,2001,"491",239,252,388,"184",204,0.8536,0.7302,0.7902
"6655",130697,2001,"722",372,350,606,"280",326,0.8763,0.8,0.8393
"6656",130776,2001,"841",439,402,111,"36",75,0.1708,0.0896,0.132
"6657",130794,2001,"1293",648,645,1125,"538",587,0.9059,0.8341,0.8701
"6658",130934,2001,"686",385,301,107,"30",77,0.2,0.0997,0.156
"6659",130943,2001,"3362",1944,1418,2147,"767",1380,0.7099,0.5409,0.6386
"6660",131159,2001,"1387",875,512,924,"330",594,0.6789,0.6445,0.6662
"6661",131283,2001,"613",342,271,407,"170",237,0.693,0.6273,0.6639
"6662",131450,2001,"213",113,100,10,"3",7,0.0619,0.03,0.0469
"6663",131469,2001,"2566",1433,1133,1864,"761",1103,0.7697,0.6717,0.7264
"6664",131496,2001,"1482",757,725,1339,"648",691,0.9128,0.8938,0.9035
"6665",131520,2001,"1344",900,444,680,"185",495,0.55,0.4167,0.506
"6666",132471,2001,"431",264,167,101,"32",69,0.2614,0.1916,0.2343
"6667",132602,2001,"720",386,334,91,"31",60,0.1554,0.0928,0.1264
"6668",132903,2001,"4913",2621,2292,1529,"529",1000,0.3815,0.2308,0.3112
"6669",133492,2001,"424",241,183,225,"83",142,0.5892,0.4536,0.5307
"6670",133553,2001,"1013",159,854,338,"277",61,0.3836,0.3244,0.3337
"6671",133650,2001,"2243",1300,943,368,"88",280,0.2154,0.0933,0.1641
"6672",133669,2001,"1937",1120,817,292,"85",207,0.1848,0.104,0.1507
"6673",133711,2001,"407",253,154,185,"59",126,0.498,0.3831,0.4545
"6674",133881,2001,"544",153,391,203,"128",75,0.4902,0.3274,0.3732
"6675",133951,2001,"2457",1364,1093,527,"145",382,0.2801,0.1327,0.2145
"6676",134079,2001,"515",323,192,205,"66",139,0.4303,0.3438,0.3981
"6677",134097,2001,"5681",3318,2363,2702,"928",1774,0.5347,0.3927,0.4756
"6678",134130,2001,"6178",3348,2830,3304,"1208",2096,0.626,0.4269,0.5348
"6679",134945,2001,"428",186,242,219,"140",79,0.4247,0.5785,0.5117
"6680",135726,2001,"2152",1277,875,1349,"503",846,0.6625,0.5749,0.6269
"6681",136172,2001,"1672",979,693,392,"126",266,0.2717,0.1818,0.2344
"6682",136950,2001,"473",300,173,278,"90",188,0.6267,0.5202,0.5877
"6683",137546,2001,"527",298,229,289,"117",172,0.5772,0.5109,0.5484
"6684",138354,2001,"695",406,289,167,"59",108,0.266,0.2042,0.2403
"6685",138716,2001,"420",266,154,79,"17",62,0.2331,0.1104,0.1881
"6686",138789,2001,"551",328,223,39,"7",32,0.0976,0.0314,0.0708
"6687",139144,2001,"536",357,179,262,"74",188,0.5266,0.4134,0.4888
"6688",139366,2001,"761",468,293,84,"20",64,0.1368,0.0683,0.1104
"6689",139393,2001,"238",151,87,120,"41",79,0.5232,0.4713,0.5042
"6690",139658,2001,"1547",817,730,1013,"486",527,0.645,0.6658,0.6548
"6691",139719,2001,"425",225,200,60,"16",44,0.1956,0.08,0.1412
"6692",139755,2001,"2223",634,1589,736,"441",295,0.4653,0.2775,0.3311
"6693",139764,2001,"266",173,93,31,"8",23,0.1329,0.086,0.1165
"6694",139861,2001,"879",556,323,203,"52",151,0.2716,0.161,0.2309
"6695",139931,2001,"2632",1278,1354,435,"110",325,0.2543,0.0812,0.1653
"6696",139940,2001,"2136",1305,831,357,"99",258,0.1977,0.1191,0.1671
"6697",139959,2001,"4459",2646,1813,2137,"677",1460,0.5518,0.3734,0.4793
"6698",140447,2001,"767",472,295,257,"73",184,0.3898,0.2475,0.3351
"6699",140960,2001,"440",238,202,58,"13",45,0.1891,0.0644,0.1318
"6700",140988,2001,"258",186,72,92,"20",72,0.3871,0.2778,0.3566
"6701",141185,2001,"198",124,74,71,"25",46,0.371,0.3378,0.3586
"6702",141264,2001,"1534",937,597,266,"67",199,0.2124,0.1122,0.1734
"6703",141334,2001,"1551",931,620,194,"34",160,0.1719,0.0548,0.1251
"6704",141486,2001,"223",160,63,39,"11",28,0.175,0.1746,0.1749
"6705",141565,2001,"400",231,169,53,"17",36,0.1558,0.1006,0.1325
"6706",141574,2001,"1521",883,638,224,"61",163,0.1846,0.0956,0.1473
"6707",142276,2001,"1485",783,702,53,"9",44,0.0562,0.0128,0.0357
"6708",142285,2001,"1642",791,851,340,"122",218,0.2756,0.1434,0.2071
"6709",142461,2001,"265",150,115,83,"31",52,0.3467,0.2696,0.3132
"6710",143084,2001,"550",310,240,392,"167",225,0.7258,0.6958,0.7127
"6711",143288,2001,"162",95,67,60,"18",42,0.4421,0.2687,0.3704
"6712",144005,2001,"395",280,115,16,"3",13,0.0464,0.0261,0.0405
"6713",144281,2001,"1448",767,681,353,"157",196,0.2555,0.2305,0.2438
"6714",144740,2001,"2042",1180,862,866,"325",541,0.4585,0.377,0.4241
"6715",144892,2001,"1431",836,595,445,"135",310,0.3708,0.2269,0.311
"6716",144962,2001,"302",169,133,153,"47",106,0.6272,0.3534,0.5066
"6717",144971,2001,"146",75,71,60,"26",34,0.4533,0.3662,0.411
"6718",145600,2001,"2637",1470,1167,590,"210",380,0.2585,0.1799,0.2237
"6719",145619,2001,"262",159,103,120,"41",79,0.4969,0.3981,0.458
"6720",145637,2001,"6234",3008,3226,3886,"1789",2097,0.6971,0.5546,0.6234
"6721",145691,2001,"205",113,92,94,"37",57,0.5044,0.4022,0.4585
"6722",145813,2001,"3331",2080,1251,1316,"364",952,0.4577,0.291,0.3951
"6723",146481,2001,"336",188,148,214,"83",131,0.6968,0.5608,0.6369
"6724",146612,2001,"384",191,193,126,"52",74,0.3874,0.2694,0.3281
"6725",146719,2001,"1424",960,464,674,"202",472,0.4917,0.4353,0.4733
"6726",146825,2001,"144",65,79,37,"14",23,0.3538,0.1772,0.2569
"6727",147013,2001,"284",168,116,128,"35",93,0.5536,0.3017,0.4507
"6728",147244,2001,"646",356,290,349,"139",210,0.5899,0.4793,0.5402
"6729",147341,2001,"258",122,136,128,"67",61,0.5,0.4926,0.4961
"6730",147703,2001,"2792",1459,1333,725,"281",444,0.3043,0.2108,0.2597
"6731",147767,2001,"1947",1026,921,1682,"769",913,0.8899,0.835,0.8639
"6732",147776,2001,"964",622,342,21,"7",14,0.0225,0.0205,0.0218
"6733",147828,2001,"541",297,244,240,"90",150,0.5051,0.3689,0.4436
"6734",148131,2001,"231",119,112,83,"32",51,0.4286,0.2857,0.3593
"6735",148496,2001,"222",139,83,111,"34",77,0.554,0.4096,0.5
"6736",148584,2001,"177",112,65,72,"21",51,0.4554,0.3231,0.4068
"6737",148627,2001,"353",208,145,88,"31",57,0.274,0.2138,0.2493
"6738",149222,2001,"2153",967,1186,501,"220",281,0.2906,0.1855,0.2327
"6739",149231,2001,"1573",895,678,332,"108",224,0.2503,0.1593,0.2111
"6740",149772,2001,"1677",836,841,557,"245",312,0.3732,0.2913,0.3321
"6741",149781,2001,"572",276,296,416,"200",216,0.7826,0.6757,0.7273
"6742",150066,2001,"462",272,190,170,"45",125,0.4596,0.2368,0.368
"6743",150136,2001,"3743",2039,1704,1066,"344",722,0.3541,0.2019,0.2848
"6744",150145,2001,"258",161,97,110,"34",76,0.472,0.3505,0.4264
"6745",150163,2001,"929",593,336,512,"168",344,0.5801,0.5,0.5511
"6746",150400,2001,"620",350,270,481,"205",276,0.7886,0.7593,0.7758
"6747",150534,2001,"511",310,201,226,"93",133,0.429,0.4627,0.4423
"6748",150668,2001,"172",94,78,87,"33",54,0.5745,0.4231,0.5058
"6749",150941,2001,"220",135,85,117,"43",74,0.5481,0.5059,0.5318
"6750",151102,2001,"1426",735,691,69,"30",39,0.0531,0.0434,0.0484
"6751",151111,2001,"2275",1325,950,188,"71",117,0.0883,0.0747,0.0826
"6752",151306,2001,"1897",1135,762,236,"64",172,0.1515,0.084,0.1244
"6753",151324,2001,"2156",1166,990,413,"148",265,0.2273,0.1495,0.1916
"6754",151333,2001,"343",233,110,36,"8",28,0.1202,0.0727,0.105
"6755",151342,2001,"750",449,301,40,"15",25,0.0557,0.0498,0.0533
"6756",151351,2001,"6728",3716,3012,3353,"1424",1929,0.5191,0.4728,0.4984
"6757",151360,2001,"511",340,171,43,"12",31,0.0912,0.0702,0.0841
"6758",151379,2001,"722",440,282,57,"13",44,0.1,0.0461,0.0789
"6759",151388,2001,"264",172,92,18,"5",13,0.0756,0.0543,0.0682
"6760",151777,2001,"334",179,155,145,"53",92,0.514,0.3419,0.4341
"6761",151786,2001,"183",113,70,66,"21",45,0.3982,0.3,0.3607
"6762",152080,2001,"2036",958,1078,1825,"956",869,0.9071,0.8868,0.8964
"6763",152248,2001,"958",507,451,37,"12",25,0.0493,0.0266,0.0386
"6764",152363,2001,"232",121,111,105,"43",62,0.5124,0.3874,0.4526
"6765",152530,2001,"491",251,240,341,"160",181,0.7211,0.6667,0.6945
"6766",152600,2001,"660",339,321,442,"187",255,0.7522,0.5826,0.6697
"6767",153001,2001,"379",189,190,166,"69",97,0.5132,0.3632,0.438
"6768",153108,2001,"412",237,175,274,"108",166,0.7004,0.6171,0.665
"6769",153269,2001,"755",476,279,361,"122",239,0.5021,0.4373,0.4781
"6770",153384,2001,"356",184,172,291,"130",161,0.875,0.7558,0.8174
"6771",153603,2001,"4589",2087,2502,1463,"591",872,0.4178,0.2362,0.3188
"6772",153834,2001,"636",397,239,401,"144",257,0.6474,0.6025,0.6305
"6773",154095,2001,"2055",1310,745,665,"189",476,0.3634,0.2537,0.3236
"6774",155089,2001,"197",133,64,23,"6",17,0.1278,0.0938,0.1168
"6775",155317,2001,"4024",2198,1826,1267,"476",791,0.3599,0.2607,0.3149
"6776",155335,2001,"130",76,54,40,"18",22,0.2895,0.3333,0.3077
"6777",155399,2001,"3358",1689,1669,836,"274",562,0.3327,0.1642,0.249
"6778",155520,2001,"248",124,124,74,"20",54,0.4355,0.1613,0.2984
"6779",155627,2001,"132",46,86,35,"11",24,0.5217,0.1279,0.2652
"6780",155937,2001,"105",51,54,39,"16",23,0.451,0.2963,0.3714
"6781",156213,2001,"331",206,125,178,"66",112,0.5437,0.528,0.5378
"6782",156286,2001,"376",255,121,178,"47",131,0.5137,0.3884,0.4734
"6783",156295,2001,"424",241,183,192,"76",116,0.4813,0.4153,0.4528
"6784",156365,2001,"330",175,155,58,"24",34,0.1943,0.1548,0.1758
"6785",156541,2001,"406",203,203,93,"33",60,0.2956,0.1626,0.2291
"6786",156745,2001,"356",203,153,173,"69",104,0.5123,0.451,0.486
"6787",157058,2001,"387",199,188,31,"4",27,0.1357,0.0213,0.0801
"6788",157076,2001,"164",60,104,24,"8",16,0.2667,0.0769,0.1463
"6789",157085,2001,"3129",1679,1450,942,"374",568,0.3383,0.2579,0.3011
"6790",157289,2001,"2209",1150,1059,351,"137",214,0.1861,0.1294,0.1589
"6791",157386,2001,"1588",894,694,185,"66",119,0.1331,0.0951,0.1165
"6792",157401,2001,"1409",827,582,423,"135",288,0.3482,0.232,0.3002
"6793",157447,2001,"1787",1008,779,149,"52",97,0.0962,0.0668,0.0834
"6794",157535,2001,"258",142,116,41,"11",30,0.2113,0.0948,0.1589
"6795",157951,2001,"2640",1563,1077,651,"192",459,0.2937,0.1783,0.2466
"6796",158477,2001,"256",168,88,116,"31",85,0.506,0.3523,0.4531
"6797",159009,2001,"884",479,405,94,"23",71,0.1482,0.0568,0.1063
"6798",159391,2001,"5214",2873,2341,1282,"424",858,0.2986,0.1811,0.2459
"6799",159647,2001,"1770",850,920,481,"211",270,0.3176,0.2293,0.2718
"6800",159717,2001,"1350",745,605,151,"56",95,0.1275,0.0926,0.1119
"6801",159966,2001,"1408",841,567,121,"28",93,0.1106,0.0494,0.0859
"6802",160038,2001,"1543",951,592,198,"43",155,0.163,0.0726,0.1283
"6803",160612,2001,"2007",1209,798,199,"51",148,0.1224,0.0639,0.0992
"6804",160621,2001,"1206",690,516,75,"14",61,0.0884,0.0271,0.0622
"6805",160658,2001,"2301",1306,995,322,"93",229,0.1753,0.0935,0.1399
"6806",161004,2001,"452",228,224,374,"191",183,0.8026,0.8527,0.8274
"6807",161226,2001,"479",323,156,174,"45",129,0.3994,0.2885,0.3633
"6808",161235,2001,"99",49,50,24,"8",16,0.3265,0.16,0.2424
"6809",161244,2001,"155",105,50,32,"6",26,0.2476,0.12,0.2065
"6810",161253,2001,"1545",737,808,495,"214",281,0.3813,0.2649,0.3204
"6811",161554,2001,"922",538,384,93,"26",67,0.1245,0.0677,0.1009
"6812",162007,2001,"594",356,238,89,"21",68,0.191,0.0882,0.1498
"6813",162210,2001,"153",95,58,26,"3",23,0.2421,0.0517,0.1699
"6814",162283,2001,"540",384,156,36,"4",32,0.0833,0.0256,0.0667
"6815",162584,2001,"923",471,452,204,"65",139,0.2951,0.1438,0.221
"6816",162654,2001,"341",247,94,197,"45",152,0.6154,0.4787,0.5777
"6817",162760,2001,"112",110,2,76,"2",74,0.6727,1,0.6786
"6818",162928,2001,"1077",435,642,884,"510",374,0.8598,0.7944,0.8208
"6819",163046,2001,"880",517,363,679,"252",427,0.8259,0.6942,0.7716
"6820",163268,2001,"1332",603,729,461,"204",257,0.4262,0.2798,0.3461
"6821",163286,2001,"4341",2063,2278,2535,"1169",1366,0.6621,0.5132,0.584
"6822",163453,2001,"1125",663,462,172,"39",133,0.2006,0.0844,0.1529
"6823",163462,2001,"355",197,158,230,"105",125,0.6345,0.6646,0.6479
"6824",163851,2001,"945",542,403,429,"135",294,0.5424,0.335,0.454
"6825",163912,2001,"457",287,170,344,"114",230,0.8014,0.6706,0.7527
"6826",164076,2001,"1910",1245,665,681,"169",512,0.4112,0.2541,0.3565
"6827",164173,2001,"512",374,138,246,"56",190,0.508,0.4058,0.4805
"6828",164216,2001,"338",204,134,234,"89",145,0.7108,0.6642,0.6923
"6829",164270,2001,"368",209,159,244,"88",156,0.7464,0.5535,0.663
"6830",164447,2001,"197",98,99,91,"34",57,0.5816,0.3434,0.4619
"6831",164492,2001,"140",97,43,69,"24",45,0.4639,0.5581,0.4929
"6832",164562,2001,"604",369,235,402,"148",254,0.6883,0.6298,0.6656
"6833",165015,2001,"735",416,319,629,"261",368,0.8846,0.8182,0.8558
"6834",165024,2001,"1139",695,444,255,"59",196,0.282,0.1329,0.2239
"6835",165334,2001,"511",330,181,354,"123",231,0.7,0.6796,0.6928
"6836",165662,2001,"643",406,237,440,"163",277,0.6823,0.6878,0.6843
"6837",165671,2001,"277",189,88,128,"32",96,0.5079,0.3636,0.4621
"6838",165820,2001,"405",220,185,91,"29",62,0.2818,0.1568,0.2247
"6839",165866,2001,"645",455,190,145,"28",117,0.2571,0.1474,0.2248
"6840",165936,2001,"441",313,128,246,"63",183,0.5847,0.4922,0.5578
"6841",166027,2001,"1637",786,851,1448,"742",706,0.8982,0.8719,0.8845
"6842",166124,2001,"691",366,325,609,"274",335,0.9153,0.8431,0.8813
"6843",166513,2001,"967",349,618,269,"128",141,0.404,0.2071,0.2782
"6844",166629,2001,"4289",2298,1991,2046,"783",1263,0.5496,0.3933,0.477
"6845",166638,2001,"676",359,317,67,"22",45,0.1253,0.0694,0.0991
"6846",166683,2001,"1027",426,601,857,"479",378,0.8873,0.797,0.8345
"6847",167288,2001,"268",171,97,85,"26",59,0.345,0.268,0.3172
"6848",167987,2001,"1148",575,573,310,"125",185,0.3217,0.2182,0.27
"6849",167996,2001,"586",328,258,479,"203",276,0.8415,0.7868,0.8174
"6850",168005,2001,"710",393,317,285,"116",169,0.43,0.3659,0.4014
"6851",168148,2001,"1163",640,523,970,"426",544,0.85,0.8145,0.834
"6852",168254,2001,"654",287,367,346,"176",170,0.5923,0.4796,0.5291
"6853",168281,2001,"494",328,166,364,"114",250,0.7622,0.6867,0.7368
"6854",168342,2001,"520",257,263,475,"236",239,0.93,0.8973,0.9135
"6855",168546,2001,"450",226,224,267,"115",152,0.6726,0.5134,0.5933
"6856",168786,2001,"321",227,94,107,"29",78,0.3436,0.3085,0.3333
"6857",169080,2001,"1026",601,425,571,"214",357,0.594,0.5035,0.5565
"6858",169798,2001,"2706",1627,1079,284,"92",192,0.118,0.0853,0.105
"6859",169910,2001,"2128",901,1227,123,"66",57,0.0633,0.0538,0.0578
"6860",170082,2001,"2977",1826,1151,569,"189",380,0.2081,0.1642,0.1911
"6861",170301,2001,"763",468,295,474,"158",316,0.6752,0.5356,0.6212
"6862",170532,2001,"341",198,143,248,"100",148,0.7475,0.6993,0.7273
"6863",170639,2001,"536",235,301,83,"42",41,0.1745,0.1395,0.1549
"6864",170976,2001,"5531",2884,2647,3896,"1752",2144,0.7434,0.6619,0.7044
"6865",171100,2001,"6755",3808,2947,2878,"1041",1837,0.4824,0.3532,0.4261
"6866",171128,2001,"1189",281,908,281,"181",100,0.3559,0.1993,0.2363
"6867",171137,2001,"658",330,328,90,"33",57,0.1727,0.1006,0.1368
"6868",171146,2001,"549",330,219,54,"17",37,0.1121,0.0776,0.0984
"6869",171599,2001,"151",59,92,52,"26",26,0.4407,0.2826,0.3444
"6870",172051,2001,"1044",539,505,106,"39",67,0.1243,0.0772,0.1015
"6871",172699,2001,"4562",2306,2256,857,"334",523,0.2268,0.148,0.1879
"6872",173160,2001,"645",385,260,442,"173",269,0.6987,0.6654,0.6853
"6873",173258,2001,"516",265,251,467,"222",245,0.9245,0.8845,0.905
"6874",173328,2001,"200",87,113,57,"26",31,0.3563,0.2301,0.285
"6875",173647,2001,"601",343,258,468,"196",272,0.793,0.7597,0.7787
"6876",173902,2001,"505",265,240,415,"193",222,0.8377,0.8042,0.8218
"6877",174066,2001,"5259",2677,2582,1939,"841",1098,0.4102,0.3257,0.3687
"6878",174233,2001,"2109",1094,1015,495,"180",315,0.2879,0.1773,0.2347
"6879",174251,2001,"474",296,178,206,"74",132,0.4459,0.4157,0.4346
"6880",174491,2001,"400",262,138,184,"54",130,0.4962,0.3913,0.46
"6881",174792,2001,"502",0,502,360,"360",0,NA,0.7171,0.7171
"6882",174844,2001,"744",432,312,608,"253",355,0.8218,0.8109,0.8172
"6883",174899,2001,"314",224,90,175,"48",127,0.567,0.5333,0.5573
"6884",174914,2001,"1080",579,501,601,"253",348,0.601,0.505,0.5565
"6885",175342,2001,"495",262,233,97,"36",61,0.2328,0.1545,0.196
"6886",175421,2001,"224",122,102,50,"22",28,0.2295,0.2157,0.2232
"6887",175616,2001,"430",253,177,77,"21",56,0.2213,0.1186,0.1791
"6888",175856,2001,"930",540,390,154,"35",119,0.2204,0.0897,0.1656
"6889",175980,2001,"324",178,146,208,"80",128,0.7191,0.5479,0.642
"6890",176017,2001,"2126",1110,1016,402,"215",187,0.1685,0.2116,0.1891
"6891",176035,2001,"189",163,26,44,"3",41,0.2515,0.1154,0.2328
"6892",176044,2001,"258",158,100,42,"9",33,0.2089,0.09,0.1628
"6893",176080,2001,"1826",909,917,483,"201",282,0.3102,0.2192,0.2645
"6894",176406,2001,"201",137,64,58,"13",45,0.3285,0.2031,0.2886
"6895",176628,2001,"155",62,93,32,"7",25,0.4032,0.0753,0.2065
"6896",176947,2001,"240",116,124,67,"23",44,0.3793,0.1855,0.2792
"6897",176965,2001,"1437",789,648,275,"33",242,0.3067,0.0509,0.1914
"6898",177418,2001,"153",111,42,50,"12",38,0.3423,0.2857,0.3268
"6899",178059,2001,"247",183,64,141,"31",110,0.6011,0.4844,0.5709
"6900",178341,2001,"786",411,375,117,"47",70,0.1703,0.1253,0.1489
"6901",178387,2001,"1079",666,413,140,"44",96,0.1441,0.1065,0.1297
"6902",178396,2001,"4112",2175,1937,1686,"643",1043,0.4795,0.332,0.41
"6903",178402,2001,"734",444,290,106,"36",70,0.1577,0.1241,0.1444
"6904",178411,2001,"691",126,565,144,"109",35,0.2778,0.1929,0.2084
"6905",178420,2001,"515",313,202,96,"25",71,0.2268,0.1238,0.1864
"6906",178615,2001,"1456",865,591,666,"232",434,0.5017,0.3926,0.4574
"6907",179043,2001,"298",150,148,165,"76",89,0.5933,0.5135,0.5537
"6908",179159,2001,"1329",695,634,827,"374",453,0.6518,0.5899,0.6223
"6909",179557,2001,"1502",910,592,356,"98",258,0.2835,0.1655,0.237
"6910",179566,2001,"2508",1417,1091,672,"213",459,0.3239,0.1952,0.2679
"6911",179867,2001,"1262",637,625,1049,"494",555,0.8713,0.7904,0.8312
"6912",179894,2001,"399",250,149,179,"64",115,0.46,0.4295,0.4486
"6913",179946,2001,"248",102,146,97,"42",55,0.5392,0.2877,0.3911
"6914",180179,2001,"526",346,180,48,"15",33,0.0954,0.0833,0.0913
"6915",180461,2001,"1720",731,989,292,"148",144,0.197,0.1496,0.1698
"6916",180522,2001,"177",76,101,16,"10",6,0.0789,0.099,0.0904
"6917",180984,2001,"265",163,102,71,"23",48,0.2945,0.2255,0.2679
"6918",181002,2001,"760",440,320,454,"170",284,0.6455,0.5312,0.5974
"6919",181020,2001,"218",118,100,128,"62",66,0.5593,0.62,0.5872
"6920",181127,2001,"252",125,127,130,"55",75,0.6,0.4331,0.5159
"6921",181215,2001,"1038",602,436,213,"62",151,0.2508,0.1422,0.2052
"6922",181394,2001,"1588",857,731,170,"62",108,0.126,0.0848,0.1071
"6923",181446,2001,"392",223,169,219,"84",135,0.6054,0.497,0.5587
"6924",181464,2001,"3480",1691,1789,788,"308",480,0.2839,0.1722,0.2264
"6925",181534,2001,"186",85,101,16,"5",11,0.1294,0.0495,0.086
"6926",181783,2001,"583",359,224,138,"40",98,0.273,0.1786,0.2367
"6927",182281,2001,"2424",1411,1013,324,"99",225,0.1595,0.0977,0.1337
"6928",182290,2001,"1956",1125,831,268,"78",190,0.1689,0.0939,0.137
"6929",182634,2001,"285",184,101,140,"43",97,0.5272,0.4257,0.4912
"6930",182795,2001,"477",249,228,153,"67",86,0.3454,0.2939,0.3208
"6931",183062,2001,"942",561,381,283,"94",189,0.3369,0.2467,0.3004
"6932",183080,2001,"872",463,409,272,"89",183,0.3952,0.2176,0.3119
"6933",183239,2001,"535",286,249,363,"152",211,0.7378,0.6104,0.6785
"6934",183822,2001,"250",150,100,41,"16",25,0.1667,0.16,0.164
"6935",183974,2001,"195",141,54,57,"6",51,0.3617,0.1111,0.2923
"6936",184348,2001,"395",254,141,261,"89",172,0.6772,0.6312,0.6608
"6937",184603,2001,"448",260,188,80,"27",53,0.2038,0.1436,0.1786
"6938",184612,2001,"272",188,84,46,"9",37,0.1968,0.1071,0.1691
"6939",184782,2001,"1276",680,596,498,"201",297,0.4368,0.3372,0.3903
"6940",185129,2001,"540",304,236,43,"14",29,0.0954,0.0593,0.0796
"6941",185572,2001,"881",484,397,339,"125",214,0.4421,0.3149,0.3848
"6942",185590,2001,"1378",826,552,371,"102",269,0.3257,0.1848,0.2692
"6943",185828,2001,"706",129,577,102,"70",32,0.2481,0.1213,0.1445
"6944",186131,2001,"1184",570,614,1051,"526",525,0.9211,0.8567,0.8877
"6945",186201,2001,"628",382,246,303,"99",204,0.534,0.4024,0.4825
"6946",186283,2001,"839",472,367,361,"143",218,0.4619,0.3896,0.4303
"6947",186584,2001,"1182",601,581,495,"210",285,0.4742,0.3614,0.4188
"6948",186876,2001,"751",424,327,335,"122",213,0.5024,0.3731,0.4461
"6949",187134,2001,"1258",750,508,852,"302",550,0.7333,0.5945,0.6773
"6950",187444,2001,"1247",697,550,185,"59",126,0.1808,0.1073,0.1484
"6951",187985,2001,"2364",1323,1041,280,"103",177,0.1338,0.0989,0.1184
"6952",188030,2001,"2051",1075,976,250,"76",174,0.1619,0.0779,0.1219
"6953",188429,2001,"664",469,195,367,"89",278,0.5928,0.4564,0.5527
"6954",188641,2001,"500",243,257,232,"97",135,0.5556,0.3774,0.464
"6955",190044,2001,"722",164,558,382,"290",92,0.561,0.5197,0.5291
"6956",190099,2001,"740",392,348,631,"282",349,0.8903,0.8103,0.8527
"6957",190150,2001,"1330",607,723,1108,"612",496,0.8171,0.8465,0.8331
"6958",190248,2001,"132",88,44,50,"9",41,0.4659,0.2045,0.3788
"6959",190415,2001,"2984",1471,1513,2524,"1246",1278,0.8688,0.8235,0.8458
"6960",190512,2001,"1688",921,767,554,"231",323,0.3507,0.3012,0.3282
"6961",190549,2001,"1017",591,426,209,"64",145,0.2453,0.1502,0.2055
"6962",190558,2001,"1600",817,783,57,"22",35,0.0428,0.0281,0.0356
"6963",190567,2001,"705",310,395,54,"17",37,0.1194,0.043,0.0766
"6964",190594,2001,"1877",1284,593,234,"41",193,0.1503,0.0691,0.1247
"6965",190637,2001,"642",441,201,77,"18",59,0.1338,0.0896,0.1199
"6966",190664,2001,"1204",704,500,325,"100",225,0.3196,0.2,0.2699
"6967",190691,2001,"464",320,144,35,"11",24,0.075,0.0764,0.0754
"6968",190725,2001,"340",278,62,88,"12",76,0.2734,0.1935,0.2588
"6969",191241,2001,"1610",950,660,1218,"470",748,0.7874,0.7121,0.7565
"6970",191515,2001,"465",233,232,386,"185",201,0.8627,0.7974,0.8301
"6971",191533,2001,"433",232,201,200,"73",127,0.5474,0.3632,0.4619
"6972",191630,2001,"548",313,235,368,"137",231,0.738,0.583,0.6715
"6973",191649,2001,"1974",1037,937,685,"248",437,0.4214,0.2647,0.347
"6974",191676,2001,"355",229,126,222,"77",145,0.6332,0.6111,0.6254
"6975",191931,2001,"768",376,392,360,"144",216,0.5745,0.3673,0.4688
"6976",191968,2001,"1755",1002,753,1230,"501",729,0.7275,0.6653,0.7009
"6977",192192,2001,"253",188,65,88,"14",74,0.3936,0.2154,0.3478
"6978",192323,2001,"502",292,210,311,"122",189,0.6473,0.581,0.6195
"6979",192439,2001,"825",574,251,55,"20",35,0.061,0.0797,0.0667
"6980",192703,2001,"597",276,321,344,"162",182,0.6594,0.5047,0.5762
"6981",192749,2001,"404",277,127,226,"65",161,0.5812,0.5118,0.5594
"6982",192819,2001,"908",484,424,632,"281",351,0.7252,0.6627,0.696
"6983",192925,2001,"208",166,42,53,"12",41,0.247,0.2857,0.2548
"6984",193016,2001,"618",412,206,61,"10",51,0.1238,0.0485,0.0987
"6985",193292,2001,"210",145,65,66,"16",50,0.3448,0.2462,0.3143
"6986",193353,2001,"343",239,104,143,"33",110,0.4603,0.3173,0.4169
"6987",193399,2001,"286",214,72,111,"21",90,0.4206,0.2917,0.3881
"6988",193584,2001,"358",274,84,239,"50",189,0.6898,0.5952,0.6676
"6989",193645,2001,"774",650,124,169,"13",156,0.24,0.1048,0.2183
"6990",193654,2001,"617",422,195,269,"74",195,0.4621,0.3795,0.436
"6991",193900,2001,"4136",2525,1611,2574,"1016",1558,0.617,0.6307,0.6223
"6992",193973,2001,"598",362,236,322,"117",205,0.5663,0.4958,0.5385
"6993",194161,2001,"320",206,114,103,"35",68,0.3301,0.307,0.3219
"6994",194310,2001,"1573",948,625,567,"192",375,0.3956,0.3072,0.3605
"6995",194824,2001,"1109",283,826,730,"532",198,0.6996,0.6441,0.6583
"6996",195003,2001,"2227",574,1653,451,"249",202,0.3519,0.1506,0.2025
"6997",195030,2001,"1095",481,614,767,"390",377,0.7838,0.6352,0.7005
"6998",195164,2001,"518",263,255,280,"121",159,0.6046,0.4745,0.5405
"6999",195173,2001,"471",220,251,171,"75",96,0.4364,0.2988,0.3631
"7000",195216,2001,"511",269,242,377,"179",198,0.7361,0.7397,0.7378
"7001",195234,2001,"490",356,134,239,"45",194,0.5449,0.3358,0.4878
"7002",195243,2001,"301",164,137,101,"35",66,0.4024,0.2555,0.3355
"7003",195304,2001,"323",240,83,213,"50",163,0.6792,0.6024,0.6594
"7004",195474,2001,"713",394,319,530,"230",300,0.7614,0.721,0.7433
"7005",195526,2001,"598",352,246,469,"196",273,0.7756,0.7967,0.7843
"7006",195544,2001,"66",56,10,43,"4",39,0.6964,0.4,0.6515
"7007",195809,2001,"2670",1523,1147,957,"357",600,0.394,0.3112,0.3584
"7008",196413,2001,"2601",1493,1108,1837,"716",1121,0.7508,0.6462,0.7063
"7009",196592,2001,"1520",1064,456,146,"42",104,0.0977,0.0921,0.0961
"7010",197045,2001,"475",218,257,154,"76",78,0.3578,0.2957,0.3242
"7011",197133,2001,"695",447,248,612,"211",401,0.8971,0.8508,0.8806
"7012",197869,2001,"2303",1196,1107,857,"309",548,0.4582,0.2791,0.3721
"7013",197984,2001,"143",68,75,61,"22",39,0.5735,0.2933,0.4266
"7014",198385,2001,"465",246,219,420,"193",227,0.9228,0.8813,0.9032
"7015",198464,2001,"3182",1877,1305,813,"242",571,0.3042,0.1854,0.2555
"7016",198507,2001,"363",200,163,102,"32",70,0.35,0.1963,0.281
"7017",198516,2001,"1212",757,455,797,"263",534,0.7054,0.578,0.6576
"7018",198835,2001,"268",159,109,107,"27",80,0.5031,0.2477,0.3993
"7019",198969,2001,"379",117,262,59,"28",31,0.265,0.1069,0.1557
"7020",199102,2001,"1760",874,886,354,"117",237,0.2712,0.1321,0.2011
"7021",199111,2001,"446",281,165,149,"43",106,0.3772,0.2606,0.3341
"7022",199120,2001,"3681",2195,1486,2611,"986",1625,0.7403,0.6635,0.7093
"7023",199139,2001,"2309",1273,1036,610,"209",401,0.315,0.2017,0.2642
"7024",199148,2001,"1898",1350,548,511,"102",409,0.303,0.1861,0.2692
"7025",199157,2001,"763",492,271,174,"29",145,0.2947,0.107,0.228
"7026",199193,2001,"3862",1630,2232,1404,"619",785,0.4816,0.2773,0.3635
"7027",199218,2001,"1983",1246,737,824,"205",619,0.4968,0.2782,0.4155
"7028",199281,2001,"688",363,325,100,"31",69,0.1901,0.0954,0.1453
"7029",199306,2001,"146",69,77,63,"26",37,0.5362,0.3377,0.4315
"7030",199412,2001,"209",166,43,105,"23",82,0.494,0.5349,0.5024
"7031",199582,2001,"324",172,152,52,"16",36,0.2093,0.1053,0.1605
"7032",199643,2001,"445",283,162,83,"18",65,0.2297,0.1111,0.1865
"7033",199847,2001,"960",481,479,756,"343",413,0.8586,0.7161,0.7875
"7034",199962,2001,"393",209,184,147,"44",103,0.4928,0.2391,0.374
"7035",199999,2001,"614",424,190,124,"17",107,0.2524,0.0895,0.202
"7036",200004,2001,"1176",530,646,266,"108",158,0.2981,0.1672,0.2262
"7037",200059,2001,"375",188,187,39,"8",31,0.1649,0.0428,0.104
"7038",200156,2001,"293",173,120,96,"35",61,0.3526,0.2917,0.3276
"7039",200217,2001,"372",213,159,143,"43",100,0.4695,0.2704,0.3844
"7040",200226,2001,"133",62,71,18,"6",12,0.1935,0.0845,0.1353
"7041",200253,2001,"419",241,178,43,"11",32,0.1328,0.0618,0.1026
"7042",200280,2001,"1969",870,1099,436,"191",245,0.2816,0.1738,0.2214
"7043",200332,2001,"1187",491,696,162,"80",82,0.167,0.1149,0.1365
"7044",200572,2001,"155",75,80,40,"15",25,0.3333,0.1875,0.2581
"7045",201104,2001,"492",273,219,200,"69",131,0.4799,0.3151,0.4065
"7046",201371,2001,"239",133,106,117,"44",73,0.5489,0.4151,0.4895
"7047",201548,2001,"519",324,195,243,"68",175,0.5401,0.3487,0.4682
"7048",201645,2001,"737",288,449,433,"228",205,0.7118,0.5078,0.5875
"7049",201690,2001,"397",204,193,33,"7",26,0.1275,0.0363,0.0831
"7050",202134,2001,"1008",493,515,95,"47",48,0.0974,0.0913,0.0942
"7051",202480,2001,"1715",879,836,971,"389",582,0.6621,0.4653,0.5662
"7052",202523,2001,"553",309,244,414,"170",244,0.7896,0.6967,0.7486
"7053",202763,2001,"613",377,236,255,"69",186,0.4934,0.2924,0.416
"7054",203085,2001,"262",119,143,113,"38",75,0.6303,0.2657,0.4313
"7055",203128,2001,"269",157,112,149,"52",97,0.6178,0.4643,0.5539
"7056",203368,2001,"789",442,347,515,"219",296,0.6697,0.6311,0.6527
"7057",203517,2001,"3588",2202,1386,556,"158",398,0.1807,0.114,0.155
"7058",203535,2001,"424",243,181,344,"149",195,0.8025,0.8232,0.8113
"7059",203580,2001,"127",98,29,46,"7",39,0.398,0.2414,0.3622
"7060",203775,2001,"355",214,141,145,"46",99,0.4626,0.3262,0.4085
"7061",203845,2001,"362",151,211,164,"77",87,0.5762,0.3649,0.453
"7062",204024,2001,"3440",1922,1518,2305,"905",1400,0.7284,0.5962,0.6701
"7063",204185,2001,"591",329,262,298,"89",209,0.6353,0.3397,0.5042
"7064",204194,2001,"321",176,145,110,"34",76,0.4318,0.2345,0.3427
"7065",204617,2001,"174",116,58,51,"18",33,0.2845,0.3103,0.2931
"7066",204796,2001,"5955",2935,3020,2381,"906",1475,0.5026,0.3,0.3998
"7067",204857,2001,"3697",2200,1497,1778,"594",1184,0.5382,0.3968,0.4809
"7068",206330,2001,"202",67,135,42,"19",23,0.3433,0.1407,0.2079
"7069",206589,2001,"532",282,250,342,"143",199,0.7057,0.572,0.6429
"7070",206604,2001,"2117",1165,952,373,"129",244,0.2094,0.1355,0.1762
"7071",206622,2001,"795",426,369,555,"249",306,0.7183,0.6748,0.6981
"7072",206695,2001,"1951",1041,910,243,"81",162,0.1556,0.089,0.1246
"7073",206914,2001,"673",355,318,55,"16",39,0.1099,0.0503,0.0817
"7074",207209,2001,"446",232,214,18,"5",13,0.056,0.0234,0.0404
"7075",207306,2001,"310",138,172,36,"16",20,0.1449,0.093,0.1161
"7076",207324,2001,"465",234,231,107,"42",65,0.2778,0.1818,0.2301
"7077",207388,2001,"3111",1594,1517,834,"285",549,0.3444,0.1879,0.2681
"7078",207500,2001,"3629",1908,1721,897,"332",565,0.2961,0.1929,0.2472
"7079",207722,2001,"261",138,123,26,"11",15,0.1087,0.0894,0.0996
"7080",207847,2001,"579",266,313,75,"40",35,0.1316,0.1278,0.1295
"7081",207865,2001,"853",481,372,128,"45",83,0.1726,0.121,0.1501
"7082",208822,2001,"301",180,121,172,"64",108,0.6,0.5289,0.5714
"7083",209056,2001,"415",240,175,277,"109",168,0.7,0.6229,0.6675
"7084",209065,2001,"422",232,190,250,"89",161,0.694,0.4684,0.5924
"7085",209542,2001,"2982",1467,1515,885,"356",529,0.3606,0.235,0.2968
"7086",209551,2001,"3049",1687,1362,1244,"464",780,0.4624,0.3407,0.408
"7087",209612,2001,"310",206,104,171,"47",124,0.6019,0.4519,0.5516
"7088",209807,2001,"1020",548,472,129,"42",87,0.1588,0.089,0.1265
"7089",209922,2001,"349",198,151,203,"84",119,0.601,0.5563,0.5817
"7090",210146,2001,"759",436,323,149,"47",102,0.2339,0.1455,0.1963
"7091",210401,2001,"476",261,215,345,"143",202,0.7739,0.6651,0.7248
"7092",210429,2001,"811",536,275,144,"25",119,0.222,0.0909,0.1776
"7093",210571,2001,"402",243,159,215,"75",140,0.5761,0.4717,0.5348
"7094",210669,2001,"486",271,215,312,"128",184,0.679,0.5953,0.642
"7095",210775,2001,"248",159,89,90,"28",62,0.3899,0.3146,0.3629
"7096",211088,2001,"293",203,90,158,"47",111,0.5468,0.5222,0.5392
"7097",211158,2001,"1684",1021,663,646,"183",463,0.4535,0.276,0.3836
"7098",211291,2001,"913",468,445,784,"367",417,0.891,0.8247,0.8587
"7099",211352,2001,"374",221,153,166,"50",116,0.5249,0.3268,0.4439
"7100",211361,2001,"817",413,404,208,"84",124,0.3002,0.2079,0.2546
"7101",211431,2001,"177",170,7,65,"0",65,0.3824,0,0.3672
"7102",211440,2001,"1317",534,783,927,"526",401,0.7509,0.6718,0.7039
"7103",211468,2001,"170",170,0,78,"0",78,0.4588,NA,0.4588
"7104",211556,2001,"133",133,0,56,"0",56,0.4211,NA,0.4211
"7105",211583,2001,"94",94,0,50,"0",50,0.5319,NA,0.5319
"7106",211608,2001,"292",146,146,32,"7",25,0.1712,0.0479,0.1096
"7107",211644,2001,"1286",814,472,313,"82",231,0.2838,0.1737,0.2434
"7108",211981,2001,"355",157,198,126,"53",73,0.465,0.2677,0.3549
"7109",212009,2001,"611",321,290,484,"218",266,0.8287,0.7517,0.7921
"7110",212054,2001,"1934",759,1175,313,"124",189,0.249,0.1055,0.1618
"7111",212106,2001,"1176",684,492,596,"219",377,0.5512,0.4451,0.5068
"7112",212115,2001,"969",564,405,259,"66",193,0.3422,0.163,0.2673
"7113",212133,2001,"427",287,140,216,"69",147,0.5122,0.4929,0.5059
"7114",212160,2001,"1409",831,578,323,"99",224,0.2696,0.1713,0.2292
"7115",212197,2001,"514",319,195,326,"116",210,0.6583,0.5949,0.6342
"7116",212577,2001,"510",248,262,401,"190",211,0.8508,0.7252,0.7863
"7117",212601,2001,"525",313,212,244,"83",161,0.5144,0.3915,0.4648
"7118",212832,2001,"176",140,36,85,"15",70,0.5,0.4167,0.483
"7119",212911,2001,"296",154,142,256,"120",136,0.8831,0.8451,0.8649
"7120",213020,2001,"2557",1460,1097,624,"190",434,0.2973,0.1732,0.244
"7121",213251,2001,"340",205,135,242,"87",155,0.7561,0.6444,0.7118
"7122",213321,2001,"441",217,224,286,"121",165,0.7604,0.5402,0.6485
"7123",213349,2001,"1630",957,673,474,"111",363,0.3793,0.1649,0.2908
"7124",213358,2001,"214",133,81,91,"34",57,0.4286,0.4198,0.4252
"7125",213367,2001,"849",476,373,514,"190",324,0.6807,0.5094,0.6054
"7126",213385,2001,"575",287,288,487,"238",249,0.8676,0.8264,0.847
"7127",213507,2001,"416",229,187,266,"105",161,0.7031,0.5615,0.6394
"7128",213543,2001,"1109",435,674,798,"436",362,0.8322,0.6469,0.7196
"7129",213613,2001,"978",581,397,286,"96",190,0.327,0.2418,0.2924
"7130",213668,2001,"407",218,189,249,"100",149,0.6835,0.5291,0.6118
"7131",213783,2001,"640",362,278,200,"77",123,0.3398,0.277,0.3125
"7132",213826,2001,"287",215,72,114,"23",91,0.4233,0.3194,0.3972
"7133",213996,2001,"702",425,277,472,"166",306,0.72,0.5993,0.6724
"7134",214041,2001,"1245",758,487,518,"162",356,0.4697,0.3326,0.4161
"7135",214069,2001,"260",188,72,157,"39",118,0.6277,0.5417,0.6038
"7136",214157,2001,"315",200,115,219,"68",151,0.755,0.5913,0.6952
"7137",214175,2001,"574",330,244,456,"184",272,0.8242,0.7541,0.7944
"7138",214272,2001,"345",217,128,115,"25",90,0.4147,0.1953,0.3333
"7139",214777,2001,"6146",2983,3163,3576,"1586",1990,0.6671,0.5014,0.5818
"7140",215062,2001,"2316",1148,1168,2018,"997",1021,0.8894,0.8536,0.8713
"7141",215743,2001,"342",187,155,163,"60",103,0.5508,0.3871,0.4766
"7142",215798,2001,"262",128,134,161,"69",92,0.7188,0.5149,0.6145
"7143",215929,2001,"1013",578,435,674,"258",416,0.7197,0.5931,0.6654
"7144",216010,2001,"1478",805,673,683,"239",444,0.5516,0.3551,0.4621
"7145",216038,2001,"1314",751,563,378,"117",261,0.3475,0.2078,0.2877
"7146",216287,2001,"380",193,187,346,"165",181,0.9378,0.8824,0.9105
"7147",216339,2001,"3157",1826,1331,919,"319",600,0.3286,0.2397,0.2911
"7148",216524,2001,"387",230,157,278,"114",164,0.713,0.7261,0.7183
"7149",216694,2001,"315",159,156,141,"56",85,0.5346,0.359,0.4476
"7150",216764,2001,"1626",1020,606,561,"144",417,0.4088,0.2376,0.345
"7151",216807,2001,"375",219,156,224,"76",148,0.6758,0.4872,0.5973
"7152",216852,2001,"550",227,323,188,"78",110,0.4846,0.2415,0.3418
"7153",216931,2001,"407",198,209,198,"99",99,0.5,0.4737,0.4865
"7154",217059,2001,"968",540,428,383,"137",246,0.4556,0.3201,0.3957
"7155",217156,2001,"1375",760,615,1154,"506",648,0.8526,0.8228,0.8393
"7156",217402,2001,"933",531,402,795,"334",461,0.8682,0.8308,0.8521
"7157",217536,2001,"551",396,155,321,"78",243,0.6136,0.5032,0.5826
"7158",217776,2001,"139",78,61,46,"18",28,0.359,0.2951,0.3309
"7159",217819,2001,"1967",1295,672,868,"248",620,0.4788,0.369,0.4413
"7160",217882,2001,"2530",1184,1346,1166,"443",723,0.6106,0.3291,0.4609
"7161",217998,2001,"217",127,90,125,"44",81,0.6378,0.4889,0.576
"7162",218061,2001,"634",377,257,127,"41",86,0.2281,0.1595,0.2003
"7163",218229,2001,"488",291,197,118,"25",93,0.3196,0.1269,0.2418
"7164",218238,2001,"136",69,67,31,"11",20,0.2899,0.1642,0.2279
"7165",218399,2001,"268",167,101,56,"13",43,0.2575,0.1287,0.209
"7166",218414,2001,"178",70,108,55,"26",29,0.4143,0.2407,0.309
"7167",218663,2001,"3227",1770,1457,1304,"461",843,0.4763,0.3164,0.4041
"7168",218724,2001,"931",494,437,212,"60",152,0.3077,0.1373,0.2277
"7169",218733,2001,"615",358,257,135,"47",88,0.2458,0.1829,0.2195
"7170",218742,2001,"573",350,223,107,"36",71,0.2029,0.1614,0.1867
"7171",218973,2001,"303",152,151,218,"100",118,0.7763,0.6623,0.7195
"7172",219000,2001,"416",276,140,214,"58",156,0.5652,0.4143,0.5144
"7173",219046,2001,"565",354,211,65,"27",38,0.1073,0.128,0.115
"7174",219082,2001,"292",123,169,54,"28",26,0.2114,0.1657,0.1849
"7175",219198,2001,"148",109,39,49,"10",39,0.3578,0.2564,0.3311
"7176",219259,2001,"409",244,165,61,"14",47,0.1926,0.0848,0.1491
"7177",219356,2001,"1495",751,744,316,"105",211,0.281,0.1411,0.2114
"7178",219471,2001,"932",578,354,196,"45",151,0.2612,0.1271,0.2103
"7179",219602,2001,"900",569,331,77,"20",57,0.1002,0.0604,0.0856
"7180",219709,2001,"502",309,193,284,"121",163,0.5275,0.6269,0.5657
"7181",219718,2001,"141",63,78,21,"3",18,0.2857,0.0385,0.1489
"7182",219949,2001,"200",92,108,39,"15",24,0.2609,0.1389,0.195
"7183",220075,2001,"1472",838,634,255,"79",176,0.21,0.1246,0.1732
"7184",220215,2001,"346",191,155,146,"58",88,0.4607,0.3742,0.422
"7185",220613,2001,"663",405,258,204,"57",147,0.363,0.2209,0.3077
"7186",220631,2001,"153",101,52,34,"12",22,0.2178,0.2308,0.2222
"7187",220710,2001,"288",166,122,133,"35",98,0.5904,0.2869,0.4618
"7188",221351,2001,"417",249,168,292,"107",185,0.743,0.6369,0.7002
"7189",221519,2001,"353",185,168,259,"117",142,0.7676,0.6964,0.7337
"7190",221731,2001,"119",69,50,33,"9",24,0.3478,0.18,0.2773
"7191",221847,2001,"1289",529,760,230,"108",122,0.2306,0.1421,0.1784
"7192",221892,2001,"216",112,104,82,"36",46,0.4107,0.3462,0.3796
"7193",222178,2001,"1031",598,433,387,"127",260,0.4348,0.2933,0.3754
"7194",222983,2001,"312",174,138,220,"91",129,0.7414,0.6594,0.7051
"7195",223232,2001,"2790",1664,1126,1340,"434",906,0.5445,0.3854,0.4803
"7196",224004,2001,"189",104,85,28,"10",18,0.1731,0.1176,0.1481
"7197",224323,2001,"310",180,130,170,"77",93,0.5167,0.5923,0.5484
"7198",225432,2001,"869",481,388,19,"5",14,0.0291,0.0129,0.0219
"7199",225548,2001,"319",152,167,80,"34",46,0.3026,0.2036,0.2508
"7200",225627,2001,"416",285,131,66,"10",56,0.1965,0.0763,0.1587
"7201",226231,2001,"242",66,176,74,"47",27,0.4091,0.267,0.3058
"7202",226833,2001,"668",376,292,69,"22",47,0.125,0.0753,0.1033
"7203",227216,2001,"2803",1665,1138,466,"146",320,0.1922,0.1283,0.1663
"7204",227331,2001,"401",323,78,49,"7",42,0.13,0.0897,0.1222
"7205",227526,2001,"1380",771,609,182,"62",120,0.1556,0.1018,0.1319
"7206",227757,2001,"657",326,331,509,"247",262,0.8037,0.7462,0.7747
"7207",227845,2001,"413",254,159,131,"37",94,0.3701,0.2327,0.3172
"7208",227863,2001,"272",166,106,68,"23",45,0.2711,0.217,0.25
"7209",228042,2001,"180",110,70,46,"12",34,0.3091,0.1714,0.2556
"7210",228149,2001,"534",299,235,181,"72",109,0.3645,0.3064,0.339
"7211",228246,2001,"1353",713,640,751,"297",454,0.6367,0.4641,0.5551
"7212",228343,2001,"327",174,153,196,"77",119,0.6839,0.5033,0.5994
"7213",228431,2001,"2191",1370,821,360,"90",270,0.1971,0.1096,0.1643
"7214",228459,2001,"2469",1508,961,553,"134",419,0.2779,0.1394,0.224
"7215",228501,2001,"333",124,209,28,"7",21,0.1694,0.0335,0.0841
"7216",228529,2001,"783",411,372,126,"37",89,0.2165,0.0995,0.1609
"7217",228705,2001,"820",388,432,66,"28",38,0.0979,0.0648,0.0805
"7218",228723,2001,"6271",3265,3006,2408,"815",1593,0.4879,0.2711,0.384
"7219",228769,2001,"1838",914,924,271,"104",167,0.1827,0.1126,0.1474
"7220",228778,2001,"7198",3742,3456,3385,"1392",1993,0.5326,0.4028,0.4703
"7221",228787,2001,"984",402,582,304,"145",159,0.3955,0.2491,0.3089
"7222",228796,2001,"2156",1156,1000,89,"30",59,0.051,0.03,0.0413
"7223",228875,2001,"1514",894,620,761,"251",510,0.5705,0.4048,0.5026
"7224",228981,2001,"376",208,168,133,"42",91,0.4375,0.25,0.3537
"7225",229018,2001,"165",104,61,36,"9",27,0.2596,0.1475,0.2182
"7226",229027,2001,"1910",977,933,137,"60",77,0.0788,0.0643,0.0717
"7227",229115,2001,"4075",1967,2108,1133,"438",695,0.3533,0.2078,0.278
"7228",229780,2001,"204",111,93,50,"17",33,0.2973,0.1828,0.2451
"7229",229814,2001,"759",419,340,109,"24",85,0.2029,0.0706,0.1436
"7230",230603,2001,"562",443,119,113,"18",95,0.2144,0.1513,0.2011
"7231",230728,2001,"1892",1270,622,384,"72",312,0.2457,0.1158,0.203
"7232",230764,2001,"1877",1038,839,390,"135",255,0.2457,0.1609,0.2078
"7233",230782,2001,"1509",897,612,47,"18",29,0.0323,0.0294,0.0311
"7234",231059,2001,"518",286,232,380,"150",230,0.8042,0.6466,0.7336
"7235",231174,2001,"1835",1052,783,1017,"381",636,0.6046,0.4866,0.5542
"7236",231420,2001,"175",81,94,48,"12",36,0.4444,0.1277,0.2743
"7237",231554,2001,"162",91,71,53,"21",32,0.3516,0.2958,0.3272
"7238",231624,2001,"1358",793,565,1140,"441",699,0.8815,0.7805,0.8395
"7239",231712,2001,"1042",595,447,318,"100",218,0.3664,0.2237,0.3052
"7240",232025,2001,"267",130,137,113,"48",65,0.5,0.3504,0.4232
"7241",232043,2001,"208",124,84,115,"44",71,0.5726,0.5238,0.5529
"7242",232089,2001,"269",104,165,51,"20",31,0.2981,0.1212,0.1896
"7243",232186,2001,"2068",1136,932,631,"191",440,0.3873,0.2049,0.3051
"7244",232265,2001,"1189",748,441,450,"106",344,0.4599,0.2404,0.3785
"7245",232423,2001,"3244",2004,1240,2103,"696",1407,0.7021,0.5613,0.6483
"7246",232557,2001,"1129",602,527,381,"146",235,0.3904,0.277,0.3375
"7247",232566,2001,"891",611,280,410,"103",307,0.5025,0.3679,0.4602
"7248",232609,2001,"475",278,197,219,"67",152,0.5468,0.3401,0.4611
"7249",232681,2001,"840",574,266,570,"158",412,0.7178,0.594,0.6786
"7250",232706,2001,"354",241,113,123,"29",94,0.39,0.2566,0.3475
"7251",232937,2001,"1067",655,412,113,"25",88,0.1344,0.0607,0.1059
"7252",232982,2001,"1502",821,681,340,"116",224,0.2728,0.1703,0.2264
"7253",233277,2001,"1875",1155,720,674,"200",474,0.4104,0.2778,0.3595
"7254",233374,2001,"790",430,360,640,"277",363,0.8442,0.7694,0.8101
"7255",233426,2001,"498",311,187,283,"96",187,0.6013,0.5134,0.5683
"7256",233541,2001,"308",158,150,106,"40",66,0.4177,0.2667,0.3442
"7257",233897,2001,"325",154,171,80,"36",44,0.2857,0.2105,0.2462
"7258",233921,2001,"5020",2063,2957,2511,"1228",1283,0.6219,0.4153,0.5002
"7259",234030,2001,"2675",1563,1112,547,"170",377,0.2412,0.1529,0.2045
"7260",234085,2001,"372",17,355,205,"196",9,0.5294,0.5521,0.5511
"7261",234155,2001,"1085",618,467,252,"61",191,0.3091,0.1306,0.2323
"7262",234164,2001,"534",316,218,68,"12",56,0.1772,0.055,0.1273
"7263",235097,2001,"1179",694,485,256,"98",158,0.2277,0.2021,0.2171
"7264",235167,2001,"460",236,224,206,"93",113,0.4788,0.4152,0.4478
"7265",236230,2001,"578",348,230,287,"89",198,0.569,0.387,0.4965
"7266",236328,2001,"702",423,279,477,"182",295,0.6974,0.6523,0.6795
"7267",236577,2001,"645",433,212,327,"95",232,0.5358,0.4481,0.507
"7268",236595,2001,"643",412,231,321,"101",220,0.534,0.4372,0.4992
"7269",236896,2001,"285",149,136,63,"26",37,0.2483,0.1912,0.2211
"7270",236939,2001,"2575",1369,1206,852,"314",538,0.393,0.2604,0.3309
"7271",236948,2001,"5288",2737,2551,2555,"1099",1456,0.532,0.4308,0.4832
"7272",237011,2001,"2205",1284,921,641,"207",434,0.338,0.2248,0.2907
"7273",237057,2001,"362",195,167,288,"126",162,0.8308,0.7545,0.7956
"7274",237066,2001,"427",265,162,251,"88",163,0.6151,0.5432,0.5878
"7275",237215,2001,"380",233,147,3,"1",2,0.0086,0.0068,0.0079
"7276",237330,2001,"646",343,303,199,"74",125,0.3644,0.2442,0.308
"7277",237358,2001,"123",71,52,31,"13",18,0.2535,0.25,0.252
"7278",237367,2001,"568",320,248,62,"18",44,0.1375,0.0726,0.1092
"7279",237792,2001,"647",333,314,71,"27",44,0.1321,0.086,0.1097
"7280",237899,2001,"379",193,186,16,"5",11,0.057,0.0269,0.0422
"7281",237932,2001,"521",298,223,99,"40",59,0.198,0.1794,0.19
"7282",237969,2001,"400",202,198,175,"65",110,0.5446,0.3283,0.4375
"7283",238032,2001,"3593",1743,1850,928,"381",547,0.3138,0.2059,0.2583
"7284",238333,2001,"311",189,122,234,"86",148,0.7831,0.7049,0.7524
"7285",238430,2001,"296",215,81,78,"29",49,0.2279,0.358,0.2635
"7286",238458,2001,"471",319,152,197,"48",149,0.4671,0.3158,0.4183
"7287",238476,2001,"578",280,298,237,"112",125,0.4464,0.3758,0.41
"7288",238616,2001,"351",169,182,158,"82",76,0.4497,0.4505,0.4501
"7289",238661,2001,"291",203,88,70,"21",49,0.2414,0.2386,0.2405
"7290",239080,2001,"227",149,78,65,"18",47,0.3154,0.2308,0.2863
"7291",239105,2001,"1658",950,708,947,"374",573,0.6032,0.5282,0.5712
"7292",239628,2001,"200",108,92,119,"48",71,0.6574,0.5217,0.595
"7293",239716,2001,"558",306,252,359,"142",217,0.7092,0.5635,0.6434
"7294",240107,2001,"335",254,81,97,"20",77,0.3031,0.2469,0.2896
"7295",240189,2001,"1857",936,921,379,"153",226,0.2415,0.1661,0.2041
"7296",240277,2001,"866",608,258,214,"45",169,0.278,0.1744,0.2471
"7297",240329,2001,"1596",1022,574,444,"138",306,0.2994,0.2404,0.2782
"7298",240338,2001,"200",124,76,96,"31",65,0.5242,0.4079,0.48
"7299",240365,2001,"1822",994,828,249,"86",163,0.164,0.1039,0.1367
"7300",240374,2001,"854",486,368,84,"21",63,0.1296,0.0571,0.0984
"7301",240417,2001,"1272",652,620,202,"62",140,0.2147,0.1,0.1588
"7302",240426,2001,"339",192,147,53,"24",29,0.151,0.1633,0.1563
"7303",240444,2001,"6050",3370,2680,2758,"1046",1712,0.508,0.3903,0.4559
"7304",240453,2001,"2884",1532,1352,423,"160",263,0.1717,0.1183,0.1467
"7305",240462,2001,"1039",373,666,176,"85",91,0.244,0.1276,0.1694
"7306",240471,2001,"1108",680,428,265,"86",179,0.2632,0.2009,0.2392
"7307",240480,2001,"1505",849,656,297,"108",189,0.2226,0.1646,0.1973
"7308",240727,2001,"1411",724,687,369,"135",234,0.3232,0.1965,0.2615
"7309",243443,2001,"478",333,145,52,"7",45,0.1351,0.0483,0.1088
"7310",243780,2001,"6567",2601,3966,2218,"1059",1159,0.4456,0.267,0.3377
"7311",100654,2000,"1020",504,516,118,"24",94,0.1865,0.0465,0.1157
"7312",100663,2000,"1234",748,486,173,"51",122,0.1631,0.1049,0.1402
"7313",100751,2000,"2886",1653,1233,1038,"303",735,0.4446,0.2457,0.3597
"7314",100858,2000,"3861",1990,1871,1277,"451",826,0.4151,0.241,0.3307
"7315",101435,2000,"151",95,56,67,"21",46,0.4842,0.375,0.4437
"7316",101480,2000,"850",443,407,127,"39",88,0.1986,0.0958,0.1494
"7317",101675,2000,"425",220,205,85,"19",66,0.3,0.0927,0.2
"7318",101879,2000,"824",481,343,143,"35",108,0.2245,0.102,0.1735
"7319",102049,2000,"657",427,230,359,"122",237,0.555,0.5304,0.5464
"7320",102094,2000,"1064",679,385,167,"46",121,0.1782,0.1195,0.157
"7321",102234,2000,"284",186,98,158,"47",111,0.5968,0.4796,0.5563
"7322",102368,2000,"941",513,428,271,"105",166,0.3236,0.2453,0.288
"7323",102377,2000,"591",354,237,149,"37",112,0.3164,0.1561,0.2521
"7324",104151,2000,"5763",3058,2705,1615,"596",1019,0.3332,0.2203,0.2802
"7325",104179,2000,"5443",2924,2519,1613,"618",995,0.3403,0.2453,0.2963
"7326",105330,2000,"2273",1384,889,613,"174",439,0.3172,0.1957,0.2697
"7327",106245,2000,"836",484,352,73,"28",45,0.093,0.0795,0.0873
"7328",106342,2000,"127",71,56,74,"30",44,0.6197,0.5357,0.5827
"7329",106397,2000,"2179",1092,1087,645,"246",399,0.3654,0.2263,0.296
"7330",106412,2000,"629",330,299,43,"13",30,0.0909,0.0435,0.0684
"7331",106458,2000,"1591",893,698,307,"97",210,0.2352,0.139,0.193
"7332",106467,2000,"1124",593,531,205,"70",135,0.2277,0.1318,0.1824
"7333",106485,2000,"628",346,282,51,"17",34,0.0983,0.0603,0.0812
"7334",106704,2000,"1627",982,645,325,"80",245,0.2495,0.124,0.1998
"7335",107044,2000,"975",557,418,365,"137",228,0.4093,0.3278,0.3744
"7336",107080,2000,"326",173,153,194,"85",109,0.6301,0.5556,0.5951
"7337",107141,2000,"276",164,112,140,"51",89,0.5427,0.4554,0.5072
"7338",107512,2000,"440",247,193,187,"69",118,0.4777,0.3575,0.425
"7339",107558,2000,"166",100,66,52,"17",35,0.35,0.2576,0.3133
"7340",110097,2000,"608",409,199,326,"88",238,0.5819,0.4422,0.5362
"7341",110404,2000,"205",74,131,166,"107",59,0.7973,0.8168,0.8098
"7342",110422,2000,"3053",1332,1721,607,"212",395,0.2965,0.1232,0.1988
"7343",110486,2000,"545",349,196,77,"22",55,0.1576,0.1122,0.1413
"7344",110495,2000,"565",362,203,113,"27",86,0.2376,0.133,0.2
"7345",110510,2000,"1146",750,396,142,"33",109,0.1453,0.0833,0.1239
"7346",110529,2000,"2600",1121,1479,265,"113",152,0.1356,0.0764,0.1019
"7347",110538,2000,"1931",1079,852,336,"79",257,0.2382,0.0927,0.174
"7348",110547,2000,"495",355,140,31,"7",24,0.0676,0.05,0.0626
"7349",110556,2000,"1885",1138,747,227,"67",160,0.1406,0.0897,0.1204
"7350",110565,2000,"2655",1609,1046,381,"83",298,0.1852,0.0793,0.1435
"7351",110574,2000,"669",452,217,109,"26",83,0.1836,0.1198,0.1629
"7352",110583,2000,"3214",2038,1176,375,"87",288,0.1413,0.074,0.1167
"7353",110592,2000,"1184",755,429,126,"24",102,0.1351,0.0559,0.1064
"7354",110617,2000,"2055",1198,857,178,"36",142,0.1185,0.042,0.0866
"7355",113698,2000,"113",86,27,48,"13",35,0.407,0.4815,0.4248
"7356",115755,2000,"769",460,309,94,"32",62,0.1348,0.1036,0.1222
"7357",119173,2000,"297",296,1,67,"1",66,0.223,1,0.2256
"7358",120184,2000,"137",99,38,54,"15",39,0.3939,0.3947,0.3942
"7359",121309,2000,"539",312,227,274,"101",173,0.5545,0.4449,0.5083
"7360",121345,2000,"398",208,190,346,"163",183,0.8798,0.8579,0.8693
"7361",122409,2000,"2719",1598,1121,472,"130",342,0.214,0.116,0.1736
"7362",122436,2000,"1024",642,382,656,"225",431,0.6713,0.589,0.6406
"7363",122597,2000,"1870",1212,658,205,"54",151,0.1246,0.0821,0.1096
"7364",122612,2000,"757",518,239,363,"100",263,0.5077,0.4184,0.4795
"7365",122931,2000,"1025",544,481,814,"366",448,0.8235,0.7609,0.7941
"7366",123554,2000,"620",366,254,368,"149",219,0.5984,0.5866,0.5935
"7367",123572,2000,"1064",714,350,236,"46",190,0.2661,0.1314,0.2218
"7368",126562,2000,"515",296,219,71,"23",48,0.1622,0.105,0.1379
"7369",126580,2000,"718",457,261,162,"38",124,0.2713,0.1456,0.2256
"7370",126614,2000,"5047",2445,2602,1937,"829",1108,0.4532,0.3186,0.3838
"7371",126818,2000,"3240",1862,1378,1119,"370",749,0.4023,0.2685,0.3454
"7372",127060,2000,"926",505,421,526,"214",312,0.6178,0.5083,0.568
"7373",127185,2000,"938",428,510,120,"45",75,0.1752,0.0882,0.1279
"7374",127565,2000,"1435",778,657,79,"27",52,0.0668,0.0411,0.0551
"7375",127741,2000,"2113",1240,873,605,"162",443,0.3573,0.1856,0.2863
"7376",128106,2000,"641",331,310,101,"41",60,0.1813,0.1323,0.1576
"7377",128744,2000,"161",80,81,53,"21",32,0.4,0.2593,0.3292
"7378",128771,2000,"1304",635,669,141,"42",99,0.1559,0.0628,0.1081
"7379",129020,2000,"2802",1549,1253,1484,"554",930,0.6004,0.4421,0.5296
"7380",129242,2000,"1008",610,398,797,"291",506,0.8295,0.7312,0.7907
"7381",129941,2000,"457",195,262,101,"48",53,0.2718,0.1832,0.221
"7382",130253,2000,"834",498,336,477,"168",309,0.6205,0.5,0.5719
"7383",130314,2000,"187",187,0,86,"0",86,0.4599,NA,0.4599
"7384",130493,2000,"1350",775,575,142,"38",104,0.1342,0.0661,0.1052
"7385",130590,2000,"489",253,236,389,"181",208,0.8221,0.7669,0.7955
"7386",130697,2000,"720",371,349,607,"281",326,0.8787,0.8052,0.8431
"7387",130776,2000,"822",404,418,104,"42",62,0.1535,0.1005,0.1265
"7388",130794,2000,"1349",678,671,1189,"582",607,0.8953,0.8674,0.8814
"7389",130934,2000,"684",405,279,155,"36",119,0.2938,0.129,0.2266
"7390",130943,2000,"3128",1926,1202,1884,"620",1264,0.6563,0.5158,0.6023
"7391",131159,2000,"1272",821,451,818,"260",558,0.6797,0.5765,0.6431
"7392",131283,2000,"530",298,232,315,"126",189,0.6342,0.5431,0.5943
"7393",131450,2000,"241",123,118,16,"3",13,0.1057,0.0254,0.0664
"7394",131469,2000,"2093",1241,852,1504,"574",930,0.7494,0.6737,0.7186
"7395",131496,2000,"1469",789,680,1327,"603",724,0.9176,0.8868,0.9033
"7396",131520,2000,"1355",909,446,624,"145",479,0.527,0.3251,0.4605
"7397",132471,2000,"401",258,143,70,"18",52,0.2016,0.1259,0.1746
"7398",132602,2000,"833",478,355,105,"26",79,0.1653,0.0732,0.1261
"7399",132903,2000,"4558",2436,2122,1384,"436",948,0.3892,0.2055,0.3036
"7400",133492,2000,"408",223,185,215,"95",120,0.5381,0.5135,0.527
"7401",133553,2000,"797",124,673,280,"225",55,0.4435,0.3343,0.3513
"7402",133650,2000,"2145",1263,882,415,"99",316,0.2502,0.1122,0.1935
"7403",133669,2000,"1818",988,830,254,"89",165,0.167,0.1072,0.1397
"7404",133711,2000,"496",315,181,206,"72",134,0.4254,0.3978,0.4153
"7405",133881,2000,"531",156,375,214,"145",69,0.4423,0.3867,0.403
"7406",133951,2000,"2582",1511,1071,507,"148",359,0.2376,0.1382,0.1964
"7407",134079,2000,"506",306,200,209,"62",147,0.4804,0.31,0.413
"7408",134097,2000,"5557",3294,2263,2481,"811",1670,0.507,0.3584,0.4465
"7409",134130,2000,"6864",3874,2990,3692,"1285",2407,0.6213,0.4298,0.5379
"7410",134945,2000,"406",163,243,155,"80",75,0.4601,0.3292,0.3818
"7411",135726,2000,"1964",1081,883,1140,"469",671,0.6207,0.5311,0.5804
"7412",136172,2000,"1664",963,701,335,"100",235,0.244,0.1427,0.2013
"7413",136950,2000,"425",256,169,252,"87",165,0.6445,0.5148,0.5929
"7414",137546,2000,"502",262,240,265,"108",157,0.5992,0.45,0.5279
"7415",138354,2000,"629",355,274,117,"30",87,0.2451,0.1095,0.186
"7416",138716,2000,"643",431,212,79,"14",65,0.1508,0.066,0.1229
"7417",138789,2000,"568",327,241,27,"9",18,0.055,0.0373,0.0475
"7418",139144,2000,"486",321,165,258,"84",174,0.5421,0.5091,0.5309
"7419",139366,2000,"759",468,291,87,"24",63,0.1346,0.0825,0.1146
"7420",139393,2000,"206",117,89,107,"47",60,0.5128,0.5281,0.5194
"7421",139658,2000,"1532",831,701,936,"420",516,0.6209,0.5991,0.611
"7422",139719,2000,"360",195,165,48,"14",34,0.1744,0.0848,0.1333
"7423",139755,2000,"2242",640,1602,760,"470",290,0.4531,0.2934,0.339
"7424",139764,2000,"308",202,106,44,"15",29,0.1436,0.1415,0.1429
"7425",139861,2000,"820",506,314,189,"41",148,0.2925,0.1306,0.2305
"7426",139931,2000,"2859",1481,1378,379,"105",274,0.185,0.0762,0.1326
"7427",139940,2000,"2061",1233,828,303,"85",218,0.1768,0.1027,0.147
"7428",139959,2000,"4207",2556,1651,1911,"584",1327,0.5192,0.3537,0.4542
"7429",140447,2000,"733",438,295,223,"71",152,0.347,0.2407,0.3042
"7430",140960,2000,"370",195,175,35,"7",28,0.1436,0.04,0.0946
"7431",140988,2000,"299",205,94,105,"23",82,0.4,0.2447,0.3512
"7432",141185,2000,"192",105,87,51,"13",38,0.3619,0.1494,0.2656
"7433",141264,2000,"788",512,276,141,"49",92,0.1797,0.1775,0.1789
"7434",141334,2000,"1661",987,674,187,"34",153,0.155,0.0504,0.1126
"7435",141486,2000,"237",163,74,45,"13",32,0.1963,0.1757,0.1899
"7436",141565,2000,"362",223,139,39,"13",26,0.1166,0.0935,0.1077
"7437",141574,2000,"1499",846,653,168,"48",120,0.1418,0.0735,0.1121
"7438",142276,2000,"1345",781,564,51,"9",42,0.0538,0.016,0.0379
"7439",142285,2000,"1560",722,838,311,"127",184,0.2548,0.1516,0.1994
"7440",142461,2000,"240",137,103,74,"24",50,0.365,0.233,0.3083
"7441",143084,2000,"610",359,251,443,"172",271,0.7549,0.6853,0.7262
"7442",143288,2000,"191",107,84,56,"18",38,0.3551,0.2143,0.2932
"7443",144005,2000,"345",232,113,10,"5",5,0.0216,0.0442,0.029
"7444",144281,2000,"1265",640,625,330,"139",191,0.2984,0.2224,0.2609
"7445",144740,2000,"1897",1140,757,852,"308",544,0.4772,0.4069,0.4491
"7446",144892,2000,"1495",870,625,471,"151",320,0.3678,0.2416,0.3151
"7447",144962,2000,"301",185,116,183,"50",133,0.7189,0.431,0.608
"7448",144971,2000,"121",72,49,49,"17",32,0.4444,0.3469,0.405
"7449",145600,2000,"2762",1557,1205,588,"203",385,0.2473,0.1685,0.2129
"7450",145619,2000,"278",156,122,114,"45",69,0.4423,0.3689,0.4101
"7451",145637,2000,"6167",2990,3177,3737,"1692",2045,0.6839,0.5326,0.606
"7452",145691,2000,"239",128,111,102,"32",70,0.5469,0.2883,0.4268
"7453",145813,2000,"3254",1996,1258,1204,"347",857,0.4294,0.2758,0.37
"7454",146481,2000,"335",187,148,194,"78",116,0.6203,0.527,0.5791
"7455",146612,2000,"427",183,244,127,"69",58,0.3169,0.2828,0.2974
"7456",146719,2000,"889",585,304,542,"164",378,0.6462,0.5395,0.6097
"7457",146825,2000,"199",97,102,55,"20",35,0.3608,0.1961,0.2764
"7458",147013,2000,"265",154,111,97,"35",62,0.4026,0.3153,0.366
"7459",147244,2000,"574",316,258,320,"120",200,0.6329,0.4651,0.5575
"7460",147341,2000,"235",136,99,143,"51",92,0.6765,0.5152,0.6085
"7461",147703,2000,"2765",1341,1424,634,"273",361,0.2692,0.1917,0.2293
"7462",147767,2000,"1876",983,893,1612,"731",881,0.8962,0.8186,0.8593
"7463",147776,2000,"948",570,378,27,"7",20,0.0351,0.0185,0.0285
"7464",147828,2000,"468",278,190,187,"61",126,0.4532,0.3211,0.3996
"7465",148131,2000,"235",137,98,81,"25",56,0.4088,0.2551,0.3447
"7466",148496,2000,"165",108,57,94,"30",64,0.5926,0.5263,0.5697
"7467",148584,2000,"190",109,81,73,"25",48,0.4404,0.3086,0.3842
"7468",148627,2000,"352",222,130,112,"36",76,0.3423,0.2769,0.3182
"7469",149222,2000,"2325",1036,1289,473,"201",272,0.2625,0.1559,0.2034
"7470",149231,2000,"1495",848,647,324,"103",221,0.2606,0.1592,0.2167
"7471",149772,2000,"1762",904,858,557,"245",312,0.3451,0.2855,0.3161
"7472",149781,2000,"568",291,277,441,"212",229,0.7869,0.7653,0.7764
"7473",150066,2000,"538",275,263,212,"77",135,0.4909,0.2928,0.3941
"7474",150136,2000,"3694",2023,1671,1062,"372",690,0.3411,0.2226,0.2875
"7475",150145,2000,"294",182,112,114,"41",73,0.4011,0.3661,0.3878
"7476",150163,2000,"868",559,309,516,"182",334,0.5975,0.589,0.5945
"7477",150400,2000,"610",336,274,479,"202",277,0.8244,0.7372,0.7852
"7478",150534,2000,"555",320,235,237,"84",153,0.4781,0.3574,0.427
"7479",150668,2000,"194",113,81,87,"30",57,0.5044,0.3704,0.4485
"7480",150941,2000,"206",109,97,100,"46",54,0.4954,0.4742,0.4854
"7481",151102,2000,"1337",723,614,48,"22",26,0.036,0.0358,0.0359
"7482",151111,2000,"2473",1414,1059,168,"48",120,0.0849,0.0453,0.0679
"7483",151306,2000,"1729",1033,696,247,"57",190,0.1839,0.0819,0.1429
"7484",151324,2000,"2124",1122,1002,404,"126",278,0.2478,0.1257,0.1902
"7485",151333,2000,"347",223,124,28,"9",19,0.0852,0.0726,0.0807
"7486",151342,2000,"637",349,288,22,"6",16,0.0458,0.0208,0.0345
"7487",151351,2000,"6862",3839,3023,3421,"1362",2059,0.5363,0.4505,0.4985
"7488",151360,2000,"517",318,199,33,"16",17,0.0535,0.0804,0.0638
"7489",151379,2000,"700",413,287,57,"18",39,0.0944,0.0627,0.0814
"7490",151388,2000,"249",161,88,10,"1",9,0.0559,0.0114,0.0402
"7491",151777,2000,"333",178,155,142,"46",96,0.5393,0.2968,0.4264
"7492",151786,2000,"208",126,82,58,"12",46,0.3651,0.1463,0.2788
"7493",152080,2000,"1955",919,1036,1757,"921",836,0.9097,0.889,0.8987
"7494",152248,2000,"1043",577,466,37,"14",23,0.0399,0.03,0.0355
"7495",152363,2000,"246",132,114,109,"50",59,0.447,0.4386,0.4431
"7496",152530,2000,"482",242,240,332,"149",183,0.7562,0.6208,0.6888
"7497",152600,2000,"707",388,319,450,"188",262,0.6753,0.5893,0.6365
"7498",153001,2000,"326",182,144,153,"62",91,0.5,0.4306,0.4693
"7499",153108,2000,"369",214,155,226,"84",142,0.6636,0.5419,0.6125
"7500",153269,2000,"760",475,285,353,"127",226,0.4758,0.4456,0.4645
"7501",153384,2000,"363",209,154,312,"127",185,0.8852,0.8247,0.8595
"7502",153603,2000,"4282",1928,2354,1340,"515",825,0.4279,0.2188,0.3129
"7503",153834,2000,"662",396,266,420,"161",259,0.654,0.6053,0.6344
"7504",154095,2000,"2218",1337,881,751,"243",508,0.38,0.2758,0.3386
"7505",155089,2000,"231",127,104,49,"18",31,0.2441,0.1731,0.2121
"7506",155317,2000,"4119",2268,1851,1282,"455",827,0.3646,0.2458,0.3112
"7507",155335,2000,"171",112,59,49,"14",35,0.3125,0.2373,0.2865
"7508",155399,2000,"3399",1711,1688,829,"289",540,0.3156,0.1712,0.2439
"7509",155520,2000,"260",133,127,113,"39",74,0.5564,0.3071,0.4346
"7510",155627,2000,"111",40,71,30,"12",18,0.45,0.169,0.2703
"7511",155937,2000,"126",60,66,47,"18",29,0.4833,0.2727,0.373
"7512",156213,2000,"304",180,124,166,"60",106,0.5889,0.4839,0.5461
"7513",156286,2000,"355",224,131,172,"63",109,0.4866,0.4809,0.4845
"7514",156295,2000,"421",245,176,169,"60",109,0.4449,0.3409,0.4014
"7515",156365,2000,"317",167,150,88,"25",63,0.3772,0.1667,0.2776
"7516",156541,2000,"403",195,208,82,"37",45,0.2308,0.1779,0.2035
"7517",156745,2000,"331",189,142,158,"49",109,0.5767,0.3451,0.4773
"7518",157058,2000,"340",171,169,49,"17",32,0.1871,0.1006,0.1441
"7519",157076,2000,"159",75,84,37,"12",25,0.3333,0.1429,0.2327
"7520",157085,2000,"2971",1590,1381,884,"333",551,0.3465,0.2411,0.2975
"7521",157289,2000,"2249",1162,1087,321,"113",208,0.179,0.104,0.1427
"7522",157386,2000,"1473",849,624,181,"59",122,0.1437,0.0946,0.1229
"7523",157401,2000,"1210",730,480,348,"108",240,0.3288,0.225,0.2876
"7524",157447,2000,"1682",974,708,114,"37",77,0.0791,0.0523,0.0678
"7525",157535,2000,"282",137,145,45,"7",38,0.2774,0.0483,0.1596
"7526",157951,2000,"2477",1444,1033,634,"202",432,0.2992,0.1955,0.256
"7527",158477,2000,"229",152,77,99,"33",66,0.4342,0.4286,0.4323
"7528",159009,2000,"908",513,395,182,"46",136,0.2651,0.1165,0.2004
"7529",159391,2000,"5072",2803,2269,1229,"431",798,0.2847,0.19,0.2423
"7530",159647,2000,"1795",819,976,480,"222",258,0.315,0.2275,0.2674
"7531",159717,2000,"1320",767,553,110,"31",79,0.103,0.0561,0.0833
"7532",159966,2000,"1460",882,578,118,"26",92,0.1043,0.045,0.0808
"7533",160038,2000,"1555",959,596,194,"56",138,0.1439,0.094,0.1248
"7534",160612,2000,"2220",1351,869,176,"59",117,0.0866,0.0679,0.0793
"7535",160621,2000,"1766",996,770,2,"2",0,0,0.0026,0.0011
"7536",160658,2000,"2291",1302,989,314,"103",211,0.1621,0.1041,0.1371
"7537",161004,2000,"452",221,231,379,"188",191,0.8643,0.8139,0.8385
"7538",161226,2000,"475",329,146,176,"40",136,0.4134,0.274,0.3705
"7539",161235,2000,"82",38,44,4,"1",3,0.0789,0.0227,0.0488
"7540",161244,2000,"127",85,42,13,"4",9,0.1059,0.0952,0.1024
"7541",161253,2000,"1589",781,808,536,"222",314,0.402,0.2748,0.3373
"7542",161554,2000,"855",489,366,81,"21",60,0.1227,0.0574,0.0947
"7543",162007,2000,"361",195,166,47,"13",34,0.1744,0.0783,0.1302
"7544",162210,2000,"158",89,69,22,"4",18,0.2022,0.058,0.1392
"7545",162283,2000,"417",289,128,20,"4",16,0.0554,0.0312,0.048
"7546",162584,2000,"1028",499,529,199,"64",135,0.2705,0.121,0.1936
"7547",162654,2000,"365",258,107,227,"57",170,0.6589,0.5327,0.6219
"7548",162760,2000,"131",128,3,90,"3",87,0.6797,1,0.687
"7549",162928,2000,"1067",456,611,876,"483",393,0.8618,0.7905,0.821
"7550",163046,2000,"909",520,389,699,"277",422,0.8115,0.7121,0.769
"7551",163268,2000,"1307",601,706,362,"150",212,0.3527,0.2125,0.277
"7552",163286,2000,"3929",1896,2033,2141,"933",1208,0.6371,0.4589,0.5449
"7553",163453,2000,"1107",689,418,204,"60",144,0.209,0.1435,0.1843
"7554",163462,2000,"383",223,160,255,"109",146,0.6547,0.6812,0.6658
"7555",163851,2000,"939",546,393,488,"163",325,0.5952,0.4148,0.5197
"7556",163912,2000,"375",220,155,262,"94",168,0.7636,0.6065,0.6987
"7557",164076,2000,"1981",1198,783,630,"190",440,0.3673,0.2427,0.318
"7558",164173,2000,"425",313,112,220,"51",169,0.5399,0.4554,0.5176
"7559",164216,2000,"374",236,138,255,"80",175,0.7415,0.5797,0.6818
"7560",164270,2000,"442",247,195,293,"109",184,0.7449,0.559,0.6629
"7561",164447,2000,"239",123,116,112,"63",49,0.3984,0.5431,0.4686
"7562",164492,2000,"149",110,39,81,"18",63,0.5727,0.4615,0.5436
"7563",164562,2000,"593",367,226,409,"114",295,0.8038,0.5044,0.6897
"7564",165015,2000,"858",475,383,714,"301",413,0.8695,0.7859,0.8322
"7565",165024,2000,"1244",760,484,290,"87",203,0.2671,0.1798,0.2331
"7566",165334,2000,"497",292,205,315,"120",195,0.6678,0.5854,0.6338
"7567",165662,2000,"641",396,245,461,"179",282,0.7121,0.7306,0.7192
"7568",165671,2000,"165",165,0,82,"0",82,0.497,NA,0.497
"7569",165820,2000,"448",275,173,119,"30",89,0.3236,0.1734,0.2656
"7570",165866,2000,"612",434,178,153,"30",123,0.2834,0.1685,0.25
"7571",165936,2000,"411",274,137,233,"71",162,0.5912,0.5182,0.5669
"7572",166027,2000,"1638",755,883,1431,"757",674,0.8927,0.8573,0.8736
"7573",166124,2000,"706",376,330,626,"284",342,0.9096,0.8606,0.8867
"7574",166513,2000,"996",373,623,299,"140",159,0.4263,0.2247,0.3002
"7575",166629,2000,"3803",2086,1717,1768,"667",1101,0.5278,0.3885,0.4649
"7576",166638,2000,"593",326,267,91,"14",77,0.2362,0.0524,0.1535
"7577",166683,2000,"1010",425,585,825,"468",357,0.84,0.8,0.8168
"7578",167288,2000,"224",126,98,80,"32",48,0.381,0.3265,0.3571
"7579",167987,2000,"1300",642,658,363,"142",221,0.3442,0.2158,0.2792
"7580",167996,2000,"629",363,266,517,"210",307,0.8457,0.7895,0.8219
"7581",168005,2000,"645",371,274,243,"87",156,0.4205,0.3175,0.3767
"7582",168148,2000,"1181",637,544,1022,"464",558,0.876,0.8529,0.8654
"7583",168254,2000,"560",262,298,268,"140",128,0.4885,0.4698,0.4786
"7584",168281,2000,"450",286,164,318,"104",214,0.7483,0.6341,0.7067
"7585",168342,2000,"528",260,268,483,"240",243,0.9346,0.8955,0.9148
"7586",168546,2000,"405",253,152,270,"86",184,0.7273,0.5658,0.6667
"7587",168786,2000,"362",244,118,89,"24",65,0.2664,0.2034,0.2459
"7588",169080,2000,"1050",594,456,585,"241",344,0.5791,0.5285,0.5571
"7589",169798,2000,"2664",1619,1045,327,"109",218,0.1347,0.1043,0.1227
"7590",169910,2000,"2147",883,1264,94,"47",47,0.0532,0.0372,0.0438
"7591",170082,2000,"2831",1732,1099,548,"166",382,0.2206,0.151,0.1936
"7592",170301,2000,"754",468,286,480,"170",310,0.6624,0.5944,0.6366
"7593",170532,2000,"324",180,144,246,"103",143,0.7944,0.7153,0.7593
"7594",170639,2000,"555",262,293,76,"35",41,0.1565,0.1195,0.1369
"7595",170976,2000,"5403",2860,2543,3803,"1697",2106,0.7364,0.6673,0.7039
"7596",171100,2000,"6790",3756,3034,2908,"1026",1882,0.5011,0.3382,0.4283
"7597",171128,2000,"1267",292,975,316,"223",93,0.3185,0.2287,0.2494
"7598",171137,2000,"738",371,367,118,"52",66,0.1779,0.1417,0.1599
"7599",171146,2000,"576",349,227,64,"18",46,0.1318,0.0793,0.1111
"7600",171599,2000,"183",66,117,36,"18",18,0.2727,0.1538,0.1967
"7601",172051,2000,"1049",559,490,68,"24",44,0.0787,0.049,0.0648
"7602",172699,2000,"4429",2349,2080,865,"323",542,0.2307,0.1553,0.1953
"7603",173160,2000,"591",357,234,364,"127",237,0.6639,0.5427,0.6159
"7604",173258,2000,"471",247,224,415,"194",221,0.8947,0.8661,0.8811
"7605",173328,2000,"212",124,88,57,"15",42,0.3387,0.1705,0.2689
"7606",173647,2000,"652",383,269,392,"169",223,0.5822,0.6283,0.6012
"7607",173902,2000,"454",299,155,366,"126",240,0.8027,0.8129,0.8062
"7608",174066,2000,"4865",2577,2288,1581,"668",913,0.3543,0.292,0.325
"7609",174233,2000,"2088",1107,981,508,"182",326,0.2945,0.1855,0.2433
"7610",174251,2000,"467",267,200,186,"66",120,0.4494,0.33,0.3983
"7611",174491,2000,"430",279,151,178,"52",126,0.4516,0.3444,0.414
"7612",174792,2000,"522",0,522,406,"406",0,NA,0.7778,0.7778
"7613",174844,2000,"753",441,312,600,"232",368,0.8345,0.7436,0.7968
"7614",174899,2000,"315",226,89,173,"45",128,0.5664,0.5056,0.5492
"7615",174914,2000,"1082",578,504,597,"244",353,0.6107,0.4841,0.5518
"7616",175342,2000,"489",248,241,107,"28",79,0.3185,0.1162,0.2188
"7617",175421,2000,"182",95,87,50,"19",31,0.3263,0.2184,0.2747
"7618",175616,2000,"461",273,188,111,"24",87,0.3187,0.1277,0.2408
"7619",175856,2000,"936",547,389,134,"40",94,0.1718,0.1028,0.1432
"7620",175980,2000,"292",152,140,176,"82",94,0.6184,0.5857,0.6027
"7621",176017,2000,"1981",1019,962,655,"248",407,0.3994,0.2578,0.3306
"7622",176035,2000,"205",190,15,57,"0",57,0.3,0,0.278
"7623",176044,2000,"297",173,124,41,"13",28,0.1618,0.1048,0.138
"7624",176080,2000,"2055",1057,998,556,"204",352,0.333,0.2044,0.2706
"7625",176406,2000,"224",168,56,66,"15",51,0.3036,0.2679,0.2946
"7626",176628,2000,"162",91,71,36,"5",31,0.3407,0.0704,0.2222
"7627",176947,2000,"216",102,114,68,"17",51,0.5,0.1491,0.3148
"7628",176965,2000,"1455",794,661,380,"146",234,0.2947,0.2209,0.2612
"7629",177418,2000,"164",124,40,57,"4",53,0.4274,0.1,0.3476
"7630",178059,2000,"231",186,45,122,"18",104,0.5591,0.4,0.5281
"7631",178341,2000,"771",427,344,129,"50",79,0.185,0.1453,0.1673
"7632",178387,2000,"908",532,376,91,"20",71,0.1335,0.0532,0.1002
"7633",178396,2000,"4170",2247,1923,1657,"609",1048,0.4664,0.3167,0.3974
"7634",178402,2000,"688",391,297,120,"44",76,0.1944,0.1481,0.1744
"7635",178411,2000,"672",146,526,143,"98",45,0.3082,0.1863,0.2128
"7636",178420,2000,"497",279,218,100,"35",65,0.233,0.1606,0.2012
"7637",178615,2000,"1396",840,556,537,"181",356,0.4238,0.3255,0.3847
"7638",179043,2000,"267",141,126,135,"61",74,0.5248,0.4841,0.5056
"7639",179159,2000,"1405",748,657,886,"397",489,0.6537,0.6043,0.6306
"7640",179557,2000,"1433",817,616,372,"103",269,0.3293,0.1672,0.2596
"7641",179566,2000,"2496",1477,1019,613,"204",409,0.2769,0.2002,0.2456
"7642",179867,2000,"1392",761,631,1158,"498",660,0.8673,0.7892,0.8319
"7643",179894,2000,"412",242,170,168,"60",108,0.4463,0.3529,0.4078
"7644",179946,2000,"173",75,98,82,"37",45,0.6,0.3776,0.474
"7645",180179,2000,"538",352,186,48,"10",38,0.108,0.0538,0.0892
"7646",180461,2000,"1852",841,1011,357,"160",197,0.2342,0.1583,0.1928
"7647",180522,2000,"187",85,102,28,"17",11,0.1294,0.1667,0.1497
"7648",180984,2000,"329",173,156,84,"42",42,0.2428,0.2692,0.2553
"7649",181002,2000,"881",535,346,537,"197",340,0.6355,0.5694,0.6095
"7650",181020,2000,"300",160,140,174,"75",99,0.6188,0.5357,0.58
"7651",181127,2000,"271",119,152,129,"61",68,0.5714,0.4013,0.476
"7652",181215,2000,"996",550,446,159,"48",111,0.2018,0.1076,0.1596
"7653",181394,2000,"1517",825,692,157,"55",102,0.1236,0.0795,0.1035
"7654",181446,2000,"423",254,169,235,"87",148,0.5827,0.5148,0.5556
"7655",181464,2000,"3598",1783,1815,823,"326",497,0.2787,0.1796,0.2287
"7656",181534,2000,"201",93,108,26,"7",19,0.2043,0.0648,0.1294
"7657",181783,2000,"623",366,257,168,"49",119,0.3251,0.1907,0.2697
"7658",182281,2000,"2126",1182,944,240,"70",170,0.1438,0.0742,0.1129
"7659",182290,2000,"1930",1090,840,293,"95",198,0.1817,0.1131,0.1518
"7660",182634,2000,"274",180,94,148,"47",101,0.5611,0.5,0.5401
"7661",182795,2000,"530",262,268,227,"101",126,0.4809,0.3769,0.4283
"7662",183062,2000,"935",576,359,243,"69",174,0.3021,0.1922,0.2599
"7663",183080,2000,"902",454,448,241,"97",144,0.3172,0.2165,0.2672
"7664",183239,2000,"518",280,238,349,"142",207,0.7393,0.5966,0.6737
"7665",183822,2000,"236",135,101,13,"8",5,0.037,0.0792,0.0551
"7666",183974,2000,"145",114,31,56,"7",49,0.4298,0.2258,0.3862
"7667",184348,2000,"419",265,154,291,"98",193,0.7283,0.6364,0.6945
"7668",184603,2000,"535",300,235,79,"32",47,0.1567,0.1362,0.1477
"7669",184612,2000,"219",173,46,46,"7",39,0.2254,0.1522,0.21
"7670",184782,2000,"1053",561,492,444,"173",271,0.4831,0.3516,0.4217
"7671",185129,2000,"661",357,304,46,"20",26,0.0728,0.0658,0.0696
"7672",185572,2000,"1033",529,504,377,"142",235,0.4442,0.2817,0.365
"7673",185590,2000,"1324",827,497,351,"96",255,0.3083,0.1932,0.2651
"7674",185828,2000,"685",117,568,130,"98",32,0.2735,0.1725,0.1898
"7675",186131,2000,"1159",569,590,1031,"503",528,0.9279,0.8525,0.8896
"7676",186201,2000,"636",392,244,282,"87",195,0.4974,0.3566,0.4434
"7677",186283,2000,"884",504,380,399,"152",247,0.4901,0.4,0.4514
"7678",186584,2000,"1121",581,540,464,"186",278,0.4785,0.3444,0.4139
"7679",186876,2000,"728",431,297,296,"96",200,0.464,0.3232,0.4066
"7680",187134,2000,"1205",714,491,799,"287",512,0.7171,0.5845,0.6631
"7681",187444,2000,"1160",610,550,188,"73",115,0.1885,0.1327,0.1621
"7682",187985,2000,"2587",1474,1113,311,"106",205,0.1391,0.0952,0.1202
"7683",188030,2000,"1959",1082,877,238,"83",155,0.1433,0.0946,0.1215
"7684",188429,2000,"616",416,200,314,"82",232,0.5577,0.41,0.5097
"7685",188641,2000,"504",280,224,246,"81",165,0.5893,0.3616,0.4881
"7686",190044,2000,"638",149,489,325,"242",83,0.557,0.4949,0.5094
"7687",190099,2000,"711",339,372,600,"308",292,0.8614,0.828,0.8439
"7688",190150,2000,"1339",610,729,1136,"602",534,0.8754,0.8258,0.8484
"7689",190248,2000,"122",68,54,55,"23",32,0.4706,0.4259,0.4508
"7690",190415,2000,"3047",1438,1609,2569,"1308",1261,0.8769,0.8129,0.8431
"7691",190512,2000,"1295",701,594,351,"137",214,0.3053,0.2306,0.271
"7692",190549,2000,"1238",717,521,218,"79",139,0.1939,0.1516,0.1761
"7693",190558,2000,"1488",796,692,44,"10",34,0.0427,0.0145,0.0296
"7694",190567,2000,"852",399,453,27,"8",19,0.0476,0.0177,0.0317
"7695",190594,2000,"1741",1227,514,188,"43",145,0.1182,0.0837,0.108
"7696",190637,2000,"542",367,175,45,"11",34,0.0926,0.0629,0.083
"7697",190664,2000,"1085",639,446,254,"65",189,0.2958,0.1457,0.2341
"7698",190691,2000,"458",314,144,29,"6",23,0.0732,0.0417,0.0633
"7699",190725,2000,"317",254,63,77,"13",64,0.252,0.2063,0.2429
"7700",191241,2000,"1632",975,657,1183,"468",715,0.7333,0.7123,0.7249
"7701",191515,2000,"467",251,216,386,"172",214,0.8526,0.7963,0.8266
"7702",191533,2000,"425",245,180,188,"61",127,0.5184,0.3389,0.4424
"7703",191630,2000,"521",282,239,353,"144",209,0.7411,0.6025,0.6775
"7704",191649,2000,"1937",1036,901,703,"266",437,0.4218,0.2952,0.3629
"7705",191676,2000,"358",226,132,217,"75",142,0.6283,0.5682,0.6061
"7706",191931,2000,"723",351,372,337,"132",205,0.584,0.3548,0.4661
"7707",191968,2000,"1675",940,735,1149,"474",675,0.7181,0.6449,0.686
"7708",192192,2000,"281",183,98,83,"28",55,0.3005,0.2857,0.2954
"7709",192323,2000,"510",291,219,298,"119",179,0.6151,0.5434,0.5843
"7710",192439,2000,"863",578,285,36,"9",27,0.0467,0.0316,0.0417
"7711",192703,2000,"623",315,308,361,"153",208,0.6603,0.4968,0.5795
"7712",192749,2000,"403",277,126,213,"58",155,0.5596,0.4603,0.5285
"7713",192819,2000,"993",589,404,690,"272",418,0.7097,0.6733,0.6949
"7714",192925,2000,"208",153,55,36,"10",26,0.1699,0.1818,0.1731
"7715",193016,2000,"637",421,216,69,"10",59,0.1401,0.0463,0.1083
"7716",193292,2000,"195",133,62,56,"13",43,0.3233,0.2097,0.2872
"7717",193353,2000,"328",251,77,124,"15",109,0.4343,0.1948,0.378
"7718",193399,2000,"236",174,62,83,"16",67,0.3851,0.2581,0.3517
"7719",193584,2000,"402",304,98,244,"56",188,0.6184,0.5714,0.607
"7720",193645,2000,"755",662,93,159,"13",146,0.2205,0.1398,0.2106
"7721",193654,2000,"595",402,193,245,"69",176,0.4378,0.3575,0.4118
"7722",193900,2000,"3966",2424,1542,2416,"966",1450,0.5982,0.6265,0.6092
"7723",193973,2000,"628",371,257,350,"122",228,0.6146,0.4747,0.5573
"7724",194161,2000,"373",233,140,105,"35",70,0.3004,0.25,0.2815
"7725",194310,2000,"1602",976,626,612,"204",408,0.418,0.3259,0.382
"7726",194824,2000,"1303",334,969,833,"603",230,0.6886,0.6223,0.6393
"7727",195003,2000,"2278",636,1642,453,"244",209,0.3286,0.1486,0.1989
"7728",195030,2000,"1044",460,584,741,"395",346,0.7522,0.6764,0.7098
"7729",195164,2000,"584",316,268,309,"116",193,0.6108,0.4328,0.5291
"7730",195173,2000,"434",242,192,191,"72",119,0.4917,0.375,0.4401
"7731",195216,2000,"612",325,287,436,"186",250,0.7692,0.6481,0.7124
"7732",195234,2000,"485",349,136,216,"47",169,0.4842,0.3456,0.4454
"7733",195243,2000,"298",173,125,117,"38",79,0.4566,0.304,0.3926
"7734",195304,2000,"292",212,80,204,"56",148,0.6981,0.7,0.6986
"7735",195474,2000,"765",404,361,547,"234",313,0.7748,0.6482,0.715
"7736",195526,2000,"599",345,254,461,"186",275,0.7971,0.7323,0.7696
"7737",195544,2000,"98",80,18,67,"6",61,0.7625,0.3333,0.6837
"7738",195809,2000,"2853",1619,1234,997,"387",610,0.3768,0.3136,0.3495
"7739",196413,2000,"2791",1569,1222,1981,"805",1176,0.7495,0.6588,0.7098
"7740",196592,2000,"1272",919,353,121,"46",75,0.0816,0.1303,0.0951
"7741",197045,2000,"445",260,185,139,"41",98,0.3769,0.2216,0.3124
"7742",197133,2000,"639",389,250,544,"211",333,0.856,0.844,0.8513
"7743",197869,2000,"2544",1370,1174,872,"285",587,0.4285,0.2428,0.3428
"7744",197984,2000,"188",113,75,63,"22",41,0.3628,0.2933,0.3351
"7745",198385,2000,"465",229,236,413,"193",220,0.9607,0.8178,0.8882
"7746",198464,2000,"3105",1837,1268,856,"248",608,0.331,0.1956,0.2757
"7747",198507,2000,"441",248,193,133,"32",101,0.4073,0.1658,0.3016
"7748",198516,2000,"1144",718,426,744,"244",500,0.6964,0.5728,0.6503
"7749",198835,2000,"268",142,126,122,"42",80,0.5634,0.3333,0.4552
"7750",198969,2000,"308",115,193,46,"18",28,0.2435,0.0933,0.1494
"7751",199102,2000,"1661",884,777,321,"97",224,0.2534,0.1248,0.1933
"7752",199111,2000,"496",284,212,154,"54",100,0.3521,0.2547,0.3105
"7753",199120,2000,"3406",2121,1285,2426,"829",1597,0.7529,0.6451,0.7123
"7754",199139,2000,"2142",1208,934,553,"194",359,0.2972,0.2077,0.2582
"7755",199148,2000,"1867",1355,512,556,"112",444,0.3277,0.2188,0.2978
"7756",199157,2000,"720",443,277,162,"26",136,0.307,0.0939,0.225
"7757",199193,2000,"3816",1622,2194,1379,"634",745,0.4593,0.289,0.3614
"7758",199218,2000,"1661",1081,580,711,"185",526,0.4866,0.319,0.4281
"7759",199281,2000,"567",303,264,114,"34",80,0.264,0.1288,0.2011
"7760",199306,2000,"185",90,95,58,"17",41,0.4556,0.1789,0.3135
"7761",199412,2000,"188",136,52,93,"23",70,0.5147,0.4423,0.4947
"7762",199582,2000,"398",232,166,67,"17",50,0.2155,0.1024,0.1683
"7763",199643,2000,"401",247,154,43,"13",30,0.1215,0.0844,0.1072
"7764",199847,2000,"1020",530,490,804,"355",449,0.8472,0.7245,0.7882
"7765",199962,2000,"380",181,199,142,"54",88,0.4862,0.2714,0.3737
"7766",199999,2000,"499",359,140,97,"19",78,0.2173,0.1357,0.1944
"7767",200004,2000,"1211",594,617,298,"120",178,0.2997,0.1945,0.2461
"7768",200059,2000,"350",208,142,34,"14",20,0.0962,0.0986,0.0971
"7769",200156,2000,"331",192,139,107,"35",72,0.375,0.2518,0.3233
"7770",200217,2000,"351",201,150,142,"37",105,0.5224,0.2467,0.4046
"7771",200226,2000,"153",73,80,22,"6",16,0.2192,0.075,0.1438
"7772",200253,2000,"452",260,192,61,"25",36,0.1385,0.1302,0.135
"7773",200280,2000,"1832",858,974,394,"192",202,0.2354,0.1971,0.2151
"7774",200332,2000,"1280",512,768,217,"102",115,0.2246,0.1328,0.1695
"7775",200572,2000,"179",92,87,35,"11",24,0.2609,0.1264,0.1955
"7776",201104,2000,"448",265,183,187,"51",136,0.5132,0.2787,0.4174
"7777",201371,2000,"227",124,103,114,"48",66,0.5323,0.466,0.5022
"7778",201548,2000,"558",333,225,305,"111",194,0.5826,0.4933,0.5466
"7779",201645,2000,"833",305,528,489,"279",210,0.6885,0.5284,0.587
"7780",201690,2000,"307",173,134,39,"5",34,0.1965,0.0373,0.127
"7781",202134,2000,"934",471,463,103,"42",61,0.1295,0.0907,0.1103
"7782",202480,2000,"1764",932,832,1055,"431",624,0.6695,0.518,0.5981
"7783",202523,2000,"648",370,278,484,"198",286,0.773,0.7122,0.7469
"7784",202763,2000,"684",399,285,257,"87",170,0.4261,0.3053,0.3757
"7785",203085,2000,"277",137,140,121,"39",82,0.5985,0.2786,0.4368
"7786",203128,2000,"244",139,105,128,"54",74,0.5324,0.5143,0.5246
"7787",203368,2000,"830",467,363,543,"214",329,0.7045,0.5895,0.6542
"7788",203517,2000,"3556",2184,1372,748,"226",522,0.239,0.1647,0.2103
"7789",203535,2000,"436",227,209,371,"168",203,0.8943,0.8038,0.8509
"7790",203580,2000,"86",63,23,26,"6",20,0.3175,0.2609,0.3023
"7791",203775,2000,"388",240,148,157,"49",108,0.45,0.3311,0.4046
"7792",203845,2000,"303",141,162,154,"75",79,0.5603,0.463,0.5083
"7793",204024,2000,"3359",1947,1412,2271,"870",1401,0.7196,0.6161,0.6761
"7794",204185,2000,"555",315,240,277,"93",184,0.5841,0.3875,0.4991
"7795",204194,2000,"365",228,137,139,"39",100,0.4386,0.2847,0.3808
"7796",204617,2000,"179",118,61,48,"15",33,0.2797,0.2459,0.2682
"7797",204796,2000,"5831",3008,2823,2282,"851",1431,0.4757,0.3015,0.3914
"7798",204857,2000,"3586",2041,1545,1693,"588",1105,0.5414,0.3806,0.4721
"7799",206330,2000,"215",84,131,38,"19",19,0.2262,0.145,0.1767
"7800",206589,2000,"501",258,243,331,"137",194,0.7519,0.5638,0.6607
"7801",206604,2000,"2124",1217,907,403,"117",286,0.235,0.129,0.1897
"7802",206622,2000,"776",436,340,515,"223",292,0.6697,0.6559,0.6637
"7803",206695,2000,"1853",943,910,220,"95",125,0.1326,0.1044,0.1187
"7804",206914,2000,"620",339,281,68,"24",44,0.1298,0.0854,0.1097
"7805",207209,2000,"690",328,362,40,"14",26,0.0793,0.0387,0.058
"7806",207306,2000,"329",159,170,46,"15",31,0.195,0.0882,0.1398
"7807",207324,2000,"449",226,223,100,"45",55,0.2434,0.2018,0.2227
"7808",207388,2000,"2953",1615,1338,802,"272",530,0.3282,0.2033,0.2716
"7809",207500,2000,"3326",1760,1566,791,"268",523,0.2972,0.1711,0.2378
"7810",207722,2000,"206",135,71,29,"6",23,0.1704,0.0845,0.1408
"7811",207847,2000,"509",261,248,54,"21",33,0.1264,0.0847,0.1061
"7812",207865,2000,"815",464,351,135,"27",108,0.2328,0.0769,0.1656
"7813",208822,2000,"352",205,147,209,"81",128,0.6244,0.551,0.5938
"7814",209056,2000,"426",263,163,251,"91",160,0.6084,0.5583,0.5892
"7815",209065,2000,"434",228,206,281,"113",168,0.7368,0.5485,0.6475
"7816",209542,2000,"2652",1250,1402,770,"311",459,0.3672,0.2218,0.2903
"7817",209551,2000,"2809",1527,1282,1089,"384",705,0.4617,0.2995,0.3877
"7818",209612,2000,"303",198,105,158,"58",100,0.5051,0.5524,0.5215
"7819",209807,2000,"915",480,435,133,"50",83,0.1729,0.1149,0.1454
"7820",209922,2000,"358",202,156,204,"79",125,0.6188,0.5064,0.5698
"7821",210146,2000,"681",390,291,130,"45",85,0.2179,0.1546,0.1909
"7822",210401,2000,"506",292,214,336,"124",212,0.726,0.5794,0.664
"7823",210429,2000,"825",524,301,176,"55",121,0.2309,0.1827,0.2133
"7824",210571,2000,"407",231,176,207,"84",123,0.5325,0.4773,0.5086
"7825",210669,2000,"561",291,270,393,"175",218,0.7491,0.6481,0.7005
"7826",210775,2000,"236",149,87,70,"22",48,0.3221,0.2529,0.2966
"7827",211088,2000,"294",228,66,147,"27",120,0.5263,0.4091,0.5
"7828",211158,2000,"1414",912,502,587,"153",434,0.4759,0.3048,0.4151
"7829",211291,2000,"914",454,460,773,"376",397,0.8744,0.8174,0.8457
"7830",211352,2000,"359",221,138,161,"50",111,0.5023,0.3623,0.4485
"7831",211361,2000,"840",398,442,187,"83",104,0.2613,0.1878,0.2226
"7832",211431,2000,"180",178,2,85,"0",85,0.4775,0,0.4722
"7833",211440,2000,"1325",516,809,920,"537",383,0.7422,0.6638,0.6943
"7834",211468,2000,"200",198,2,109,"0",109,0.5505,0,0.545
"7835",211556,2000,"138",138,0,54,"0",54,0.3913,NA,0.3913
"7836",211583,2000,"104",98,6,51,"1",50,0.5102,0.1667,0.4904
"7837",211608,2000,"291",151,140,34,"9",25,0.1656,0.0643,0.1168
"7838",211644,2000,"1305",813,492,330,"99",231,0.2841,0.2012,0.2529
"7839",211981,2000,"380",188,192,160,"63",97,0.516,0.3281,0.4211
"7840",212009,2000,"594",340,254,464,"188",276,0.8118,0.7402,0.7811
"7841",212054,2000,"2125",810,1315,275,"97",178,0.2198,0.0738,0.1294
"7842",212106,2000,"1257",733,524,650,"243",407,0.5553,0.4637,0.5171
"7843",212115,2000,"878",522,356,193,"57",136,0.2605,0.1601,0.2198
"7844",212133,2000,"400",279,121,229,"60",169,0.6057,0.4959,0.5725
"7845",212160,2000,"1304",731,573,297,"88",209,0.2859,0.1536,0.2278
"7846",212197,2000,"474",318,156,310,"98",212,0.6667,0.6282,0.654
"7847",212577,2000,"510",251,259,382,"179",203,0.8088,0.6911,0.749
"7848",212601,2000,"563",327,236,257,"87",170,0.5199,0.3686,0.4565
"7849",212832,2000,"179",141,38,70,"10",60,0.4255,0.2632,0.3911
"7850",212911,2000,"334",181,153,305,"140",165,0.9116,0.915,0.9132
"7851",213020,2000,"2776",1607,1169,605,"167",438,0.2726,0.1429,0.2179
"7852",213251,2000,"359",207,152,265,"105",160,0.7729,0.6908,0.7382
"7853",213321,2000,"457",199,258,285,"133",152,0.7638,0.5155,0.6236
"7854",213349,2000,"1528",925,603,422,"100",322,0.3481,0.1658,0.2762
"7855",213358,2000,"351",199,152,200,"98",102,0.5126,0.6447,0.5698
"7856",213367,2000,"774",404,370,455,"203",252,0.6238,0.5486,0.5879
"7857",213385,2000,"558",280,278,490,"238",252,0.9,0.8561,0.8781
"7858",213507,2000,"388",225,163,242,"85",157,0.6978,0.5215,0.6237
"7859",213543,2000,"1127",464,663,845,"473",372,0.8017,0.7134,0.7498
"7860",213613,2000,"890",522,368,250,"68",182,0.3487,0.1848,0.2809
"7861",213668,2000,"337",177,160,199,"90",109,0.6158,0.5625,0.5905
"7862",213783,2000,"639",363,276,183,"79",104,0.2865,0.2862,0.2864
"7863",213826,2000,"257",188,69,100,"29",71,0.3777,0.4203,0.3891
"7864",213996,2000,"741",451,290,500,"184",316,0.7007,0.6345,0.6748
"7865",214041,2000,"1265",768,497,463,"163",300,0.3906,0.328,0.366
"7866",214069,2000,"261",185,76,160,"39",121,0.6541,0.5132,0.613
"7867",214157,2000,"378",236,142,246,"80",166,0.7034,0.5634,0.6508
"7868",214175,2000,"579",340,239,480,"196",284,0.8353,0.8201,0.829
"7869",214272,2000,"299",164,135,87,"34",53,0.3232,0.2519,0.291
"7870",214777,2000,"5621",2866,2755,3127,"1277",1850,0.6455,0.4635,0.5563
"7871",215062,2000,"2270",1125,1145,1986,"967",1019,0.9058,0.8445,0.8749
"7872",215743,2000,"355",210,145,159,"58",101,0.481,0.4,0.4479
"7873",215798,2000,"302",141,161,192,"99",93,0.6596,0.6149,0.6358
"7874",215929,2000,"833",472,361,625,"259",366,0.7754,0.7175,0.7503
"7875",216010,2000,"1520",831,689,679,"233",446,0.5367,0.3382,0.4467
"7876",216038,2000,"1346",794,552,372,"105",267,0.3363,0.1902,0.2764
"7877",216287,2000,"366",195,171,316,"141",175,0.8974,0.8246,0.8634
"7878",216339,2000,"3031",1767,1264,857,"318",539,0.305,0.2516,0.2827
"7879",216524,2000,"376",214,162,287,"112",175,0.8178,0.6914,0.7633
"7880",216694,2000,"328",160,168,146,"57",89,0.5562,0.3393,0.4451
"7881",216764,2000,"1715",1085,630,536,"127",409,0.377,0.2016,0.3125
"7882",216807,2000,"340",199,141,230,"87",143,0.7186,0.617,0.6765
"7883",216852,2000,"534",231,303,218,"96",122,0.5281,0.3168,0.4082
"7884",216931,2000,"460",196,264,194,"93",101,0.5153,0.3523,0.4217
"7885",217059,2000,"900",510,390,366,"129",237,0.4647,0.3308,0.4067
"7886",217156,2000,"1415",767,648,1177,"530",647,0.8435,0.8179,0.8318
"7887",217402,2000,"930",527,403,775,"328",447,0.8482,0.8139,0.8333
"7888",217536,2000,"510",383,127,273,"63",210,0.5483,0.4961,0.5353
"7889",217776,2000,"92",51,41,33,"12",21,0.4118,0.2927,0.3587
"7890",217819,2000,"1985",1337,648,835,"215",620,0.4637,0.3318,0.4207
"7891",217882,2000,"3028",1451,1577,1333,"496",837,0.5768,0.3145,0.4402
"7892",217998,2000,"138",79,59,89,"31",58,0.7342,0.5254,0.6449
"7893",218061,2000,"602",356,246,95,"33",62,0.1742,0.1341,0.1578
"7894",218229,2000,"509",321,188,88,"23",65,0.2025,0.1223,0.1729
"7895",218238,2000,"103",49,54,23,"6",17,0.3469,0.1111,0.2233
"7896",218399,2000,"265",167,98,48,"14",34,0.2036,0.1429,0.1811
"7897",218414,2000,"181",80,101,58,"25",33,0.4125,0.2475,0.3204
"7898",218663,2000,"2475",1394,1081,988,"351",637,0.457,0.3247,0.3992
"7899",218724,2000,"784",434,350,157,"57",100,0.2304,0.1629,0.2003
"7900",218733,2000,"571",307,264,170,"48",122,0.3974,0.1818,0.2977
"7901",218742,2000,"546",358,188,94,"24",70,0.1955,0.1277,0.1722
"7902",218973,2000,"308",150,158,222,"104",118,0.7867,0.6582,0.7208
"7903",219000,2000,"460",286,174,222,"76",146,0.5105,0.4368,0.4826
"7904",219046,2000,"586",361,225,48,"11",37,0.1025,0.0489,0.0819
"7905",219082,2000,"351",149,202,51,"25",26,0.1745,0.1238,0.1453
"7906",219198,2000,"154",97,57,46,"21",25,0.2577,0.3684,0.2987
"7907",219259,2000,"446",257,189,61,"10",51,0.1984,0.0529,0.1368
"7908",219356,2000,"1446",740,706,327,"129",198,0.2676,0.1827,0.2261
"7909",219471,2000,"918",504,414,199,"62",137,0.2718,0.1498,0.2168
"7910",219602,2000,"870",554,316,101,"29",72,0.13,0.0918,0.1161
"7911",219709,2000,"516",309,207,278,"108",170,0.5502,0.5217,0.5388
"7912",219718,2000,"137",44,93,17,"7",10,0.2273,0.0753,0.1241
"7913",219949,2000,"189",78,111,28,"9",19,0.2436,0.0811,0.1481
"7914",220075,2000,"1483",824,659,244,"73",171,0.2075,0.1108,0.1645
"7915",220215,2000,"357",198,159,132,"60",72,0.3636,0.3774,0.3697
"7916",220613,2000,"711",435,276,204,"72",132,0.3034,0.2609,0.2869
"7917",220631,2000,"168",104,64,50,"21",29,0.2788,0.3281,0.2976
"7918",220710,2000,"269",132,137,135,"54",81,0.6136,0.3942,0.5019
"7919",221351,2000,"396",227,169,296,"125",171,0.7533,0.7396,0.7475
"7920",221519,2000,"385",203,182,276,"126",150,0.7389,0.6923,0.7169
"7921",221731,2000,"134",72,62,35,"9",26,0.3611,0.1452,0.2612
"7922",221847,2000,"1305",609,696,241,"85",156,0.2562,0.1221,0.1847
"7923",221892,2000,"220",130,90,80,"24",56,0.4308,0.2667,0.3636
"7924",222178,2000,"1023",565,458,355,"139",216,0.3823,0.3035,0.347
"7925",222983,2000,"347",186,161,249,"106",143,0.7688,0.6584,0.7176
"7926",223232,2000,"2822",1666,1156,1388,"442",946,0.5678,0.3824,0.4918
"7927",224004,2000,"130",73,57,24,"8",16,0.2192,0.1404,0.1846
"7928",224323,2000,"279",168,111,167,"59",108,0.6429,0.5315,0.5986
"7929",225432,2000,"794",437,357,16,"6",10,0.0229,0.0168,0.0202
"7930",225548,2000,"355",175,180,82,"28",54,0.3086,0.1556,0.231
"7931",225627,2000,"388",253,135,77,"20",57,0.2253,0.1481,0.1985
"7932",226231,2000,"286",79,207,96,"58",38,0.481,0.2802,0.3357
"7933",226833,2000,"696",355,341,64,"33",31,0.0873,0.0968,0.092
"7934",227216,2000,"2841",1664,1177,515,"142",373,0.2242,0.1206,0.1813
"7935",227331,2000,"267",205,62,42,"7",35,0.1707,0.1129,0.1573
"7936",227526,2000,"1230",657,573,163,"46",117,0.1781,0.0803,0.1325
"7937",227757,2000,"628",290,338,498,"249",249,0.8586,0.7367,0.793
"7938",227845,2000,"397",207,190,118,"42",76,0.3671,0.2211,0.2972
"7939",227863,2000,"303",207,96,72,"19",53,0.256,0.1979,0.2376
"7940",228042,2000,"207",124,83,40,"16",24,0.1935,0.1928,0.1932
"7941",228149,2000,"656",399,257,201,"60",141,0.3534,0.2335,0.3064
"7942",228246,2000,"1276",713,563,736,"280",456,0.6396,0.4973,0.5768
"7943",228343,2000,"355",195,160,230,"91",139,0.7128,0.5688,0.6479
"7944",228431,2000,"2210",1371,839,370,"88",282,0.2057,0.1049,0.1674
"7945",228459,2000,"2531",1553,978,522,"122",400,0.2576,0.1247,0.2062
"7946",228501,2000,"263",105,158,13,"7",6,0.0571,0.0443,0.0494
"7947",228529,2000,"475",238,237,100,"40",60,0.2521,0.1688,0.2105
"7948",228705,2000,"819",332,487,79,"33",46,0.1386,0.0678,0.0965
"7949",228723,2000,"6591",3453,3138,2409,"774",1635,0.4735,0.2467,0.3655
"7950",228769,2000,"1589",801,788,225,"102",123,0.1536,0.1294,0.1416
"7951",228778,2000,"7551",3857,3694,3447,"1403",2044,0.5299,0.3798,0.4565
"7952",228787,2000,"801",303,498,248,"127",121,0.3993,0.255,0.3096
"7953",228796,2000,"2018",1046,972,85,"30",55,0.0526,0.0309,0.0421
"7954",228875,2000,"1493",902,591,671,"210",461,0.5111,0.3553,0.4494
"7955",228981,2000,"330",175,155,125,"48",77,0.44,0.3097,0.3788
"7956",229018,2000,"144",86,58,23,"8",15,0.1744,0.1379,0.1597
"7957",229027,2000,"1727",894,833,121,"47",74,0.0828,0.0564,0.0701
"7958",229115,2000,"3998",1982,2016,1005,"359",646,0.3259,0.1781,0.2514
"7959",229780,2000,"216",120,96,30,"6",24,0.2,0.0625,0.1389
"7960",229814,2000,"867",471,396,121,"40",81,0.172,0.101,0.1396
"7961",230603,2000,"513",414,99,98,"12",86,0.2077,0.1212,0.191
"7962",230728,2000,"1632",1116,516,357,"76",281,0.2518,0.1473,0.2188
"7963",230764,2000,"2067",1029,1038,441,"155",286,0.2779,0.1493,0.2134
"7964",230782,2000,"1663",1000,663,135,"39",96,0.096,0.0588,0.0812
"7965",231059,2000,"521",283,238,366,"149",217,0.7668,0.6261,0.7025
"7966",231174,2000,"1765",988,777,917,"344",573,0.58,0.4427,0.5195
"7967",231420,2000,"192",64,128,44,"17",27,0.4219,0.1328,0.2292
"7968",231554,2000,"107",54,53,26,"13",13,0.2407,0.2453,0.243
"7969",231624,2000,"1347",782,565,1118,"425",693,0.8862,0.7522,0.83
"7970",231712,2000,"999",587,412,262,"73",189,0.322,0.1772,0.2623
"7971",232025,2000,"251",127,124,126,"53",73,0.5748,0.4274,0.502
"7972",232043,2000,"220",137,83,106,"35",71,0.5182,0.4217,0.4818
"7973",232089,2000,"281",102,179,47,"23",24,0.2353,0.1285,0.1673
"7974",232186,2000,"2097",1132,965,650,"194",456,0.4028,0.201,0.31
"7975",232265,2000,"828",527,301,327,"79",248,0.4706,0.2625,0.3949
"7976",232423,2000,"3223",1981,1242,2089,"684",1405,0.7092,0.5507,0.6482
"7977",232557,2000,"1216",657,559,431,"167",264,0.4018,0.2987,0.3544
"7978",232566,2000,"895",611,284,412,"105",307,0.5025,0.3697,0.4603
"7979",232609,2000,"438",252,186,188,"70",118,0.4683,0.3763,0.4292
"7980",232681,2000,"873",609,264,622,"175",447,0.734,0.6629,0.7125
"7981",232706,2000,"309",230,79,120,"21",99,0.4304,0.2658,0.3883
"7982",232937,2000,"1262",808,454,141,"52",89,0.1101,0.1145,0.1117
"7983",232982,2000,"1407",798,609,321,"93",228,0.2857,0.1527,0.2281
"7984",233277,2000,"1753",1081,672,610,"191",419,0.3876,0.2842,0.348
"7985",233374,2000,"723",366,357,574,"278",296,0.8087,0.7787,0.7939
"7986",233426,2000,"444",274,170,259,"80",179,0.6533,0.4706,0.5833
"7987",233541,2000,"377",187,190,105,"35",70,0.3743,0.1842,0.2785
"7988",233897,2000,"277",137,140,74,"22",52,0.3796,0.1571,0.2671
"7989",233921,2000,"4586",2024,2562,2339,"1047",1292,0.6383,0.4087,0.51
"7990",234030,2000,"2670",1608,1062,522,"161",361,0.2245,0.1516,0.1955
"7991",234085,2000,"349",22,327,204,"189",15,0.6818,0.578,0.5845
"7992",234155,2000,"885",498,387,187,"45",142,0.2851,0.1163,0.2113
"7993",234164,2000,"456",265,191,69,"16",53,0.2,0.0838,0.1513
"7994",235097,2000,"1085",642,443,227,"64",163,0.2539,0.1445,0.2092
"7995",235167,2000,"468",254,214,208,"81",127,0.5,0.3785,0.4444
"7996",236230,2000,"580",355,225,293,"94",199,0.5606,0.4178,0.5052
"7997",236328,2000,"647",408,239,442,"155",287,0.7034,0.6485,0.6832
"7998",236577,2000,"612",413,199,293,"90",203,0.4915,0.4523,0.4788
"7999",236595,2000,"664",428,236,338,"104",234,0.5467,0.4407,0.509
"8000",236896,2000,"338",160,178,62,"25",37,0.2312,0.1404,0.1834
"8001",236939,2000,"2440",1257,1183,794,"277",517,0.4113,0.2342,0.3254
"8002",236948,2000,"4765",2495,2270,2271,"926",1345,0.5391,0.4079,0.4766
"8003",237011,2000,"2351",1427,924,692,"212",480,0.3364,0.2294,0.2943
"8004",237057,2000,"349",220,129,278,"99",179,0.8136,0.7674,0.7966
"8005",237066,2000,"402",234,168,242,"86",156,0.6667,0.5119,0.602
"8006",237215,2000,"443",254,189,30,"14",16,0.063,0.0741,0.0677
"8007",237330,2000,"694",381,313,87,"26",61,0.1601,0.0831,0.1254
"8008",237358,2000,"133",76,57,39,"18",21,0.2763,0.3158,0.2932
"8009",237367,2000,"589",333,256,87,"25",62,0.1862,0.0977,0.1477
"8010",237792,2000,"669",378,291,101,"32",69,0.1825,0.11,0.151
"8011",237899,2000,"542",277,265,19,"6",13,0.0469,0.0226,0.0351
"8012",237932,2000,"513",275,238,91,"29",62,0.2255,0.1218,0.1774
"8013",237969,2000,"415",232,183,169,"56",113,0.4871,0.306,0.4072
"8014",238032,2000,"3480",1679,1801,889,"346",543,0.3234,0.1921,0.2555
"8015",238333,2000,"306",177,129,168,"79",89,0.5028,0.6124,0.549
"8016",238430,2000,"207",122,85,129,"53",76,0.623,0.6235,0.6232
"8017",238458,2000,"500",334,166,220,"58",162,0.485,0.3494,0.44
"8018",238476,2000,"532",295,237,232,"91",141,0.478,0.384,0.4361
"8019",238616,2000,"285",169,116,106,"43",63,0.3728,0.3707,0.3719
"8020",238661,2000,"274",203,71,81,"13",68,0.335,0.1831,0.2956
"8021",239080,2000,"245",180,65,85,"18",67,0.3722,0.2769,0.3469
"8022",239105,2000,"1675",926,749,963,"404",559,0.6037,0.5394,0.5749
"8023",239628,2000,"280",166,114,171,"64",107,0.6446,0.5614,0.6107
"8024",239716,2000,"548",321,227,364,"128",236,0.7352,0.5639,0.6642
"8025",240107,2000,"327",252,75,98,"16",82,0.3254,0.2133,0.2997
"8026",240189,2000,"2052",1051,1001,423,"155",268,0.255,0.1548,0.2061
"8027",240277,2000,"929",631,298,216,"55",161,0.2552,0.1846,0.2325
"8028",240329,2000,"1609",1009,600,420,"131",289,0.2864,0.2183,0.261
"8029",240338,2000,"194",125,69,91,"33",58,0.464,0.4783,0.4691
"8030",240365,2000,"1624",969,655,236,"65",171,0.1765,0.0992,0.1453
"8031",240374,2000,"747",413,334,82,"31",51,0.1235,0.0928,0.1098
"8032",240417,2000,"1307",668,639,195,"58",137,0.2051,0.0908,0.1492
"8033",240426,2000,"395",234,161,57,"21",36,0.1538,0.1304,0.1443
"8034",240444,2000,"5636",3120,2516,2500,"963",1537,0.4926,0.3828,0.4436
"8035",240453,2000,"2663",1449,1214,395,"142",253,0.1746,0.117,0.1483
"8036",240462,2000,"958",340,618,129,"53",76,0.2235,0.0858,0.1347
"8037",240471,2000,"1096",669,427,259,"81",178,0.2661,0.1897,0.2363
"8038",240480,2000,"1518",925,593,333,"107",226,0.2443,0.1804,0.2194
"8039",240727,2000,"1313",658,655,337,"126",211,0.3207,0.1924,0.2567
"8040",243443,2000,"540",350,190,59,"10",49,0.14,0.0526,0.1093
"8041",243780,2000,"6403",2646,3757,2209,"1046",1163,0.4395,0.2784,0.345
"8042",100654,1999,"1111",550,561,97,"16",81,0.1473,0.0285,0.0873
"8043",100663,1999,"1143",678,465,163,"59",104,0.1534,0.1269,0.1426
"8044",100751,1999,"2687",1499,1188,948,"309",639,0.4263,0.2601,0.3528
"8045",100858,1999,"3693",1875,1818,1189,"393",796,0.4245,0.2162,0.322
"8046",101435,1999,"163",103,60,58,"14",44,0.4272,0.2333,0.3558
"8047",101480,1999,"805",455,350,142,"44",98,0.2154,0.1257,0.1764
"8048",101675,1999,"319",170,149,113,"21",92,0.5412,0.1409,0.3542
"8049",101879,1999,"809",473,336,127,"28",99,0.2093,0.0833,0.157
"8050",102049,1999,"674",420,254,353,"120",233,0.5548,0.4724,0.5237
"8051",102094,1999,"882",521,361,122,"22",100,0.1919,0.0609,0.1383
"8052",102234,1999,"299",182,117,147,"43",104,0.5714,0.3675,0.4916
"8053",102368,1999,"845",510,335,271,"85",186,0.3647,0.2537,0.3207
"8054",102377,1999,"679",400,279,119,"27",92,0.23,0.0968,0.1753
"8055",104151,1999,"5625",3096,2529,1505,"522",983,0.3175,0.2064,0.2676
"8056",104179,1999,"5126",2745,2381,1626,"623",1003,0.3654,0.2617,0.3172
"8057",105330,1999,"2162",1278,884,562,"166",396,0.3099,0.1878,0.2599
"8058",106245,1999,"826",518,308,51,"12",39,0.0753,0.039,0.0617
"8059",106342,1999,"141",79,62,82,"33",49,0.6203,0.5323,0.5816
"8060",106397,1999,"2189",1123,1066,666,"235",431,0.3838,0.2205,0.3042
"8061",106412,1999,"656",341,315,76,"20",56,0.1642,0.0635,0.1159
"8062",106458,1999,"1654",937,717,303,"92",211,0.2252,0.1283,0.1832
"8063",106467,1999,"1055",508,547,146,"55",91,0.1791,0.1005,0.1384
"8064",106485,1999,"685",370,315,53,"15",38,0.1027,0.0476,0.0774
"8065",106704,1999,"1729",1030,699,272,"86",186,0.1806,0.123,0.1573
"8066",107044,1999,"941",488,453,313,"130",183,0.375,0.287,0.3326
"8067",107080,1999,"330",181,149,183,"74",109,0.6022,0.4966,0.5545
"8068",107141,1999,"267",149,118,113,"39",74,0.4966,0.3305,0.4232
"8069",107512,1999,"443",256,187,197,"72",125,0.4883,0.385,0.4447
"8070",107558,1999,"164",93,71,53,"17",36,0.3871,0.2394,0.3232
"8071",110097,1999,"563",373,190,370,"123",247,0.6622,0.6474,0.6572
"8072",110404,1999,"234",83,151,195,"126",69,0.8313,0.8344,0.8333
"8073",110422,1999,"2673",1277,1396,557,"167",390,0.3054,0.1196,0.2084
"8074",110486,1999,"517",319,198,69,"14",55,0.1724,0.0707,0.1335
"8075",110495,1999,"470",310,160,101,"16",85,0.2742,0.1,0.2149
"8076",110510,1999,"1049",679,370,105,"30",75,0.1105,0.0811,0.1001
"8077",110529,1999,"2489",1008,1481,226,"90",136,0.1349,0.0608,0.0908
"8078",110538,1999,"2007",1139,868,304,"67",237,0.2081,0.0772,0.1515
"8079",110547,1999,"453",319,134,26,"5",21,0.0658,0.0373,0.0574
"8080",110556,1999,"1703",1002,701,225,"56",169,0.1687,0.0799,0.1321
"8081",110565,1999,"2544",1543,1001,349,"63",286,0.1854,0.0629,0.1372
"8082",110574,1999,"714",466,248,119,"26",93,0.1996,0.1048,0.1667
"8083",110583,1999,"3309",2128,1181,361,"75",286,0.1344,0.0635,0.1091
"8084",110592,1999,"1186",750,436,111,"32",79,0.1053,0.0734,0.0936
"8085",110617,1999,"1753",1013,740,159,"39",120,0.1185,0.0527,0.0907
"8086",113698,1999,"111",88,23,50,"10",40,0.4545,0.4348,0.4505
"8087",115755,1999,"751",436,315,89,"25",64,0.1468,0.0794,0.1185
"8088",119173,1999,"294",293,1,57,"0",57,0.1945,0,0.1939
"8089",120184,1999,"129",85,44,50,"17",33,0.3882,0.3864,0.3876
"8090",121309,1999,"613",392,221,332,"117",215,0.5485,0.5294,0.5416
"8091",121345,1999,"390",194,196,338,"167",171,0.8814,0.852,0.8667
"8092",122409,1999,"2834",1574,1260,394,"119",275,0.1747,0.0944,0.139
"8093",122436,1999,"990",621,369,611,"204",407,0.6554,0.5528,0.6172
"8094",122597,1999,"1898",1158,740,178,"54",124,0.1071,0.073,0.0938
"8095",122612,1999,"757",500,257,379,"109",270,0.54,0.4241,0.5007
"8096",122931,1999,"1101",619,482,854,"358",496,0.8013,0.7427,0.7757
"8097",123554,1999,"629",363,266,369,"142",227,0.6253,0.5338,0.5866
"8098",123572,1999,"844",555,289,161,"24",137,0.2468,0.083,0.1908
"8099",126562,1999,"478",259,219,76,"30",46,0.1776,0.137,0.159
"8100",126580,1999,"682",395,287,104,"35",69,0.1747,0.122,0.1525
"8101",126614,1999,"4545",2303,2242,1728,"700",1028,0.4464,0.3122,0.3802
"8102",126818,1999,"3076",1702,1374,1054,"371",683,0.4013,0.27,0.3427
"8103",127060,1999,"812",410,402,420,"181",239,0.5829,0.4502,0.5172
"8104",127185,1999,"1019",429,590,102,"37",65,0.1515,0.0627,0.1001
"8105",127565,1999,"1440",764,676,86,"40",46,0.0602,0.0592,0.0597
"8106",127741,1999,"2291",1401,890,589,"129",460,0.3283,0.1449,0.2571
"8107",128106,1999,"611",326,285,76,"27",49,0.1503,0.0947,0.1244
"8108",128744,1999,"190",96,94,39,"15",24,0.25,0.1596,0.2053
"8109",128771,1999,"1280",559,721,143,"47",96,0.1717,0.0652,0.1117
"8110",129020,1999,"2940",1596,1344,1454,"523",931,0.5833,0.3891,0.4946
"8111",129242,1999,"837",446,391,662,"287",375,0.8408,0.734,0.7909
"8112",129941,1999,"322",117,205,66,"32",34,0.2906,0.1561,0.205
"8113",130253,1999,"718",416,302,401,"141",260,0.625,0.4669,0.5585
"8114",130314,1999,"144",144,0,61,"0",61,0.4236,NA,0.4236
"8115",130493,1999,"1238",702,536,148,"50",98,0.1396,0.0933,0.1195
"8116",130590,1999,"565",286,279,442,"206",236,0.8252,0.7384,0.7823
"8117",130697,1999,"732",375,357,609,"283",326,0.8693,0.7927,0.832
"8118",130776,1999,"697",359,338,70,"22",48,0.1337,0.0651,0.1004
"8119",130794,1999,"1358",682,676,1219,"594",625,0.9164,0.8787,0.8976
"8120",130934,1999,"632",375,257,132,"37",95,0.2533,0.144,0.2089
"8121",130943,1999,"3513",2146,1367,2193,"764",1429,0.6659,0.5589,0.6243
"8122",131159,1999,"1146",744,402,723,"231",492,0.6613,0.5746,0.6309
"8123",131283,1999,"762",381,381,457,"204",253,0.664,0.5354,0.5997
"8124",131450,1999,"254",135,119,14,"6",8,0.0593,0.0504,0.0551
"8125",131469,1999,"2109",1282,827,1515,"556",959,0.748,0.6723,0.7183
"8126",131496,1999,"1474",802,672,1299,"587",712,0.8878,0.8735,0.8813
"8127",131520,1999,"937",632,305,405,"99",306,0.4842,0.3246,0.4322
"8128",132471,1999,"398",251,147,9,"1",8,0.0319,0.0068,0.0226
"8129",132602,1999,"677",360,317,134,"36",98,0.2722,0.1136,0.1979
"8130",132903,1999,"4267",2256,2011,1298,"425",873,0.387,0.2113,0.3042
"8131",133492,1999,"403",210,193,232,"101",131,0.6238,0.5233,0.5757
"8132",133553,1999,"939",151,788,305,"245",60,0.3974,0.3109,0.3248
"8133",133650,1999,"2205",1277,928,360,"86",274,0.2146,0.0927,0.1633
"8134",133669,1999,"1423",860,563,201,"56",145,0.1686,0.0995,0.1413
"8135",133711,1999,"419",267,152,186,"61",125,0.4682,0.4013,0.4439
"8136",133881,1999,"402",116,286,139,"95",44,0.3793,0.3322,0.3458
"8137",133951,1999,"2482",1460,1022,525,"141",384,0.263,0.138,0.2115
"8138",134079,1999,"425",267,158,173,"55",118,0.4419,0.3481,0.4071
"8139",134097,1999,"5078",2934,2144,2244,"793",1451,0.4945,0.3699,0.4419
"8140",134130,1999,"6065",3388,2677,3191,"1111",2080,0.6139,0.415,0.5261
"8141",134945,1999,"309",122,187,98,"49",49,0.4016,0.262,0.3172
"8142",135726,1999,"1845",998,847,1031,"439",592,0.5932,0.5183,0.5588
"8143",136172,1999,"1501",886,615,375,"97",278,0.3138,0.1577,0.2498
"8144",136950,1999,"448",267,181,220,"87",133,0.4981,0.4807,0.4911
"8145",137546,1999,"548",325,223,312,"119",193,0.5938,0.5336,0.5693
"8146",138354,1999,"637",335,302,132,"54",78,0.2328,0.1788,0.2072
"8147",138716,1999,"648",424,224,92,"23",69,0.1627,0.1027,0.142
"8148",138789,1999,"602",386,216,35,"10",25,0.0648,0.0463,0.0581
"8149",139144,1999,"401",243,158,197,"69",128,0.5267,0.4367,0.4913
"8150",139366,1999,"672",412,260,54,"13",41,0.0995,0.05,0.0804
"8151",139393,1999,"228",144,84,124,"45",79,0.5486,0.5357,0.5439
"8152",139658,1999,"1515",870,645,1148,"486",662,0.7609,0.7535,0.7578
"8153",139719,1999,"406",206,200,36,"9",27,0.1311,0.045,0.0887
"8154",139755,1999,"2293",654,1639,657,"431",226,0.3456,0.263,0.2865
"8155",139764,1999,"259",161,98,42,"14",28,0.1739,0.1429,0.1622
"8156",139861,1999,"786",486,300,164,"36",128,0.2634,0.12,0.2087
"8157",139931,1999,"3266",1729,1537,384,"98",286,0.1654,0.0638,0.1176
"8158",139940,1999,"1772",1082,690,242,"69",173,0.1599,0.1,0.1366
"8159",139959,1999,"4375",2586,1789,1860,"592",1268,0.4903,0.3309,0.4251
"8160",140447,1999,"730",449,281,254,"79",175,0.3898,0.2811,0.3479
"8161",140960,1999,"281",150,131,18,"4",14,0.0933,0.0305,0.0641
"8162",140988,1999,"259",171,88,103,"32",71,0.4152,0.3636,0.3977
"8163",141185,1999,"216",135,81,65,"19",46,0.3407,0.2346,0.3009
"8164",141264,1999,"1177",735,442,211,"52",159,0.2163,0.1176,0.1793
"8165",141334,1999,"1604",1005,599,144,"34",110,0.1095,0.0568,0.0898
"8166",141486,1999,"231",159,72,49,"12",37,0.2327,0.1667,0.2121
"8167",141565,1999,"366",207,159,39,"11",28,0.1353,0.0692,0.1066
"8168",141574,1999,"1421",793,628,164,"56",108,0.1362,0.0892,0.1154
"8169",142276,1999,"1345",740,605,45,"10",35,0.0473,0.0165,0.0335
"8170",142285,1999,"1457",736,721,318,"123",195,0.2649,0.1706,0.2183
"8171",142461,1999,"295",165,130,88,"31",57,0.3455,0.2385,0.2983
"8172",143084,1999,"565",338,227,402,"161",241,0.713,0.7093,0.7115
"8173",143288,1999,"145",76,69,44,"21",23,0.3026,0.3043,0.3034
"8174",144005,1999,"461",329,132,9,"3",6,0.0182,0.0227,0.0195
"8175",144281,1999,"1134",560,574,225,"103",122,0.2179,0.1794,0.1984
"8176",144740,1999,"1700",997,703,771,"299",472,0.4734,0.4253,0.4535
"8177",144892,1999,"1478",929,549,482,"131",351,0.3778,0.2386,0.3261
"8178",144962,1999,"269",156,113,158,"58",100,0.641,0.5133,0.5874
"8179",144971,1999,"130",76,54,60,"19",41,0.5395,0.3519,0.4615
"8180",145600,1999,"2552",1381,1171,506,"215",291,0.2107,0.1836,0.1983
"8181",145619,1999,"259",127,132,74,"30",44,0.3465,0.2273,0.2857
"8182",145637,1999,"6458",3131,3327,3849,"1733",2116,0.6758,0.5209,0.596
"8183",145691,1999,"241",131,110,97,"34",63,0.4809,0.3091,0.4025
"8184",145813,1999,"3067",1907,1160,1072,"301",771,0.4043,0.2595,0.3495
"8185",146481,1999,"341",208,133,216,"80",136,0.6538,0.6015,0.6334
"8186",146612,1999,"425",194,231,171,"82",89,0.4588,0.355,0.4024
"8187",146719,1999,"1067",717,350,541,"169",372,0.5188,0.4829,0.507
"8188",146825,1999,"187",80,107,55,"25",30,0.375,0.2336,0.2941
"8189",147013,1999,"246",164,82,101,"27",74,0.4512,0.3293,0.4106
"8190",147244,1999,"595",324,271,323,"130",193,0.5957,0.4797,0.5429
"8191",147341,1999,"259",155,104,132,"44",88,0.5677,0.4231,0.5097
"8192",147703,1999,"2924",1587,1337,742,"285",457,0.288,0.2132,0.2538
"8193",147767,1999,"1951",1039,912,1657,"746",911,0.8768,0.818,0.8493
"8194",147776,1999,"943",573,370,22,"7",15,0.0262,0.0189,0.0233
"8195",147828,1999,"410",224,186,169,"61",108,0.4821,0.328,0.4122
"8196",148131,1999,"273",148,125,98,"36",62,0.4189,0.288,0.359
"8197",148496,1999,"195",144,51,112,"28",84,0.5833,0.549,0.5744
"8198",148584,1999,"170",101,69,54,"14",40,0.396,0.2029,0.3176
"8199",148627,1999,"325",196,129,96,"33",63,0.3214,0.2558,0.2954
"8200",149222,1999,"2547",1094,1453,483,"234",249,0.2276,0.161,0.1896
"8201",149231,1999,"1357",800,557,253,"66",187,0.2338,0.1185,0.1864
"8202",149772,1999,"1690",856,834,542,"215",327,0.382,0.2578,0.3207
"8203",149781,1999,"583",311,272,450,"204",246,0.791,0.75,0.7719
"8204",150066,1999,"498",304,194,206,"61",145,0.477,0.3144,0.4137
"8205",150136,1999,"3602",1931,1671,943,"348",595,0.3081,0.2083,0.2618
"8206",150145,1999,"265",156,109,98,"30",68,0.4359,0.2752,0.3698
"8207",150163,1999,"861",529,332,470,"168",302,0.5709,0.506,0.5459
"8208",150400,1999,"579",327,252,436,"194",242,0.7401,0.7698,0.753
"8209",150534,1999,"594",367,227,276,"97",179,0.4877,0.4273,0.4646
"8210",150668,1999,"220",135,85,90,"30",60,0.4444,0.3529,0.4091
"8211",150941,1999,"221",140,81,127,"43",84,0.6,0.5309,0.5747
"8212",151102,1999,"1303",688,615,48,"16",32,0.0465,0.026,0.0368
"8213",151111,1999,"2552",1409,1143,166,"67",99,0.0703,0.0586,0.065
"8214",151306,1999,"1674",1003,671,200,"49",151,0.1505,0.073,0.1195
"8215",151324,1999,"2014",998,1016,352,"132",220,0.2204,0.1299,0.1748
"8216",151333,1999,"295",213,82,27,"7",20,0.0939,0.0854,0.0915
"8217",151342,1999,"637",382,255,37,"10",27,0.0707,0.0392,0.0581
"8218",151351,1999,"6503",3828,2675,3137,"1138",1999,0.5222,0.4254,0.4824
"8219",151360,1999,"540",345,195,45,"16",29,0.0841,0.0821,0.0833
"8220",151379,1999,"719",448,271,54,"13",41,0.0915,0.048,0.0751
"8221",151388,1999,"255",161,94,10,"1",9,0.0559,0.0106,0.0392
"8222",151777,1999,"328",166,162,132,"41",91,0.5482,0.2531,0.4024
"8223",151786,1999,"251",181,70,88,"19",69,0.3812,0.2714,0.3506
"8224",152080,1999,"1967",932,1035,1739,"880",859,0.9217,0.8502,0.8841
"8225",152248,1999,"1112",593,519,42,"13",29,0.0489,0.025,0.0378
"8226",152363,1999,"290",122,168,114,"56",58,0.4754,0.3333,0.3931
"8227",152530,1999,"473",256,217,341,"142",199,0.7773,0.6544,0.7209
"8228",152600,1999,"730",376,354,429,"192",237,0.6303,0.5424,0.5877
"8229",153001,1999,"322",144,178,146,"69",77,0.5347,0.3876,0.4534
"8230",153108,1999,"403",219,184,7,"0",7,0.032,0,0.0174
"8231",153269,1999,"670",364,306,371,"151",220,0.6044,0.4935,0.5537
"8232",153384,1999,"325",168,157,271,"126",145,0.8631,0.8025,0.8338
"8233",153603,1999,"4020",1830,2190,1261,"520",741,0.4049,0.2374,0.3137
"8234",153834,1999,"606",354,252,393,"155",238,0.6723,0.6151,0.6485
"8235",154095,1999,"2122",1303,819,713,"211",502,0.3853,0.2576,0.336
"8236",155089,1999,"226",125,101,36,"13",23,0.184,0.1287,0.1593
"8237",155317,1999,"3784",2099,1685,1155,"374",781,0.3721,0.222,0.3052
"8238",155335,1999,"148",87,61,50,"18",32,0.3678,0.2951,0.3378
"8239",155399,1999,"3280",1574,1706,723,"288",435,0.2764,0.1688,0.2204
"8240",155520,1999,"205",111,94,71,"28",43,0.3874,0.2979,0.3463
"8241",155627,1999,"136",50,86,22,"10",12,0.24,0.1163,0.1618
"8242",155937,1999,"110",63,47,61,"20",41,0.6508,0.4255,0.5545
"8243",156213,1999,"326",198,128,200,"76",124,0.6263,0.5938,0.6135
"8244",156286,1999,"324",223,101,182,"54",128,0.574,0.5347,0.5617
"8245",156295,1999,"423",233,190,150,"57",93,0.3991,0.3,0.3546
"8246",156365,1999,"290",155,135,77,"31",46,0.2968,0.2296,0.2655
"8247",156541,1999,"403",201,202,114,"41",73,0.3632,0.203,0.2829
"8248",156745,1999,"340",205,135,158,"51",107,0.522,0.3778,0.4647
"8249",157058,1999,"366",186,180,40,"8",32,0.172,0.0444,0.1093
"8250",157076,1999,"191",102,89,51,"18",33,0.3235,0.2022,0.267
"8251",157085,1999,"2742",1499,1243,792,"293",499,0.3329,0.2357,0.2888
"8252",157289,1999,"2297",1232,1065,289,"90",199,0.1615,0.0845,0.1258
"8253",157386,1999,"1325",756,569,156,"55",101,0.1336,0.0967,0.1177
"8254",157401,1999,"1177",666,511,345,"114",231,0.3468,0.2231,0.2931
"8255",157447,1999,"1696",969,727,35,"13",22,0.0227,0.0179,0.0206
"8256",157535,1999,"206",140,66,41,"10",31,0.2214,0.1515,0.199
"8257",157951,1999,"2480",1447,1033,568,"204",364,0.2516,0.1975,0.229
"8258",158477,1999,"270",162,108,112,"34",78,0.4815,0.3148,0.4148
"8259",159009,1999,"690",367,323,88,"24",64,0.1744,0.0743,0.1275
"8260",159391,1999,"5173",2956,2217,1262,"398",864,0.2923,0.1795,0.244
"8261",159647,1999,"1753",840,913,478,"199",279,0.3321,0.218,0.2727
"8262",159717,1999,"1275",636,639,127,"34",93,0.1462,0.0532,0.0996
"8263",159966,1999,"1445",860,585,129,"30",99,0.1151,0.0513,0.0893
"8264",160038,1999,"1656",988,668,184,"71",113,0.1144,0.1063,0.1111
"8265",160612,1999,"2315",1361,954,170,"44",126,0.0926,0.0461,0.0734
"8266",160621,1999,"1287",693,594,86,"19",67,0.0967,0.032,0.0668
"8267",160658,1999,"2402",1300,1102,298,"94",204,0.1569,0.0853,0.1241
"8268",161004,1999,"464",259,205,418,"183",235,0.9073,0.8927,0.9009
"8269",161226,1999,"470",344,126,197,"48",149,0.4331,0.381,0.4191
"8270",161235,1999,"109",64,45,17,"3",14,0.2188,0.0667,0.156
"8271",161244,1999,"121",83,38,15,"4",11,0.1325,0.1053,0.124
"8272",161253,1999,"1521",718,803,430,"176",254,0.3538,0.2192,0.2827
"8273",161554,1999,"815",477,338,96,"24",72,0.1509,0.071,0.1178
"8274",162007,1999,"343",189,154,45,"12",33,0.1746,0.0779,0.1312
"8275",162210,1999,"175",115,60,25,"6",19,0.1652,0.1,0.1429
"8276",162283,1999,"441",306,135,39,"12",27,0.0882,0.0889,0.0884
"8277",162584,1999,"932",508,424,165,"52",113,0.2224,0.1226,0.177
"8278",162654,1999,"322",224,98,176,"54",122,0.5446,0.551,0.5466
"8279",162760,1999,"156",152,4,100,"1",99,0.6513,0.25,0.641
"8280",162928,1999,"1098",441,657,868,"503",365,0.8277,0.7656,0.7905
"8281",163046,1999,"941",530,411,734,"292",442,0.834,0.7105,0.78
"8282",163268,1999,"1396",638,758,417,"188",229,0.3589,0.248,0.2987
"8283",163286,1999,"3871",1796,2075,1943,"884",1059,0.5896,0.426,0.5019
"8284",163453,1999,"1152",661,491,208,"41",167,0.2526,0.0835,0.1806
"8285",163462,1999,"369",221,148,238,"94",144,0.6516,0.6351,0.645
"8286",163851,1999,"877",537,340,458,"149",309,0.5754,0.4382,0.5222
"8287",163912,1999,"276",157,119,176,"70",106,0.6752,0.5882,0.6377
"8288",164076,1999,"2103",1277,826,610,"170",440,0.3446,0.2058,0.2901
"8289",164173,1999,"421",288,133,211,"60",151,0.5243,0.4511,0.5012
"8290",164216,1999,"282",175,107,175,"54",121,0.6914,0.5047,0.6206
"8291",164270,1999,"412",204,208,261,"107",154,0.7549,0.5144,0.6335
"8292",164447,1999,"240",92,148,77,"33",44,0.4783,0.223,0.3208
"8293",164492,1999,"134",90,44,64,"23",41,0.4556,0.5227,0.4776
"8294",164562,1999,"592",361,231,404,"150",254,0.7036,0.6494,0.6824
"8295",165015,1999,"793",446,347,663,"275",388,0.87,0.7925,0.8361
"8296",165024,1999,"1079",657,422,208,"43",165,0.2511,0.1019,0.1928
"8297",165334,1999,"486",304,182,308,"112",196,0.6447,0.6154,0.6337
"8298",165662,1999,"653",361,292,433,"192",241,0.6676,0.6575,0.6631
"8299",165671,1999,"133",133,0,60,"0",60,0.4511,NA,0.4511
"8300",165820,1999,"345",202,143,73,"23",50,0.2475,0.1608,0.2116
"8301",165866,1999,"559",402,157,130,"27",103,0.2562,0.172,0.2326
"8302",165936,1999,"382",243,139,205,"61",144,0.5926,0.4388,0.5366
"8303",166027,1999,"1647",775,872,1429,"757",672,0.8671,0.8681,0.8676
"8304",166124,1999,"722",383,339,645,"298",347,0.906,0.8791,0.8934
"8305",166513,1999,"935",368,567,230,"91",139,0.3777,0.1605,0.246
"8306",166629,1999,"4144",2199,1945,1824,"701",1123,0.5107,0.3604,0.4402
"8307",166638,1999,"671",368,303,102,"33",69,0.1875,0.1089,0.152
"8308",166683,1999,"1049",448,601,863,"473",390,0.8705,0.787,0.8227
"8309",167288,1999,"220",135,85,78,"27",51,0.3778,0.3176,0.3545
"8310",167987,1999,"1131",556,575,316,"126",190,0.3417,0.2191,0.2794
"8311",167996,1999,"572",333,239,458,"185",273,0.8198,0.7741,0.8007
"8312",168005,1999,"672",381,291,240,"72",168,0.4409,0.2474,0.3571
"8313",168148,1999,"1345",741,604,1134,"497",637,0.8596,0.8228,0.8431
"8314",168254,1999,"618",271,347,268,"145",123,0.4539,0.4179,0.4337
"8315",168281,1999,"427",281,146,298,"85",213,0.758,0.5822,0.6979
"8316",168342,1999,"544",264,280,487,"244",243,0.9205,0.8714,0.8952
"8317",168546,1999,"411",219,192,275,"110",165,0.7534,0.5729,0.6691
"8318",168786,1999,"347",227,120,93,"32",61,0.2687,0.2667,0.268
"8319",169080,1999,"1059",591,468,574,"225",349,0.5905,0.4808,0.542
"8320",169798,1999,"2767",1627,1140,298,"93",205,0.126,0.0816,0.1077
"8321",169910,1999,"1916",798,1118,78,"44",34,0.0426,0.0394,0.0407
"8322",170082,1999,"2528",1553,975,512,"163",349,0.2247,0.1672,0.2025
"8323",170301,1999,"755",455,300,485,"184",301,0.6615,0.6133,0.6424
"8324",170532,1999,"369",187,182,270,"128",142,0.7594,0.7033,0.7317
"8325",170639,1999,"505",242,263,71,"30",41,0.1694,0.1141,0.1406
"8326",170976,1999,"5563",2853,2710,3879,"1779",2100,0.7361,0.6565,0.6973
"8327",171100,1999,"6499",3674,2825,2580,"833",1747,0.4755,0.2949,0.397
"8328",171128,1999,"1137",276,861,259,"183",76,0.2754,0.2125,0.2278
"8329",171137,1999,"690",334,356,88,"30",58,0.1737,0.0843,0.1275
"8330",171146,1999,"492",289,203,49,"15",34,0.1176,0.0739,0.0996
"8331",171599,1999,"181",74,107,63,"32",31,0.4189,0.2991,0.3481
"8332",172051,1999,"1015",549,466,81,"36",45,0.082,0.0773,0.0798
"8333",172699,1999,"4302",2288,2014,864,"306",558,0.2439,0.1519,0.2008
"8334",173160,1999,"479",315,164,295,"98",197,0.6254,0.5976,0.6159
"8335",173258,1999,"507",257,250,410,"199",211,0.821,0.796,0.8087
"8336",173328,1999,"258",142,116,76,"32",44,0.3099,0.2759,0.2946
"8337",173647,1999,"654",365,289,473,"207",266,0.7288,0.7163,0.7232
"8338",173902,1999,"460",271,189,360,"147",213,0.786,0.7778,0.7826
"8339",174066,1999,"5025",2636,2389,1604,"655",949,0.36,0.2742,0.3192
"8340",174233,1999,"2000",1032,968,416,"168",248,0.2403,0.1736,0.208
"8341",174251,1999,"453",270,183,174,"70",104,0.3852,0.3825,0.3841
"8342",174491,1999,"392",262,130,160,"42",118,0.4504,0.3231,0.4082
"8343",174792,1999,"475",0,475,335,"335",0,NA,0.7053,0.7053
"8344",174844,1999,"761",451,310,594,"225",369,0.8182,0.7258,0.7806
"8345",174899,1999,"305",230,75,156,"36",120,0.5217,0.48,0.5115
"8346",174914,1999,"1087",603,484,642,"255",387,0.6418,0.5269,0.5906
"8347",175342,1999,"553",309,244,130,"41",89,0.288,0.168,0.2351
"8348",175421,1999,"144",71,73,46,"25",21,0.2958,0.3425,0.3194
"8349",175616,1999,"458",275,183,107,"38",69,0.2509,0.2077,0.2336
"8350",175856,1999,"845",527,318,128,"34",94,0.1784,0.1069,0.1515
"8351",175980,1999,"284",158,126,177,"67",110,0.6962,0.5317,0.6232
"8352",176017,1999,"1810",944,866,621,"218",403,0.4269,0.2517,0.3431
"8353",176035,1999,"202",177,25,59,"3",56,0.3164,0.12,0.2921
"8354",176044,1999,"248",138,110,48,"18",30,0.2174,0.1636,0.1935
"8355",176080,1999,"2033",1003,1030,507,"177",330,0.329,0.1718,0.2494
"8356",176406,1999,"252",196,56,73,"11",62,0.3163,0.1964,0.2897
"8357",176628,1999,"113",81,32,45,"7",38,0.4691,0.2188,0.3982
"8358",176947,1999,"228",108,120,62,"25",37,0.3426,0.2083,0.2719
"8359",176965,1999,"1329",725,604,300,"94",206,0.2841,0.1556,0.2257
"8360",177418,1999,"144",94,50,60,"14",46,0.4894,0.28,0.4167
"8361",178059,1999,"198",133,65,101,"26",75,0.5639,0.4,0.5101
"8362",178341,1999,"804",434,370,104,"40",64,0.1475,0.1081,0.1294
"8363",178387,1999,"980",575,405,113,"35",78,0.1357,0.0864,0.1153
"8364",178396,1999,"3871",2138,1733,1468,"525",943,0.4411,0.3029,0.3792
"8365",178402,1999,"639",356,283,105,"46",59,0.1657,0.1625,0.1643
"8366",178411,1999,"679",140,539,112,"77",35,0.25,0.1429,0.1649
"8367",178420,1999,"539",274,265,122,"43",79,0.2883,0.1623,0.2263
"8368",178615,1999,"1446",884,562,594,"201",393,0.4446,0.3577,0.4108
"8369",179043,1999,"303",177,126,152,"61",91,0.5141,0.4841,0.5017
"8370",179159,1999,"1252",695,557,764,"314",450,0.6475,0.5637,0.6102
"8371",179557,1999,"1391",816,575,320,"87",233,0.2855,0.1513,0.2301
"8372",179566,1999,"2581",1439,1142,605,"223",382,0.2655,0.1953,0.2344
"8373",179867,1999,"1369",684,685,1125,"548",577,0.8436,0.8,0.8218
"8374",179894,1999,"369",214,155,156,"52",104,0.486,0.3355,0.4228
"8375",179946,1999,"201",90,111,94,"41",53,0.5889,0.3694,0.4677
"8376",180179,1999,"629",384,245,56,"15",41,0.1068,0.0612,0.089
"8377",180461,1999,"1894",891,1003,354,"164",190,0.2132,0.1635,0.1869
"8378",180522,1999,"261",112,149,30,"16",14,0.125,0.1074,0.1149
"8379",180984,1999,"324",149,175,86,"41",45,0.302,0.2343,0.2654
"8380",181002,1999,"822",499,323,516,"209",307,0.6152,0.6471,0.6277
"8381",181020,1999,"278",141,137,174,"79",95,0.6738,0.5766,0.6259
"8382",181127,1999,"286",141,145,146,"54",92,0.6525,0.3724,0.5105
"8383",181215,1999,"1035",579,456,212,"71",141,0.2435,0.1557,0.2048
"8384",181394,1999,"1477",762,715,151,"45",106,0.1391,0.0629,0.1022
"8385",181446,1999,"358",204,154,197,"84",113,0.5539,0.5455,0.5503
"8386",181464,1999,"3592",1778,1814,807,"317",490,0.2756,0.1748,0.2247
"8387",181534,1999,"192",87,105,65,"31",34,0.3908,0.2952,0.3385
"8388",181783,1999,"659",387,272,150,"41",109,0.2817,0.1507,0.2276
"8389",182281,1999,"1486",805,681,204,"73",131,0.1627,0.1072,0.1373
"8390",182290,1999,"1466",792,674,241,"78",163,0.2058,0.1157,0.1644
"8391",182634,1999,"236",151,85,115,"47",68,0.4503,0.5529,0.4873
"8392",182795,1999,"429",184,245,189,"103",86,0.4674,0.4204,0.4406
"8393",183062,1999,"1014",649,365,262,"70",192,0.2958,0.1918,0.2584
"8394",183080,1999,"772",377,395,204,"75",129,0.3422,0.1899,0.2642
"8395",183239,1999,"534",280,254,376,"160",216,0.7714,0.6299,0.7041
"8396",183822,1999,"242",155,87,13,"4",9,0.0581,0.046,0.0537
"8397",183974,1999,"136",98,38,58,"17",41,0.4184,0.4474,0.4265
"8398",184348,1999,"407",225,182,279,"118",161,0.7156,0.6484,0.6855
"8399",184603,1999,"526",281,245,96,"31",65,0.2313,0.1265,0.1825
"8400",184612,1999,"224",140,84,7,"7",0,0,0.0833,0.0312
"8401",184782,1999,"1119",587,532,436,"183",253,0.431,0.344,0.3896
"8402",185129,1999,"603",331,272,54,"18",36,0.1088,0.0662,0.0896
"8403",185572,1999,"833",457,376,295,"99",196,0.4289,0.2633,0.3541
"8404",185590,1999,"1319",823,496,308,"81",227,0.2758,0.1633,0.2335
"8405",185828,1999,"649",114,535,116,"88",28,0.2456,0.1645,0.1787
"8406",186131,1999,"1148",556,592,1030,"530",500,0.8993,0.8953,0.8972
"8407",186201,1999,"527",293,234,201,"66",135,0.4608,0.2821,0.3814
"8408",186283,1999,"735",386,349,310,"128",182,0.4715,0.3668,0.4218
"8409",186584,1999,"1063",533,530,437,"190",247,0.4634,0.3585,0.4111
"8410",186876,1999,"705",409,296,254,"86",168,0.4108,0.2905,0.3603
"8411",187134,1999,"1207",697,510,776,"281",495,0.7102,0.551,0.6429
"8412",187444,1999,"1105",614,491,177,"56",121,0.1971,0.1141,0.1602
"8413",187985,1999,"2715",1517,1198,276,"85",191,0.1259,0.071,0.1017
"8414",188030,1999,"2210",1223,987,272,"88",184,0.1504,0.0892,0.1231
"8415",188429,1999,"532",366,166,233,"64",169,0.4617,0.3855,0.438
"8416",188641,1999,"549",277,272,242,"98",144,0.5199,0.3603,0.4408
"8417",190044,1999,"706",225,481,407,"264",143,0.6356,0.5489,0.5765
"8418",190099,1999,"750",397,353,662,"306",356,0.8967,0.8669,0.8827
"8419",190150,1999,"1298",573,725,1068,"586",482,0.8412,0.8083,0.8228
"8420",190248,1999,"111",72,39,33,"6",27,0.375,0.1538,0.2973
"8421",190415,1999,"3158",1497,1661,2660,"1341",1319,0.8811,0.8073,0.8423
"8422",190512,1999,"1133",593,540,312,"124",188,0.317,0.2296,0.2754
"8423",190549,1999,"982",591,391,166,"55",111,0.1878,0.1407,0.169
"8424",190558,1999,"1532",782,750,63,"21",42,0.0537,0.028,0.0411
"8425",190567,1999,"773",341,432,45,"16",29,0.085,0.037,0.0582
"8426",190594,1999,"1806",1281,525,176,"36",140,0.1093,0.0686,0.0975
"8427",190637,1999,"604",416,188,44,"19",25,0.0601,0.1011,0.0728
"8428",190664,1999,"876",528,348,200,"50",150,0.2841,0.1437,0.2283
"8429",190691,1999,"425",261,164,31,"11",20,0.0766,0.0671,0.0729
"8430",190725,1999,"293",230,63,70,"17",53,0.2304,0.2698,0.2389
"8431",191241,1999,"1538",891,647,1105,"443",662,0.743,0.6847,0.7185
"8432",191515,1999,"500",254,246,408,"190",218,0.8583,0.7724,0.816
"8433",191533,1999,"407",210,197,192,"75",117,0.5571,0.3807,0.4717
"8434",191630,1999,"502",255,247,307,"133",174,0.6824,0.5385,0.6116
"8435",191649,1999,"1876",1015,861,675,"242",433,0.4266,0.2811,0.3598
"8436",191676,1999,"294",186,108,166,"56",110,0.5914,0.5185,0.5646
"8437",191931,1999,"790",349,441,335,"147",188,0.5387,0.3333,0.4241
"8438",191968,1999,"1586",885,701,1022,"418",604,0.6825,0.5963,0.6444
"8439",192192,1999,"268",192,76,90,"23",67,0.349,0.3026,0.3358
"8440",192323,1999,"471",264,207,304,"121",183,0.6932,0.5845,0.6454
"8441",192439,1999,"1010",719,291,38,"12",26,0.0362,0.0412,0.0376
"8442",192703,1999,"645",289,356,386,"195",191,0.6609,0.5478,0.5984
"8443",192749,1999,"387",266,121,195,"57",138,0.5188,0.4711,0.5039
"8444",192819,1999,"975",548,427,665,"260",405,0.7391,0.6089,0.6821
"8445",192925,1999,"143",104,39,31,"6",25,0.2404,0.1538,0.2168
"8446",193016,1999,"953",630,323,68,"18",50,0.0794,0.0557,0.0714
"8447",193292,1999,"209",156,53,84,"11",73,0.4679,0.2075,0.4019
"8448",193353,1999,"323",247,76,156,"25",131,0.5304,0.3289,0.483
"8449",193399,1999,"240",167,73,76,"18",58,0.3473,0.2466,0.3167
"8450",193584,1999,"334",244,90,205,"51",154,0.6311,0.5667,0.6138
"8451",193645,1999,"814",670,144,152,"16",136,0.203,0.1111,0.1867
"8452",193654,1999,"573",399,174,234,"55",179,0.4486,0.3161,0.4084
"8453",193900,1999,"3845",2323,1522,2245,"868",1377,0.5928,0.5703,0.5839
"8454",193973,1999,"575",345,230,315,"127",188,0.5449,0.5522,0.5478
"8455",194161,1999,"322",182,140,107,"39",68,0.3736,0.2786,0.3323
"8456",194310,1999,"1500",895,605,604,"205",399,0.4458,0.3388,0.4027
"8457",194824,1999,"1323",295,1028,812,"611",201,0.6814,0.5944,0.6138
"8458",195003,1999,"2107",602,1505,366,"187",179,0.2973,0.1243,0.1737
"8459",195030,1999,"1211",525,686,828,"429",399,0.76,0.6254,0.6837
"8460",195164,1999,"520",294,226,273,"100",173,0.5884,0.4425,0.525
"8461",195173,1999,"474",284,190,130,"54",76,0.2676,0.2842,0.2743
"8462",195216,1999,"575",301,274,410,"182",228,0.7575,0.6642,0.713
"8463",195234,1999,"401",297,104,202,"39",163,0.5488,0.375,0.5037
"8464",195243,1999,"304",168,136,103,"33",70,0.4167,0.2426,0.3388
"8465",195304,1999,"278",215,63,180,"44",136,0.6326,0.6984,0.6475
"8466",195474,1999,"677",381,296,491,"197",294,0.7717,0.6655,0.7253
"8467",195526,1999,"642",367,275,470,"189",281,0.7657,0.6873,0.7321
"8468",195544,1999,"77",55,22,51,"8",43,0.7818,0.3636,0.6623
"8469",195809,1999,"2650",1500,1150,954,"357",597,0.398,0.3104,0.36
"8470",196413,1999,"2724",1534,1190,1841,"748",1093,0.7125,0.6286,0.6758
"8471",196592,1999,"1756",1210,546,152,"50",102,0.0843,0.0916,0.0866
"8472",197045,1999,"365",221,144,158,"49",109,0.4932,0.3403,0.4329
"8473",197133,1999,"633",381,252,543,"209",334,0.8766,0.8294,0.8578
"8474",197869,1999,"2199",1186,1013,778,"266",512,0.4317,0.2626,0.3538
"8475",197984,1999,"195",90,105,57,"27",30,0.3333,0.2571,0.2923
"8476",198385,1999,"456",226,230,380,"187",193,0.854,0.813,0.8333
"8477",198464,1999,"3255",1931,1324,822,"266",556,0.2879,0.2009,0.2525
"8478",198507,1999,"402",247,155,109,"22",87,0.3522,0.1419,0.2711
"8479",198516,1999,"999",637,362,701,"232",469,0.7363,0.6409,0.7017
"8480",198835,1999,"288",168,120,117,"37",80,0.4762,0.3083,0.4062
"8481",198969,1999,"378",123,255,53,"23",30,0.2439,0.0902,0.1402
"8482",199102,1999,"1530",850,680,348,"112",236,0.2776,0.1647,0.2275
"8483",199111,1999,"456",267,189,128,"48",80,0.2996,0.254,0.2807
"8484",199120,1999,"3388",2099,1289,2389,"797",1592,0.7585,0.6183,0.7051
"8485",199139,1999,"2078",1111,967,489,"181",308,0.2772,0.1872,0.2353
"8486",199148,1999,"1908",1346,562,540,"107",433,0.3217,0.1904,0.283
"8487",199157,1999,"625",345,280,143,"31",112,0.3246,0.1107,0.2288
"8488",199193,1999,"3636",1499,2137,1253,"559",694,0.463,0.2616,0.3446
"8489",199218,1999,"1649",1011,638,672,"213",459,0.454,0.3339,0.4075
"8490",199281,1999,"475",241,234,89,"33",56,0.2324,0.141,0.1874
"8491",199306,1999,"159",80,79,52,"15",37,0.4625,0.1899,0.327
"8492",199412,1999,"123",85,38,67,"15",52,0.6118,0.3947,0.5447
"8493",199582,1999,"331",173,158,57,"16",41,0.237,0.1013,0.1722
"8494",199643,1999,"440",258,182,61,"21",40,0.155,0.1154,0.1386
"8495",199847,1999,"969",498,471,760,"327",433,0.8695,0.6943,0.7843
"8496",199962,1999,"301",144,157,102,"32",70,0.4861,0.2038,0.3389
"8497",199999,1999,"476",316,160,103,"19",84,0.2658,0.1187,0.2164
"8498",200004,1999,"1151",569,582,261,"103",158,0.2777,0.177,0.2268
"8499",200059,1999,"359",179,180,39,"15",24,0.1341,0.0833,0.1086
"8500",200156,1999,"284",165,119,84,"31",53,0.3212,0.2605,0.2958
"8501",200217,1999,"373",242,131,155,"42",113,0.4669,0.3206,0.4155
"8502",200226,1999,"140",71,69,41,"15",26,0.3662,0.2174,0.2929
"8503",200253,1999,"433",251,182,40,"11",29,0.1155,0.0604,0.0924
"8504",200280,1999,"1742",846,896,394,"179",215,0.2541,0.1998,0.2262
"8505",200332,1999,"1268",514,754,240,"111",129,0.251,0.1472,0.1893
"8506",200572,1999,"158",76,82,35,"8",27,0.3553,0.0976,0.2215
"8507",201104,1999,"541",313,228,246,"80",166,0.5304,0.3509,0.4547
"8508",201371,1999,"248",156,92,114,"32",82,0.5256,0.3478,0.4597
"8509",201548,1999,"532",301,231,255,"101",154,0.5116,0.4372,0.4793
"8510",201645,1999,"762",292,470,432,"245",187,0.6404,0.5213,0.5669
"8511",201690,1999,"294",164,130,46,"12",34,0.2073,0.0923,0.1565
"8512",202134,1999,"1048",494,554,114,"50",64,0.1296,0.0903,0.1088
"8513",202480,1999,"1744",921,823,1041,"412",629,0.683,0.5006,0.5969
"8514",202523,1999,"587",335,252,444,"171",273,0.8149,0.6786,0.7564
"8515",202763,1999,"522",337,185,212,"52",160,0.4748,0.2811,0.4061
"8516",203085,1999,"259",98,161,124,"61",63,0.6429,0.3789,0.4788
"8517",203128,1999,"279",143,136,153,"64",89,0.6224,0.4706,0.5484
"8518",203368,1999,"833",451,382,539,"204",335,0.7428,0.534,0.6471
"8519",203517,1999,"3476",2160,1316,668,"187",481,0.2227,0.1421,0.1922
"8520",203535,1999,"459",255,204,367,"166",201,0.7882,0.8137,0.7996
"8521",203580,1999,"103",70,33,36,"8",28,0.4,0.2424,0.3495
"8522",203775,1999,"406",248,158,160,"47",113,0.4556,0.2975,0.3941
"8523",203845,1999,"302",136,166,149,"70",79,0.5809,0.4217,0.4934
"8524",204024,1999,"3588",2030,1558,2351,"922",1429,0.7039,0.5918,0.6552
"8525",204185,1999,"601",323,278,292,"86",206,0.6378,0.3094,0.4859
"8526",204194,1999,"393",231,162,145,"49",96,0.4156,0.3025,0.369
"8527",204617,1999,"186",120,66,68,"16",52,0.4333,0.2424,0.3656
"8528",204796,1999,"6067",3029,3038,2120,"777",1343,0.4434,0.2558,0.3494
"8529",204857,1999,"3389",1977,1412,1553,"490",1063,0.5377,0.347,0.4582
"8530",206330,1999,"121",40,81,45,"20",25,0.625,0.2469,0.3719
"8531",206589,1999,"513",265,248,372,"164",208,0.7849,0.6613,0.7251
"8532",206604,1999,"2127",1202,925,352,"99",253,0.2105,0.107,0.1655
"8533",206622,1999,"771",464,307,540,"213",327,0.7047,0.6938,0.7004
"8534",206695,1999,"1911",954,957,241,"89",152,0.1593,0.093,0.1261
"8535",206914,1999,"673",355,318,54,"16",38,0.107,0.0503,0.0802
"8536",207209,1999,"446",232,214,17,"4",13,0.056,0.0187,0.0381
"8537",207306,1999,"310",138,172,36,"16",20,0.1449,0.093,0.1161
"8538",207324,1999,"391",219,172,123,"44",79,0.3607,0.2558,0.3146
"8539",207388,1999,"2795",1491,1304,705,"206",499,0.3347,0.158,0.2522
"8540",207500,1999,"3206",1603,1603,619,"237",382,0.2383,0.1478,0.1931
"8541",207722,1999,"229",133,96,32,"12",20,0.1504,0.125,0.1397
"8542",207847,1999,"572",307,265,67,"26",41,0.1336,0.0981,0.1171
"8543",207865,1999,"779",448,331,116,"35",81,0.1808,0.1057,0.1489
"8544",208822,1999,"282",163,119,145,"48",97,0.5951,0.4034,0.5142
"8545",209056,1999,"510",307,203,330,"127",203,0.6612,0.6256,0.6471
"8546",209065,1999,"397",227,170,227,"74",153,0.674,0.4353,0.5718
"8547",209542,1999,"2772",1319,1453,847,"333",514,0.3897,0.2292,0.3056
"8548",209551,1999,"2453",1393,1060,931,"314",617,0.4429,0.2962,0.3795
"8549",209612,1999,"292",175,117,164,"70",94,0.5371,0.5983,0.5616
"8550",209807,1999,"896",496,400,118,"39",79,0.1593,0.0975,0.1317
"8551",209922,1999,"331",182,149,172,"78",94,0.5165,0.5235,0.5196
"8552",210146,1999,"754",431,323,136,"46",90,0.2088,0.1424,0.1804
"8553",210401,1999,"363",190,173,242,"100",142,0.7474,0.578,0.6667
"8554",210429,1999,"770",460,310,141,"45",96,0.2087,0.1452,0.1831
"8555",210571,1999,"392",242,150,203,"61",142,0.5868,0.4067,0.5179
"8556",210669,1999,"562",284,278,374,"167",207,0.7289,0.6007,0.6655
"8557",210775,1999,"204",101,103,79,"34",45,0.4455,0.3301,0.3873
"8558",211088,1999,"307",238,69,154,"28",126,0.5294,0.4058,0.5016
"8559",211158,1999,"1402",891,511,527,"164",363,0.4074,0.3209,0.3759
"8560",211291,1999,"886",425,461,764,"396",368,0.8659,0.859,0.8623
"8561",211352,1999,"248",163,85,124,"30",94,0.5767,0.3529,0.5
"8562",211361,1999,"924",484,440,162,"48",114,0.2355,0.1091,0.1753
"8563",211431,1999,"130",128,2,47,"0",47,0.3672,0,0.3615
"8564",211440,1999,"1255",487,768,833,"491",342,0.7023,0.6393,0.6637
"8565",211468,1999,"218",218,0,115,"0",115,0.5275,NA,0.5275
"8566",211556,1999,"126",126,0,62,"0",62,0.4921,NA,0.4921
"8567",211583,1999,"102",101,1,45,"1",44,0.4356,1,0.4412
"8568",211608,1999,"254",152,102,37,"9",28,0.1842,0.0882,0.1457
"8569",211644,1999,"1286",806,480,295,"80",215,0.2667,0.1667,0.2294
"8570",211981,1999,"327",172,155,109,"41",68,0.3953,0.2645,0.3333
"8571",212009,1999,"620",399,221,505,"178",327,0.8195,0.8054,0.8145
"8572",212054,1999,"1898",725,1173,269,"94",175,0.2414,0.0801,0.1417
"8573",212106,1999,"1211",686,525,590,"216",374,0.5452,0.4114,0.4872
"8574",212115,1999,"843",522,321,163,"42",121,0.2318,0.1308,0.1934
"8575",212133,1999,"379",274,105,190,"41",149,0.5438,0.3905,0.5013
"8576",212160,1999,"1256",749,507,227,"48",179,0.239,0.0947,0.1807
"8577",212197,1999,"477",298,179,277,"102",175,0.5872,0.5698,0.5807
"8578",212577,1999,"515",253,262,387,"181",206,0.8142,0.6908,0.7515
"8579",212601,1999,"503",314,189,246,"67",179,0.5701,0.3545,0.4891
"8580",212832,1999,"146",114,32,56,"13",43,0.3772,0.4062,0.3836
"8581",212911,1999,"301",160,141,244,"113",131,0.8188,0.8014,0.8106
"8582",213020,1999,"2552",1468,1084,561,"165",396,0.2698,0.1522,0.2198
"8583",213251,1999,"324",184,140,217,"81",136,0.7391,0.5786,0.6698
"8584",213321,1999,"420",218,202,268,"112",156,0.7156,0.5545,0.6381
"8585",213349,1999,"1550",922,628,374,"89",285,0.3091,0.1417,0.2413
"8586",213358,1999,"306",170,136,133,"58",75,0.4412,0.4265,0.4346
"8587",213367,1999,"801",426,375,446,"188",258,0.6056,0.5013,0.5568
"8588",213385,1999,"583",316,267,505,"218",287,0.9082,0.8165,0.8662
"8589",213507,1999,"407",238,169,279,"102",177,0.7437,0.6036,0.6855
"8590",213543,1999,"1077",455,622,799,"437",362,0.7956,0.7026,0.7419
"8591",213613,1999,"887",502,385,212,"65",147,0.2928,0.1688,0.239
"8592",213668,1999,"392",209,183,242,"99",143,0.6842,0.541,0.6173
"8593",213783,1999,"611",364,247,178,"53",125,0.3434,0.2146,0.2913
"8594",213826,1999,"282",207,75,118,"25",93,0.4493,0.3333,0.4184
"8595",213996,1999,"678",413,265,468,"168",300,0.7264,0.634,0.6903
"8596",214041,1999,"1239",746,493,424,"134",290,0.3887,0.2718,0.3422
"8597",214069,1999,"249",173,76,165,"42",123,0.711,0.5526,0.6627
"8598",214157,1999,"318",162,156,213,"102",111,0.6852,0.6538,0.6698
"8599",214175,1999,"551",321,230,446,"179",267,0.8318,0.7783,0.8094
"8600",214272,1999,"324",179,145,108,"38",70,0.3911,0.2621,0.3333
"8601",214777,1999,"5058",2535,2523,2738,"1142",1596,0.6296,0.4526,0.5413
"8602",215062,1999,"2402",1155,1247,2079,"1056",1023,0.8857,0.8468,0.8655
"8603",215743,1999,"333",215,118,147,"34",113,0.5256,0.2881,0.4414
"8604",215798,1999,"272",138,134,162,"74",88,0.6377,0.5522,0.5956
"8605",215929,1999,"958",550,408,675,"268",407,0.74,0.6569,0.7046
"8606",216010,1999,"1377",734,643,574,"231",343,0.4673,0.3593,0.4168
"8607",216038,1999,"1302",742,560,334,"103",231,0.3113,0.1839,0.2565
"8608",216287,1999,"368",192,176,315,"142",173,0.901,0.8068,0.856
"8609",216339,1999,"2747",1628,1119,721,"228",493,0.3028,0.2038,0.2625
"8610",216524,1999,"337",173,164,241,"106",135,0.7803,0.6463,0.7151
"8611",216694,1999,"277",126,151,121,"64",57,0.4524,0.4238,0.4368
"8612",216764,1999,"1710",1069,641,444,"122",322,0.3012,0.1903,0.2596
"8613",216807,1999,"351",224,127,228,"69",159,0.7098,0.5433,0.6496
"8614",216852,1999,"548",250,298,213,"100",113,0.452,0.3356,0.3887
"8615",216931,1999,"377",161,216,166,"88",78,0.4845,0.4074,0.4403
"8616",217059,1999,"909",511,398,372,"122",250,0.4892,0.3065,0.4092
"8617",217156,1999,"1376",729,647,1146,"539",607,0.8326,0.8331,0.8328
"8618",217402,1999,"973",556,417,838,"351",487,0.8759,0.8417,0.8613
"8619",217536,1999,"528",352,176,277,"69",208,0.5909,0.392,0.5246
"8620",217776,1999,"99",47,52,35,"12",23,0.4894,0.2308,0.3535
"8621",217819,1999,"2067",1399,668,850,"206",644,0.4603,0.3084,0.4112
"8622",217882,1999,"2886",1354,1532,1267,"490",777,0.5739,0.3198,0.439
"8623",217998,1999,"156",91,65,100,"33",67,0.7363,0.5077,0.641
"8624",218061,1999,"570",332,238,104,"27",77,0.2319,0.1134,0.1825
"8625",218229,1999,"494",313,181,107,"22",85,0.2716,0.1215,0.2166
"8626",218238,1999,"136",58,78,27,"13",14,0.2414,0.1667,0.1985
"8627",218399,1999,"263",173,90,53,"10",43,0.2486,0.1111,0.2015
"8628",218414,1999,"179",70,109,59,"18",41,0.5857,0.1651,0.3296
"8629",218663,1999,"2596",1511,1085,1073,"367",706,0.4672,0.3382,0.4133
"8630",218724,1999,"757",405,352,161,"60",101,0.2494,0.1705,0.2127
"8631",218733,1999,"680",351,329,143,"37",106,0.302,0.1125,0.2103
"8632",218742,1999,"540",334,206,87,"24",63,0.1886,0.1165,0.1611
"8633",218973,1999,"307",154,153,226,"112",114,0.7403,0.732,0.7362
"8634",219000,1999,"469",314,155,231,"65",166,0.5287,0.4194,0.4925
"8635",219046,1999,"630",360,270,71,"17",54,0.15,0.063,0.1127
"8636",219082,1999,"306",124,182,45,"21",24,0.1935,0.1154,0.1471
"8637",219198,1999,"121",84,37,34,"8",26,0.3095,0.2162,0.281
"8638",219259,1999,"523",303,220,69,"15",54,0.1782,0.0682,0.1319
"8639",219356,1999,"1457",714,743,342,"127",215,0.3011,0.1709,0.2347
"8640",219471,1999,"868",493,375,176,"53",123,0.2495,0.1413,0.2028
"8641",219602,1999,"715",432,283,66,"22",44,0.1019,0.0777,0.0923
"8642",219709,1999,"487",300,187,266,"91",175,0.5833,0.4866,0.5462
"8643",219718,1999,"142",42,100,17,"10",7,0.1667,0.1,0.1197
"8644",219949,1999,"174",67,107,36,"19",17,0.2537,0.1776,0.2069
"8645",220075,1999,"1466",821,645,217,"62",155,0.1888,0.0961,0.148
"8646",220215,1999,"322",187,135,125,"59",66,0.3529,0.437,0.3882
"8647",220613,1999,"690",400,290,213,"80",133,0.3325,0.2759,0.3087
"8648",220631,1999,"113",80,33,35,"9",26,0.325,0.2727,0.3097
"8649",220710,1999,"313",174,139,141,"50",91,0.523,0.3597,0.4505
"8650",221351,1999,"438",251,187,338,"143",195,0.7769,0.7647,0.7717
"8651",221519,1999,"391",227,164,308,"123",185,0.815,0.75,0.7877
"8652",221731,1999,"140",93,47,22,"3",19,0.2043,0.0638,0.1571
"8653",221847,1999,"1175",524,651,67,"63",4,0.0076,0.0968,0.057
"8654",221892,1999,"192",119,73,43,"14",29,0.2437,0.1918,0.224
"8655",222178,1999,"924",533,391,335,"120",215,0.4034,0.3069,0.3626
"8656",222983,1999,"324",188,136,222,"74",148,0.7872,0.5441,0.6852
"8657",223232,1999,"2766",1668,1098,1272,"379",893,0.5354,0.3452,0.4599
"8658",224004,1999,"134",66,68,15,"10",5,0.0758,0.1471,0.1119
"8659",224323,1999,"309",191,118,188,"67",121,0.6335,0.5678,0.6084
"8660",225432,1999,"729",418,311,10,"3",7,0.0167,0.0096,0.0137
"8661",225548,1999,"286",137,149,10,"3",7,0.0511,0.0201,0.035
"8662",225627,1999,"380",253,127,51,"9",42,0.166,0.0709,0.1342
"8663",226231,1999,"259",58,201,75,"52",23,0.3966,0.2587,0.2896
"8664",226833,1999,"732",409,323,67,"21",46,0.1125,0.065,0.0915
"8665",227216,1999,"2687",1550,1137,410,"111",299,0.1929,0.0976,0.1526
"8666",227331,1999,"308",241,67,44,"10",34,0.1411,0.1493,0.1429
"8667",227526,1999,"967",504,463,113,"33",80,0.1587,0.0713,0.1169
"8668",227757,1999,"670",325,345,512,"251",261,0.8031,0.7275,0.7642
"8669",227845,1999,"357",184,173,101,"35",66,0.3587,0.2023,0.2829
"8670",227863,1999,"215",128,87,50,"16",34,0.2656,0.1839,0.2326
"8671",228042,1999,"225",148,77,44,"7",37,0.25,0.0909,0.1956
"8672",228149,1999,"485",277,208,165,"54",111,0.4007,0.2596,0.3402
"8673",228246,1999,"1331",688,643,656,"262",394,0.5727,0.4075,0.4929
"8674",228343,1999,"354",210,144,236,"83",153,0.7286,0.5764,0.6667
"8675",228431,1999,"2255",1353,902,339,"92",247,0.1826,0.102,0.1503
"8676",228459,1999,"2447",1479,968,504,"130",374,0.2529,0.1343,0.206
"8677",228501,1999,"227",95,132,25,"11",14,0.1474,0.0833,0.1101
"8678",228529,1999,"585",303,282,109,"45",64,0.2112,0.1596,0.1863
"8679",228705,1999,"736",293,443,53,"24",29,0.099,0.0542,0.072
"8680",228723,1999,"6659",3419,3240,2359,"722",1637,0.4788,0.2228,0.3543
"8681",228769,1999,"1402",714,688,214,"95",119,0.1667,0.1381,0.1526
"8682",228778,1999,"6925",3508,3417,2888,"1186",1702,0.4852,0.3471,0.417
"8683",228787,1999,"603",242,361,180,"88",92,0.3802,0.2438,0.2985
"8684",228796,1999,"1662",874,788,79,"22",57,0.0652,0.0279,0.0475
"8685",228875,1999,"1427",869,558,678,"208",470,0.5409,0.3728,0.4751
"8686",228981,1999,"383",170,213,112,"45",67,0.3941,0.2113,0.2924
"8687",229018,1999,"97",65,32,15,"5",10,0.1538,0.1562,0.1546
"8688",229027,1999,"1665",882,783,105,"32",73,0.0828,0.0409,0.0631
"8689",229115,1999,"3403",1725,1678,785,"248",537,0.3113,0.1478,0.2307
"8690",229780,1999,"210",108,102,39,"15",24,0.2222,0.1471,0.1857
"8691",229814,1999,"986",506,480,126,"34",92,0.1818,0.0708,0.1278
"8692",230603,1999,"629",456,173,103,"9",94,0.2061,0.052,0.1638
"8693",230728,1999,"1521",1047,474,320,"67",253,0.2416,0.1414,0.2104
"8694",230764,1999,"1921",921,1000,295,"109",186,0.202,0.109,0.1536
"8695",230782,1999,"1619",1001,618,158,"47",111,0.1109,0.0761,0.0976
"8696",231059,1999,"501",269,232,342,"145",197,0.7323,0.625,0.6826
"8697",231174,1999,"1808",984,824,875,"351",524,0.5325,0.426,0.484
"8698",231420,1999,"204",123,81,72,"22",50,0.4065,0.2716,0.3529
"8699",231554,1999,"144",79,65,43,"18",25,0.3165,0.2769,0.2986
"8700",231624,1999,"1298",736,562,1052,"418",634,0.8614,0.7438,0.8105
"8701",231712,1999,"808",485,323,148,"44",104,0.2144,0.1362,0.1832
"8702",232025,1999,"271",129,142,117,"50",67,0.5194,0.3521,0.4317
"8703",232043,1999,"218",131,87,111,"36",75,0.5725,0.4138,0.5092
"8704",232089,1999,"309",104,205,56,"26",30,0.2885,0.1268,0.1812
"8705",232186,1999,"2030",1129,901,534,"161",373,0.3304,0.1787,0.2631
"8706",232265,1999,"1190",728,462,422,"102",320,0.4396,0.2208,0.3546
"8707",232423,1999,"3040",1855,1185,1887,"610",1277,0.6884,0.5148,0.6207
"8708",232557,1999,"1074",557,517,268,"103",165,0.2962,0.1992,0.2495
"8709",232566,1999,"815",534,281,391,"101",290,0.5431,0.3594,0.4798
"8710",232609,1999,"473",277,196,222,"73",149,0.5379,0.3724,0.4693
"8711",232681,1999,"834",619,215,583,"142",441,0.7124,0.6605,0.699
"8712",232706,1999,"302",220,82,116,"26",90,0.4091,0.3171,0.3841
"8713",232937,1999,"1111",687,424,118,"27",91,0.1325,0.0637,0.1062
"8714",232982,1999,"1500",833,667,327,"103",224,0.2689,0.1544,0.218
"8715",233277,1999,"1655",1075,580,610,"164",446,0.4149,0.2828,0.3686
"8716",233374,1999,"854",465,389,647,"273",374,0.8043,0.7018,0.7576
"8717",233426,1999,"450",274,176,257,"88",169,0.6168,0.5,0.5711
"8718",233541,1999,"292",163,129,87,"36",51,0.3129,0.2791,0.2979
"8719",233897,1999,"299",151,148,76,"36",40,0.2649,0.2432,0.2542
"8720",233921,1999,"4653",1957,2696,2177,"996",1181,0.6035,0.3694,0.4679
"8721",234030,1999,"2408",1427,981,499,"164",335,0.2348,0.1672,0.2072
"8722",234085,1999,"369",24,345,194,"180",14,0.5833,0.5217,0.5257
"8723",234155,1999,"937",543,394,185,"48",137,0.2523,0.1218,0.1974
"8724",234164,1999,"268",167,101,50,"8",42,0.2515,0.0792,0.1866
"8725",235097,1999,"1072",652,420,164,"45",119,0.1825,0.1071,0.153
"8726",235167,1999,"456",256,200,190,"69",121,0.4727,0.345,0.4167
"8727",236230,1999,"562",370,192,241,"77",164,0.4432,0.401,0.4288
"8728",236328,1999,"682",413,269,443,"170",273,0.661,0.632,0.6496
"8729",236577,1999,"567",392,175,272,"79",193,0.4923,0.4514,0.4797
"8730",236595,1999,"578",351,227,256,"92",164,0.4672,0.4053,0.4429
"8731",236896,1999,"323",158,165,64,"28",36,0.2278,0.1697,0.1981
"8732",236939,1999,"2456",1276,1180,791,"306",485,0.3801,0.2593,0.3221
"8733",236948,1999,"4319",2279,2040,1977,"790",1187,0.5208,0.3873,0.4577
"8734",237011,1999,"2074",1264,810,623,"172",451,0.3568,0.2123,0.3004
"8735",237057,1999,"361",209,152,294,"120",174,0.8325,0.7895,0.8144
"8736",237066,1999,"406",266,140,233,"74",159,0.5977,0.5286,0.5739
"8737",237215,1999,"370",225,145,8,"3",5,0.0222,0.0207,0.0216
"8738",237330,1999,"612",317,295,92,"37",55,0.1735,0.1254,0.1503
"8739",237358,1999,"129",72,57,34,"15",19,0.2639,0.2632,0.2636
"8740",237367,1999,"534",286,248,77,"28",49,0.1713,0.1129,0.1442
"8741",237792,1999,"674",367,307,91,"25",66,0.1798,0.0814,0.135
"8742",237899,1999,"555",260,295,31,"13",18,0.0692,0.0441,0.0559
"8743",237932,1999,"494",245,249,96,"31",65,0.2653,0.1245,0.1943
"8744",237969,1999,"472",261,211,211,"89",122,0.4674,0.4218,0.447
"8745",238032,1999,"3523",1641,1882,885,"363",522,0.3181,0.1929,0.2512
"8746",238333,1999,"303",173,130,196,"75",121,0.6994,0.5769,0.6469
"8747",238430,1999,"203",132,71,28,"10",18,0.1364,0.1408,0.1379
"8748",238458,1999,"482",327,155,219,"63",156,0.4771,0.4065,0.4544
"8749",238476,1999,"427",216,211,190,"78",112,0.5185,0.3697,0.445
"8750",238616,1999,"321",197,124,104,"38",66,0.335,0.3065,0.324
"8751",238661,1999,"196",132,64,49,"9",40,0.303,0.1406,0.25
"8752",239080,1999,"224",156,68,71,"17",54,0.3462,0.25,0.317
"8753",239105,1999,"1715",963,752,1064,"414",650,0.675,0.5505,0.6204
"8754",239628,1999,"283",156,127,174,"73",101,0.6474,0.5748,0.6148
"8755",239716,1999,"519",296,223,332,"136",196,0.6622,0.6099,0.6397
"8756",240107,1999,"311",235,76,111,"22",89,0.3787,0.2895,0.3569
"8757",240189,1999,"1877",1017,860,357,"119",238,0.234,0.1384,0.1902
"8758",240277,1999,"879",578,301,164,"45",119,0.2059,0.1495,0.1866
"8759",240329,1999,"1631",1035,596,395,"128",267,0.258,0.2148,0.2422
"8760",240338,1999,"161",92,69,79,"23",56,0.6087,0.3333,0.4907
"8761",240365,1999,"1834",1084,750,284,"85",199,0.1836,0.1133,0.1549
"8762",240374,1999,"811",419,392,78,"30",48,0.1146,0.0765,0.0962
"8763",240417,1999,"1317",661,656,185,"57",128,0.1936,0.0869,0.1405
"8764",240426,1999,"406",241,165,38,"6",32,0.1328,0.0364,0.0936
"8765",240444,1999,"5520",2985,2535,2263,"847",1416,0.4744,0.3341,0.41
"8766",240453,1999,"2694",1523,1171,356,"127",229,0.1504,0.1085,0.1321
"8767",240462,1999,"1093",377,716,148,"61",87,0.2308,0.0852,0.1354
"8768",240471,1999,"1104",684,420,277,"95",182,0.2661,0.2262,0.2509
"8769",240480,1999,"1490",849,641,285,"99",186,0.2191,0.1544,0.1913
"8770",240727,1999,"1194",654,540,352,"124",228,0.3486,0.2296,0.2948
"8771",243443,1999,"799",506,293,63,"13",50,0.0988,0.0444,0.0788
"8772",243780,1999,"6895",2945,3950,2083,"974",1109,0.3766,0.2466,0.3021
"8773",100654,1998,"995",518,477,182,"38",144,0.278,0.0797,0.1829
"8774",100663,1998,"1076",646,430,164,"48",116,0.1796,0.1116,0.1524
"8775",100751,1998,"2597",1437,1160,857,"269",588,0.4092,0.2319,0.33
"8776",100858,1998,"3654",1913,1741,1229,"415",814,0.4255,0.2384,0.3363
"8777",101435,1998,"175",96,79,88,"31",57,0.5938,0.3924,0.5029
"8778",101480,1998,"752",392,360,112,"34",78,0.199,0.0944,0.1489
"8779",101675,1998,"340",177,163,133,"51",82,0.4633,0.3129,0.3912
"8780",101879,1998,"828",490,338,118,"28",90,0.1837,0.0828,0.1425
"8781",102049,1998,"625",390,235,316,"110",206,0.5282,0.4681,0.5056
"8782",102094,1998,"1044",618,426,143,"36",107,0.1731,0.0845,0.137
"8783",102234,1998,"242",119,123,120,"61",59,0.4958,0.4959,0.4959
"8784",102368,1998,"768",437,331,251,"75",176,0.4027,0.2266,0.3268
"8785",102377,1998,"683",412,271,154,"37",117,0.284,0.1365,0.2255
"8786",104151,1998,"4753",2561,2192,1270,"480",790,0.3085,0.219,0.2672
"8787",104179,1998,"5088",2773,2315,1595,"590",1005,0.3624,0.2549,0.3135
"8788",105330,1998,"2073",1188,885,554,"176",378,0.3182,0.1989,0.2672
"8789",106245,1998,"865",539,326,93,"22",71,0.1317,0.0675,0.1075
"8790",106342,1998,"107",65,42,56,"21",35,0.5385,0.5,0.5234
"8791",106397,1998,"2456",1245,1211,665,"246",419,0.3365,0.2031,0.2708
"8792",106412,1998,"721",372,349,70,"22",48,0.129,0.063,0.0971
"8793",106458,1998,"1705",928,777,270,"68",202,0.2177,0.0875,0.1584
"8794",106467,1998,"821",401,420,105,"41",64,0.1596,0.0976,0.1279
"8795",106485,1998,"558",292,266,52,"18",34,0.1164,0.0677,0.0932
"8796",106704,1998,"1575",944,631,249,"58",191,0.2023,0.0919,0.1581
"8797",107044,1998,"908",535,373,285,"101",184,0.3439,0.2708,0.3139
"8798",107080,1998,"320",166,154,196,"89",107,0.6446,0.5779,0.6125
"8799",107141,1998,"250",138,112,112,"44",68,0.4928,0.3929,0.448
"8800",107512,1998,"362",220,142,120,"36",84,0.3818,0.2535,0.3315
"8801",107558,1998,"137",69,68,43,"18",25,0.3623,0.2647,0.3139
"8802",110097,1998,"469",313,156,227,"75",152,0.4856,0.4808,0.484
"8803",110404,1998,"254",79,175,195,"136",59,0.7468,0.7771,0.7677
"8804",110422,1998,"2260",945,1315,367,"136",231,0.2444,0.1034,0.1624
"8805",110486,1998,"471",298,173,54,"9",45,0.151,0.052,0.1146
"8806",110495,1998,"444",297,147,84,"16",68,0.229,0.1088,0.1892
"8807",110510,1998,"1068",680,388,124,"39",85,0.125,0.1005,0.1161
"8808",110529,1998,"2033",855,1178,191,"80",111,0.1298,0.0679,0.0939
"8809",110538,1998,"1850",1069,781,299,"65",234,0.2189,0.0832,0.1616
"8810",110547,1998,"465",330,135,21,"3",18,0.0545,0.0222,0.0452
"8811",110556,1998,"1566",933,633,215,"44",171,0.1833,0.0695,0.1373
"8812",110565,1998,"2146",1240,906,274,"65",209,0.1685,0.0717,0.1277
"8813",110574,1998,"732",470,262,106,"24",82,0.1745,0.0916,0.1448
"8814",110583,1998,"2652",1707,945,285,"61",224,0.1312,0.0646,0.1075
"8815",110592,1998,"1255",789,466,103,"22",81,0.1027,0.0472,0.0821
"8816",110617,1998,"1467",828,639,136,"30",106,0.128,0.0469,0.0927
"8817",113698,1998,"72",58,14,30,"6",24,0.4138,0.4286,0.4167
"8818",115755,1998,"731",405,326,71,"24",47,0.116,0.0736,0.0971
"8819",119173,1998,"295",293,2,62,"0",62,0.2116,0,0.2102
"8820",120184,1998,"130",80,50,52,"14",38,0.475,0.28,0.4
"8821",121309,1998,"598",375,223,261,"87",174,0.464,0.3901,0.4365
"8822",121345,1998,"396",182,214,321,"168",153,0.8407,0.785,0.8106
"8823",122409,1998,"3128",1815,1313,308,"79",229,0.1262,0.0602,0.0985
"8824",122436,1998,"1028",614,414,610,"222",388,0.6319,0.5362,0.5934
"8825",122597,1998,"1805",1143,662,134,"23",111,0.0971,0.0347,0.0742
"8826",122612,1998,"640",436,204,296,"80",216,0.4954,0.3922,0.4625
"8827",122931,1998,"1032",570,462,783,"331",452,0.793,0.7165,0.7587
"8828",123554,1998,"573",343,230,352,"125",227,0.6618,0.5435,0.6143
"8829",123572,1998,"823",557,266,177,"37",140,0.2513,0.1391,0.2151
"8830",126562,1998,"394",223,171,58,"17",41,0.1839,0.0994,0.1472
"8831",126580,1998,"635",372,263,154,"53",101,0.2715,0.2015,0.2425
"8832",126614,1998,"4263",2037,2226,1545,"647",898,0.4408,0.2907,0.3624
"8833",126818,1998,"3028",1772,1256,1028,"301",727,0.4103,0.2396,0.3395
"8834",127060,1998,"768",393,375,414,"185",229,0.5827,0.4933,0.5391
"8835",127185,1998,"970",405,565,108,"46",62,0.1531,0.0814,0.1113
"8836",127565,1998,"1382",759,623,81,"29",52,0.0685,0.0465,0.0586
"8837",127741,1998,"2165",1314,851,515,"123",392,0.2983,0.1445,0.2379
"8838",128106,1998,"611",345,266,80,"30",50,0.1449,0.1128,0.1309
"8839",128744,1998,"233",94,139,80,"48",32,0.3404,0.3453,0.3433
"8840",128771,1998,"1317",675,642,163,"46",117,0.1733,0.0717,0.1238
"8841",129020,1998,"2536",1358,1178,1135,"431",704,0.5184,0.3659,0.4476
"8842",129242,1998,"875",478,397,679,"299",380,0.795,0.7531,0.776
"8843",129941,1998,"370",141,229,95,"51",44,0.3121,0.2227,0.2568
"8844",130253,1998,"702",409,293,308,"112",196,0.4792,0.3823,0.4387
"8845",130314,1998,"142",142,0,66,"0",66,0.4648,NA,0.4648
"8846",130493,1998,"1077",647,430,140,"24",116,0.1793,0.0558,0.13
"8847",130590,1998,"509",263,246,390,"176",214,0.8137,0.7154,0.7662
"8848",130697,1998,"716",382,334,593,"264",329,0.8613,0.7904,0.8282
"8849",130776,1998,"655",315,340,91,"33",58,0.1841,0.0971,0.1389
"8850",130794,1998,"1295",646,649,1146,"573",573,0.887,0.8829,0.8849
"8851",130934,1998,"578",339,239,118,"39",79,0.233,0.1632,0.2042
"8852",130943,1998,"3545",2149,1396,2078,"696",1382,0.6431,0.4986,0.5862
"8853",131159,1998,"1232",774,458,802,"262",540,0.6977,0.5721,0.651
"8854",131283,1998,"597",338,259,378,"149",229,0.6775,0.5753,0.6332
"8855",131450,1998,"230",112,118,17,"7",10,0.0893,0.0593,0.0739
"8856",131469,1998,"1773",1057,716,1285,"471",814,0.7701,0.6578,0.7248
"8857",131496,1998,"1470",810,660,1302,"581",721,0.8901,0.8803,0.8857
"8858",131520,1998,"1244",831,413,469,"103",366,0.4404,0.2494,0.377
"8859",132471,1998,"393",249,144,82,"20",62,0.249,0.1389,0.2087
"8860",132602,1998,"623",316,307,97,"24",73,0.231,0.0782,0.1557
"8861",132903,1998,"3792",1932,1860,1097,"387",710,0.3675,0.2081,0.2893
"8862",133492,1998,"407",227,180,234,"99",135,0.5947,0.55,0.5749
"8863",133553,1998,"934",128,806,279,"230",49,0.3828,0.2854,0.2987
"8864",133650,1998,"2213",1294,919,385,"120",265,0.2048,0.1306,0.174
"8865",133669,1998,"1309",773,536,196,"56",140,0.1811,0.1045,0.1497
"8866",133711,1998,"418",285,133,182,"58",124,0.4351,0.4361,0.4354
"8867",133881,1998,"461",145,316,173,"108",65,0.4483,0.3418,0.3753
"8868",133951,1998,"2227",1298,929,430,"117",313,0.2411,0.1259,0.1931
"8869",134079,1998,"440",286,154,199,"55",144,0.5035,0.3571,0.4523
"8870",134097,1998,"5066",2932,2134,2143,"705",1438,0.4905,0.3304,0.423
"8871",134130,1998,"5629",3171,2458,2886,"1037",1849,0.5831,0.4219,0.5127
"8872",134945,1998,"307",112,195,75,"40",35,0.3125,0.2051,0.2443
"8873",135726,1998,"1831",980,851,975,"389",586,0.598,0.4571,0.5325
"8874",136172,1998,"1371",842,529,353,"105",248,0.2945,0.1985,0.2575
"8875",136950,1998,"458",278,180,232,"80",152,0.5468,0.4444,0.5066
"8876",137546,1998,"539",311,228,279,"113",166,0.5338,0.4956,0.5176
"8877",138354,1998,"647",365,282,136,"40",96,0.263,0.1418,0.2102
"8878",138716,1998,"493",313,180,30,"10",20,0.0639,0.0556,0.0609
"8879",138789,1998,"550",378,172,26,"8",18,0.0476,0.0465,0.0473
"8880",139144,1998,"525",336,189,297,"106",191,0.5685,0.5608,0.5657
"8881",139366,1998,"723",450,273,63,"17",46,0.1022,0.0623,0.0871
"8882",139393,1998,"211",134,77,112,"36",76,0.5672,0.4675,0.5308
"8883",139658,1998,"1692",908,784,1227,"548",679,0.7478,0.699,0.7252
"8884",139719,1998,"432",240,192,40,"11",29,0.1208,0.0573,0.0926
"8885",139755,1998,"2487",721,1766,644,"371",273,0.3786,0.2101,0.2589
"8886",139764,1998,"335",215,120,41,"5",36,0.1674,0.0417,0.1224
"8887",139861,1998,"750",470,280,127,"22",105,0.2234,0.0786,0.1693
"8888",139931,1998,"2897",1549,1348,335,"87",248,0.1601,0.0645,0.1156
"8889",139940,1998,"1491",924,567,208,"63",145,0.1569,0.1111,0.1395
"8890",139959,1998,"4384",2588,1796,1771,"535",1236,0.4776,0.2979,0.404
"8891",140447,1998,"706",428,278,221,"74",147,0.3435,0.2662,0.313
"8892",140960,1998,"321",179,142,23,"5",18,0.1006,0.0352,0.0717
"8893",140988,1998,"247",167,80,86,"22",64,0.3832,0.275,0.3482
"8894",141185,1998,"229",141,88,76,"24",52,0.3688,0.2727,0.3319
"8895",141264,1998,"1301",755,546,158,"44",114,0.151,0.0806,0.1214
"8896",141334,1998,"1670",1042,628,166,"34",132,0.1267,0.0541,0.0994
"8897",141486,1998,"186",122,64,40,"12",28,0.2295,0.1875,0.2151
"8898",141565,1998,"351",194,157,24,"11",13,0.067,0.0701,0.0684
"8899",141574,1998,"1388",795,593,162,"55",107,0.1346,0.0927,0.1167
"8900",142276,1998,"1442",787,655,52,"15",37,0.047,0.0229,0.0361
"8901",142285,1998,"1481",732,749,297,"112",185,0.2527,0.1495,0.2005
"8902",142461,1998,"310",193,117,101,"27",74,0.3834,0.2308,0.3258
"8903",143084,1998,"567",321,246,389,"148",241,0.7508,0.6016,0.6861
"8904",143288,1998,"144",66,78,37,"16",21,0.3182,0.2051,0.2569
"8905",144005,1998,"601",399,202,10,"3",7,0.0175,0.0149,0.0166
"8906",144281,1998,"1210",588,622,229,"108",121,0.2058,0.1736,0.1893
"8907",144740,1998,"1448",852,596,591,"216",375,0.4401,0.3624,0.4081
"8908",144892,1998,"1604",984,620,547,"148",399,0.4055,0.2387,0.341
"8909",144962,1998,"266",152,114,154,"51",103,0.6776,0.4474,0.5789
"8910",144971,1998,"114",57,57,65,"31",34,0.5965,0.5439,0.5702
"8911",145600,1998,"2880",1629,1251,465,"166",299,0.1835,0.1327,0.1615
"8912",145619,1998,"299",160,139,93,"35",58,0.3625,0.2518,0.311
"8913",145637,1998,"6453",3174,3279,3729,"1680",2049,0.6456,0.5124,0.5779
"8914",145691,1998,"238",133,105,107,"37",70,0.5263,0.3524,0.4496
"8915",145813,1998,"2740",1728,1012,915,"268",647,0.3744,0.2648,0.3339
"8916",146481,1998,"302",177,125,167,"63",104,0.5876,0.504,0.553
"8917",146612,1998,"391",193,198,151,"64",87,0.4508,0.3232,0.3862
"8918",146719,1998,"1340",868,472,641,"208",433,0.4988,0.4407,0.4784
"8919",146825,1998,"163",79,84,59,"22",37,0.4684,0.2619,0.362
"8920",147013,1998,"247",139,108,91,"24",67,0.482,0.2222,0.3684
"8921",147244,1998,"594",331,263,291,"91",200,0.6042,0.346,0.4899
"8922",147341,1998,"320",146,174,170,"84",86,0.589,0.4828,0.5312
"8923",147703,1998,"2818",1513,1305,682,"244",438,0.2895,0.187,0.242
"8924",147767,1998,"1912",1023,889,1601,"706",895,0.8749,0.7942,0.8373
"8925",147776,1998,"961",594,367,15,"3",12,0.0202,0.0082,0.0156
"8926",147828,1998,"428",227,201,159,"59",100,0.4405,0.2935,0.3715
"8927",148131,1998,"232",122,110,109,"43",66,0.541,0.3909,0.4698
"8928",148496,1998,"207",137,70,102,"36",66,0.4818,0.5143,0.4928
"8929",148584,1998,"176",88,88,64,"21",43,0.4886,0.2386,0.3636
"8930",148627,1998,"271",180,91,87,"21",66,0.3667,0.2308,0.321
"8931",149222,1998,"2637",1131,1506,542,"248",294,0.2599,0.1647,0.2055
"8932",149231,1998,"1408",853,555,257,"70",187,0.2192,0.1261,0.1825
"8933",149772,1998,"1749",928,821,504,"203",301,0.3244,0.2473,0.2882
"8934",149781,1998,"573",300,273,409,"186",223,0.7433,0.6813,0.7138
"8935",150066,1998,"534",319,215,202,"78",124,0.3887,0.3628,0.3783
"8936",150136,1998,"3512",1905,1607,896,"311",585,0.3071,0.1935,0.2551
"8937",150145,1998,"273",173,100,104,"36",68,0.3931,0.36,0.381
"8938",150163,1998,"912",557,355,452,"145",307,0.5512,0.4085,0.4956
"8939",150400,1998,"593",344,249,423,"164",259,0.7529,0.6586,0.7133
"8940",150534,1998,"665",423,242,293,"92",201,0.4752,0.3802,0.4406
"8941",150668,1998,"207",121,86,99,"39",60,0.4959,0.4535,0.4783
"8942",150941,1998,"227",151,76,115,"34",81,0.5364,0.4474,0.5066
"8943",151102,1998,"1303",673,630,38,"16",22,0.0327,0.0254,0.0292
"8944",151111,1998,"2570",1387,1183,110,"41",69,0.0497,0.0347,0.0428
"8945",151306,1998,"1552",945,607,197,"56",141,0.1492,0.0923,0.1269
"8946",151324,1998,"1994",1062,932,368,"123",245,0.2307,0.132,0.1846
"8947",151333,1998,"333",230,103,25,"2",23,0.1,0.0194,0.0751
"8948",151342,1998,"732",427,305,31,"14",17,0.0398,0.0459,0.0423
"8949",151351,1998,"6735",3810,2925,2747,"1088",1659,0.4354,0.372,0.4079
"8950",151360,1998,"535",347,188,31,"8",23,0.0663,0.0426,0.0579
"8951",151379,1998,"727",407,320,28,"6",22,0.0541,0.0187,0.0385
"8952",151388,1998,"230",146,84,7,"2",5,0.0342,0.0238,0.0304
"8953",151777,1998,"309",173,136,139,"47",92,0.5318,0.3456,0.4498
"8954",151786,1998,"205",158,47,70,"14",56,0.3544,0.2979,0.3415
"8955",152080,1998,"1937",895,1042,1706,"891",815,0.9106,0.8551,0.8807
"8956",152248,1998,"1062",560,502,38,"17",21,0.0375,0.0339,0.0358
"8957",152363,1998,"254",136,118,113,"46",67,0.4926,0.3898,0.4449
"8958",152530,1998,"460",243,217,293,"128",165,0.679,0.5899,0.637
"8959",152600,1998,"685",350,335,396,"162",234,0.6686,0.4836,0.5781
"8960",153001,1998,"323",165,158,165,"68",97,0.5879,0.4304,0.5108
"8961",153108,1998,"411",222,189,249,"101",148,0.6667,0.5344,0.6058
"8962",153269,1998,"670",379,291,378,"134",244,0.6438,0.4605,0.5642
"8963",153384,1998,"350",194,156,282,"127",155,0.799,0.8141,0.8057
"8964",153603,1998,"3800",1775,2025,1111,"438",673,0.3792,0.2163,0.2924
"8965",153834,1998,"678",396,282,446,"179",267,0.6742,0.6348,0.6578
"8966",154095,1998,"1982",1257,725,585,"146",439,0.3492,0.2014,0.2952
"8967",155089,1998,"195",106,89,35,"14",21,0.1981,0.1573,0.1795
"8968",155317,1998,"3698",2069,1629,974,"322",652,0.3151,0.1977,0.2634
"8969",155335,1998,"110",65,45,28,"8",20,0.3077,0.1778,0.2545
"8970",155399,1998,"2921",1388,1533,755,"295",460,0.3314,0.1924,0.2585
"8971",155520,1998,"254",114,140,64,"27",37,0.3246,0.1929,0.252
"8972",155627,1998,"117",43,74,24,"10",14,0.3256,0.1351,0.2051
"8973",155937,1998,"161",81,80,52,"18",34,0.4198,0.225,0.323
"8974",156213,1998,"333",204,129,211,"82",129,0.6324,0.6357,0.6336
"8975",156286,1998,"362",212,150,165,"61",104,0.4906,0.4067,0.4558
"8976",156295,1998,"414",237,177,161,"70",91,0.384,0.3955,0.3889
"8977",156365,1998,"359",194,165,82,"25",57,0.2938,0.1515,0.2284
"8978",156541,1998,"412",177,235,87,"30",57,0.322,0.1277,0.2112
"8979",156745,1998,"408",224,184,194,"61",133,0.5938,0.3315,0.4755
"8980",157058,1998,"379",215,164,34,"9",25,0.1163,0.0549,0.0897
"8981",157076,1998,"152",95,57,53,"18",35,0.3684,0.3158,0.3487
"8982",157085,1998,"2931",1548,1383,815,"331",484,0.3127,0.2393,0.2781
"8983",157289,1998,"2032",1011,1021,222,"81",141,0.1395,0.0793,0.1093
"8984",157386,1998,"1369",739,630,157,"48",109,0.1475,0.0762,0.1147
"8985",157401,1998,"1275",707,568,341,"122",219,0.3098,0.2148,0.2675
"8986",157447,1998,"1627",956,671,118,"32",86,0.09,0.0477,0.0725
"8987",157535,1998,"169",110,59,30,"12",18,0.1636,0.2034,0.1775
"8988",157951,1998,"2353",1347,1006,542,"190",352,0.2613,0.1889,0.2303
"8989",158477,1998,"294",180,114,126,"34",92,0.5111,0.2982,0.4286
"8990",159009,1998,"771",359,412,71,"23",48,0.1337,0.0558,0.0921
"8991",159391,1998,"5066",2874,2192,1198,"399",799,0.278,0.182,0.2365
"8992",159647,1998,"1621",794,827,449,"178",271,0.3413,0.2152,0.277
"8993",159717,1998,"1433",802,631,141,"35",106,0.1322,0.0555,0.0984
"8994",159966,1998,"1351",781,570,117,"22",95,0.1216,0.0386,0.0866
"8995",160038,1998,"1364",857,507,157,"43",114,0.133,0.0848,0.1151
"8996",160612,1998,"2588",1471,1117,156,"50",106,0.0721,0.0448,0.0603
"8997",160621,1998,"1715",911,804,110,"25",85,0.0933,0.0311,0.0641
"8998",160658,1998,"2931",1621,1310,249,"69",180,0.111,0.0527,0.085
"8999",161004,1998,"433",213,220,361,"181",180,0.8451,0.8227,0.8337
"9000",161226,1998,"484",333,151,155,"41",114,0.3423,0.2715,0.3202
"9001",161235,1998,"93",40,53,9,"1",8,0.2,0.0189,0.0968
"9002",161244,1998,"148",95,53,8,"2",6,0.0632,0.0377,0.0541
"9003",161253,1998,"1342",671,671,418,"165",253,0.377,0.2459,0.3115
"9004",161554,1998,"789",463,326,66,"18",48,0.1037,0.0552,0.0837
"9005",162007,1998,"418",225,193,49,"7",42,0.1867,0.0363,0.1172
"9006",162210,1998,"140",67,73,17,"7",10,0.1493,0.0959,0.1214
"9007",162283,1998,"457",337,120,32,"10",22,0.0653,0.0833,0.07
"9008",162584,1998,"932",486,446,181,"66",115,0.2366,0.148,0.1942
"9009",162654,1998,"302",213,89,169,"36",133,0.6244,0.4045,0.5596
"9010",162760,1998,"149",144,5,97,"2",95,0.6597,0.4,0.651
"9011",162928,1998,"1077",467,610,864,"469",395,0.8458,0.7689,0.8022
"9012",163046,1998,"854",485,369,668,"276",392,0.8082,0.748,0.7822
"9013",163268,1998,"1246",609,637,347,"138",209,0.3432,0.2166,0.2785
"9014",163286,1998,"4039",2007,2032,1858,"801",1057,0.5267,0.3942,0.46
"9015",163453,1998,"1136",674,462,166,"42",124,0.184,0.0909,0.1461
"9016",163462,1998,"410",213,197,249,"113",136,0.6385,0.5736,0.6073
"9017",163851,1998,"935",534,401,438,"139",299,0.5599,0.3466,0.4684
"9018",163912,1998,"331",181,150,211,"77",134,0.7403,0.5133,0.6375
"9019",164076,1998,"1923",1175,748,573,"183",390,0.3319,0.2447,0.298
"9020",164173,1998,"443",305,138,163,"46",117,0.3836,0.3333,0.3679
"9021",164216,1998,"278",174,104,163,"53",110,0.6322,0.5096,0.5863
"9022",164270,1998,"331",173,158,210,"86",124,0.7168,0.5443,0.6344
"9023",164447,1998,"226",96,130,57,"22",35,0.3646,0.1692,0.2522
"9024",164492,1998,"153",116,37,70,"19",51,0.4397,0.5135,0.4575
"9025",164562,1998,"522",334,188,402,"138",264,0.7904,0.734,0.7701
"9026",165015,1998,"850",477,373,715,"293",422,0.8847,0.7855,0.8412
"9027",165024,1998,"1128",695,433,260,"75",185,0.2662,0.1732,0.2305
"9028",165334,1998,"501",305,196,323,"119",204,0.6689,0.6071,0.6447
"9029",165662,1998,"612",368,244,377,"150",227,0.6168,0.6148,0.616
"9030",165671,1998,"151",151,0,80,"0",80,0.5298,NA,0.5298
"9031",165820,1998,"503",281,222,81,"24",57,0.2028,0.1081,0.161
"9032",165866,1998,"601",381,220,136,"27",109,0.2861,0.1227,0.2263
"9033",165936,1998,"417",289,128,214,"65",149,0.5156,0.5078,0.5132
"9034",166027,1998,"1650",772,878,1423,"748",675,0.8744,0.8519,0.8624
"9035",166124,1998,"723",354,369,623,"305",318,0.8983,0.8266,0.8617
"9036",166513,1998,"997",366,631,235,"116",119,0.3251,0.1838,0.2357
"9037",166629,1998,"3953",2021,1932,1651,"625",1026,0.5077,0.3235,0.4177
"9038",166638,1998,"579",307,272,69,"29",40,0.1303,0.1066,0.1192
"9039",166683,1998,"1042",446,596,840,"466",374,0.8386,0.7819,0.8061
"9040",167288,1998,"209",131,78,66,"17",49,0.374,0.2179,0.3158
"9041",167987,1998,"1086",535,551,284,"102",182,0.3402,0.1851,0.2615
"9042",167996,1998,"531",313,218,421,"168",253,0.8083,0.7706,0.7928
"9043",168005,1998,"620",355,265,208,"75",133,0.3746,0.283,0.3355
"9044",168148,1998,"1236",668,568,1040,"466",574,0.8593,0.8204,0.8414
"9045",168254,1998,"535",238,297,231,"119",112,0.4706,0.4007,0.4318
"9046",168281,1998,"435",294,141,291,"79",212,0.7211,0.5603,0.669
"9047",168342,1998,"537",265,272,492,"252",240,0.9057,0.9265,0.9162
"9048",168546,1998,"448",248,200,298,"126",172,0.6935,0.63,0.6652
"9049",168786,1998,"346",213,133,75,"23",52,0.2441,0.1729,0.2168
"9050",169080,1998,"974",536,438,559,"236",323,0.6026,0.5388,0.5739
"9051",169798,1998,"2349",1426,923,244,"79",165,0.1157,0.0856,0.1039
"9052",169910,1998,"1946",812,1134,53,"25",28,0.0345,0.022,0.0272
"9053",170082,1998,"2482",1544,938,469,"153",316,0.2047,0.1631,0.189
"9054",170301,1998,"747",462,285,446,"148",298,0.645,0.5193,0.5971
"9055",170532,1998,"442",256,186,322,"126",196,0.7656,0.6774,0.7285
"9056",170639,1998,"575",250,325,67,"27",40,0.16,0.0831,0.1165
"9057",170976,1998,"5258",2654,2604,3531,"1620",1911,0.72,0.6221,0.6715
"9058",171100,1998,"6724",3767,2957,2343,"757",1586,0.421,0.256,0.3485
"9059",171128,1998,"1194",328,866,323,"202",121,0.3689,0.2333,0.2705
"9060",171137,1998,"741",373,368,99,"41",58,0.1555,0.1114,0.1336
"9061",171146,1998,"613",372,241,60,"20",40,0.1075,0.083,0.0979
"9062",171599,1998,"198",85,113,42,"21",21,0.2471,0.1858,0.2121
"9063",172051,1998,"895",492,403,59,"20",39,0.0793,0.0496,0.0659
"9064",172699,1998,"3621",1981,1640,699,"255",444,0.2241,0.1555,0.193
"9065",173160,1998,"513",314,199,314,"122",192,0.6115,0.6131,0.6121
"9066",173258,1998,"520",279,241,450,"204",246,0.8817,0.8465,0.8654
"9067",173328,1998,"213",106,107,57,"24",33,0.3113,0.2243,0.2676
"9068",173647,1998,"695",391,304,477,"195",282,0.7212,0.6414,0.6863
"9069",173902,1998,"465",260,205,339,"153",186,0.7154,0.7463,0.729
"9070",174066,1998,"4992",2582,2410,1441,"573",868,0.3362,0.2378,0.2887
"9071",174233,1998,"1746",911,835,362,"138",224,0.2459,0.1653,0.2073
"9072",174251,1998,"522",330,192,198,"62",136,0.4121,0.3229,0.3793
"9073",174491,1998,"393",242,151,155,"55",100,0.4132,0.3642,0.3944
"9074",174792,1998,"427",0,427,317,"317",0,NA,0.7424,0.7424
"9075",174844,1998,"756",431,325,594,"256",338,0.7842,0.7877,0.7857
"9076",174899,1998,"277",213,64,163,"30",133,0.6244,0.4688,0.5884
"9077",174914,1998,"1038",579,459,561,"230",331,0.5717,0.5011,0.5405
"9078",175342,1998,"556",306,250,140,"41",99,0.3235,0.164,0.2518
"9079",175421,1998,"112",53,59,35,"12",23,0.434,0.2034,0.3125
"9080",175616,1998,"427",265,162,100,"23",77,0.2906,0.142,0.2342
"9081",175856,1998,"842",494,348,155,"43",112,0.2267,0.1236,0.1841
"9082",175980,1998,"286",145,141,169,"79",90,0.6207,0.5603,0.5909
"9083",176017,1998,"1794",920,874,602,"213",389,0.4228,0.2437,0.3356
"9084",176035,1998,"210",180,30,47,"4",43,0.2389,0.1333,0.2238
"9085",176044,1998,"321",182,139,68,"16",52,0.2857,0.1151,0.2118
"9086",176080,1998,"1929",944,985,501,"178",323,0.3422,0.1807,0.2597
"9087",176406,1998,"198",142,56,66,"12",54,0.3803,0.2143,0.3333
"9088",176628,1998,"113",64,49,39,"9",30,0.4688,0.1837,0.3451
"9089",176947,1998,"218",111,107,59,"19",40,0.3604,0.1776,0.2706
"9090",176965,1998,"1408",730,678,317,"107",210,0.2877,0.1578,0.2251
"9091",177418,1998,"156",111,45,59,"11",48,0.4324,0.2444,0.3782
"9092",178059,1998,"225",158,67,100,"26",74,0.4684,0.3881,0.4444
"9093",178341,1998,"857",469,388,95,"30",65,0.1386,0.0773,0.1109
"9094",178387,1998,"983",577,406,127,"27",100,0.1733,0.0665,0.1292
"9095",178396,1998,"3785",2077,1708,1425,"500",925,0.4454,0.2927,0.3765
"9096",178402,1998,"618",336,282,114,"39",75,0.2232,0.1383,0.1845
"9097",178411,1998,"717",151,566,106,"81",25,0.1656,0.1431,0.1478
"9098",178420,1998,"528",274,254,114,"46",68,0.2482,0.1811,0.2159
"9099",178615,1998,"1482",914,568,562,"181",381,0.4168,0.3187,0.3792
"9100",179043,1998,"280",153,127,141,"50",91,0.5948,0.3937,0.5036
"9101",179159,1998,"1239",694,545,684,"251",433,0.6239,0.4606,0.5521
"9102",179557,1998,"1239",757,482,300,"75",225,0.2972,0.1556,0.2421
"9103",179566,1998,"2739",1545,1194,607,"192",415,0.2686,0.1608,0.2216
"9104",179867,1998,"1465",770,695,1221,"570",651,0.8455,0.8201,0.8334
"9105",179894,1998,"339",198,141,123,"50",73,0.3687,0.3546,0.3628
"9106",179946,1998,"205",94,111,78,"40",38,0.4043,0.3604,0.3805
"9107",180179,1998,"539",325,214,52,"10",42,0.1292,0.0467,0.0965
"9108",180461,1998,"1886",846,1040,299,"140",159,0.1879,0.1346,0.1585
"9109",180522,1998,"253",107,146,25,"15",10,0.0935,0.1027,0.0988
"9110",180984,1998,"294",172,122,90,"25",65,0.3779,0.2049,0.3061
"9111",181002,1998,"794",462,332,481,"195",286,0.619,0.5873,0.6058
"9112",181020,1998,"266",123,143,156,"70",86,0.6992,0.4895,0.5865
"9113",181127,1998,"309",168,141,160,"57",103,0.6131,0.4043,0.5178
"9114",181215,1998,"1022",598,424,204,"55",149,0.2492,0.1297,0.1996
"9115",181394,1998,"1296",701,595,120,"42",78,0.1113,0.0706,0.0926
"9116",181446,1998,"429",246,183,200,"76",124,0.5041,0.4153,0.4662
"9117",181464,1998,"3353",1619,1734,740,"275",465,0.2872,0.1586,0.2207
"9118",181534,1998,"213",91,122,22,"3",19,0.2088,0.0246,0.1033
"9119",181783,1998,"700",402,298,177,"56",121,0.301,0.1879,0.2529
"9120",182281,1998,"1546",885,661,186,"58",128,0.1446,0.0877,0.1203
"9121",182290,1998,"1260",675,585,181,"60",121,0.1793,0.1026,0.1437
"9122",182634,1998,"235",162,73,111,"29",82,0.5062,0.3973,0.4723
"9123",182795,1998,"429",203,226,145,"59",86,0.4236,0.2611,0.338
"9124",183062,1998,"773",470,303,178,"53",125,0.266,0.1749,0.2303
"9125",183080,1998,"784",375,409,190,"81",109,0.2907,0.198,0.2423
"9126",183239,1998,"528",296,232,392,"159",233,0.7872,0.6853,0.7424
"9127",183822,1998,"247",170,77,25,"7",18,0.1059,0.0909,0.1012
"9128",183974,1998,"124",77,47,26,"8",18,0.2338,0.1702,0.2097
"9129",184348,1998,"337",213,124,226,"84",142,0.6667,0.6774,0.6706
"9130",184603,1998,"566",307,259,90,"30",60,0.1954,0.1158,0.159
"9131",184612,1998,"151",118,33,20,"3",17,0.1441,0.0909,0.1325
"9132",184782,1998,"1118",624,494,414,"160",254,0.4071,0.3239,0.3703
"9133",185129,1998,"549",305,244,40,"13",27,0.0885,0.0533,0.0729
"9134",185572,1998,"834",429,405,253,"98",155,0.3613,0.242,0.3034
"9135",185590,1998,"1106",660,446,252,"60",192,0.2909,0.1345,0.2278
"9136",185828,1998,"563",120,443,93,"64",29,0.2417,0.1445,0.1652
"9137",186131,1998,"1167",560,607,1000,"495",505,0.9018,0.8155,0.8569
"9138",186201,1998,"472",271,201,169,"56",113,0.417,0.2786,0.3581
"9139",186283,1998,"869",483,386,419,"161",258,0.5342,0.4171,0.4822
"9140",186584,1998,"1221",657,564,486,"173",313,0.4764,0.3067,0.398
"9141",186876,1998,"744",420,324,321,"116",205,0.4881,0.358,0.4315
"9142",187134,1998,"1206",714,492,760,"278",482,0.6751,0.565,0.6302
"9143",187444,1998,"1133",663,470,145,"39",106,0.1599,0.083,0.128
"9144",187985,1998,"2617",1475,1142,281,"96",185,0.1254,0.0841,0.1074
"9145",188030,1998,"2077",1070,1007,254,"77",177,0.1654,0.0765,0.1223
"9146",188429,1998,"525",343,182,214,"67",147,0.4286,0.3681,0.4076
"9147",188641,1998,"554",275,279,272,"118",154,0.56,0.4229,0.491
"9148",190044,1998,"616",138,478,292,"216",76,0.5507,0.4519,0.474
"9149",190099,1998,"751",407,344,641,"283",358,0.8796,0.8227,0.8535
"9150",190150,1998,"1283",619,664,1061,"545",516,0.8336,0.8208,0.827
"9151",190248,1998,"114",68,46,40,"17",23,0.3382,0.3696,0.3509
"9152",190415,1998,"3084",1452,1632,2633,"1358",1275,0.8781,0.8321,0.8538
"9153",190512,1998,"946",493,453,231,"83",148,0.3002,0.1832,0.2442
"9154",190549,1998,"1029",615,414,184,"56",128,0.2081,0.1353,0.1788
"9155",190558,1998,"1510",786,724,36,"14",22,0.028,0.0193,0.0238
"9156",190567,1998,"901",462,439,31,"11",20,0.0433,0.0251,0.0344
"9157",190594,1998,"1468",1026,442,134,"29",105,0.1023,0.0656,0.0913
"9158",190637,1998,"581",398,183,28,"8",20,0.0503,0.0437,0.0482
"9159",190664,1998,"1133",711,422,235,"59",176,0.2475,0.1398,0.2074
"9160",190691,1998,"383",235,148,22,"8",14,0.0596,0.0541,0.0574
"9161",190725,1998,"345",262,83,80,"20",60,0.229,0.241,0.2319
"9162",191241,1998,"1532",912,620,1111,"422",689,0.7555,0.6806,0.7252
"9163",191515,1998,"464",238,226,372,"170",202,0.8487,0.7522,0.8017
"9164",191533,1998,"440",227,213,204,"82",122,0.5374,0.385,0.4636
"9165",191630,1998,"488",280,208,347,"129",218,0.7786,0.6202,0.7111
"9166",191649,1998,"1749",907,842,593,"217",376,0.4146,0.2577,0.3391
"9167",191676,1998,"309",204,105,180,"50",130,0.6373,0.4762,0.5825
"9168",191931,1998,"696",302,394,279,"117",162,0.5364,0.297,0.4009
"9169",191968,1998,"1337",759,578,909,"379",530,0.6983,0.6557,0.6799
"9170",192192,1998,"226",180,46,75,"15",60,0.3333,0.3261,0.3319
"9171",192323,1998,"471",279,192,309,"114",195,0.6989,0.5938,0.6561
"9172",192439,1998,"1061",689,372,44,"8",36,0.0522,0.0215,0.0415
"9173",192703,1998,"547",274,273,328,"159",169,0.6168,0.5824,0.5996
"9174",192749,1998,"338",225,113,126,"35",91,0.4044,0.3097,0.3728
"9175",192819,1998,"834",430,404,547,"240",307,0.714,0.5941,0.6559
"9176",192925,1998,"153",113,40,45,"15",30,0.2655,0.375,0.2941
"9177",193016,1998,"907",582,325,53,"14",39,0.067,0.0431,0.0584
"9178",193292,1998,"180",117,63,72,"21",51,0.4359,0.3333,0.4
"9179",193353,1998,"304",230,74,122,"27",95,0.413,0.3649,0.4013
"9180",193399,1998,"266",200,66,124,"26",98,0.49,0.3939,0.4662
"9181",193584,1998,"321",246,75,199,"38",161,0.6545,0.5067,0.6199
"9182",193645,1998,"852",738,114,161,"11",150,0.2033,0.0965,0.189
"9183",193654,1998,"581",394,187,240,"51",189,0.4797,0.2727,0.4131
"9184",193900,1998,"3722",2224,1498,2028,"805",1223,0.5499,0.5374,0.5449
"9185",193973,1998,"543",332,211,271,"93",178,0.5361,0.4408,0.4991
"9186",194161,1998,"258",159,99,73,"20",53,0.3333,0.202,0.2829
"9187",194310,1998,"1536",911,625,602,"220",382,0.4193,0.352,0.3919
"9188",194824,1998,"1138",258,880,654,"483",171,0.6628,0.5489,0.5747
"9189",195003,1998,"1980",609,1371,816,"526",290,0.4762,0.3837,0.4121
"9190",195030,1998,"1062",481,581,730,"372",358,0.7443,0.6403,0.6874
"9191",195164,1998,"568",284,284,290,"126",164,0.5775,0.4437,0.5106
"9192",195173,1998,"440",259,181,146,"40",106,0.4093,0.221,0.3318
"9193",195216,1998,"479",255,224,339,"155",184,0.7216,0.692,0.7077
"9194",195234,1998,"345",262,83,175,"29",146,0.5573,0.3494,0.5072
"9195",195243,1998,"306",179,127,97,"34",63,0.352,0.2677,0.317
"9196",195304,1998,"306",227,79,202,"57",145,0.6388,0.7215,0.6601
"9197",195474,1998,"619",311,308,436,"202",234,0.7524,0.6558,0.7044
"9198",195526,1998,"596",366,230,482,"193",289,0.7896,0.8391,0.8087
"9199",195544,1998,"100",82,18,69,"9",60,0.7317,0.5,0.69
"9200",195809,1998,"2504",1417,1087,886,"318",568,0.4008,0.2925,0.3538
"9201",196413,1998,"2566",1383,1183,1689,"702",987,0.7137,0.5934,0.6582
"9202",196592,1998,"1651",1155,496,221,"65",156,0.1351,0.131,0.1339
"9203",197045,1998,"306",203,103,107,"31",76,0.3744,0.301,0.3497
"9204",197133,1998,"626",379,247,504,"191",313,0.8259,0.7733,0.8051
"9205",197869,1998,"2312",1192,1120,687,"239",448,0.3758,0.2134,0.2971
"9206",197984,1998,"198",94,104,87,"41",46,0.4894,0.3942,0.4394
"9207",198385,1998,"472",253,219,423,"198",225,0.8893,0.9041,0.8962
"9208",198464,1998,"2803",1714,1089,720,"196",524,0.3057,0.18,0.2569
"9209",198507,1998,"378",229,149,109,"22",87,0.3799,0.1477,0.2884
"9210",198516,1998,"1013",632,381,660,"234",426,0.6741,0.6142,0.6515
"9211",198835,1998,"267",138,129,112,"38",74,0.5362,0.2946,0.4195
"9212",198969,1998,"437",117,320,88,"55",33,0.2821,0.1719,0.2014
"9213",199102,1998,"1366",695,671,323,"104",219,0.3151,0.155,0.2365
"9214",199111,1998,"474",278,196,120,"35",85,0.3058,0.1786,0.2532
"9215",199120,1998,"3425",2116,1309,2289,"794",1495,0.7065,0.6066,0.6683
"9216",199139,1998,"2122",1178,944,456,"169",287,0.2436,0.179,0.2149
"9217",199148,1998,"1791",1257,534,472,"94",378,0.3007,0.176,0.2635
"9218",199157,1998,"673",409,264,184,"41",143,0.3496,0.1553,0.2734
"9219",199193,1998,"3751",1513,2238,1075,"492",583,0.3853,0.2198,0.2866
"9220",199218,1998,"1681",1030,651,628,"180",448,0.435,0.2765,0.3736
"9221",199281,1998,"464",244,220,99,"36",63,0.2582,0.1636,0.2134
"9222",199306,1998,"148",67,81,45,"17",28,0.4179,0.2099,0.3041
"9223",199412,1998,"147",111,36,67,"15",52,0.4685,0.4167,0.4558
"9224",199582,1998,"299",164,135,57,"13",44,0.2683,0.0963,0.1906
"9225",199643,1998,"382",220,162,73,"20",53,0.2409,0.1235,0.1911
"9226",199847,1998,"993",505,488,746,"334",412,0.8158,0.6844,0.7513
"9227",199962,1998,"273",127,146,89,"34",55,0.4331,0.2329,0.326
"9228",199999,1998,"524",364,160,114,"23",91,0.25,0.1437,0.2176
"9229",200004,1998,"1098",544,554,249,"80",169,0.3107,0.1444,0.2268
"9230",200059,1998,"363",204,159,26,"4",22,0.1078,0.0252,0.0716
"9231",200156,1998,"278",150,128,99,"39",60,0.4,0.3047,0.3561
"9232",200217,1998,"404",244,160,149,"39",110,0.4508,0.2438,0.3688
"9233",200226,1998,"153",56,97,32,"16",16,0.2857,0.1649,0.2092
"9234",200253,1998,"371",217,154,28,"7",21,0.0968,0.0455,0.0755
"9235",200280,1998,"1465",722,743,326,"141",185,0.2562,0.1898,0.2225
"9236",200332,1998,"1259",524,735,181,"83",98,0.187,0.1129,0.1438
"9237",200572,1998,"193",100,93,47,"12",35,0.35,0.129,0.2435
"9238",201104,1998,"570",351,219,235,"66",169,0.4815,0.3014,0.4123
"9239",201371,1998,"190",112,78,102,"32",70,0.625,0.4103,0.5368
"9240",201548,1998,"518",313,205,250,"79",171,0.5463,0.3854,0.4826
"9241",201645,1998,"830",301,529,476,"265",211,0.701,0.5009,0.5735
"9242",201690,1998,"230",130,100,27,"5",22,0.1692,0.05,0.1174
"9243",202134,1998,"962",455,507,86,"37",49,0.1077,0.073,0.0894
"9244",202480,1998,"1792",919,873,991,"385",606,0.6594,0.441,0.553
"9245",202523,1998,"631",364,267,456,"173",283,0.7775,0.6479,0.7227
"9246",202763,1998,"585",384,201,228,"64",164,0.4271,0.3184,0.3897
"9247",203085,1998,"290",138,152,130,"54",76,0.5507,0.3553,0.4483
"9248",203128,1998,"231",106,125,137,"63",74,0.6981,0.504,0.5931
"9249",203368,1998,"854",433,421,532,"241",291,0.6721,0.5724,0.623
"9250",203517,1998,"3019",1867,1152,491,"154",337,0.1805,0.1337,0.1626
"9251",203535,1998,"451",252,199,369,"156",213,0.8452,0.7839,0.8182
"9252",203580,1998,"68",62,6,32,"3",29,0.4677,0.5,0.4706
"9253",203775,1998,"398",235,163,153,"56",97,0.4128,0.3436,0.3844
"9254",203845,1998,"338",177,161,146,"46",100,0.565,0.2857,0.432
"9255",204024,1998,"3332",1904,1428,2182,"856",1326,0.6964,0.5994,0.6549
"9256",204185,1998,"568",289,279,318,"116",202,0.699,0.4158,0.5599
"9257",204194,1998,"345",205,140,141,"44",97,0.4732,0.3143,0.4087
"9258",204617,1998,"184",118,66,73,"18",55,0.4661,0.2727,0.3967
"9259",204796,1998,"6151",3177,2974,1886,"610",1276,0.4016,0.2051,0.3066
"9260",204857,1998,"3369",1988,1381,1489,"480",1009,0.5075,0.3476,0.442
"9261",206330,1998,"143",68,75,37,"13",24,0.3529,0.1733,0.2587
"9262",206589,1998,"504",259,245,335,"147",188,0.7259,0.6,0.6647
"9263",206604,1998,"2101",1178,923,354,"109",245,0.208,0.1181,0.1685
"9264",206622,1998,"831",483,348,541,"227",314,0.6501,0.6523,0.651
"9265",206695,1998,"1839",954,885,250,"81",169,0.1771,0.0915,0.1359
"9266",206914,1998,"590",327,263,35,"13",22,0.0673,0.0494,0.0593
"9267",207209,1998,"517",262,255,22,"3",19,0.0725,0.0118,0.0426
"9268",207306,1998,"290",147,143,35,"15",20,0.1361,0.1049,0.1207
"9269",207324,1998,"468",277,191,93,"33",60,0.2166,0.1728,0.1987
"9270",207388,1998,"2584",1301,1283,624,"226",398,0.3059,0.1761,0.2415
"9271",207500,1998,"3148",1618,1530,641,"214",427,0.2639,0.1399,0.2036
"9272",207722,1998,"279",159,120,48,"19",29,0.1824,0.1583,0.172
"9273",207847,1998,"499",260,239,59,"21",38,0.1462,0.0879,0.1182
"9274",207865,1998,"866",453,413,136,"38",98,0.2163,0.092,0.157
"9275",208822,1998,"361",240,121,208,"73",135,0.5625,0.6033,0.5762
"9276",209056,1998,"424",253,171,249,"94",155,0.6126,0.5497,0.5873
"9277",209065,1998,"415",232,183,238,"81",157,0.6767,0.4426,0.5735
"9278",209542,1998,"2229",1105,1124,615,"210",405,0.3665,0.1868,0.2759
"9279",209551,1998,"2304",1289,1015,839,"280",559,0.4337,0.2759,0.3641
"9280",209612,1998,"246",157,89,133,"39",94,0.5987,0.4382,0.5407
"9281",209807,1998,"800",419,381,101,"28",73,0.1742,0.0735,0.1262
"9282",209922,1998,"338",164,174,165,"86",79,0.4817,0.4943,0.4882
"9283",210146,1998,"670",403,267,124,"40",84,0.2084,0.1498,0.1851
"9284",210401,1998,"406",236,170,263,"105",158,0.6695,0.6176,0.6478
"9285",210429,1998,"700",425,275,116,"26",90,0.2118,0.0945,0.1657
"9286",210571,1998,"355",187,168,176,"71",105,0.5615,0.4226,0.4958
"9287",210669,1998,"545",272,273,321,"144",177,0.6507,0.5275,0.589
"9288",210775,1998,"168",93,75,56,"16",40,0.4301,0.2133,0.3333
"9289",211088,1998,"334",248,86,189,"46",143,0.5766,0.5349,0.5659
"9290",211158,1998,"1377",890,487,465,"102",363,0.4079,0.2094,0.3377
"9291",211291,1998,"954",468,486,840,"427",413,0.8825,0.8786,0.8805
"9292",211352,1998,"304",209,95,152,"35",117,0.5598,0.3684,0.5
"9293",211361,1998,"931",480,451,180,"68",112,0.2333,0.1508,0.1933
"9294",211431,1998,"163",157,6,43,"3",40,0.2548,0.5,0.2638
"9295",211440,1998,"1303",445,858,848,"539",309,0.6944,0.6282,0.6508
"9296",211468,1998,"187",185,2,104,"1",103,0.5568,0.5,0.5561
"9297",211556,1998,"142",142,0,63,"0",63,0.4437,NA,0.4437
"9298",211583,1998,"95",93,2,42,"0",42,0.4516,0,0.4421
"9299",211608,1998,"235",147,88,23,"3",20,0.1361,0.0341,0.0979
"9300",211644,1998,"1191",717,474,250,"64",186,0.2594,0.135,0.2099
"9301",211981,1998,"400",203,197,172,"70",102,0.5025,0.3553,0.43
"9302",212009,1998,"541",334,207,417,"155",262,0.7844,0.7488,0.7708
"9303",212054,1998,"2087",792,1295,247,"73",174,0.2197,0.0564,0.1184
"9304",212106,1998,"1253",771,482,615,"210",405,0.5253,0.4357,0.4908
"9305",212115,1998,"856",475,381,182,"53",129,0.2716,0.1391,0.2126
"9306",212133,1998,"317",220,97,168,"48",120,0.5455,0.4948,0.53
"9307",212160,1998,"1205",691,514,210,"54",156,0.2258,0.1051,0.1743
"9308",212197,1998,"422",271,151,265,"87",178,0.6568,0.5762,0.628
"9309",212577,1998,"502",257,245,394,"175",219,0.8521,0.7143,0.7849
"9310",212601,1998,"608",360,248,282,"95",187,0.5194,0.3831,0.4638
"9311",212832,1998,"143",100,43,44,"9",35,0.35,0.2093,0.3077
"9312",212911,1998,"322",170,152,277,"130",147,0.8647,0.8553,0.8602
"9313",213020,1998,"2757",1643,1114,661,"161",500,0.3043,0.1445,0.2398
"9314",213251,1998,"337",192,145,227,"88",139,0.724,0.6069,0.6736
"9315",213321,1998,"396",189,207,240,"113",127,0.672,0.5459,0.6061
"9316",213349,1998,"1417",840,577,282,"70",212,0.2524,0.1213,0.199
"9317",213358,1998,"204",127,77,82,"30",52,0.4094,0.3896,0.402
"9318",213367,1998,"663",321,342,361,"161",200,0.6231,0.4708,0.5445
"9319",213385,1998,"597",281,316,480,"241",239,0.8505,0.7627,0.804
"9320",213507,1998,"422",208,214,247,"110",137,0.6587,0.514,0.5853
"9321",213543,1998,"1112",478,634,789,"397",392,0.8201,0.6262,0.7095
"9322",213613,1998,"813",463,350,159,"50",109,0.2354,0.1429,0.1956
"9323",213668,1998,"380",195,185,222,"85",137,0.7026,0.4595,0.5842
"9324",213783,1998,"619",346,273,143,"64",79,0.2283,0.2344,0.231
"9325",213826,1998,"241",186,55,102,"16",86,0.4624,0.2909,0.4232
"9326",213996,1998,"763",480,283,536,"205",331,0.6896,0.7244,0.7025
"9327",214041,1998,"1110",651,459,383,"132",251,0.3856,0.2876,0.345
"9328",214069,1998,"187",142,45,126,"31",95,0.669,0.6889,0.6738
"9329",214157,1998,"292",172,120,183,"69",114,0.6628,0.575,0.6267
"9330",214175,1998,"577",344,233,438,"162",276,0.8023,0.6953,0.7591
"9331",214272,1998,"314",206,108,131,"42",89,0.432,0.3889,0.4172
"9332",214777,1998,"5117",2590,2527,2448,"959",1489,0.5749,0.3795,0.4784
"9333",215062,1998,"2301",1128,1173,1975,"969",1006,0.8918,0.8261,0.8583
"9334",215743,1998,"335",182,153,90,"47",43,0.2363,0.3072,0.2687
"9335",215798,1998,"262",135,127,153,"73",80,0.5926,0.5748,0.584
"9336",215929,1998,"873",527,346,607,"217",390,0.74,0.6272,0.6953
"9337",216010,1998,"1211",654,557,480,"181",299,0.4572,0.325,0.3964
"9338",216038,1998,"1260",713,547,297,"95",202,0.2833,0.1737,0.2357
"9339",216287,1998,"361",193,168,297,"132",165,0.8549,0.7857,0.8227
"9340",216339,1998,"2150",1279,871,521,"171",350,0.2737,0.1963,0.2423
"9341",216524,1998,"336",189,147,249,"93",156,0.8254,0.6327,0.7411
"9342",216694,1998,"290",113,177,116,"60",56,0.4956,0.339,0.4
"9343",216764,1998,"1629",1031,598,474,"124",350,0.3395,0.2074,0.291
"9344",216807,1998,"372",236,136,252,"79",173,0.7331,0.5809,0.6774
"9345",216852,1998,"490",207,283,204,"111",93,0.4493,0.3922,0.4163
"9346",216931,1998,"376",160,216,148,"70",78,0.4875,0.3241,0.3936
"9347",217059,1998,"853",462,391,370,"145",225,0.487,0.3708,0.4338
"9348",217156,1998,"1417",772,645,1180,"520",660,0.8549,0.8062,0.8327
"9349",217402,1998,"994",599,395,813,"323",490,0.818,0.8177,0.8179
"9350",217536,1998,"443",296,147,241,"69",172,0.5811,0.4694,0.544
"9351",217776,1998,"91",51,40,25,"11",14,0.2745,0.275,0.2747
"9352",217819,1998,"1937",1248,689,712,"179",533,0.4271,0.2598,0.3676
"9353",217882,1998,"2699",1273,1426,1091,"396",695,0.546,0.2777,0.4042
"9354",217998,1998,"136",84,52,89,"28",61,0.7262,0.5385,0.6544
"9355",218061,1998,"649",372,277,188,"57",131,0.3522,0.2058,0.2897
"9356",218229,1998,"488",322,166,92,"19",73,0.2267,0.1145,0.1885
"9357",218238,1998,"112",58,54,26,"8",18,0.3103,0.1481,0.2321
"9358",218399,1998,"204",123,81,37,"10",27,0.2195,0.1235,0.1814
"9359",218414,1998,"206",92,114,74,"27",47,0.5109,0.2368,0.3592
"9360",218663,1998,"2756",1553,1203,1098,"398",700,0.4507,0.3308,0.3984
"9361",218724,1998,"855",468,387,150,"53",97,0.2073,0.137,0.1754
"9362",218733,1998,"739",428,311,186,"50",136,0.3178,0.1608,0.2517
"9363",218742,1998,"547",362,185,106,"18",88,0.2431,0.0973,0.1938
"9364",218973,1998,"298",145,153,224,"113",111,0.7655,0.7386,0.7517
"9365",219000,1998,"403",257,146,213,"61",152,0.5914,0.4178,0.5285
"9366",219046,1998,"632",381,251,48,"13",35,0.0919,0.0518,0.0759
"9367",219082,1998,"231",110,121,45,"17",28,0.2545,0.1405,0.1948
"9368",219198,1998,"126",85,41,44,"13",31,0.3647,0.3171,0.3492
"9369",219259,1998,"480",276,204,66,"16",50,0.1812,0.0784,0.1375
"9370",219356,1998,"1510",766,744,384,"147",237,0.3094,0.1976,0.2543
"9371",219471,1998,"894",500,394,180,"58",122,0.244,0.1472,0.2013
"9372",219602,1998,"846",518,328,76,"20",56,0.1081,0.061,0.0898
"9373",219709,1998,"413",254,159,201,"73",128,0.5039,0.4591,0.4867
"9374",219718,1998,"82",29,53,16,"6",10,0.3448,0.1132,0.1951
"9375",219949,1998,"236",111,125,44,"8",36,0.3243,0.064,0.1864
"9376",220075,1998,"1507",880,627,204,"64",140,0.1591,0.1021,0.1354
"9377",220215,1998,"358",199,159,116,"53",63,0.3166,0.3333,0.324
"9378",220613,1998,"722",417,305,193,"62",131,0.3141,0.2033,0.2673
"9379",220631,1998,"179",122,57,31,"10",21,0.1721,0.1754,0.1732
"9380",220710,1998,"228",132,96,96,"35",61,0.4621,0.3646,0.4211
"9381",221351,1998,"383",206,177,291,"128",163,0.7913,0.7232,0.7598
"9382",221519,1998,"382",198,184,284,"124",160,0.8081,0.6739,0.7435
"9383",221731,1998,"105",61,44,28,"8",20,0.3279,0.1818,0.2667
"9384",221847,1998,"1044",460,584,124,"38",86,0.187,0.0651,0.1188
"9385",221892,1998,"187",111,76,40,"16",24,0.2162,0.2105,0.2139
"9386",222178,1998,"988",541,447,280,"110",170,0.3142,0.2461,0.2834
"9387",222983,1998,"347",190,157,242,"97",145,0.7632,0.6178,0.6974
"9388",223232,1998,"2933",1712,1221,1261,"405",856,0.5,0.3317,0.4299
"9389",224004,1998,"127",75,52,23,"8",15,0.2,0.1538,0.1811
"9390",224323,1998,"291",188,103,207,"67",140,0.7447,0.6505,0.7113
"9391",225432,1998,"696",406,290,8,"3",5,0.0123,0.0103,0.0115
"9392",225548,1998,"315",143,172,66,"25",41,0.2867,0.1453,0.2095
"9393",225627,1998,"375",265,110,59,"10",49,0.1849,0.0909,0.1573
"9394",226231,1998,"257",55,202,72,"48",24,0.4364,0.2376,0.2802
"9395",226833,1998,"685",350,335,74,"26",48,0.1371,0.0776,0.108
"9396",227216,1998,"2449",1400,1049,363,"105",258,0.1843,0.1001,0.1482
"9397",227331,1998,"310",251,59,50,"2",48,0.1912,0.0339,0.1613
"9398",227526,1998,"1197",626,571,132,"42",90,0.1438,0.0736,0.1103
"9399",227757,1998,"642",320,322,489,"228",261,0.8156,0.7081,0.7617
"9400",227845,1998,"367",212,155,95,"34",61,0.2877,0.2194,0.2589
"9401",227863,1998,"231",153,78,65,"12",53,0.3464,0.1538,0.2814
"9402",228042,1998,"198",118,80,39,"17",22,0.1864,0.2125,0.197
"9403",228149,1998,"499",313,186,147,"49",98,0.3131,0.2634,0.2946
"9404",228246,1998,"1306",720,586,689,"249",440,0.6111,0.4249,0.5276
"9405",228343,1998,"378",218,160,227,"74",153,0.7018,0.4625,0.6005
"9406",228431,1998,"2348",1432,916,388,"69",319,0.2228,0.0753,0.1652
"9407",228459,1998,"2592",1546,1046,458,"127",331,0.2141,0.1214,0.1767
"9408",228501,1998,"316",113,203,26,"10",16,0.1416,0.0493,0.0823
"9409",228529,1998,"605",296,309,102,"44",58,0.1959,0.1424,0.1686
"9410",228705,1998,"872",375,497,73,"34",39,0.104,0.0684,0.0837
"9411",228723,1998,"7322",3701,3621,2350,"782",1568,0.4237,0.216,0.321
"9412",228769,1998,"1241",568,673,155,"64",91,0.1602,0.0951,0.1249
"9413",228778,1998,"6598",3388,3210,2590,"1036",1554,0.4587,0.3227,0.3925
"9414",228787,1998,"494",213,281,187,"98",89,0.4178,0.3488,0.3785
"9415",228796,1998,"1639",847,792,58,"21",37,0.0437,0.0265,0.0354
"9416",228875,1998,"1397",839,558,587,"177",410,0.4887,0.3172,0.4202
"9417",228981,1998,"366",180,186,101,"34",67,0.3722,0.1828,0.276
"9418",229018,1998,"112",69,43,19,"7",12,0.1739,0.1628,0.1696
"9419",229027,1998,"2067",1099,968,152,"38",114,0.1037,0.0393,0.0735
"9420",229115,1998,"3149",1581,1568,804,"283",521,0.3295,0.1805,0.2553
"9421",229780,1998,"244",120,124,37,"9",28,0.2333,0.0726,0.1516
"9422",229814,1998,"884",465,419,140,"42",98,0.2108,0.1002,0.1584
"9423",230603,1998,"667",487,180,113,"7",106,0.2177,0.0389,0.1694
"9424",230728,1998,"1764",1229,535,328,"43",285,0.2319,0.0804,0.1859
"9425",230764,1998,"1702",991,711,363,"116",247,0.2492,0.1632,0.2133
"9426",230782,1998,"1453",935,518,147,"36",111,0.1187,0.0695,0.1012
"9427",231059,1998,"518",278,240,378,"166",212,0.7626,0.6917,0.7297
"9428",231174,1998,"1758",994,764,872,"336",536,0.5392,0.4398,0.496
"9429",231420,1998,"145",78,67,31,"18",13,0.1667,0.2687,0.2138
"9430",231554,1998,"129",69,60,4,"1",3,0.0435,0.0167,0.031
"9431",231624,1998,"1290",701,589,1007,"412",595,0.8488,0.6995,0.7806
"9432",231712,1998,"693",414,279,121,"35",86,0.2077,0.1254,0.1746
"9433",232025,1998,"290",144,146,120,"43",77,0.5347,0.2945,0.4138
"9434",232043,1998,"229",130,99,107,"43",64,0.4923,0.4343,0.4672
"9435",232089,1998,"305",128,177,60,"29",31,0.2422,0.1638,0.1967
"9436",232186,1998,"2022",1112,910,540,"164",376,0.3381,0.1802,0.2671
"9437",232265,1998,"1153",715,438,461,"105",356,0.4979,0.2397,0.3998
"9438",232423,1998,"2971",1788,1183,1830,"546",1284,0.7181,0.4615,0.616
"9439",232557,1998,"1020",479,541,327,"126",201,0.4196,0.2329,0.3206
"9440",232566,1998,"812",539,273,362,"91",271,0.5028,0.3333,0.4458
"9441",232609,1998,"433",267,166,218,"65",153,0.573,0.3916,0.5035
"9442",232681,1998,"812",557,255,530,"156",374,0.6715,0.6118,0.6527
"9443",232706,1998,"262",177,85,100,"24",76,0.4294,0.2824,0.3817
"9444",232937,1998,"1092",680,412,95,"26",69,0.1015,0.0631,0.087
"9445",232982,1998,"1561",904,657,324,"82",242,0.2677,0.1248,0.2076
"9446",233277,1998,"1518",1011,507,569,"154",415,0.4105,0.3037,0.3748
"9447",233374,1998,"739",358,381,576,"281",295,0.824,0.7375,0.7794
"9448",233426,1998,"426",272,154,222,"68",154,0.5662,0.4416,0.5211
"9449",233541,1998,"288",178,110,80,"19",61,0.3427,0.1727,0.2778
"9450",233897,1998,"297",146,151,57,"18",39,0.2671,0.1192,0.1919
"9451",233921,1998,"4638",1941,2697,1999,"855",1144,0.5894,0.317,0.431
"9452",234030,1998,"2141",1257,884,364,"117",247,0.1965,0.1324,0.17
"9453",234085,1998,"375",23,352,180,"174",6,0.2609,0.4943,0.48
"9454",234155,1998,"871",526,345,192,"48",144,0.2738,0.1391,0.2204
"9455",234164,1998,"313",191,122,61,"15",46,0.2408,0.123,0.1949
"9456",235097,1998,"816",486,330,148,"34",114,0.2346,0.103,0.1814
"9457",235167,1998,"475",280,195,185,"65",120,0.4286,0.3333,0.3895
"9458",236230,1998,"652",414,238,272,"77",195,0.471,0.3235,0.4172
"9459",236328,1998,"680",417,263,446,"151",295,0.7074,0.5741,0.6559
"9460",236577,1998,"582",376,206,232,"75",157,0.4176,0.3641,0.3986
"9461",236595,1998,"626",369,257,287,"114",173,0.4688,0.4436,0.4585
"9462",236896,1998,"305",165,140,60,"27",33,0.2,0.1929,0.1967
"9463",236939,1998,"2934",1526,1408,888,"335",553,0.3624,0.2379,0.3027
"9464",236948,1998,"4038",2076,1962,1716,"718",998,0.4807,0.366,0.425
"9465",237011,1998,"2104",1221,883,623,"202",421,0.3448,0.2288,0.2961
"9466",237057,1998,"386",204,182,286,"132",154,0.7549,0.7253,0.7409
"9467",237066,1998,"373",224,149,197,"74",123,0.5491,0.4966,0.5282
"9468",237215,1998,"426",215,211,7,"4",3,0.014,0.019,0.0164
"9469",237330,1998,"545",293,252,74,"30",44,0.1502,0.119,0.1358
"9470",237358,1998,"152",87,65,66,"29",37,0.4253,0.4462,0.4342
"9471",237367,1998,"555",311,244,93,"27",66,0.2122,0.1107,0.1676
"9472",237792,1998,"610",356,254,93,"23",70,0.1966,0.0906,0.1525
"9473",237899,1998,"551",282,269,31,"13",18,0.0638,0.0483,0.0563
"9474",237932,1998,"498",268,230,96,"35",61,0.2276,0.1522,0.1928
"9475",237969,1998,"472",247,225,204,"74",130,0.5263,0.3289,0.4322
"9476",238032,1998,"3335",1571,1764,818,"348",470,0.2992,0.1973,0.2453
"9477",238333,1998,"302",180,122,166,"58",108,0.6,0.4754,0.5497
"9478",238430,1998,"224",140,84,71,"28",43,0.3071,0.3333,0.317
"9479",238458,1998,"414",296,118,156,"31",125,0.4223,0.2627,0.3768
"9480",238476,1998,"432",216,216,190,"86",104,0.4815,0.3981,0.4398
"9481",238616,1998,"337",187,150,126,"46",80,0.4278,0.3067,0.3739
"9482",238661,1998,"213",157,56,55,"13",42,0.2675,0.2321,0.2582
"9483",239080,1998,"204",137,67,64,"20",44,0.3212,0.2985,0.3137
"9484",239105,1998,"1730",952,778,960,"355",605,0.6355,0.4563,0.5549
"9485",239628,1998,"162",66,96,99,"55",44,0.6667,0.5729,0.6111
"9486",239716,1998,"460",247,213,282,"106",176,0.7126,0.4977,0.613
"9487",240107,1998,"318",220,98,88,"21",67,0.3045,0.2143,0.2767
"9488",240189,1998,"1901",965,936,354,"122",232,0.2404,0.1303,0.1862
"9489",240277,1998,"946",612,334,155,"53",102,0.1667,0.1587,0.1638
"9490",240329,1998,"1740",1123,617,450,"128",322,0.2867,0.2075,0.2586
"9491",240338,1998,"124",80,44,60,"20",40,0.5,0.4545,0.4839
"9492",240365,1998,"1894",1095,799,252,"67",185,0.1689,0.0839,0.1331
"9493",240374,1998,"790",441,349,83,"24",59,0.1338,0.0688,0.1051
"9494",240417,1998,"1333",614,719,209,"74",135,0.2199,0.1029,0.1568
"9495",240426,1998,"376",218,158,55,"16",39,0.1789,0.1013,0.1463
"9496",240444,1998,"5548",3038,2510,2190,"844",1346,0.4431,0.3363,0.3947
"9497",240453,1998,"2513",1367,1146,273,"102",171,0.1251,0.089,0.1086
"9498",240462,1998,"1118",369,749,134,"63",71,0.1924,0.0841,0.1199
"9499",240471,1998,"1199",773,426,287,"87",200,0.2587,0.2042,0.2394
"9500",240480,1998,"1503",868,635,310,"85",225,0.2592,0.1339,0.2063
"9501",240727,1998,"1225",660,565,306,"104",202,0.3061,0.1841,0.2498
"9502",243443,1998,"885",567,318,76,"10",66,0.1164,0.0314,0.0859
"9503",243780,1998,"6625",2825,3800,2040,"998",1042,0.3688,0.2626,0.3079
"9504",100654,1997,"789",412,377,159,"41",118,0.2864,0.1088,0.2015
"9505",100663,1997,"1115",657,458,161,"52",109,0.1659,0.1135,0.1444
"9506",100751,1997,"2572",1403,1169,859,"307",552,0.3934,0.2626,0.334
"9507",100858,1997,"3140",1676,1464,1165,"385",780,0.4654,0.263,0.371
"9508",101435,1997,"191",114,77,89,"28",61,0.5351,0.3636,0.466
"9509",101480,1997,"764",401,363,123,"43",80,0.1995,0.1185,0.161
"9510",101675,1997,"374",169,205,3,"2",1,0.0059,0.0098,0.008
"9511",101879,1997,"751",448,303,111,"20",91,0.2031,0.066,0.1478
"9512",102049,1997,"745",470,275,405,"139",266,0.566,0.5055,0.5436
"9513",102094,1997,"1132",663,469,138,"38",100,0.1508,0.081,0.1219
"9514",102234,1997,"254",144,110,118,"55",63,0.4375,0.5,0.4646
"9515",102368,1997,"803",474,329,307,"109",198,0.4177,0.3313,0.3823
"9516",102377,1997,"713",466,247,179,"29",150,0.3219,0.1174,0.2511
"9517",104151,1997,"4938",2646,2292,1284,"448",836,0.3159,0.1955,0.26
"9518",104179,1997,"4431",2409,2022,1294,"463",831,0.345,0.229,0.292
"9519",105330,1997,"1983",1169,814,530,"154",376,0.3216,0.1892,0.2673
"9520",106245,1997,"841",503,338,46,"13",33,0.0656,0.0385,0.0547
"9521",106342,1997,"125",63,62,54,"19",35,0.5556,0.3065,0.432
"9522",106397,1997,"2125",1077,1048,515,"191",324,0.3008,0.1823,0.2424
"9523",106412,1997,"608",297,311,51,"12",39,0.1313,0.0386,0.0839
"9524",106458,1997,"1687",922,765,249,"89",160,0.1735,0.1163,0.1476
"9525",106467,1997,"725",376,349,83,"32",51,0.1356,0.0917,0.1145
"9526",106485,1997,"620",342,278,47,"8",39,0.114,0.0288,0.0758
"9527",106704,1997,"1598",1031,567,284,"55",229,0.2221,0.097,0.1777
"9528",107044,1997,"863",495,368,271,"85",186,0.3758,0.231,0.314
"9529",107080,1997,"329",193,136,184,"76",108,0.5596,0.5588,0.5593
"9530",107141,1997,"225",121,104,83,"37",46,0.3802,0.3558,0.3689
"9531",107512,1997,"404",230,174,164,"59",105,0.4565,0.3391,0.4059
"9532",107558,1997,"155",66,89,44,"21",23,0.3485,0.236,0.2839
"9533",110097,1997,"437",296,141,204,"60",144,0.4865,0.4255,0.4668
"9534",110404,1997,"217",64,153,169,"119",50,0.7812,0.7778,0.7788
"9535",110422,1997,"2114",951,1163,318,"108",210,0.2208,0.0929,0.1504
"9536",110486,1997,"467",288,179,49,"15",34,0.1181,0.0838,0.1049
"9537",110495,1997,"409",270,139,84,"19",65,0.2407,0.1367,0.2054
"9538",110510,1997,"890",559,331,83,"26",57,0.102,0.0785,0.0933
"9539",110529,1997,"1856",810,1046,157,"56",101,0.1247,0.0535,0.0846
"9540",110538,1997,"1618",948,670,246,"45",201,0.212,0.0672,0.152
"9541",110547,1997,"512",363,149,17,"2",15,0.0413,0.0134,0.0332
"9542",110556,1997,"1510",901,609,180,"69",111,0.1232,0.1133,0.1192
"9543",110565,1997,"2192",1317,875,215,"48",167,0.1268,0.0549,0.0981
"9544",110574,1997,"711",451,260,94,"26",68,0.1508,0.1,0.1322
"9545",110583,1997,"2498",1597,901,205,"60",145,0.0908,0.0666,0.0821
"9546",110592,1997,"1274",828,446,82,"17",65,0.0785,0.0381,0.0644
"9547",110617,1997,"1350",777,573,95,"31",64,0.0824,0.0541,0.0704
"9548",113698,1997,"74",55,19,24,"5",19,0.3455,0.2632,0.3243
"9549",115755,1997,"718",401,317,85,"14",71,0.1771,0.0442,0.1184
"9550",119173,1997,"258",258,0,82,"0",82,0.3178,NA,0.3178
"9551",120184,1997,"129",79,50,38,"15",23,0.2911,0.3,0.2946
"9552",121309,1997,"494",306,188,187,"64",123,0.402,0.3404,0.3785
"9553",121345,1997,"393",195,198,338,"166",172,0.8821,0.8384,0.8601
"9554",122409,1997,"3008",1766,1242,280,"73",207,0.1172,0.0588,0.0931
"9555",122436,1997,"1036",630,406,589,"194",395,0.627,0.4778,0.5685
"9556",122597,1997,"1732",1086,646,115,"36",79,0.0727,0.0557,0.0664
"9557",122612,1997,"600",385,215,285,"96",189,0.4909,0.4465,0.475
"9558",122931,1997,"1004",543,461,766,"328",438,0.8066,0.7115,0.7629
"9559",123554,1997,"596",348,248,390,"144",246,0.7069,0.5806,0.6544
"9560",123572,1997,"872",581,291,192,"43",149,0.2565,0.1478,0.2202
"9561",126562,1997,"439",245,194,63,"23",40,0.1633,0.1186,0.1435
"9562",126580,1997,"519",298,221,83,"27",56,0.1879,0.1222,0.1599
"9563",126614,1997,"4259",2157,2102,1565,"633",932,0.4321,0.3011,0.3675
"9564",126818,1997,"2615",1435,1180,861,"304",557,0.3882,0.2576,0.3293
"9565",127060,1997,"689",354,335,387,"173",214,0.6045,0.5164,0.5617
"9566",127185,1997,"1056",450,606,97,"39",58,0.1289,0.0644,0.0919
"9567",127565,1997,"1478",787,691,69,"19",50,0.0635,0.0275,0.0467
"9568",127741,1997,"1905",1147,758,490,"107",383,0.3339,0.1412,0.2572
"9569",128106,1997,"580",299,281,49,"20",29,0.097,0.0712,0.0845
"9570",128744,1997,"187",93,94,58,"24",34,0.3656,0.2553,0.3102
"9571",128771,1997,"1213",626,587,82,"36",46,0.0735,0.0613,0.0676
"9572",129020,1997,"2172",1181,991,977,"340",637,0.5394,0.3431,0.4498
"9573",129242,1997,"876",462,414,649,"286",363,0.7857,0.6908,0.7409
"9574",129941,1997,"324",130,194,87,"46",41,0.3154,0.2371,0.2685
"9575",130253,1997,"632",377,255,297,"113",184,0.4881,0.4431,0.4699
"9576",130314,1997,"174",174,0,87,"0",87,0.5,NA,0.5
"9577",130493,1997,"1089",624,465,146,"39",107,0.1715,0.0839,0.1341
"9578",130590,1997,"500",220,280,386,"205",181,0.8227,0.7321,0.772
"9579",130697,1997,"700",371,329,583,"263",320,0.8625,0.7994,0.8329
"9580",130776,1997,"668",303,365,90,"35",55,0.1815,0.0959,0.1347
"9581",130794,1997,"1307",662,645,1170,"552",618,0.9335,0.8558,0.8952
"9582",130934,1997,"637",359,278,121,"35",86,0.2396,0.1259,0.19
"9583",130943,1997,"3179",1881,1298,1823,"622",1201,0.6385,0.4792,0.5735
"9584",131159,1997,"1056",665,391,678,"239",439,0.6602,0.6113,0.642
"9585",131283,1997,"567",313,254,337,"148",189,0.6038,0.5827,0.5944
"9586",131450,1997,"211",116,95,10,"3",7,0.0603,0.0316,0.0474
"9587",131469,1997,"1716",972,744,1185,"485",700,0.7202,0.6519,0.6906
"9588",131496,1997,"1394",757,637,1247,"561",686,0.9062,0.8807,0.8945
"9589",131520,1997,"1098",715,383,402,"98",304,0.4252,0.2559,0.3661
"9590",132471,1997,"176",112,64,58,"18",40,0.3571,0.2812,0.3295
"9591",132602,1997,"749",388,361,77,"25",52,0.134,0.0693,0.1028
"9592",132903,1997,"2839",1510,1329,785,"265",520,0.3444,0.1994,0.2765
"9593",133492,1997,"386",230,156,230,"88",142,0.6174,0.5641,0.5959
"9594",133553,1997,"1020",136,884,213,"184",29,0.2132,0.2081,0.2088
"9595",133650,1997,"1947",1148,799,328,"84",244,0.2125,0.1051,0.1685
"9596",133669,1997,"1174",669,505,161,"54",107,0.1599,0.1069,0.1371
"9597",133711,1997,"424",272,152,176,"55",121,0.4449,0.3618,0.4151
"9598",133881,1997,"367",112,255,128,"84",44,0.3929,0.3294,0.3488
"9599",133951,1997,"1987",1144,843,352,"91",261,0.2281,0.1079,0.1772
"9600",134079,1997,"428",270,158,196,"67",129,0.4778,0.4241,0.4579
"9601",134097,1997,"4491",2525,1966,1822,"606",1216,0.4816,0.3082,0.4057
"9602",134130,1997,"5959",3307,2652,2950,"1073",1877,0.5676,0.4046,0.495
"9603",134945,1997,"290",125,165,65,"19",46,0.368,0.1152,0.2241
"9604",135726,1997,"1814",960,854,962,"421",541,0.5635,0.493,0.5303
"9605",136172,1997,"1105",646,459,269,"77",192,0.2972,0.1678,0.2434
"9606",136950,1997,"415",253,162,192,"65",127,0.502,0.4012,0.4627
"9607",137546,1997,"504",289,215,283,"104",179,0.6194,0.4837,0.5615
"9608",138354,1997,"620",372,248,101,"28",73,0.1962,0.1129,0.1629
"9609",138716,1997,"575",359,216,35,"9",26,0.0724,0.0417,0.0609
"9610",138789,1997,"690",470,220,50,"7",43,0.0915,0.0318,0.0725
"9611",139144,1997,"504",332,172,295,"99",196,0.5904,0.5756,0.5853
"9612",139366,1997,"612",354,258,53,"14",39,0.1102,0.0543,0.0866
"9613",139393,1997,"197",112,85,89,"31",58,0.5179,0.3647,0.4518
"9614",139658,1997,"1477",762,715,1120,"525",595,0.7808,0.7343,0.7583
"9615",139719,1997,"502",270,232,75,"19",56,0.2074,0.0819,0.1494
"9616",139755,1997,"2069",565,1504,487,"305",182,0.3221,0.2028,0.2354
"9617",139764,1997,"449",283,166,85,"29",56,0.1979,0.1747,0.1893
"9618",139861,1997,"818",528,290,130,"31",99,0.1875,0.1069,0.1589
"9619",139931,1997,"2596",1387,1209,306,"81",225,0.1622,0.067,0.1179
"9620",139940,1997,"1906",1172,734,211,"60",151,0.1288,0.0817,0.1107
"9621",139959,1997,"4348",2544,1804,1729,"569",1160,0.456,0.3154,0.3977
"9622",140447,1997,"679",428,251,215,"70",145,0.3388,0.2789,0.3166
"9623",140960,1997,"455",240,215,19,"4",15,0.0625,0.0186,0.0418
"9624",140988,1997,"242",162,80,90,"26",64,0.3951,0.325,0.3719
"9625",141185,1997,"263",157,106,79,"29",50,0.3185,0.2736,0.3004
"9626",141264,1997,"1594",947,647,179,"50",129,0.1362,0.0773,0.1123
"9627",141334,1997,"1208",718,490,135,"29",106,0.1476,0.0592,0.1118
"9628",141486,1997,"146",105,41,30,"9",21,0.2,0.2195,0.2055
"9629",141565,1997,"335",202,133,36,"11",25,0.1238,0.0827,0.1075
"9630",141574,1997,"1439",807,632,174,"50",124,0.1537,0.0791,0.1209
"9631",142276,1997,"1400",793,607,44,"11",33,0.0416,0.0181,0.0314
"9632",142285,1997,"1360",687,673,240,"82",158,0.23,0.1218,0.1765
"9633",142461,1997,"277",148,129,91,"37",54,0.3649,0.2868,0.3285
"9634",143084,1997,"564",328,236,400,"146",254,0.7744,0.6186,0.7092
"9635",143288,1997,"155",81,74,39,"11",28,0.3457,0.1486,0.2516
"9636",144005,1997,"487",332,155,6,"1",5,0.0151,0.0065,0.0123
"9637",144281,1997,"1078",519,559,147,"61",86,0.1657,0.1091,0.1364
"9638",144740,1997,"1211",713,498,566,"212",354,0.4965,0.4257,0.4674
"9639",144892,1997,"1552",950,602,479,"121",358,0.3768,0.201,0.3086
"9640",144962,1997,"289",155,134,2,"1",1,0.0065,0.0075,0.0069
"9641",144971,1997,"141",50,91,54,"25",29,0.58,0.2747,0.383
"9642",145600,1997,"2820",1560,1260,460,"165",295,0.1891,0.131,0.1631
"9643",145619,1997,"300",129,171,117,"56",61,0.4729,0.3275,0.39
"9644",145637,1997,"5789",2865,2924,3331,"1523",1808,0.6311,0.5209,0.5754
"9645",145691,1997,"242",148,94,102,"30",72,0.4865,0.3191,0.4215
"9646",145813,1997,"3253",1981,1272,1016,"297",719,0.3629,0.2335,0.3123
"9647",146481,1997,"337",191,146,205,"77",128,0.6702,0.5274,0.6083
"9648",146612,1997,"386",176,210,145,"70",75,0.4261,0.3333,0.3756
"9649",146719,1997,"1189",758,431,558,"189",369,0.4868,0.4385,0.4693
"9650",146825,1997,"127",49,78,47,"24",23,0.4694,0.3077,0.3701
"9651",147013,1997,"242",131,111,98,"35",63,0.4809,0.3153,0.405
"9652",147244,1997,"569",302,267,286,"112",174,0.5762,0.4195,0.5026
"9653",147341,1997,"272",176,96,150,"48",102,0.5795,0.5,0.5515
"9654",147703,1997,"2673",1444,1229,691,"252",439,0.304,0.205,0.2585
"9655",147767,1997,"1889",959,930,1578,"743",835,0.8707,0.7989,0.8354
"9656",147776,1997,"1007",630,377,25,"9",16,0.0254,0.0239,0.0248
"9657",147828,1997,"426",229,197,170,"53",117,0.5109,0.269,0.3991
"9658",148131,1997,"224",116,108,77,"26",51,0.4397,0.2407,0.3438
"9659",148496,1997,"199",140,59,99,"28",71,0.5071,0.4746,0.4975
"9660",148584,1997,"134",82,52,48,"13",35,0.4268,0.25,0.3582
"9661",148627,1997,"270",180,90,82,"21",61,0.3389,0.2333,0.3037
"9662",149222,1997,"2400",1051,1349,451,"188",263,0.2502,0.1394,0.1879
"9663",149231,1997,"1219",734,485,242,"65",177,0.2411,0.134,0.1985
"9664",149772,1997,"1602",833,769,450,"180",270,0.3241,0.2341,0.2809
"9665",149781,1997,"546",290,256,418,"189",229,0.7897,0.7383,0.7656
"9666",150066,1997,"451",266,185,172,"54",118,0.4436,0.2919,0.3814
"9667",150136,1997,"4047",2177,1870,837,"242",595,0.2733,0.1294,0.2068
"9668",150145,1997,"223",144,79,97,"33",64,0.4444,0.4177,0.435
"9669",150163,1997,"699",458,241,369,"120",249,0.5437,0.4979,0.5279
"9670",150400,1997,"673",363,310,493,"228",265,0.73,0.7355,0.7325
"9671",150534,1997,"719",424,295,312,"108",204,0.4811,0.3661,0.4339
"9672",150668,1997,"209",116,93,89,"32",57,0.4914,0.3441,0.4258
"9673",150941,1997,"197",129,68,95,"21",74,0.5736,0.3088,0.4822
"9674",151102,1997,"1196",659,537,49,"7",42,0.0637,0.013,0.041
"9675",151111,1997,"2154",1198,956,113,"55",58,0.0484,0.0575,0.0525
"9676",151306,1997,"1839",1053,786,239,"63",176,0.1671,0.0802,0.13
"9677",151324,1997,"1878",998,880,356,"127",229,0.2295,0.1443,0.1896
"9678",151333,1997,"306",204,102,17,"5",12,0.0588,0.049,0.0556
"9679",151342,1997,"629",384,245,47,"20",27,0.0703,0.0816,0.0747
"9680",151351,1997,"6036",3497,2539,2827,"1045",1782,0.5096,0.4116,0.4684
"9681",151360,1997,"508",340,168,21,"7",14,0.0412,0.0417,0.0413
"9682",151379,1997,"641",376,265,57,"12",45,0.1197,0.0453,0.0889
"9683",151388,1997,"278",193,85,14,"7",7,0.0363,0.0824,0.0504
"9684",151777,1997,"288",135,153,122,"47",75,0.5556,0.3072,0.4236
"9685",151786,1997,"255",156,99,73,"21",52,0.3333,0.2121,0.2863
"9686",152080,1997,"1904",875,1029,1675,"879",796,0.9097,0.8542,0.8797
"9687",152248,1997,"1071",556,515,101,"49",52,0.0935,0.0951,0.0943
"9688",152363,1997,"267",138,129,112,"46",66,0.4783,0.3566,0.4195
"9689",152530,1997,"486",262,224,321,"143",178,0.6794,0.6384,0.6605
"9690",152600,1997,"702",382,320,416,"163",253,0.6623,0.5094,0.5926
"9691",153001,1997,"385",185,200,169,"70",99,0.5351,0.35,0.439
"9692",153108,1997,"306",178,128,183,"67",116,0.6517,0.5234,0.598
"9693",153269,1997,"636",368,268,389,"141",248,0.6739,0.5261,0.6116
"9694",153384,1997,"413",234,179,330,"140",190,0.812,0.7821,0.799
"9695",153603,1997,"4007",1790,2217,1081,"437",644,0.3598,0.1971,0.2698
"9696",153834,1997,"629",385,244,431,"161",270,0.7013,0.6598,0.6852
"9697",154095,1997,"1920",1192,728,553,"169",384,0.3221,0.2321,0.288
"9698",155089,1997,"179",99,80,39,"11",28,0.2828,0.1375,0.2179
"9699",155317,1997,"3808",1989,1819,1093,"424",669,0.3363,0.2331,0.287
"9700",155335,1997,"89",50,39,22,"10",12,0.24,0.2564,0.2472
"9701",155399,1997,"2906",1382,1524,640,"232",408,0.2952,0.1522,0.2202
"9702",155520,1997,"256",140,116,107,"38",69,0.4929,0.3276,0.418
"9703",155627,1997,"149",39,110,39,"23",16,0.4103,0.2091,0.2617
"9704",155937,1997,"140",56,84,45,"21",24,0.4286,0.25,0.3214
"9705",156213,1997,"365",223,142,179,"66",113,0.5067,0.4648,0.4904
"9706",156286,1997,"318",178,140,155,"62",93,0.5225,0.4429,0.4874
"9707",156295,1997,"404",239,165,118,"36",82,0.3431,0.2182,0.2921
"9708",156365,1997,"342",182,160,93,"32",61,0.3352,0.2,0.2719
"9709",156541,1997,"418",227,191,87,"30",57,0.2511,0.1571,0.2081
"9710",156745,1997,"394",239,155,208,"59",149,0.6234,0.3806,0.5279
"9711",157058,1997,"302",172,130,33,"5",28,0.1628,0.0385,0.1093
"9712",157076,1997,"203",131,72,84,"27",57,0.4351,0.375,0.4138
"9713",157085,1997,"2740",1499,1241,743,"281",462,0.3082,0.2264,0.2712
"9714",157289,1997,"1931",1024,907,241,"86",155,0.1514,0.0948,0.1248
"9715",157386,1997,"1227",674,553,160,"55",105,0.1558,0.0995,0.1304
"9716",157401,1997,"1206",691,515,184,"51",133,0.1925,0.099,0.1526
"9717",157447,1997,"1657",949,708,84,"21",63,0.0664,0.0297,0.0507
"9718",157535,1997,"178",110,68,25,"8",17,0.1545,0.1176,0.1404
"9719",157951,1997,"2205",1244,961,445,"148",297,0.2387,0.154,0.2018
"9720",158477,1997,"226",116,110,88,"28",60,0.5172,0.2545,0.3894
"9721",159009,1997,"799",408,391,52,"25",27,0.0662,0.0639,0.0651
"9722",159391,1997,"4443",2533,1910,959,"319",640,0.2527,0.167,0.2158
"9723",159647,1997,"1428",714,714,361,"133",228,0.3193,0.1863,0.2528
"9724",159717,1997,"1447",779,668,116,"27",89,0.1142,0.0404,0.0802
"9725",159966,1997,"1075",646,429,81,"14",67,0.1037,0.0326,0.0753
"9726",160038,1997,"1415",878,537,129,"35",94,0.1071,0.0652,0.0912
"9727",160612,1997,"2487",1371,1116,107,"24",83,0.0605,0.0215,0.043
"9728",160621,1997,"1853",997,856,106,"28",78,0.0782,0.0327,0.0572
"9729",160658,1997,"2764",1543,1221,169,"44",125,0.081,0.036,0.0611
"9730",161004,1997,"473",246,227,384,"175",209,0.8496,0.7709,0.8118
"9731",161226,1997,"466",308,158,148,"28",120,0.3896,0.1772,0.3176
"9732",161235,1997,"77",47,30,5,"0",5,0.1064,0,0.0649
"9733",161244,1997,"121",63,58,9,"3",6,0.0952,0.0517,0.0744
"9734",161253,1997,"1091",513,578,327,"144",183,0.3567,0.2491,0.2997
"9735",161554,1997,"760",450,310,90,"31",59,0.1311,0.1,0.1184
"9736",162007,1997,"357",190,167,44,"8",36,0.1895,0.0479,0.1232
"9737",162210,1997,"164",99,65,34,"11",23,0.2323,0.1692,0.2073
"9738",162283,1997,"382",268,114,17,"3",14,0.0522,0.0263,0.0445
"9739",162584,1997,"865",444,421,210,"71",139,0.3131,0.1686,0.2428
"9740",162654,1997,"335",255,80,212,"49",163,0.6392,0.6125,0.6328
"9741",162760,1997,"162",158,4,109,"3",106,0.6709,0.75,0.6728
"9742",162928,1997,"941",411,530,749,"411",338,0.8224,0.7755,0.796
"9743",163046,1997,"833",478,355,650,"258",392,0.8201,0.7268,0.7803
"9744",163268,1997,"1135",605,530,343,"133",210,0.3471,0.2509,0.3022
"9745",163286,1997,"3950",1873,2077,1699,"731",968,0.5168,0.3519,0.4301
"9746",163453,1997,"1016",588,428,176,"30",146,0.2483,0.0701,0.1732
"9747",163462,1997,"325",179,146,221,"95",126,0.7039,0.6507,0.68
"9748",163851,1997,"886",515,371,418,"133",285,0.5534,0.3585,0.4718
"9749",163912,1997,"345",194,151,232,"92",140,0.7216,0.6093,0.6725
"9750",164076,1997,"1808",1079,729,557,"166",391,0.3624,0.2277,0.3081
"9751",164173,1997,"367",259,108,122,"21",101,0.39,0.1944,0.3324
"9752",164216,1997,"290",162,128,182,"79",103,0.6358,0.6172,0.6276
"9753",164270,1997,"427",241,186,274,"98",176,0.7303,0.5269,0.6417
"9754",164447,1997,"253",133,120,79,"30",49,0.3684,0.25,0.3123
"9755",164492,1997,"135",90,45,54,"19",35,0.3889,0.4222,0.4
"9756",164562,1997,"582",365,217,386,"137",249,0.6822,0.6313,0.6632
"9757",165015,1997,"794",470,324,633,"250",383,0.8149,0.7716,0.7972
"9758",165024,1997,"1147",672,475,206,"46",160,0.2381,0.0968,0.1796
"9759",165334,1997,"520",313,207,313,"110",203,0.6486,0.5314,0.6019
"9760",165662,1997,"547",333,214,343,"130",213,0.6396,0.6075,0.6271
"9761",165671,1997,"112",112,0,59,"0",59,0.5268,NA,0.5268
"9762",165820,1997,"488",270,218,104,"29",75,0.2778,0.133,0.2131
"9763",165866,1997,"590",397,193,120,"25",95,0.2393,0.1295,0.2034
"9764",165936,1997,"406",279,127,206,"68",138,0.4946,0.5354,0.5074
"9765",166027,1997,"1642",782,860,1436,"744",692,0.8849,0.8651,0.8745
"9766",166124,1997,"726",409,317,635,"270",365,0.8924,0.8517,0.8747
"9767",166513,1997,"989",367,622,232,"104",128,0.3488,0.1672,0.2346
"9768",166629,1997,"3831",2012,1819,1635,"614",1021,0.5075,0.3375,0.4268
"9769",166638,1997,"533",284,249,65,"25",40,0.1408,0.1004,0.122
"9770",166683,1997,"1066",405,661,861,"521",340,0.8395,0.7882,0.8077
"9771",167288,1997,"274",152,122,89,"30",59,0.3882,0.2459,0.3248
"9772",167987,1997,"835",440,395,217,"72",145,0.3295,0.1823,0.2599
"9773",167996,1997,"530",287,243,429,"185",244,0.8502,0.7613,0.8094
"9774",168005,1997,"525",299,226,198,"70",128,0.4281,0.3097,0.3771
"9775",168148,1997,"1270",659,611,1063,"498",565,0.8574,0.8151,0.837
"9776",168254,1997,"526",220,306,210,"98",112,0.5091,0.3203,0.3992
"9777",168281,1997,"438",277,161,298,"97",201,0.7256,0.6025,0.6804
"9778",168342,1997,"544",266,278,499,"253",246,0.9248,0.9101,0.9173
"9779",168546,1997,"474",260,214,301,"114",187,0.7192,0.5327,0.635
"9780",168786,1997,"329",204,125,79,"30",49,0.2402,0.24,0.2401
"9781",169080,1997,"1053",614,439,595,"243",352,0.5733,0.5535,0.5651
"9782",169798,1997,"2314",1372,942,260,"80",180,0.1312,0.0849,0.1124
"9783",169910,1997,"1906",763,1143,46,"21",25,0.0328,0.0184,0.0241
"9784",170082,1997,"2406",1494,912,410,"120",290,0.1941,0.1316,0.1704
"9785",170301,1997,"721",432,289,450,"164",286,0.662,0.5675,0.6241
"9786",170532,1997,"290",170,120,201,"78",123,0.7235,0.65,0.6931
"9787",170639,1997,"522",239,283,71,"34",37,0.1548,0.1201,0.136
"9788",170976,1997,"5535",2763,2772,3619,"1656",1963,0.7105,0.5974,0.6538
"9789",171100,1997,"6804",3723,3081,2232,"751",1481,0.3978,0.2438,0.328
"9790",171128,1997,"1251",295,956,329,"224",105,0.3559,0.2343,0.263
"9791",171137,1997,"696",378,318,96,"29",67,0.1772,0.0912,0.1379
"9792",171146,1997,"552",337,215,30,"10",20,0.0593,0.0465,0.0543
"9793",171599,1997,"228",73,155,2,"0",2,0.0274,0,0.0088
"9794",172051,1997,"818",461,357,55,"12",43,0.0933,0.0336,0.0672
"9795",172699,1997,"3213",1835,1378,592,"211",381,0.2076,0.1531,0.1843
"9796",173160,1997,"447",281,166,279,"98",181,0.6441,0.5904,0.6242
"9797",173258,1997,"484",255,229,412,"195",217,0.851,0.8515,0.8512
"9798",173328,1997,"222",132,90,86,"32",54,0.4091,0.3556,0.3874
"9799",173647,1997,"625",353,272,438,"174",264,0.7479,0.6397,0.7008
"9800",173902,1997,"450",251,199,339,"140",199,0.7928,0.7035,0.7533
"9801",174066,1997,"4371",2282,2089,1208,"467",741,0.3247,0.2236,0.2764
"9802",174233,1997,"1679",843,836,363,"140",223,0.2645,0.1675,0.2162
"9803",174251,1997,"461",271,190,161,"53",108,0.3985,0.2789,0.3492
"9804",174491,1997,"372",231,141,162,"61",101,0.4372,0.4326,0.4355
"9805",174792,1997,"450",0,450,335,"335",0,NA,0.7444,0.7444
"9806",174844,1997,"722",416,306,539,"227",312,0.75,0.7418,0.7465
"9807",174899,1997,"244",180,64,141,"32",109,0.6056,0.5,0.5779
"9808",174914,1997,"955",514,441,595,"237",358,0.6965,0.5374,0.623
"9809",175342,1997,"532",299,233,138,"42",96,0.3211,0.1803,0.2594
"9810",175421,1997,"86",42,44,28,"11",17,0.4048,0.25,0.3256
"9811",175616,1997,"521",338,183,136,"40",96,0.284,0.2186,0.261
"9812",175856,1997,"808",463,345,124,"28",96,0.2073,0.0812,0.1535
"9813",175980,1997,"299",159,140,188,"84",104,0.6541,0.6,0.6288
"9814",176017,1997,"1770",948,822,578,"209",369,0.3892,0.2543,0.3266
"9815",176035,1997,"231",193,38,71,"6",65,0.3368,0.1579,0.3074
"9816",176044,1997,"343",198,145,73,"23",50,0.2525,0.1586,0.2128
"9817",176080,1997,"2016",965,1051,462,"162",300,0.3109,0.1541,0.2292
"9818",176406,1997,"206",146,60,66,"11",55,0.3767,0.1833,0.3204
"9819",176628,1997,"96",57,39,29,"6",23,0.4035,0.1538,0.3021
"9820",176947,1997,"233",115,118,72,"25",47,0.4087,0.2119,0.309
"9821",176965,1997,"1323",718,605,298,"88",210,0.2925,0.1455,0.2252
"9822",177418,1997,"171",124,47,50,"10",40,0.3226,0.2128,0.2924
"9823",178059,1997,"223",173,50,114,"26",88,0.5087,0.52,0.5112
"9824",178341,1997,"675",368,307,61,"19",42,0.1141,0.0619,0.0904
"9825",178387,1997,"985",572,413,135,"42",93,0.1626,0.1017,0.1371
"9826",178396,1997,"3512",1935,1577,1290,"461",829,0.4284,0.2923,0.3673
"9827",178402,1997,"588",321,267,79,"27",52,0.162,0.1011,0.1344
"9828",178411,1997,"692",168,524,99,"76",23,0.1369,0.145,0.1431
"9829",178420,1997,"458",242,216,60,"12",48,0.1983,0.0556,0.131
"9830",178615,1997,"1654",1020,634,593,"175",418,0.4098,0.276,0.3585
"9831",179043,1997,"319",175,144,181,"78",103,0.5886,0.5417,0.5674
"9832",179159,1997,"1084",609,475,601,"246",355,0.5829,0.5179,0.5544
"9833",179557,1997,"1124",713,411,248,"65",183,0.2567,0.1582,0.2206
"9834",179566,1997,"2704",1543,1161,522,"180",342,0.2216,0.155,0.193
"9835",179867,1997,"1230",646,584,976,"424",552,0.8545,0.726,0.7935
"9836",179894,1997,"314",193,121,124,"41",83,0.4301,0.3388,0.3949
"9837",179946,1997,"190",71,119,78,"40",38,0.5352,0.3361,0.4105
"9838",180179,1997,"508",334,174,121,"28",93,0.2784,0.1609,0.2382
"9839",180461,1997,"1819",784,1035,259,"116",143,0.1824,0.1121,0.1424
"9840",180522,1997,"235",89,146,28,"16",12,0.1348,0.1096,0.1191
"9841",180984,1997,"277",152,125,64,"22",42,0.2763,0.176,0.231
"9842",181002,1997,"798",457,341,466,"184",282,0.6171,0.5396,0.584
"9843",181020,1997,"260",134,126,135,"55",80,0.597,0.4365,0.5192
"9844",181127,1997,"282",145,137,145,"50",95,0.6552,0.365,0.5142
"9845",181215,1997,"1005",570,435,174,"60",114,0.2,0.1379,0.1731
"9846",181394,1997,"1185",615,570,95,"33",62,0.1008,0.0579,0.0802
"9847",181446,1997,"437",250,187,205,"87",118,0.472,0.4652,0.4691
"9848",181464,1997,"3195",1596,1599,681,"259",422,0.2644,0.162,0.2131
"9849",181534,1997,"258",107,151,38,"16",22,0.2056,0.106,0.1473
"9850",181783,1997,"707",407,300,161,"42",119,0.2924,0.14,0.2277
"9851",182281,1997,"1491",773,718,183,"54",129,0.1669,0.0752,0.1227
"9852",182290,1997,"1165",654,511,171,"54",117,0.1789,0.1057,0.1468
"9853",182634,1997,"240",172,68,111,"29",82,0.4767,0.4265,0.4625
"9854",182795,1997,"489",257,232,178,"69",109,0.4241,0.2974,0.364
"9855",183062,1997,"845",501,344,193,"71",122,0.2435,0.2064,0.2284
"9856",183080,1997,"844",396,448,163,"75",88,0.2222,0.1674,0.1931
"9857",183239,1997,"508",283,225,350,"134",216,0.7633,0.5956,0.689
"9858",183822,1997,"312",213,99,26,"8",18,0.0845,0.0808,0.0833
"9859",183974,1997,"104",65,39,24,"8",16,0.2462,0.2051,0.2308
"9860",184348,1997,"418",243,175,294,"117",177,0.7284,0.6686,0.7033
"9861",184603,1997,"519",265,254,83,"27",56,0.2113,0.1063,0.1599
"9862",184612,1997,"112",94,18,9,"0",9,0.0957,0,0.0804
"9863",184782,1997,"1038",552,486,321,"119",202,0.3659,0.2449,0.3092
"9864",185129,1997,"455",237,218,34,"13",21,0.0886,0.0596,0.0747
"9865",185572,1997,"801",432,369,264,"87",177,0.4097,0.2358,0.3296
"9866",185590,1997,"1148",709,439,230,"62",168,0.237,0.1412,0.2003
"9867",185828,1997,"568",105,463,88,"73",15,0.1429,0.1577,0.1549
"9868",186131,1997,"1129",511,618,1033,"562",471,0.9217,0.9094,0.915
"9869",186201,1997,"453",228,225,125,"53",72,0.3158,0.2356,0.2759
"9870",186283,1997,"751",435,316,340,"135",205,0.4713,0.4272,0.4527
"9871",186584,1997,"1056",547,509,409,"157",252,0.4607,0.3084,0.3873
"9872",186876,1997,"700",415,285,283,"93",190,0.4578,0.3263,0.4043
"9873",187134,1997,"1396",847,549,870,"305",565,0.6671,0.5556,0.6232
"9874",187444,1997,"1032",563,469,154,"51",103,0.1829,0.1087,0.1492
"9875",187985,1997,"2047",1132,915,244,"71",173,0.1528,0.0776,0.1192
"9876",188030,1997,"1694",901,793,201,"70",131,0.1454,0.0883,0.1187
"9877",188429,1997,"289",174,115,130,"49",81,0.4655,0.4261,0.4498
"9878",188641,1997,"467",205,262,204,"99",105,0.5122,0.3779,0.4368
"9879",190044,1997,"612",136,476,378,"297",81,0.5956,0.6239,0.6176
"9880",190099,1997,"711",364,347,599,"276",323,0.8874,0.7954,0.8425
"9881",190150,1997,"1271",583,688,1036,"547",489,0.8388,0.7951,0.8151
"9882",190248,1997,"113",71,42,41,"13",28,0.3944,0.3095,0.3628
"9883",190415,1997,"2998",1405,1593,2551,"1307",1244,0.8854,0.8205,0.8509
"9884",190512,1997,"1109",608,501,202,"75",127,0.2089,0.1497,0.1821
"9885",190549,1997,"1344",774,570,194,"75",119,0.1537,0.1316,0.1443
"9886",190558,1997,"1418",729,689,32,"7",25,0.0343,0.0102,0.0226
"9887",190567,1997,"947",464,483,44,"17",27,0.0582,0.0352,0.0465
"9888",190594,1997,"1630",1137,493,136,"26",110,0.0967,0.0527,0.0834
"9889",190637,1997,"736",519,217,45,"11",34,0.0655,0.0507,0.0611
"9890",190664,1997,"1153",675,478,227,"65",162,0.24,0.136,0.1969
"9891",190691,1997,"500",323,177,38,"12",26,0.0805,0.0678,0.076
"9892",190725,1997,"416",313,103,87,"22",65,0.2077,0.2136,0.2091
"9893",191241,1997,"1459",849,610,1075,"445",630,0.742,0.7295,0.7368
"9894",191515,1997,"457",239,218,381,"172",209,0.8745,0.789,0.8337
"9895",191533,1997,"388",197,191,209,"94",115,0.5838,0.4921,0.5387
"9896",191630,1997,"549",284,265,354,"174",180,0.6338,0.6566,0.6448
"9897",191649,1997,"1743",928,815,648,"221",427,0.4601,0.2712,0.3718
"9898",191676,1997,"310",198,112,179,"65",114,0.5758,0.5804,0.5774
"9899",191931,1997,"695",312,383,263,"98",165,0.5288,0.2559,0.3784
"9900",191968,1997,"1417",801,616,909,"362",547,0.6829,0.5877,0.6415
"9901",192192,1997,"141",112,29,69,"12",57,0.5089,0.4138,0.4894
"9902",192323,1997,"453",292,161,299,"101",198,0.6781,0.6273,0.66
"9903",192439,1997,"915",595,320,33,"13",20,0.0336,0.0406,0.0361
"9904",192703,1997,"527",235,292,269,"134",135,0.5745,0.4589,0.5104
"9905",192749,1997,"294",202,92,148,"40",108,0.5347,0.4348,0.5034
"9906",192819,1997,"973",532,441,570,"232",338,0.6353,0.5261,0.5858
"9907",192925,1997,"164",102,62,19,"6",13,0.1275,0.0968,0.1159
"9908",193016,1997,"1052",692,360,46,"16",30,0.0434,0.0444,0.0437
"9909",193292,1997,"156",112,44,46,"6",40,0.3571,0.1364,0.2949
"9910",193353,1997,"260",177,83,121,"43",78,0.4407,0.5181,0.4654
"9911",193399,1997,"225",168,57,95,"18",77,0.4583,0.3158,0.4222
"9912",193584,1997,"351",257,94,214,"59",155,0.6031,0.6277,0.6097
"9913",193645,1997,"758",643,115,165,"18",147,0.2286,0.1565,0.2177
"9914",193654,1997,"465",308,157,205,"56",149,0.4838,0.3567,0.4409
"9915",193900,1997,"3557",2054,1503,1963,"775",1188,0.5784,0.5156,0.5519
"9916",193973,1997,"705",417,288,299,"102",197,0.4724,0.3542,0.4241
"9917",194161,1997,"208",114,94,46,"17",29,0.2544,0.1809,0.2212
"9918",194310,1997,"1476",859,617,588,"203",385,0.4482,0.329,0.3984
"9919",194824,1997,"1069",267,802,584,"414",170,0.6367,0.5162,0.5463
"9920",195003,1997,"1836",617,1219,727,"446",281,0.4554,0.3659,0.396
"9921",195030,1997,"892",404,488,592,"301",291,0.7203,0.6168,0.6637
"9922",195164,1997,"542",274,268,309,"144",165,0.6022,0.5373,0.5701
"9923",195173,1997,"410",253,157,95,"26",69,0.2727,0.1656,0.2317
"9924",195216,1997,"476",232,244,328,"148",180,0.7759,0.6066,0.6891
"9925",195234,1997,"311",223,88,146,"29",117,0.5247,0.3295,0.4695
"9926",195243,1997,"300",179,121,106,"34",72,0.4022,0.281,0.3533
"9927",195304,1997,"283",222,61,174,"33",141,0.6351,0.541,0.6148
"9928",195474,1997,"583",301,282,400,"181",219,0.7276,0.6418,0.6861
"9929",195526,1997,"605",372,233,452,"175",277,0.7446,0.7511,0.7471
"9930",195544,1997,"107",74,33,60,"18",42,0.5676,0.5455,0.5607
"9931",195809,1997,"2480",1358,1122,789,"311",478,0.352,0.2772,0.3181
"9932",196413,1997,"2562",1417,1145,1773,"713",1060,0.7481,0.6227,0.692
"9933",196592,1997,"2028",1457,571,85,"27",58,0.0398,0.0473,0.0419
"9934",197045,1997,"320",216,104,130,"44",86,0.3981,0.4231,0.4062
"9935",197133,1997,"646",409,237,529,"186",343,0.8386,0.7848,0.8189
"9936",197869,1997,"2161",1177,984,711,"235",476,0.4044,0.2388,0.329
"9937",197984,1997,"159",68,91,61,"27",34,0.5,0.2967,0.3836
"9938",198385,1997,"470",230,240,417,"206",211,0.9174,0.8583,0.8872
"9939",198464,1997,"2871",1718,1153,705,"222",483,0.2811,0.1925,0.2456
"9940",198507,1997,"424",251,173,133,"33",100,0.3984,0.1908,0.3137
"9941",198516,1997,"964",584,380,599,"207",392,0.6712,0.5447,0.6214
"9942",198835,1997,"306",167,139,119,"41",78,0.4671,0.295,0.3889
"9943",198969,1997,"350",107,243,69,"41",28,0.2617,0.1687,0.1971
"9944",199102,1997,"1383",727,656,363,"118",245,0.337,0.1799,0.2625
"9945",199111,1997,"470",264,206,138,"49",89,0.3371,0.2379,0.2936
"9946",199120,1997,"3412",2118,1294,2371,"816",1555,0.7342,0.6306,0.6949
"9947",199139,1997,"1904",1077,827,418,"155",263,0.2442,0.1874,0.2195
"9948",199148,1997,"1577",1091,486,431,"90",341,0.3126,0.1852,0.2733
"9949",199157,1997,"712",467,245,202,"45",157,0.3362,0.1837,0.2837
"9950",199193,1997,"3756",1496,2260,961,"427",534,0.357,0.1889,0.2559
"9951",199218,1997,"1350",837,513,478,"149",329,0.3931,0.2904,0.3541
"9952",199281,1997,"480",258,222,98,"34",64,0.2481,0.1532,0.2042
"9953",199306,1997,"162",59,103,40,"21",19,0.322,0.2039,0.2469
"9954",199412,1997,"198",142,56,80,"20",60,0.4225,0.3571,0.404
"9955",199582,1997,"400",228,172,60,"14",46,0.2018,0.0814,0.15
"9956",199643,1997,"304",173,131,43,"12",31,0.1792,0.0916,0.1414
"9957",199847,1997,"962",483,479,739,"338",401,0.8302,0.7056,0.7682
"9958",199962,1997,"296",123,173,103,"43",60,0.4878,0.2486,0.348
"9959",199999,1997,"485",329,156,117,"27",90,0.2736,0.1731,0.2412
"9960",200004,1997,"1224",629,595,310,"100",210,0.3339,0.1681,0.2533
"9961",200059,1997,"408",233,175,39,"15",24,0.103,0.0857,0.0956
"9962",200156,1997,"232",134,98,100,"36",64,0.4776,0.3673,0.431
"9963",200217,1997,"381",242,139,131,"32",99,0.4091,0.2302,0.3438
"9964",200226,1997,"129",73,56,20,"6",14,0.1918,0.1071,0.155
"9965",200253,1997,"442",270,172,38,"9",29,0.1074,0.0523,0.086
"9966",200280,1997,"1516",742,774,222,"94",128,0.1725,0.1214,0.1464
"9967",200332,1997,"1199",497,702,194,"83",111,0.2233,0.1182,0.1618
"9968",200572,1997,"177",100,77,37,"8",29,0.29,0.1039,0.209
"9969",201104,1997,"531",302,229,220,"76",144,0.4768,0.3319,0.4143
"9970",201371,1997,"254",149,105,124,"37",87,0.5839,0.3524,0.4882
"9971",201548,1997,"478",290,188,239,"82",157,0.5414,0.4362,0.5
"9972",201645,1997,"736",269,467,408,"235",173,0.6431,0.5032,0.5543
"9973",201690,1997,"88",47,41,4,"0",4,0.0851,0,0.0455
"9974",202134,1997,"924",464,460,89,"36",53,0.1142,0.0783,0.0963
"9975",202480,1997,"1622",872,750,896,"351",545,0.625,0.468,0.5524
"9976",202523,1997,"593",325,268,438,"185",253,0.7785,0.6903,0.7386
"9977",202763,1997,"651",390,261,264,"75",189,0.4846,0.2874,0.4055
"9978",203085,1997,"264",114,150,127,"58",69,0.6053,0.3867,0.4811
"9979",203128,1997,"240",123,117,136,"54",82,0.6667,0.4615,0.5667
"9980",203368,1997,"790",408,382,495,"217",278,0.6814,0.5681,0.6266
"9981",203517,1997,"2573",1524,1049,508,"173",335,0.2198,0.1649,0.1974
"9982",203535,1997,"441",255,186,349,"143",206,0.8078,0.7688,0.7914
"9983",203580,1997,"70",47,23,29,"13",16,0.3404,0.5652,0.4143
"9984",203775,1997,"464",293,171,208,"73",135,0.4608,0.4269,0.4483
"9985",203845,1997,"331",163,168,157,"72",85,0.5215,0.4286,0.4743
"9986",204024,1997,"3379",1914,1465,2180,"855",1325,0.6923,0.5836,0.6452
"9987",204185,1997,"540",297,243,306,"113",193,0.6498,0.465,0.5667
"9988",204194,1997,"333",195,138,119,"45",74,0.3795,0.3261,0.3574
"9989",204617,1997,"180",101,79,65,"18",47,0.4653,0.2278,0.3611
"9990",204796,1997,"5897",3081,2816,1719,"555",1164,0.3778,0.1971,0.2915
"9991",204857,1997,"3255",1913,1342,1401,"427",974,0.5091,0.3182,0.4304
"9992",206330,1997,"96",40,56,12,"4",8,0.2,0.0714,0.125
"9993",206589,1997,"538",289,249,328,"130",198,0.6851,0.5221,0.6097
"9994",206604,1997,"2025",1103,922,336,"126",210,0.1904,0.1367,0.1659
"9995",206622,1997,"757",439,318,512,"220",292,0.6651,0.6918,0.6764
"9996",206695,1997,"1764",924,840,231,"85",146,0.158,0.1012,0.131
"9997",206914,1997,"615",322,293,50,"21",29,0.0901,0.0717,0.0813
"9998",207209,1997,"566",304,262,34,"3",31,0.102,0.0115,0.0601
"9999",207306,1997,"293",148,145,35,"11",24,0.1622,0.0759,0.1195
"10000",207324,1997,"453",222,231,73,"32",41,0.1847,0.1385,0.1611
"10001",207388,1997,"2321",1214,1107,565,"194",371,0.3056,0.1752,0.2434
"10002",207500,1997,"2895",1523,1372,552,"195",357,0.2344,0.1421,0.1907
"10003",207722,1997,"222",133,89,32,"9",23,0.1729,0.1011,0.1441
"10004",207847,1997,"578",314,264,89,"33",56,0.1783,0.125,0.154
"10005",207865,1997,"717",386,331,107,"28",79,0.2047,0.0846,0.1492
"10006",208822,1997,"345",225,120,212,"70",142,0.6311,0.5833,0.6145
"10007",209056,1997,"463",272,191,289,"121",168,0.6176,0.6335,0.6242
"10008",209065,1997,"410",235,175,244,"91",153,0.6511,0.52,0.5951
"10009",209542,1997,"1869",860,1009,525,"212",313,0.364,0.2101,0.2809
"10010",209551,1997,"2384",1307,1077,856,"314",542,0.4147,0.2916,0.3591
"10011",209612,1997,"261",175,86,129,"39",90,0.5143,0.4535,0.4943
"10012",209807,1997,"743",368,375,96,"37",59,0.1603,0.0987,0.1292
"10013",209922,1997,"315",176,139,146,"59",87,0.4943,0.4245,0.4635
"10014",210146,1997,"759",426,333,142,"47",95,0.223,0.1411,0.1871
"10015",210401,1997,"410",224,186,299,"131",168,0.75,0.7043,0.7293
"10016",210429,1997,"759",481,278,103,"35",68,0.1414,0.1259,0.1357
"10017",210571,1997,"295",137,158,176,"83",93,0.6788,0.5253,0.5966
"10018",210669,1997,"541",289,252,328,"139",189,0.654,0.5516,0.6063
"10019",210775,1997,"155",95,60,64,"26",38,0.4,0.4333,0.4129
"10020",211088,1997,"260",191,69,142,"34",108,0.5654,0.4928,0.5462
"10021",211158,1997,"1355",893,462,459,"125",334,0.374,0.2706,0.3387
"10022",211291,1997,"898",426,472,752,"380",372,0.8732,0.8051,0.8374
"10023",211352,1997,"339",231,108,160,"39",121,0.5238,0.3611,0.472
"10024",211361,1997,"942",446,496,163,"64",99,0.222,0.129,0.173
"10025",211431,1997,"142",139,3,50,"1",49,0.3525,0.3333,0.3521
"10026",211440,1997,"1270",464,806,841,"522",319,0.6875,0.6476,0.6622
"10027",211468,1997,"195",194,1,122,"1",121,0.6237,1,0.6256
"10028",211556,1997,"92",92,0,51,"0",51,0.5543,NA,0.5543
"10029",211583,1997,"92",92,0,51,"0",51,0.5543,NA,0.5543
"10030",211608,1997,"236",122,114,18,"4",14,0.1148,0.0351,0.0763
"10031",211644,1997,"1220",751,469,294,"84",210,0.2796,0.1791,0.241
"10032",211981,1997,"407",185,222,149,"58",91,0.4919,0.2613,0.3661
"10033",212009,1997,"563",354,209,429,"148",281,0.7938,0.7081,0.762
"10034",212054,1997,"1776",729,1047,231,"73",158,0.2167,0.0697,0.1301
"10035",212106,1997,"1211",716,495,599,"225",374,0.5223,0.4545,0.4946
"10036",212115,1997,"886",532,354,166,"34",132,0.2481,0.096,0.1874
"10037",212133,1997,"305",211,94,171,"40",131,0.6209,0.4255,0.5607
"10038",212160,1997,"1251",729,522,234,"63",171,0.2346,0.1207,0.1871
"10039",212197,1997,"438",298,140,265,"74",191,0.6409,0.5286,0.605
"10040",212577,1997,"504",251,253,402,"202",200,0.7968,0.7984,0.7976
"10041",212601,1997,"533",318,215,244,"74",170,0.5346,0.3442,0.4578
"10042",212832,1997,"65",54,11,26,"4",22,0.4074,0.3636,0.4
"10043",212911,1997,"298",150,148,264,"127",137,0.9133,0.8581,0.8859
"10044",213020,1997,"2620",1479,1141,618,"176",442,0.2989,0.1543,0.2359
"10045",213251,1997,"342",186,156,232,"89",143,0.7688,0.5705,0.6784
"10046",213321,1997,"435",195,240,260,"121",139,0.7128,0.5042,0.5977
"10047",213349,1997,"1497",837,660,252,"72",180,0.2151,0.1091,0.1683
"10048",213358,1997,"184",101,83,91,"44",47,0.4653,0.5301,0.4946
"10049",213367,1997,"834",479,355,476,"184",292,0.6096,0.5183,0.5707
"10050",213385,1997,"568",263,305,456,"230",226,0.8593,0.7541,0.8028
"10051",213507,1997,"303",174,129,185,"71",114,0.6552,0.5504,0.6106
"10052",213543,1997,"1097",442,655,803,"444",359,0.8122,0.6779,0.732
"10053",213613,1997,"822",430,392,188,"67",121,0.2814,0.1709,0.2287
"10054",213668,1997,"379",227,152,214,"65",149,0.6564,0.4276,0.5646
"10055",213783,1997,"597",329,268,141,"53",88,0.2675,0.1978,0.2362
"10056",213826,1997,"276",209,67,103,"18",85,0.4067,0.2687,0.3732
"10057",213996,1997,"689",445,244,445,"165",280,0.6292,0.6762,0.6459
"10058",214041,1997,"1068",627,441,409,"132",277,0.4418,0.2993,0.383
"10059",214069,1997,"240",174,66,162,"32",130,0.7471,0.4848,0.675
"10060",214157,1997,"325",190,135,219,"86",133,0.7,0.637,0.6738
"10061",214175,1997,"493",293,200,352,"135",217,0.7406,0.675,0.714
"10062",214272,1997,"187",126,61,59,"15",44,0.3492,0.2459,0.3155
"10063",214777,1997,"5185",2686,2499,2497,"980",1517,0.5648,0.3922,0.4816
"10064",215062,1997,"2324",1132,1192,1928,"941",987,0.8719,0.7894,0.8296
"10065",215743,1997,"354",200,154,79,"22",57,0.285,0.1429,0.2232
"10066",215798,1997,"272",129,143,159,"77",82,0.6357,0.5385,0.5846
"10067",215929,1997,"905",538,367,644,"247",397,0.7379,0.673,0.7116
"10068",216010,1997,"1292",741,551,476,"178",298,0.4022,0.323,0.3684
"10069",216038,1997,"1193",684,509,248,"76",172,0.2515,0.1493,0.2079
"10070",216287,1997,"373",193,180,309,"136",173,0.8964,0.7556,0.8284
"10071",216339,1997,"2149",1233,916,503,"176",327,0.2652,0.1921,0.2341
"10072",216524,1997,"314",162,152,236,"117",119,0.7346,0.7697,0.7516
"10073",216694,1997,"309",123,186,132,"72",60,0.4878,0.3871,0.4272
"10074",216764,1997,"1581",1025,556,409,"93",316,0.3083,0.1673,0.2587
"10075",216807,1997,"394",239,155,259,"93",166,0.6946,0.6,0.6574
"10076",216852,1997,"391",174,217,145,"65",80,0.4598,0.2995,0.3708
"10077",216931,1997,"355",168,187,161,"72",89,0.5298,0.385,0.4535
"10078",217059,1997,"842",496,346,348,"128",220,0.4435,0.3699,0.4133
"10079",217156,1997,"1368",722,646,1136,"527",609,0.8435,0.8158,0.8304
"10080",217402,1997,"974",563,411,801,"326",475,0.8437,0.7932,0.8224
"10081",217536,1997,"479",318,161,219,"55",164,0.5157,0.3416,0.4572
"10082",217776,1997,"101",51,50,27,"9",18,0.3529,0.18,0.2673
"10083",217819,1997,"1568",1031,537,565,"130",435,0.4219,0.2421,0.3603
"10084",217882,1997,"2579",1265,1314,997,"341",656,0.5186,0.2595,0.3866
"10085",217998,1997,"132",78,54,85,"31",54,0.6923,0.5741,0.6439
"10086",218061,1997,"582",336,246,99,"34",65,0.1935,0.1382,0.1701
"10087",218229,1997,"434",288,146,94,"23",71,0.2465,0.1575,0.2166
"10088",218238,1997,"193",92,101,4,"3",1,0.0109,0.0297,0.0207
"10089",218399,1997,"262",180,82,68,"15",53,0.2944,0.1829,0.2595
"10090",218414,1997,"161",52,109,41,"22",19,0.3654,0.2018,0.2547
"10091",218663,1997,"2919",1596,1323,1065,"393",672,0.4211,0.2971,0.3649
"10092",218724,1997,"826",443,383,121,"43",78,0.1761,0.1123,0.1465
"10093",218733,1997,"601",320,281,169,"52",117,0.3656,0.1851,0.2812
"10094",218742,1997,"539",327,212,81,"18",63,0.1927,0.0849,0.1503
"10095",218973,1997,"296",139,157,210,"102",108,0.777,0.6497,0.7095
"10096",219000,1997,"326",209,117,171,"53",118,0.5646,0.453,0.5245
"10097",219046,1997,"451",227,224,38,"8",30,0.1322,0.0357,0.0843
"10098",219082,1997,"249",135,114,1,"1",0,0,0.0088,0.004
"10099",219198,1997,"129",96,33,47,"12",35,0.3646,0.3636,0.3643
"10100",219259,1997,"539",321,218,83,"22",61,0.19,0.1009,0.154
"10101",219356,1997,"1531",741,790,346,"130",216,0.2915,0.1646,0.226
"10102",219471,1997,"896",503,393,213,"80",133,0.2644,0.2036,0.2377
"10103",219602,1997,"788",503,285,144,"40",104,0.2068,0.1404,0.1827
"10104",219709,1997,"399",248,151,197,"67",130,0.5242,0.4437,0.4937
"10105",219718,1997,"65",26,39,8,"2",6,0.2308,0.0513,0.1231
"10106",219949,1997,"186",91,95,42,"10",32,0.3516,0.1053,0.2258
"10107",220075,1997,"1487",853,634,192,"70",122,0.143,0.1104,0.1291
"10108",220215,1997,"294",181,113,100,"40",60,0.3315,0.354,0.3401
"10109",220613,1997,"655",379,276,149,"50",99,0.2612,0.1812,0.2275
"10110",220631,1997,"134",88,46,39,"15",24,0.2727,0.3261,0.291
"10111",220710,1997,"245",117,128,99,"44",55,0.4701,0.3438,0.4041
"10112",221351,1997,"422",239,183,301,"128",173,0.7238,0.6995,0.7133
"10113",221519,1997,"364",195,169,285,"130",155,0.7949,0.7692,0.783
"10114",221731,1997,"96",61,35,35,"12",23,0.377,0.3429,0.3646
"10115",221847,1997,"1089",466,623,100,"33",67,0.1438,0.053,0.0918
"10116",221892,1997,"179",100,79,30,"9",21,0.21,0.1139,0.1676
"10117",222178,1997,"964",530,434,259,"97",162,0.3057,0.2235,0.2687
"10118",222983,1997,"317",150,167,215,"103",112,0.7467,0.6168,0.6782
"10119",223232,1997,"2404",1416,988,967,"300",667,0.471,0.3036,0.4022
"10120",224004,1997,"125",57,68,15,"7",8,0.1404,0.1029,0.12
"10121",224323,1997,"261",160,101,136,"47",89,0.5562,0.4653,0.5211
"10122",225432,1997,"679",374,305,14,"2",12,0.0321,0.0066,0.0206
"10123",225548,1997,"323",112,211,66,"32",34,0.3036,0.1517,0.2043
"10124",225627,1997,"341",233,108,47,"10",37,0.1588,0.0926,0.1378
"10125",226231,1997,"209",50,159,65,"45",20,0.4,0.283,0.311
"10126",226833,1997,"668",329,339,37,"13",24,0.0729,0.0383,0.0554
"10127",227216,1997,"2292",1310,982,303,"83",220,0.1679,0.0845,0.1322
"10128",227331,1997,"372",293,79,59,"10",49,0.1672,0.1266,0.1586
"10129",227526,1997,"1183",670,513,127,"34",93,0.1388,0.0663,0.1074
"10130",227757,1997,"703",334,369,516,"248",268,0.8024,0.6721,0.734
"10131",227845,1997,"359",216,143,98,"38",60,0.2778,0.2657,0.273
"10132",227863,1997,"235",155,80,58,"19",39,0.2516,0.2375,0.2468
"10133",228042,1997,"194",116,78,40,"16",24,0.2069,0.2051,0.2062
"10134",228149,1997,"507",311,196,170,"50",120,0.3859,0.2551,0.3353
"10135",228246,1997,"1247",686,561,702,"282",420,0.6122,0.5027,0.563
"10136",228343,1997,"332",177,155,201,"85",116,0.6554,0.5484,0.6054
"10137",228431,1997,"2360",1422,938,358,"71",287,0.2018,0.0757,0.1517
"10138",228459,1997,"2331",1399,932,413,"107",306,0.2187,0.1148,0.1772
"10139",228501,1997,"280",113,167,20,"12",8,0.0708,0.0719,0.0714
"10140",228529,1997,"595",306,289,98,"38",60,0.1961,0.1315,0.1647
"10141",228705,1997,"898",402,496,47,"15",32,0.0796,0.0302,0.0523
"10142",228723,1997,"6169",3158,3011,1953,"619",1334,0.4224,0.2056,0.3166
"10143",228769,1997,"1270",644,626,250,"105",145,0.2252,0.1677,0.1969
"10144",228778,1997,"6945",3568,3377,2531,"990",1541,0.4319,0.2932,0.3644
"10145",228787,1997,"444",183,261,143,"77",66,0.3607,0.295,0.3221
"10146",228796,1997,"1482",750,732,36,"15",21,0.028,0.0205,0.0243
"10147",228875,1997,"1463",885,578,563,"167",396,0.4475,0.2889,0.3848
"10148",228981,1997,"312",186,126,118,"38",80,0.4301,0.3016,0.3782
"10149",229018,1997,"113",60,53,17,"2",15,0.25,0.0377,0.1504
"10150",229027,1997,"1749",938,811,109,"30",79,0.0842,0.037,0.0623
"10151",229115,1997,"3221",1625,1596,764,"302",462,0.2843,0.1892,0.2372
"10152",229780,1997,"241",132,109,58,"21",37,0.2803,0.1927,0.2407
"10153",229814,1997,"854",414,440,105,"33",72,0.1739,0.075,0.123
"10154",230603,1997,"717",530,187,113,"18",95,0.1792,0.0963,0.1576
"10155",230728,1997,"1465",1029,436,304,"60",244,0.2371,0.1376,0.2075
"10156",230764,1997,"1962",1039,923,407,"133",274,0.2637,0.1441,0.2074
"10157",230782,1997,"1503",978,525,152,"37",115,0.1176,0.0705,0.1011
"10158",231059,1997,"528",279,249,358,"158",200,0.7168,0.6345,0.678
"10159",231174,1997,"1823",1005,818,959,"381",578,0.5751,0.4658,0.5261
"10160",231420,1997,"160",91,69,43,"16",27,0.2967,0.2319,0.2688
"10161",231554,1997,"130",64,66,44,"19",25,0.3906,0.2879,0.3385
"10162",231624,1997,"1327",802,525,1063,"381",682,0.8504,0.7257,0.8011
"10163",231712,1997,"665",398,267,88,"29",59,0.1482,0.1086,0.1323
"10164",232025,1997,"197",98,99,92,"35",57,0.5816,0.3535,0.467
"10165",232043,1997,"242",138,104,109,"44",65,0.471,0.4231,0.4504
"10166",232089,1997,"240",102,138,72,"35",37,0.3627,0.2536,0.3
"10167",232186,1997,"1930",1072,858,437,"140",297,0.2771,0.1632,0.2264
"10168",232265,1997,"1218",765,453,459,"119",340,0.4444,0.2627,0.3768
"10169",232423,1997,"3059",1791,1268,1855,"643",1212,0.6767,0.5071,0.6064
"10170",232557,1997,"995",531,464,279,"101",178,0.3352,0.2177,0.2804
"10171",232566,1997,"728",513,215,303,"67",236,0.46,0.3116,0.4162
"10172",232609,1997,"477",275,202,220,"72",148,0.5382,0.3564,0.4612
"10173",232681,1997,"808",547,261,479,"129",350,0.6399,0.4943,0.5928
"10174",232706,1997,"261",190,71,111,"28",83,0.4368,0.3944,0.4253
"10175",232937,1997,"1132",700,432,104,"30",74,0.1057,0.0694,0.0919
"10176",232982,1997,"1464",791,673,207,"54",153,0.1934,0.0802,0.1414
"10177",233277,1997,"1619",1048,571,551,"145",406,0.3874,0.2539,0.3403
"10178",233374,1997,"750",367,383,548,"258",290,0.7902,0.6736,0.7307
"10179",233426,1997,"438",248,190,225,"70",155,0.625,0.3684,0.5137
"10180",233541,1997,"257",159,98,61,"17",44,0.2767,0.1735,0.2374
"10181",233897,1997,"303",155,148,80,"28",52,0.3355,0.1892,0.264
"10182",233921,1997,"4522",1818,2704,1903,"869",1034,0.5688,0.3214,0.4208
"10183",234030,1997,"2175",1301,874,337,"106",231,0.1776,0.1213,0.1549
"10184",234085,1997,"394",20,374,201,"188",13,0.65,0.5027,0.5102
"10185",234155,1997,"865",493,372,170,"48",122,0.2475,0.129,0.1965
"10186",234164,1997,"304",155,149,3,"1",2,0.0129,0.0067,0.0099
"10187",235097,1997,"624",367,257,86,"21",65,0.1771,0.0817,0.1378
"10188",235167,1997,"494",271,223,186,"71",115,0.4244,0.3184,0.3765
"10189",236230,1997,"660",394,266,303,"87",216,0.5482,0.3271,0.4591
"10190",236328,1997,"642",390,252,430,"155",275,0.7051,0.6151,0.6698
"10191",236577,1997,"584",392,192,233,"63",170,0.4337,0.3281,0.399
"10192",236595,1997,"499",288,211,220,"78",142,0.4931,0.3697,0.4409
"10193",236896,1997,"283",142,141,62,"29",33,0.2324,0.2057,0.2191
"10194",236939,1997,"2276",1191,1085,657,"235",422,0.3543,0.2166,0.2887
"10195",236948,1997,"4346",2270,2076,1734,"667",1067,0.47,0.3213,0.399
"10196",237011,1997,"2068",1266,802,601,"176",425,0.3357,0.2195,0.2906
"10197",237057,1997,"370",223,147,277,"97",180,0.8072,0.6599,0.7486
"10198",237066,1997,"398",212,186,226,"103",123,0.5802,0.5538,0.5678
"10199",237215,1997,"423",237,186,6,"0",6,0.0253,0,0.0142
"10200",237330,1997,"726",390,336,121,"49",72,0.1846,0.1458,0.1667
"10201",237358,1997,"95",54,41,6,"3",3,0.0556,0.0732,0.0632
"10202",237367,1997,"540",300,240,115,"45",70,0.2333,0.1875,0.213
"10203",237792,1997,"643",341,302,111,"43",68,0.1994,0.1424,0.1726
"10204",237899,1997,"581",288,293,33,"13",20,0.0694,0.0444,0.0568
"10205",237932,1997,"491",257,234,77,"21",56,0.2179,0.0897,0.1568
"10206",237969,1997,"480",260,220,201,"72",129,0.4962,0.3273,0.4188
"10207",238032,1997,"3079",1431,1648,794,"344",450,0.3145,0.2087,0.2579
"10208",238333,1997,"339",194,145,204,"73",131,0.6753,0.5034,0.6018
"10209",238430,1997,"226",149,77,55,"19",36,0.2416,0.2468,0.2434
"10210",238458,1997,"459",287,172,232,"65",167,0.5819,0.3779,0.5054
"10211",238476,1997,"395",201,194,174,"75",99,0.4925,0.3866,0.4405
"10212",238616,1997,"253",147,106,128,"45",83,0.5646,0.4245,0.5059
"10213",238661,1997,"222",164,58,53,"11",42,0.2561,0.1897,0.2387
"10214",239080,1997,"208",119,89,62,"16",46,0.3866,0.1798,0.2981
"10215",239105,1997,"1573",830,743,876,"351",525,0.6325,0.4724,0.5569
"10216",239628,1997,"135",62,73,71,"35",36,0.5806,0.4795,0.5259
"10217",239716,1997,"480",288,192,324,"121",203,0.7049,0.6302,0.675
"10218",240107,1997,"331",240,91,96,"18",78,0.325,0.1978,0.29
"10219",240189,1997,"1881",944,937,349,"138",211,0.2235,0.1473,0.1855
"10220",240277,1997,"895",568,327,141,"39",102,0.1796,0.1193,0.1575
"10221",240329,1997,"1700",1042,658,386,"108",278,0.2668,0.1641,0.2271
"10222",240338,1997,"109",61,48,50,"21",29,0.4754,0.4375,0.4587
"10223",240365,1997,"1719",994,725,242,"69",173,0.174,0.0952,0.1408
"10224",240374,1997,"726",440,286,87,"24",63,0.1432,0.0839,0.1198
"10225",240417,1997,"1241",604,637,170,"47",123,0.2036,0.0738,0.137
"10226",240426,1997,"326",182,144,36,"13",23,0.1264,0.0903,0.1104
"10227",240444,1997,"5828",3156,2672,2303,"835",1468,0.4651,0.3125,0.3952
"10228",240453,1997,"2272",1263,1009,327,"124",203,0.1607,0.1229,0.1439
"10229",240462,1997,"978",304,674,138,"69",69,0.227,0.1024,0.1411
"10230",240471,1997,"1144",698,446,269,"79",190,0.2722,0.1771,0.2351
"10231",240480,1997,"1527",837,690,262,"78",184,0.2198,0.113,0.1716
"10232",240727,1997,"1119",562,557,276,"97",179,0.3185,0.1741,0.2466
"10233",243443,1997,"723",471,252,50,"6",44,0.0934,0.0238,0.0692
"10234",243780,1997,"6369",2806,3563,1994,"953",1041,0.371,0.2675,0.3131
"10235",100654,1996,"716",372,344,147,"44",103,0.2769,0.1279,0.2053
"10236",100663,1996,"1027",597,430,134,"35",99,0.1658,0.0814,0.1305
"10237",100751,1996,"2049",1195,854,744,"240",504,0.4218,0.281,0.3631
"10238",100858,1996,"3287",1746,1541,1321,"446",875,0.5011,0.2894,0.4019
"10239",101435,1996,"165",95,70,62,"16",46,0.4842,0.2286,0.3758
"10240",101480,1996,"817",446,371,122,"23",99,0.222,0.062,0.1493
"10241",101675,1996,"327",146,181,125,"58",67,0.4589,0.3204,0.3823
"10242",101879,1996,"790",459,331,99,"28",71,0.1547,0.0846,0.1253
"10243",102049,1996,"646",388,258,329,"117",212,0.5464,0.4535,0.5093
"10244",102094,1996,"1066",590,476,147,"37",110,0.1864,0.0777,0.1379
"10245",102234,1996,"201",121,80,96,"32",64,0.5289,0.4,0.4776
"10246",102368,1996,"877",483,394,340,"133",207,0.4286,0.3376,0.3877
"10247",102377,1996,"810",497,313,180,"34",146,0.2938,0.1086,0.2222
"10248",104151,1996,"4001",2117,1884,1028,"398",630,0.2976,0.2113,0.2569
"10249",104179,1996,"4006",2102,1904,1145,"441",704,0.3349,0.2316,0.2858
"10250",105330,1996,"2267",1288,979,538,"170",368,0.2857,0.1736,0.2373
"10251",106245,1996,"691",429,262,65,"18",47,0.1096,0.0687,0.0941
"10252",106342,1996,"129",69,60,60,"22",38,0.5507,0.3667,0.4651
"10253",106397,1996,"2174",1105,1069,490,"184",306,0.2769,0.1721,0.2254
"10254",106412,1996,"575",302,273,47,"12",35,0.1159,0.044,0.0817
"10255",106458,1996,"1592",893,699,216,"64",152,0.1702,0.0916,0.1357
"10256",106467,1996,"668",339,329,94,"40",54,0.1593,0.1216,0.1407
"10257",106485,1996,"453",240,213,44,"19",25,0.1042,0.0892,0.0971
"10258",106704,1996,"1478",928,550,239,"69",170,0.1832,0.1255,0.1617
"10259",107044,1996,"846",497,349,266,"85",181,0.3642,0.2436,0.3144
"10260",107080,1996,"306",185,121,188,"78",110,0.5946,0.6446,0.6144
"10261",107141,1996,"266",148,118,101,"37",64,0.4324,0.3136,0.3797
"10262",107512,1996,"451",237,214,184,"69",115,0.4852,0.3224,0.408
"10263",107558,1996,"110",52,58,37,"14",23,0.4423,0.2414,0.3364
"10264",110097,1996,"407",268,139,184,"62",122,0.4552,0.446,0.4521
"10265",110404,1996,"216",64,152,156,"112",44,0.6875,0.7368,0.7222
"10266",110422,1996,"2757",1202,1555,448,"132",316,0.2629,0.0849,0.1625
"10267",110486,1996,"418",253,165,56,"14",42,0.166,0.0848,0.134
"10268",110495,1996,"381",244,137,85,"22",63,0.2582,0.1606,0.2231
"10269",110510,1996,"882",554,328,78,"18",60,0.1083,0.0549,0.0884
"10270",110529,1996,"1497",647,850,128,"56",72,0.1113,0.0659,0.0855
"10271",110538,1996,"1524",874,650,173,"35",138,0.1579,0.0538,0.1135
"10272",110547,1996,"475",358,117,24,"3",21,0.0587,0.0256,0.0505
"10273",110556,1996,"1503",846,657,198,"54",144,0.1702,0.0822,0.1317
"10274",110565,1996,"2028",1158,870,199,"48",151,0.1304,0.0552,0.0981
"10275",110574,1996,"661",420,241,83,"26",57,0.1357,0.1079,0.1256
"10276",110583,1996,"2299",1407,892,152,"38",114,0.081,0.0426,0.0661
"10277",110592,1996,"1313",763,550,51,"15",36,0.0472,0.0273,0.0388
"10278",110617,1996,"1396",826,570,84,"23",61,0.0738,0.0404,0.0602
"10279",113698,1996,"58",41,17,23,"6",17,0.4146,0.3529,0.3966
"10280",115755,1996,"823",471,352,62,"13",49,0.104,0.0369,0.0753
"10281",119173,1996,"112",112,0,61,"0",61,0.5446,NA,0.5446
"10282",120184,1996,"124",75,49,49,"16",33,0.44,0.3265,0.3952
"10283",121309,1996,"515",313,202,218,"70",148,0.4728,0.3465,0.4233
"10284",121345,1996,"396",187,209,331,"173",158,0.8449,0.8278,0.8359
"10285",122409,1996,"2908",1752,1156,208,"55",153,0.0873,0.0476,0.0715
"10286",122436,1996,"1042",569,473,542,"213",329,0.5782,0.4503,0.5202
"10287",122597,1996,"1727",1102,625,111,"35",76,0.069,0.056,0.0643
"10288",122612,1996,"616",413,203,307,"89",218,0.5278,0.4384,0.4984
"10289",122931,1996,"1075",586,489,798,"349",449,0.7662,0.7137,0.7423
"10290",123554,1996,"488",288,200,307,"102",205,0.7118,0.51,0.6291
"10291",123572,1996,"781",502,279,156,"36",120,0.239,0.129,0.1997
"10292",126562,1996,"373",215,158,54,"20",34,0.1581,0.1266,0.1448
"10293",126580,1996,"375",227,148,63,"18",45,0.1982,0.1216,0.168
"10294",126614,1996,"3953",1983,1970,1529,"623",906,0.4569,0.3162,0.3868
"10295",126818,1996,"2695",1511,1184,847,"307",540,0.3574,0.2593,0.3143
"10296",127060,1996,"717",372,345,389,"168",221,0.5941,0.487,0.5425
"10297",127185,1996,"1124",493,631,122,"43",79,0.1602,0.0681,0.1085
"10298",127565,1996,"1324",677,647,51,"15",36,0.0532,0.0232,0.0385
"10299",127741,1996,"1642",1000,642,413,"120",293,0.293,0.1869,0.2515
"10300",128106,1996,"574",305,269,68,"19",49,0.1607,0.0706,0.1185
"10301",128744,1996,"116",58,58,35,"17",18,0.3103,0.2931,0.3017
"10302",128771,1996,"1092",534,558,165,"65",100,0.1873,0.1165,0.1511
"10303",129020,1996,"2142",1156,986,908,"311",597,0.5164,0.3154,0.4239
"10304",129242,1996,"876",440,436,642,"299",343,0.7795,0.6858,0.7329
"10305",129941,1996,"329",109,220,68,"40",28,0.2569,0.1818,0.2067
"10306",130253,1996,"602",361,241,281,"81",200,0.554,0.3361,0.4668
"10307",130314,1996,"164",164,0,66,"0",66,0.4024,NA,0.4024
"10308",130493,1996,"1009",587,422,137,"39",98,0.167,0.0924,0.1358
"10309",130590,1996,"504",238,266,387,"195",192,0.8067,0.7331,0.7679
"10310",130697,1996,"738",374,364,633,"311",322,0.861,0.8544,0.8577
"10311",130776,1996,"496",242,254,60,"32",28,0.1157,0.126,0.121
"10312",130794,1996,"1403",688,715,1235,"611",624,0.907,0.8545,0.8803
"10313",130934,1996,"544",305,239,87,"21",66,0.2164,0.0879,0.1599
"10314",130943,1996,"3290",1980,1310,1823,"623",1200,0.6061,0.4756,0.5541
"10315",131159,1996,"1107",703,404,643,"224",419,0.596,0.5545,0.5808
"10316",131283,1996,"452",264,188,261,"100",161,0.6098,0.5319,0.5774
"10317",131450,1996,"186",105,81,13,"6",7,0.0667,0.0741,0.0699
"10318",131469,1996,"1643",973,670,1082,"427",655,0.6732,0.6373,0.6586
"10319",131496,1996,"1408",760,648,1256,"569",687,0.9039,0.8781,0.892
"10320",131520,1996,"1002",648,354,463,"126",337,0.5201,0.3559,0.4621
"10321",132471,1996,"177",101,76,40,"16",24,0.2376,0.2105,0.226
"10322",132602,1996,"575",322,253,93,"20",73,0.2267,0.0791,0.1617
"10323",132903,1996,"2579",1316,1263,672,"219",453,0.3442,0.1734,0.2606
"10324",133492,1996,"429",260,169,242,"84",158,0.6077,0.497,0.5641
"10325",133553,1996,"711",95,616,132,"119",13,0.1368,0.1932,0.1857
"10326",133650,1996,"1717",1017,700,281,"83",198,0.1947,0.1186,0.1637
"10327",133669,1996,"1001",551,450,155,"57",98,0.1779,0.1267,0.1548
"10328",133711,1996,"355",217,138,143,"45",98,0.4516,0.3261,0.4028
"10329",133881,1996,"491",149,342,171,"101",70,0.4698,0.2953,0.3483
"10330",133951,1996,"1846",1067,779,314,"87",227,0.2127,0.1117,0.1701
"10331",134079,1996,"458",287,171,224,"67",157,0.547,0.3918,0.4891
"10332",134097,1996,"3999",2329,1670,1583,"536",1047,0.4495,0.321,0.3958
"10333",134130,1996,"5171",2899,2272,2599,"929",1670,0.5761,0.4089,0.5026
"10334",134945,1996,"365",197,168,113,"44",69,0.3503,0.2619,0.3096
"10335",135726,1996,"1678",893,785,887,"381",506,0.5666,0.4854,0.5286
"10336",136172,1996,"987",583,404,213,"62",151,0.259,0.1535,0.2158
"10337",136950,1996,"418",240,178,194,"69",125,0.5208,0.3876,0.4641
"10338",137546,1996,"416",229,187,211,"83",128,0.559,0.4439,0.5072
"10339",138354,1996,"459",261,198,107,"39",68,0.2605,0.197,0.2331
"10340",138716,1996,"503",281,222,34,"10",24,0.0854,0.045,0.0676
"10341",138789,1996,"805",519,286,60,"14",46,0.0886,0.049,0.0745
"10342",139144,1996,"539",339,200,252,"79",173,0.5103,0.395,0.4675
"10343",139366,1996,"616",383,233,43,"10",33,0.0862,0.0429,0.0698
"10344",139393,1996,"206",119,87,109,"43",66,0.5546,0.4943,0.5291
"10345",139658,1996,"1508",867,641,1076,"438",638,0.7359,0.6833,0.7135
"10346",139719,1996,"573",307,266,48,"6",42,0.1368,0.0226,0.0838
"10347",139755,1996,"2120",596,1524,484,"288",196,0.3289,0.189,0.2283
"10348",139764,1996,"315",199,116,43,"10",33,0.1658,0.0862,0.1365
"10349",139861,1996,"715",483,232,119,"23",96,0.1988,0.0991,0.1664
"10350",139931,1996,"3159",1699,1460,385,"115",270,0.1589,0.0788,0.1219
"10351",139940,1996,"1551",985,566,211,"58",153,0.1553,0.1025,0.136
"10352",139959,1996,"3671",2184,1487,1546,"494",1052,0.4817,0.3322,0.4211
"10353",140447,1996,"681",432,249,228,"63",165,0.3819,0.253,0.3348
"10354",140960,1996,"483",268,215,13,"3",10,0.0373,0.014,0.0269
"10355",140988,1996,"204",134,70,75,"22",53,0.3955,0.3143,0.3676
"10356",141185,1996,"187",120,67,66,"22",44,0.3667,0.3284,0.3529
"10357",141264,1996,"1838",1030,808,227,"65",162,0.1573,0.0804,0.1235
"10358",141334,1996,"1296",801,495,141,"28",113,0.1411,0.0566,0.1088
"10359",141486,1996,"152",100,52,31,"10",21,0.21,0.1923,0.2039
"10360",141565,1996,"333",207,126,35,"11",24,0.1159,0.0873,0.1051
"10361",141574,1996,"1357",769,588,154,"45",109,0.1417,0.0765,0.1135
"10362",142276,1996,"1378",789,589,49,"15",34,0.0431,0.0255,0.0356
"10363",142285,1996,"1201",574,627,222,"85",137,0.2387,0.1356,0.1848
"10364",142461,1996,"264",156,108,18,"4",14,0.0897,0.037,0.0682
"10365",143084,1996,"574",345,229,397,"153",244,0.7072,0.6681,0.6916
"10366",143288,1996,"142",72,70,35,"13",22,0.3056,0.1857,0.2465
"10367",144005,1996,"563",409,154,17,"4",13,0.0318,0.026,0.0302
"10368",144281,1996,"868",411,457,130,"52",78,0.1898,0.1138,0.1498
"10369",144740,1996,"1122",668,454,483,"184",299,0.4476,0.4053,0.4305
"10370",144892,1996,"1640",1000,640,505,"126",379,0.379,0.1969,0.3079
"10371",144962,1996,"222",137,85,130,"49",81,0.5912,0.5765,0.5856
"10372",144971,1996,"128",67,61,55,"19",36,0.5373,0.3115,0.4297
"10373",145600,1996,"2720",1505,1215,454,"179",275,0.1827,0.1473,0.1669
"10374",145619,1996,"231",112,119,82,"30",52,0.4643,0.2521,0.355
"10375",145637,1996,"5938",2865,3073,3321,"1507",1814,0.6332,0.4904,0.5593
"10376",145691,1996,"200",123,77,87,"22",65,0.5285,0.2857,0.435
"10377",145813,1996,"2888",1793,1095,877,"245",632,0.3525,0.2237,0.3037
"10378",146481,1996,"324",152,172,188,"90",98,0.6447,0.5233,0.5802
"10379",146612,1996,"312",137,175,120,"57",63,0.4599,0.3257,0.3846
"10380",146719,1996,"1063",690,373,562,"175",387,0.5609,0.4692,0.5287
"10381",146825,1996,"156",90,66,54,"15",39,0.4333,0.2273,0.3462
"10382",147013,1996,"309",142,167,106,"46",60,0.4225,0.2754,0.343
"10383",147244,1996,"497",284,213,253,"80",173,0.6092,0.3756,0.5091
"10384",147341,1996,"282",167,115,139,"52",87,0.521,0.4522,0.4929
"10385",147703,1996,"2434",1339,1095,613,"246",367,0.2741,0.2247,0.2518
"10386",147767,1996,"1947",1035,912,1639,"719",920,0.8889,0.7884,0.8418
"10387",147776,1996,"799",474,325,12,"6",6,0.0127,0.0185,0.015
"10388",147828,1996,"400",231,169,141,"55",86,0.3723,0.3254,0.3525
"10389",148131,1996,"283",135,148,112,"50",62,0.4593,0.3378,0.3958
"10390",148496,1996,"153",106,47,80,"27",53,0.5,0.5745,0.5229
"10391",148584,1996,"151",91,60,53,"15",38,0.4176,0.25,0.351
"10392",148627,1996,"203",116,87,56,"14",42,0.3621,0.1609,0.2759
"10393",149222,1996,"2404",1054,1350,376,"152",224,0.2125,0.1126,0.1564
"10394",149231,1996,"1176",741,435,170,"36",134,0.1808,0.0828,0.1446
"10395",149772,1996,"1477",720,757,428,"171",257,0.3569,0.2259,0.2898
"10396",149781,1996,"557",278,279,424,"207",217,0.7806,0.7419,0.7612
"10397",150066,1996,"406",222,184,144,"47",97,0.4369,0.2554,0.3547
"10398",150136,1996,"3763",1959,1804,726,"241",485,0.2476,0.1336,0.1929
"10399",150145,1996,"201",117,84,68,"22",46,0.3932,0.2619,0.3383
"10400",150163,1996,"777",475,302,426,"137",289,0.6084,0.4536,0.5483
"10401",150400,1996,"619",351,268,450,"192",258,0.735,0.7164,0.727
"10402",150534,1996,"694",428,266,294,"99",195,0.4556,0.3722,0.4236
"10403",150668,1996,"197",107,90,90,"39",51,0.4766,0.4333,0.4569
"10404",150941,1996,"174",104,70,95,"37",58,0.5577,0.5286,0.546
"10405",151102,1996,"1196",647,549,44,"16",28,0.0433,0.0291,0.0368
"10406",151111,1996,"2100",1172,928,87,"30",57,0.0486,0.0323,0.0414
"10407",151306,1996,"1573",912,661,173,"45",128,0.1404,0.0681,0.11
"10408",151324,1996,"1911",1026,885,355,"111",244,0.2378,0.1254,0.1858
"10409",151333,1996,"339",227,112,20,"6",14,0.0617,0.0536,0.059
"10410",151342,1996,"593",360,233,41,"9",32,0.0889,0.0386,0.0691
"10411",151351,1996,"5766",3376,2390,2660,"975",1685,0.4991,0.4079,0.4613
"10412",151360,1996,"560",355,205,37,"14",23,0.0648,0.0683,0.0661
"10413",151379,1996,"643",375,268,60,"18",42,0.112,0.0672,0.0933
"10414",151388,1996,"233",148,85,9,"3",6,0.0405,0.0353,0.0386
"10415",151777,1996,"305",151,154,113,"46",67,0.4437,0.2987,0.3705
"10416",151786,1996,"221",151,70,67,"16",51,0.3377,0.2286,0.3032
"10417",152080,1996,"1920",862,1058,1698,"915",783,0.9084,0.8648,0.8844
"10418",152248,1996,"1026",558,468,92,"42",50,0.0896,0.0897,0.0897
"10419",152363,1996,"212",107,105,93,"40",53,0.4953,0.381,0.4387
"10420",152530,1996,"485",270,215,348,"147",201,0.7444,0.6837,0.7175
"10421",152600,1996,"656",348,308,381,"149",232,0.6667,0.4838,0.5808
"10422",153001,1996,"311",161,150,124,"52",72,0.4472,0.3467,0.3987
"10423",153108,1996,"303",178,125,160,"58",102,0.573,0.464,0.5281
"10424",153269,1996,"638",385,253,352,"145",207,0.5377,0.5731,0.5517
"10425",153384,1996,"354",210,144,271,"106",165,0.7857,0.7361,0.7655
"10426",153603,1996,"3599",1592,2007,1022,"455",567,0.3562,0.2267,0.284
"10427",153834,1996,"615",347,268,437,"190",247,0.7118,0.709,0.7106
"10428",154095,1996,"2012",1234,778,673,"224",449,0.3639,0.2879,0.3345
"10429",155089,1996,"196",111,85,47,"12",35,0.3153,0.1412,0.2398
"10430",155317,1996,"3546",1902,1644,926,"349",577,0.3034,0.2123,0.2611
"10431",155335,1996,"96",61,35,29,"10",19,0.3115,0.2857,0.3021
"10432",155399,1996,"2681",1326,1355,583,"208",375,0.2828,0.1535,0.2175
"10433",155520,1996,"230",129,101,70,"21",49,0.3798,0.2079,0.3043
"10434",155627,1996,"130",48,82,52,"23",29,0.6042,0.2805,0.4
"10435",155937,1996,"146",72,74,50,"18",32,0.4444,0.2432,0.3425
"10436",156213,1996,"289",184,105,133,"50",83,0.4511,0.4762,0.4602
"10437",156286,1996,"327",203,124,164,"57",107,0.5271,0.4597,0.5015
"10438",156295,1996,"396",225,171,125,"53",72,0.32,0.3099,0.3157
"10439",156365,1996,"295",151,144,66,"21",45,0.298,0.1458,0.2237
"10440",156541,1996,"421",210,211,95,"40",55,0.2619,0.1896,0.2257
"10441",156745,1996,"326",193,133,131,"41",90,0.4663,0.3083,0.4018
"10442",157058,1996,"364",163,201,27,"7",20,0.1227,0.0348,0.0742
"10443",157076,1996,"179",103,76,44,"22",22,0.2136,0.2895,0.2458
"10444",157085,1996,"2640",1459,1181,720,"253",467,0.3201,0.2142,0.2727
"10445",157289,1996,"1861",950,911,197,"69",128,0.1347,0.0757,0.1059
"10446",157386,1996,"1271",687,584,157,"55",102,0.1485,0.0942,0.1235
"10447",157401,1996,"1366",749,617,339,"105",234,0.3124,0.1702,0.2482
"10448",157447,1996,"1487",823,664,71,"16",55,0.0668,0.0241,0.0477
"10449",157535,1996,"211",144,67,34,"11",23,0.1597,0.1642,0.1611
"10450",157951,1996,"2257",1234,1023,471,"164",307,0.2488,0.1603,0.2087
"10451",158477,1996,"190",103,87,74,"29",45,0.4369,0.3333,0.3895
"10452",159009,1996,"1091",574,517,90,"27",63,0.1098,0.0522,0.0825
"10453",159391,1996,"3992",2169,1823,867,"264",603,0.278,0.1448,0.2172
"10454",159647,1996,"1279",618,661,330,"133",197,0.3188,0.2012,0.258
"10455",159717,1996,"1357",750,607,105,"24",81,0.108,0.0395,0.0774
"10456",159966,1996,"1008",603,405,54,"13",41,0.068,0.0321,0.0536
"10457",160038,1996,"1480",891,589,22,"5",17,0.0191,0.0085,0.0149
"10458",160612,1996,"2337",1273,1064,107,"33",74,0.0581,0.031,0.0458
"10459",160621,1996,"1910",1041,869,129,"24",105,0.1009,0.0276,0.0675
"10460",160658,1996,"2674",1461,1213,161,"41",120,0.0821,0.0338,0.0602
"10461",161004,1996,"443",223,220,369,"175",194,0.87,0.7955,0.833
"10462",161226,1996,"477",332,145,147,"32",115,0.3464,0.2207,0.3082
"10463",161235,1996,"84",49,35,9,"1",8,0.1633,0.0286,0.1071
"10464",161244,1996,"143",86,57,9,"3",6,0.0698,0.0526,0.0629
"10465",161253,1996,"1264",549,715,340,"156",184,0.3352,0.2182,0.269
"10466",161554,1996,"683",383,300,56,"17",39,0.1018,0.0567,0.082
"10467",162007,1996,"301",169,132,41,"9",32,0.1893,0.0682,0.1362
"10468",162210,1996,"154",79,75,20,"6",14,0.1772,0.08,0.1299
"10469",162283,1996,"513",357,156,33,"11",22,0.0616,0.0705,0.0643
"10470",162584,1996,"975",482,493,195,"70",125,0.2593,0.142,0.2
"10471",162654,1996,"268",188,80,165,"38",127,0.6755,0.475,0.6157
"10472",162760,1996,"129",128,1,73,"0",73,0.5703,0,0.5659
"10473",162928,1996,"1018",408,610,826,"483",343,0.8407,0.7918,0.8114
"10474",163046,1996,"812",443,369,592,"245",347,0.7833,0.664,0.7291
"10475",163268,1996,"1005",505,500,280,"106",174,0.3446,0.212,0.2786
"10476",163286,1996,"3539",1720,1819,1449,"585",864,0.5023,0.3216,0.4094
"10477",163453,1996,"917",546,371,162,"27",135,0.2473,0.0728,0.1767
"10478",163462,1996,"367",207,160,214,"80",134,0.6473,0.5,0.5831
"10479",163851,1996,"689",393,296,311,"98",213,0.542,0.3311,0.4514
"10480",163912,1996,"312",180,132,221,"93",128,0.7111,0.7045,0.7083
"10481",164076,1996,"1851",1127,724,513,"127",386,0.3425,0.1754,0.2771
"10482",164173,1996,"286",205,81,89,"20",69,0.3366,0.2469,0.3112
"10483",164216,1996,"312",198,114,203,"67",136,0.6869,0.5877,0.6506
"10484",164270,1996,"385",199,186,236,"100",136,0.6834,0.5376,0.613
"10485",164447,1996,"253",133,120,79,"30",49,0.3684,0.25,0.3123
"10486",164492,1996,"112",69,43,53,"24",29,0.4203,0.5581,0.4732
"10487",164562,1996,"431",266,165,296,"112",184,0.6917,0.6788,0.6868
"10488",165015,1996,"761",393,368,608,"275",333,0.8473,0.7473,0.7989
"10489",165024,1996,"1155",697,458,222,"52",170,0.2439,0.1135,0.1922
"10490",165334,1996,"527",301,226,336,"128",208,0.691,0.5664,0.6376
"10491",165662,1996,"547",318,229,358,"161",197,0.6195,0.7031,0.6545
"10492",165671,1996,"86",86,0,45,"0",45,0.5233,NA,0.5233
"10493",165820,1996,"436",265,171,95,"19",76,0.2868,0.1111,0.2179
"10494",165866,1996,"644",429,215,127,"26",101,0.2354,0.1209,0.1972
"10495",165936,1996,"326",210,116,152,"41",111,0.5286,0.3534,0.4663
"10496",166027,1996,"1611",721,890,1390,"754",636,0.8821,0.8472,0.8628
"10497",166124,1996,"688",349,339,611,"287",324,0.9284,0.8466,0.8881
"10498",166513,1996,"1022",428,594,228,"96",132,0.3084,0.1616,0.2231
"10499",166629,1996,"4073",1964,2109,1577,"660",917,0.4669,0.3129,0.3872
"10500",166638,1996,"538",274,264,55,"14",41,0.1496,0.053,0.1022
"10501",166683,1996,"1065",446,619,875,"498",377,0.8453,0.8045,0.8216
"10502",167288,1996,"311",176,135,101,"35",66,0.375,0.2593,0.3248
"10503",167987,1996,"825",429,396,240,"71",169,0.3939,0.1793,0.2909
"10504",167996,1996,"551",310,241,419,"169",250,0.8065,0.7012,0.7604
"10505",168005,1996,"507",288,219,140,"46",94,0.3264,0.21,0.2761
"10506",168148,1996,"1179",597,582,950,"452",498,0.8342,0.7766,0.8058
"10507",168254,1996,"478",174,304,173,"104",69,0.3966,0.3421,0.3619
"10508",168281,1996,"445",315,130,295,"82",213,0.6762,0.6308,0.6629
"10509",168342,1996,"553",276,277,507,"248",259,0.9384,0.8953,0.9168
"10510",168546,1996,"433",227,206,278,"120",158,0.696,0.5825,0.642
"10511",168786,1996,"283",177,106,92,"28",64,0.3616,0.2642,0.3251
"10512",169080,1996,"960",565,395,545,"209",336,0.5947,0.5291,0.5677
"10513",169798,1996,"2298",1371,927,225,"77",148,0.108,0.0831,0.0979
"10514",169910,1996,"1831",731,1100,48,"28",20,0.0274,0.0255,0.0262
"10515",170082,1996,"2039",1200,839,356,"112",244,0.2033,0.1335,0.1746
"10516",170301,1996,"695",415,280,474,"166",308,0.7422,0.5929,0.682
"10517",170532,1996,"360",202,158,239,"108",131,0.6485,0.6835,0.6639
"10518",170639,1996,"540",247,293,63,"27",36,0.1457,0.0922,0.1167
"10519",170976,1996,"5328",2710,2618,3399,"1533",1866,0.6886,0.5856,0.638
"10520",171100,1996,"6708",3728,2980,2358,"809",1549,0.4155,0.2715,0.3515
"10521",171128,1996,"1068",260,808,298,"199",99,0.3808,0.2463,0.279
"10522",171137,1996,"666",321,345,67,"23",44,0.1371,0.0667,0.1006
"10523",171146,1996,"551",352,199,53,"15",38,0.108,0.0754,0.0962
"10524",171599,1996,"241",93,148,45,"21",24,0.2581,0.1419,0.1867
"10525",172051,1996,"747",425,322,33,"8",25,0.0588,0.0248,0.0442
"10526",172699,1996,"3121",1801,1320,557,"177",380,0.211,0.1341,0.1785
"10527",173160,1996,"468",284,184,292,"103",189,0.6655,0.5598,0.6239
"10528",173258,1996,"471",256,215,387,"164",223,0.8711,0.7628,0.8217
"10529",173328,1996,"161",82,79,53,"25",28,0.3415,0.3165,0.3292
"10530",173647,1996,"633",375,258,504,"202",302,0.8053,0.7829,0.7962
"10531",173902,1996,"491",293,198,377,"151",226,0.7713,0.7626,0.7678
"10532",174066,1996,"4057",2049,2008,1050,"451",599,0.2923,0.2246,0.2588
"10533",174233,1996,"1736",886,850,411,"156",255,0.2878,0.1835,0.2368
"10534",174251,1996,"522",310,212,223,"71",152,0.4903,0.3349,0.4272
"10535",174491,1996,"358",223,135,140,"36",104,0.4664,0.2667,0.3911
"10536",174792,1996,"426",0,426,296,"296",0,NA,0.6948,0.6948
"10537",174844,1996,"771",448,323,565,"228",337,0.7522,0.7059,0.7328
"10538",174899,1996,"295",229,66,145,"36",109,0.476,0.5455,0.4915
"10539",174914,1996,"991",540,451,519,"204",315,0.5833,0.4523,0.5237
"10540",175342,1996,"621",384,237,175,"44",131,0.3411,0.1857,0.2818
"10541",175421,1996,"84",42,42,21,"11",10,0.2381,0.2619,0.25
"10542",175616,1996,"449",278,171,94,"27",67,0.241,0.1579,0.2094
"10543",175856,1996,"906",508,398,140,"33",107,0.2106,0.0829,0.1545
"10544",175980,1996,"292",163,129,166,"64",102,0.6258,0.4961,0.5685
"10545",176017,1996,"1736",909,827,580,"199",381,0.4191,0.2406,0.3341
"10546",176035,1996,"291",248,43,58,"2",56,0.2258,0.0465,0.1993
"10547",176044,1996,"367",170,197,59,"26",33,0.1941,0.132,0.1608
"10548",176080,1996,"1864",869,995,463,"175",288,0.3314,0.1759,0.2484
"10549",176406,1996,"211",144,67,68,"11",57,0.3958,0.1642,0.3223
"10550",176628,1996,"91",56,35,20,"5",15,0.2679,0.1429,0.2198
"10551",176947,1996,"212",82,130,48,"19",29,0.3537,0.1462,0.2264
"10552",176965,1996,"1252",655,597,221,"77",144,0.2198,0.129,0.1765
"10553",177418,1996,"146",104,42,66,"13",53,0.5096,0.3095,0.4521
"10554",178059,1996,"185",127,58,100,"28",72,0.5669,0.4828,0.5405
"10555",178341,1996,"685",373,312,77,"25",52,0.1394,0.0801,0.1124
"10556",178387,1996,"963",564,399,113,"28",85,0.1507,0.0702,0.1173
"10557",178396,1996,"3687",2046,1641,1282,"462",820,0.4008,0.2815,0.3477
"10558",178402,1996,"567",299,268,86,"33",53,0.1773,0.1231,0.1517
"10559",178411,1996,"777",179,598,121,"77",44,0.2458,0.1288,0.1557
"10560",178420,1996,"632",351,281,78,"20",58,0.1652,0.0712,0.1234
"10561",178615,1996,"1480",868,612,592,"185",407,0.4689,0.3023,0.4
"10562",179043,1996,"362",196,166,9,"3",6,0.0306,0.0181,0.0249
"10563",179159,1996,"1047",609,438,577,"202",375,0.6158,0.4612,0.5511
"10564",179557,1996,"1212",681,531,294,"82",212,0.3113,0.1544,0.2426
"10565",179566,1996,"2447",1404,1043,433,"127",306,0.2179,0.1218,0.177
"10566",179867,1996,"1275",642,633,1006,"463",543,0.8458,0.7314,0.789
"10567",179894,1996,"270",139,131,116,"50",66,0.4748,0.3817,0.4296
"10568",179946,1996,"214",84,130,100,"62",38,0.4524,0.4769,0.4673
"10569",180179,1996,"520",332,188,79,"28",51,0.1536,0.1489,0.1519
"10570",180461,1996,"1740",780,960,246,"120",126,0.1615,0.125,0.1414
"10571",180522,1996,"218",96,122,24,"13",11,0.1146,0.1066,0.1101
"10572",180984,1996,"247",133,114,67,"27",40,0.3008,0.2368,0.2713
"10573",181002,1996,"832",494,338,489,"194",295,0.5972,0.574,0.5877
"10574",181020,1996,"276",139,137,146,"62",84,0.6043,0.4526,0.529
"10575",181127,1996,"262",140,122,138,"51",87,0.6214,0.418,0.5267
"10576",181215,1996,"1279",707,572,174,"59",115,0.1627,0.1031,0.136
"10577",181394,1996,"1129",588,541,87,"32",55,0.0935,0.0591,0.0771
"10578",181446,1996,"383",225,158,202,"79",123,0.5467,0.5,0.5274
"10579",181464,1996,"3625",1814,1811,654,"248",406,0.2238,0.1369,0.1804
"10580",181534,1996,"223",97,126,38,"11",27,0.2784,0.0873,0.1704
"10581",181783,1996,"690",397,293,147,"53",94,0.2368,0.1809,0.213
"10582",182281,1996,"1509",797,712,179,"49",130,0.1631,0.0688,0.1186
"10583",182290,1996,"1123",605,518,163,"46",117,0.1934,0.0888,0.1451
"10584",182634,1996,"227",158,69,91,"31",60,0.3797,0.4493,0.4009
"10585",182795,1996,"438",210,228,181,"81",100,0.4762,0.3553,0.4132
"10586",183062,1996,"839",499,340,211,"68",143,0.2866,0.2,0.2515
"10587",183080,1996,"894",433,461,196,"87",109,0.2517,0.1887,0.2192
"10588",183239,1996,"549",301,248,397,"172",225,0.7475,0.6935,0.7231
"10589",183822,1996,"227",150,77,36,"6",30,0.2,0.0779,0.1586
"10590",183974,1996,"86",63,23,21,"0",21,0.3333,0,0.2442
"10591",184348,1996,"371",203,168,265,"118",147,0.7241,0.7024,0.7143
"10592",184603,1996,"915",494,421,187,"76",111,0.2247,0.1805,0.2044
"10593",184612,1996,"141",92,49,8,"3",5,0.0543,0.0612,0.0567
"10594",184782,1996,"1132",609,523,414,"173",241,0.3957,0.3308,0.3657
"10595",185129,1996,"531",283,248,32,"10",22,0.0777,0.0403,0.0603
"10596",185572,1996,"799",411,388,261,"99",162,0.3942,0.2552,0.3267
"10597",185590,1996,"1194",706,488,243,"64",179,0.2535,0.1311,0.2035
"10598",185828,1996,"599",116,483,60,"39",21,0.181,0.0807,0.1002
"10599",186131,1996,"1123",525,598,1032,"540",492,0.9371,0.903,0.919
"10600",186201,1996,"413",240,173,101,"29",72,0.3,0.1676,0.2446
"10601",186283,1996,"678",394,284,311,"113",198,0.5025,0.3979,0.4587
"10602",186584,1996,"968",547,421,349,"112",237,0.4333,0.266,0.3605
"10603",186876,1996,"705",404,301,278,"110",168,0.4158,0.3654,0.3943
"10604",187134,1996,"1009",675,334,648,"187",461,0.683,0.5599,0.6422
"10605",187444,1996,"918",523,395,148,"41",107,0.2046,0.1038,0.1612
"10606",187985,1996,"1600",875,725,217,"67",150,0.1714,0.0924,0.1356
"10607",188030,1996,"1510",807,703,188,"51",137,0.1698,0.0725,0.1245
"10608",188429,1996,"316",204,112,128,"40",88,0.4314,0.3571,0.4051
"10609",188641,1996,"330",166,164,178,"76",102,0.6145,0.4634,0.5394
"10610",190044,1996,"664",176,488,349,"253",96,0.5455,0.5184,0.5256
"10611",190099,1996,"718",351,367,592,"282",310,0.8832,0.7684,0.8245
"10612",190150,1996,"1260",576,684,1041,"542",499,0.8663,0.7924,0.8262
"10613",190248,1996,"94",43,51,19,"7",12,0.2791,0.1373,0.2021
"10614",190415,1996,"2001",870,1131,1570,"872",698,0.8023,0.771,0.7846
"10615",190512,1996,"1365",797,568,196,"82",114,0.143,0.1444,0.1436
"10616",190549,1996,"1211",739,472,183,"49",134,0.1813,0.1038,0.1511
"10617",190558,1996,"1434",727,707,32,"9",23,0.0316,0.0127,0.0223
"10618",190567,1996,"768",352,416,28,"14",14,0.0398,0.0337,0.0365
"10619",190594,1996,"1456",1008,448,127,"28",99,0.0982,0.0625,0.0872
"10620",190637,1996,"605",422,183,45,"8",37,0.0877,0.0437,0.0744
"10621",190664,1996,"1040",621,419,225,"56",169,0.2721,0.1337,0.2163
"10622",190691,1996,"543",368,175,47,"16",31,0.0842,0.0914,0.0866
"10623",190725,1996,"372",259,113,69,"11",58,0.2239,0.0973,0.1855
"10624",191241,1996,"1206",694,512,822,"338",484,0.6974,0.6602,0.6816
"10625",191515,1996,"497",239,258,392,"196",196,0.8201,0.7597,0.7887
"10626",191533,1996,"482",257,225,228,"93",135,0.5253,0.4133,0.473
"10627",191630,1996,"530",267,263,356,"161",195,0.7303,0.6122,0.6717
"10628",191649,1996,"1735",996,739,653,"217",436,0.4378,0.2936,0.3764
"10629",191676,1996,"288",194,94,164,"47",117,0.6031,0.5,0.5694
"10630",191931,1996,"662",320,342,260,"100",160,0.5,0.2924,0.3927
"10631",191968,1996,"1426",820,606,908,"355",553,0.6744,0.5858,0.6367
"10632",192192,1996,"234",168,66,61,"17",44,0.2619,0.2576,0.2607
"10633",192323,1996,"434",255,179,305,"115",190,0.7451,0.6425,0.7028
"10634",192439,1996,"956",654,302,51,"17",34,0.052,0.0563,0.0533
"10635",192703,1996,"557",258,299,313,"143",170,0.6589,0.4783,0.5619
"10636",192749,1996,"271",181,90,117,"33",84,0.4641,0.3667,0.4317
"10637",192819,1996,"839",482,357,510,"187",323,0.6701,0.5238,0.6079
"10638",192925,1996,"81",58,23,6,"2",4,0.069,0.087,0.0741
"10639",193016,1996,"551",336,215,62,"12",50,0.1488,0.0558,0.1125
"10640",193292,1996,"183",125,58,21,"5",16,0.128,0.0862,0.1148
"10641",193353,1996,"266",199,67,105,"20",85,0.4271,0.2985,0.3947
"10642",193399,1996,"208",162,46,111,"26",85,0.5247,0.5652,0.5337
"10643",193584,1996,"337",242,95,208,"55",153,0.6322,0.5789,0.6172
"10644",193645,1996,"931",787,144,129,"13",116,0.1474,0.0903,0.1386
"10645",193654,1996,"401",272,129,132,"27",105,0.386,0.2093,0.3292
"10646",193900,1996,"3393",2002,1391,1838,"770",1068,0.5335,0.5536,0.5417
"10647",193973,1996,"552",314,238,253,"107",146,0.465,0.4496,0.4583
"10648",194161,1996,"208",129,79,69,"23",46,0.3566,0.2911,0.3317
"10649",194310,1996,"1388",788,600,487,"180",307,0.3896,0.3,0.3509
"10650",194824,1996,"898",225,673,454,"318",136,0.6044,0.4725,0.5056
"10651",195003,1996,"1725",571,1154,690,"419",271,0.4746,0.3631,0.4
"10652",195030,1996,"1011",501,510,719,"336",383,0.7645,0.6588,0.7112
"10653",195164,1996,"590",311,279,327,"153",174,0.5595,0.5484,0.5542
"10654",195173,1996,"305",181,124,93,"35",58,0.3204,0.2823,0.3049
"10655",195216,1996,"592",281,311,388,"209",179,0.637,0.672,0.6554
"10656",195234,1996,"319",226,93,146,"30",116,0.5133,0.3226,0.4577
"10657",195243,1996,"238",142,96,65,"16",49,0.3451,0.1667,0.2731
"10658",195304,1996,"294",219,75,193,"47",146,0.6667,0.6267,0.6565
"10659",195474,1996,"558",325,233,354,"137",217,0.6677,0.588,0.6344
"10660",195526,1996,"702",424,278,501,"196",305,0.7193,0.705,0.7137
"10661",195544,1996,"97",76,21,59,"8",51,0.6711,0.381,0.6082
"10662",195809,1996,"2157",1146,1011,629,"229",400,0.349,0.2265,0.2916
"10663",196413,1996,"2652",1429,1223,1722,"735",987,0.6907,0.601,0.6493
"10664",196592,1996,"2337",1646,691,73,"40",33,0.02,0.0579,0.0312
"10665",197045,1996,"338",223,115,126,"34",92,0.4126,0.2957,0.3728
"10666",197133,1996,"614",375,239,499,"191",308,0.8213,0.7992,0.8127
"10667",197869,1996,"2026",1111,915,689,"226",463,0.4167,0.247,0.3401
"10668",197984,1996,"181",93,88,62,"30",32,0.3441,0.3409,0.3425
"10669",198385,1996,"439",230,209,385,"181",204,0.887,0.866,0.877
"10670",198464,1996,"2626",1581,1045,673,"216",457,0.2891,0.2067,0.2563
"10671",198507,1996,"380",205,175,130,"44",86,0.4195,0.2514,0.3421
"10672",198516,1996,"941",569,372,551,"204",347,0.6098,0.5484,0.5855
"10673",198835,1996,"232",135,97,96,"32",64,0.4741,0.3299,0.4138
"10674",198969,1996,"320",100,220,55,"30",25,0.25,0.1364,0.1719
"10675",199102,1996,"1313",692,621,300,"90",210,0.3035,0.1449,0.2285
"10676",199111,1996,"450",275,175,139,"42",97,0.3527,0.24,0.3089
"10677",199120,1996,"3270",2065,1205,2185,"718",1467,0.7104,0.5959,0.6682
"10678",199139,1996,"1682",952,730,359,"113",246,0.2584,0.1548,0.2134
"10679",199148,1996,"1552",1075,477,390,"77",313,0.2912,0.1614,0.2513
"10680",199157,1996,"681",441,240,179,"38",141,0.3197,0.1583,0.2628
"10681",199193,1996,"3630",1457,2173,968,"442",526,0.361,0.2034,0.2667
"10682",199218,1996,"1619",990,629,602,"196",406,0.4101,0.3116,0.3718
"10683",199281,1996,"450",211,239,80,"30",50,0.237,0.1255,0.1778
"10684",199306,1996,"120",54,66,26,"12",14,0.2593,0.1818,0.2167
"10685",199412,1996,"155",116,39,80,"14",66,0.569,0.359,0.5161
"10686",199582,1996,"408",228,180,46,"21",25,0.1096,0.1167,0.1127
"10687",199643,1996,"374",232,142,67,"17",50,0.2155,0.1197,0.1791
"10688",199847,1996,"934",500,434,707,"297",410,0.82,0.6843,0.757
"10689",199962,1996,"331",137,194,101,"43",58,0.4234,0.2216,0.3051
"10690",199999,1996,"480",351,129,95,"19",76,0.2165,0.1473,0.1979
"10691",200004,1996,"1177",560,617,260,"87",173,0.3089,0.141,0.2209
"10692",200059,1996,"397",193,204,24,"9",15,0.0777,0.0441,0.0605
"10693",200156,1996,"288",159,129,90,"25",65,0.4088,0.1938,0.3125
"10694",200217,1996,"440",266,174,117,"36",81,0.3045,0.2069,0.2659
"10695",200226,1996,"148",79,69,22,"7",15,0.1899,0.1014,0.1486
"10696",200253,1996,"457",304,153,35,"10",25,0.0822,0.0654,0.0766
"10697",200280,1996,"1365",630,735,194,"92",102,0.1619,0.1252,0.1421
"10698",200332,1996,"1295",543,752,169,"83",86,0.1584,0.1104,0.1305
"10699",200572,1996,"178",99,79,38,"15",23,0.2323,0.1899,0.2135
"10700",201104,1996,"432",240,192,150,"47",103,0.4292,0.2448,0.3472
"10701",201371,1996,"183",115,68,97,"38",59,0.513,0.5588,0.5301
"10702",201548,1996,"468",285,183,275,"90",185,0.6491,0.4918,0.5876
"10703",201645,1996,"738",284,454,387,"202",185,0.6514,0.4449,0.5244
"10704",201690,1996,"330",161,169,28,"12",16,0.0994,0.071,0.0848
"10705",202134,1996,"845",443,402,80,"25",55,0.1242,0.0622,0.0947
"10706",202480,1996,"1553",845,708,890,"310",580,0.6864,0.4379,0.5731
"10707",202523,1996,"642",305,337,464,"229",235,0.7705,0.6795,0.7227
"10708",202763,1996,"553",302,251,210,"83",127,0.4205,0.3307,0.3797
"10709",203085,1996,"303",141,162,141,"68",73,0.5177,0.4198,0.4653
"10710",203128,1996,"232",129,103,144,"60",84,0.6512,0.5825,0.6207
"10711",203368,1996,"775",425,350,483,"201",282,0.6635,0.5743,0.6232
"10712",203517,1996,"2600",1516,1084,448,"150",298,0.1966,0.1384,0.1723
"10713",203535,1996,"423",238,185,338,"147",191,0.8025,0.7946,0.7991
"10714",203580,1996,"61",44,17,32,"10",22,0.5,0.5882,0.5246
"10715",203775,1996,"400",234,166,141,"41",100,0.4274,0.247,0.3525
"10716",203845,1996,"271",111,160,110,"50",60,0.5405,0.3125,0.4059
"10717",204024,1996,"3342",1935,1407,2180,"798",1382,0.7142,0.5672,0.6523
"10718",204185,1996,"483",217,266,254,"113",141,0.6498,0.4248,0.5259
"10719",204194,1996,"407",252,155,154,"43",111,0.4405,0.2774,0.3784
"10720",204617,1996,"180",113,67,52,"11",41,0.3628,0.1642,0.2889
"10721",204796,1996,"6027",3018,3009,1526,"565",961,0.3184,0.1878,0.2532
"10722",204857,1996,"3123",1832,1291,1390,"446",944,0.5153,0.3455,0.4451
"10723",206330,1996,"235",94,141,31,"12",19,0.2021,0.0851,0.1319
"10724",206589,1996,"516",255,261,302,"136",166,0.651,0.5211,0.5853
"10725",206604,1996,"1859",995,864,281,"78",203,0.204,0.0903,0.1512
"10726",206622,1996,"778",461,317,458,"184",274,0.5944,0.5804,0.5887
"10727",206695,1996,"1685",859,826,212,"88",124,0.1444,0.1065,0.1258
"10728",206914,1996,"616",353,263,63,"25",38,0.1076,0.0951,0.1023
"10729",207209,1996,"518",259,259,33,"8",25,0.0965,0.0309,0.0637
"10730",207306,1996,"234",110,124,22,"11",11,0.1,0.0887,0.094
"10731",207324,1996,"464",234,230,106,"41",65,0.2778,0.1783,0.2284
"10732",207388,1996,"2336",1223,1113,488,"155",333,0.2723,0.1393,0.2089
"10733",207500,1996,"2605",1264,1341,525,"200",325,0.2571,0.1491,0.2015
"10734",207722,1996,"261",138,123,26,"11",15,0.1087,0.0894,0.0996
"10735",207847,1996,"579",266,313,78,"41",37,0.1391,0.131,0.1347
"10736",207865,1996,"737",386,351,92,"34",58,0.1503,0.0969,0.1248
"10737",208822,1996,"386",250,136,200,"71",129,0.516,0.5221,0.5181
"10738",209056,1996,"443",262,181,249,"91",158,0.6031,0.5028,0.5621
"10739",209065,1996,"445",238,207,272,"109",163,0.6849,0.5266,0.6112
"10740",209542,1996,"1833",883,950,492,"181",311,0.3522,0.1905,0.2684
"10741",209551,1996,"2580",1444,1136,958,"349",609,0.4217,0.3072,0.3713
"10742",209612,1996,"268",179,89,117,"36",81,0.4525,0.4045,0.4366
"10743",209807,1996,"726",351,375,97,"34",63,0.1795,0.0907,0.1336
"10744",209922,1996,"357",200,157,159,"59",100,0.5,0.3758,0.4454
"10745",210146,1996,"701",388,313,111,"48",63,0.1624,0.1534,0.1583
"10746",210401,1996,"419",241,178,304,"115",189,0.7842,0.6461,0.7255
"10747",210429,1996,"742",448,294,107,"33",74,0.1652,0.1122,0.1442
"10748",210571,1996,"354",190,164,215,"77",138,0.7263,0.4695,0.6073
"10749",210669,1996,"523",311,212,346,"125",221,0.7106,0.5896,0.6616
"10750",210775,1996,"143",73,70,44,"16",28,0.3836,0.2286,0.3077
"10751",211088,1996,"292",219,73,131,"29",102,0.4658,0.3973,0.4486
"10752",211158,1996,"1556",994,562,567,"147",420,0.4225,0.2616,0.3644
"10753",211291,1996,"895",440,455,761,"365",396,0.9,0.8022,0.8503
"10754",211352,1996,"247",186,61,114,"23",91,0.4892,0.377,0.4615
"10755",211361,1996,"805",398,407,140,"47",93,0.2337,0.1155,0.1739
"10756",211431,1996,"148",145,3,65,"0",65,0.4483,0,0.4392
"10757",211440,1996,"1386",472,914,903,"563",340,0.7203,0.616,0.6515
"10758",211468,1996,"329",328,1,189,"0",189,0.5762,0,0.5745
"10759",211556,1996,"102",102,0,60,"0",60,0.5882,NA,0.5882
"10760",211583,1996,"77",77,0,46,"0",46,0.5974,NA,0.5974
"10761",211608,1996,"236",124,112,16,"2",14,0.1129,0.0179,0.0678
"10762",211644,1996,"1215",711,504,284,"79",205,0.2883,0.1567,0.2337
"10763",211981,1996,"385",177,208,149,"67",82,0.4633,0.3221,0.387
"10764",212009,1996,"491",264,227,371,"168",203,0.7689,0.7401,0.7556
"10765",212054,1996,"1348",476,872,172,"76",96,0.2017,0.0872,0.1276
"10766",212106,1996,"1196",690,506,558,"204",354,0.513,0.4032,0.4666
"10767",212115,1996,"872",499,373,198,"50",148,0.2966,0.134,0.2271
"10768",212133,1996,"245",168,77,138,"34",104,0.619,0.4416,0.5633
"10769",212160,1996,"1250",707,543,214,"69",145,0.2051,0.1271,0.1712
"10770",212197,1996,"429",295,134,263,"73",190,0.6441,0.5448,0.6131
"10771",212577,1996,"522",272,250,408,"175",233,0.8566,0.7,0.7816
"10772",212601,1996,"504",305,199,229,"72",157,0.5148,0.3618,0.4544
"10773",212832,1996,"44",32,12,16,"3",13,0.4062,0.25,0.3636
"10774",212911,1996,"313",172,141,267,"116",151,0.8779,0.8227,0.853
"10775",213020,1996,"2617",1493,1124,613,"163",450,0.3014,0.145,0.2342
"10776",213251,1996,"349",182,167,237,"100",137,0.7527,0.5988,0.6791
"10777",213321,1996,"432",236,196,284,"116",168,0.7119,0.5918,0.6574
"10778",213349,1996,"1440",883,557,245,"56",189,0.214,0.1005,0.1701
"10779",213358,1996,"152",106,46,57,"19",38,0.3585,0.413,0.375
"10780",213367,1996,"648",355,293,362,"146",216,0.6085,0.4983,0.5586
"10781",213385,1996,"572",281,291,460,"215",245,0.8719,0.7388,0.8042
"10782",213507,1996,"287",172,115,165,"53",112,0.6512,0.4609,0.5749
"10783",213543,1996,"1101",409,692,768,"433",335,0.8191,0.6257,0.6975
"10784",213613,1996,"780",419,361,179,"62",117,0.2792,0.1717,0.2295
"10785",213668,1996,"386",186,200,226,"102",124,0.6667,0.51,0.5855
"10786",213783,1996,"590",316,274,154,"57",97,0.307,0.208,0.261
"10787",213826,1996,"251",191,60,103,"18",85,0.445,0.3,0.4104
"10788",213996,1996,"672",407,265,448,"168",280,0.688,0.634,0.6667
"10789",214041,1996,"979",587,392,327,"121",206,0.3509,0.3087,0.334
"10790",214069,1996,"251",186,65,59,"16",43,0.2312,0.2462,0.2351
"10791",214157,1996,"284",138,146,194,"90",104,0.7536,0.6164,0.6831
"10792",214175,1996,"532",307,225,414,"161",253,0.8241,0.7156,0.7782
"10793",214272,1996,"114",82,32,41,"11",30,0.3659,0.3438,0.3596
"10794",214777,1996,"4701",2344,2357,2052,"837",1215,0.5183,0.3551,0.4365
"10795",215062,1996,"2307",1169,1138,1976,"924",1052,0.8999,0.812,0.8565
"10796",215743,1996,"346",205,141,95,"24",71,0.3463,0.1702,0.2746
"10797",215798,1996,"271",136,135,168,"76",92,0.6765,0.563,0.6199
"10798",215929,1996,"948",550,398,623,"254",369,0.6709,0.6382,0.6572
"10799",216010,1996,"1272",674,598,455,"168",287,0.4258,0.2809,0.3577
"10800",216038,1996,"1197",677,520,247,"85",162,0.2393,0.1635,0.2063
"10801",216287,1996,"412",217,195,354,"167",187,0.8618,0.8564,0.8592
"10802",216339,1996,"2155",1284,871,442,"138",304,0.2368,0.1584,0.2051
"10803",216524,1996,"327",180,147,244,"105",139,0.7722,0.7143,0.7462
"10804",216694,1996,"305",134,171,138,"59",79,0.5896,0.345,0.4525
"10805",216764,1996,"1454",943,511,376,"88",288,0.3054,0.1722,0.2586
"10806",216807,1996,"304",176,128,208,"78",130,0.7386,0.6094,0.6842
"10807",216852,1996,"462",217,245,172,"73",99,0.4562,0.298,0.3723
"10808",216931,1996,"448",181,267,154,"83",71,0.3923,0.3109,0.3438
"10809",217059,1996,"805",443,362,319,"122",197,0.4447,0.337,0.3963
"10810",217156,1996,"1469",810,659,1220,"536",684,0.8444,0.8134,0.8305
"10811",217402,1996,"938",556,382,786,"310",476,0.8561,0.8115,0.838
"10812",217536,1996,"393",271,122,209,"61",148,0.5461,0.5,0.5318
"10813",217776,1996,"73",36,37,19,"8",11,0.3056,0.2162,0.2603
"10814",217819,1996,"1867",1236,631,624,"149",475,0.3843,0.2361,0.3342
"10815",217882,1996,"2538",1234,1304,945,"327",618,0.5008,0.2508,0.3723
"10816",217998,1996,"134",82,52,89,"34",55,0.6707,0.6538,0.6642
"10817",218061,1996,"636",365,271,119,"39",80,0.2192,0.1439,0.1871
"10818",218229,1996,"437",273,164,134,"40",94,0.3443,0.2439,0.3066
"10819",218238,1996,"87",38,49,16,"5",11,0.2895,0.102,0.1839
"10820",218399,1996,"246",145,101,45,"11",34,0.2345,0.1089,0.1829
"10821",218414,1996,"234",103,131,91,"36",55,0.534,0.2748,0.3889
"10822",218663,1996,"2635",1518,1117,857,"289",568,0.3742,0.2587,0.3252
"10823",218724,1996,"823",408,415,120,"44",76,0.1863,0.106,0.1458
"10824",218733,1996,"801",452,349,159,"24",135,0.2987,0.0688,0.1985
"10825",218742,1996,"438",284,154,75,"12",63,0.2218,0.0779,0.1712
"10826",218973,1996,"291",132,159,204,"106",98,0.7424,0.6667,0.701
"10827",219000,1996,"383",244,139,190,"55",135,0.5533,0.3957,0.4961
"10828",219046,1996,"452",260,192,58,"15",43,0.1654,0.0781,0.1283
"10829",219082,1996,"189",100,89,25,"5",20,0.2,0.0562,0.1323
"10830",219198,1996,"117",77,40,42,"11",31,0.4026,0.275,0.359
"10831",219259,1996,"560",324,236,68,"24",44,0.1358,0.1017,0.1214
"10832",219356,1996,"1481",733,748,303,"129",174,0.2374,0.1725,0.2046
"10833",219471,1996,"875",489,386,175,"62",113,0.2311,0.1606,0.2
"10834",219602,1996,"777",498,279,156,"38",118,0.2369,0.1362,0.2008
"10835",219709,1996,"418",262,156,185,"66",119,0.4542,0.4231,0.4426
"10836",219718,1996,"180",82,98,24,"6",18,0.2195,0.0612,0.1333
"10837",219949,1996,"154",78,76,37,"10",27,0.3462,0.1316,0.2403
"10838",220075,1996,"1532",894,638,186,"62",124,0.1387,0.0972,0.1214
"10839",220215,1996,"314",194,120,107,"30",77,0.3969,0.25,0.3408
"10840",220613,1996,"525",304,221,128,"45",83,0.273,0.2036,0.2438
"10841",220631,1996,"212",134,78,58,"23",35,0.2612,0.2949,0.2736
"10842",220710,1996,"259",134,125,134,"54",80,0.597,0.432,0.5174
"10843",221351,1996,"375",196,179,264,"128",136,0.6939,0.7151,0.704
"10844",221519,1996,"365",205,160,264,"115",149,0.7268,0.7188,0.7233
"10845",221731,1996,"145",98,47,2,"0",2,0.0204,0,0.0138
"10846",221847,1996,"1130",497,633,134,"39",95,0.1911,0.0616,0.1186
"10847",221892,1996,"189",108,81,37,"9",28,0.2593,0.1111,0.1958
"10848",222178,1996,"898",478,420,241,"97",144,0.3013,0.231,0.2684
"10849",222983,1996,"344",181,163,254,"106",148,0.8177,0.6503,0.7384
"10850",223232,1996,"2463",1444,1019,1062,"350",712,0.4931,0.3435,0.4312
"10851",224004,1996,"121",74,47,42,"12",30,0.4054,0.2553,0.3471
"10852",224323,1996,"251",157,94,141,"46",95,0.6051,0.4894,0.5618
"10853",225432,1996,"638",385,253,13,"5",8,0.0208,0.0198,0.0204
"10854",225548,1996,"335",151,184,83,"27",56,0.3709,0.1467,0.2478
"10855",225627,1996,"404",288,116,46,"6",40,0.1389,0.0517,0.1139
"10856",226231,1996,"163",35,128,26,"19",7,0.2,0.1484,0.1595
"10857",226833,1996,"602",312,290,52,"17",35,0.1122,0.0586,0.0864
"10858",227216,1996,"2268",1304,964,256,"70",186,0.1426,0.0726,0.1129
"10859",227331,1996,"355",257,98,66,"12",54,0.2101,0.1224,0.1859
"10860",227526,1996,"1166",568,598,133,"48",85,0.1496,0.0803,0.1141
"10861",227757,1996,"668",314,354,499,"240",259,0.8248,0.678,0.747
"10862",227845,1996,"373",239,134,107,"35",72,0.3013,0.2612,0.2869
"10863",227863,1996,"222",136,86,55,"19",36,0.2647,0.2209,0.2477
"10864",228042,1996,"180",112,68,34,"10",24,0.2143,0.1471,0.1889
"10865",228149,1996,"507",312,195,177,"56",121,0.3878,0.2872,0.3491
"10866",228246,1996,"1217",663,554,687,"270",417,0.629,0.4874,0.5645
"10867",228343,1996,"310",198,112,179,"60",119,0.601,0.5357,0.5774
"10868",228431,1996,"2007",1188,819,332,"71",261,0.2197,0.0867,0.1654
"10869",228459,1996,"2396",1472,924,408,"88",320,0.2174,0.0952,0.1703
"10870",228501,1996,"355",135,220,22,"8",14,0.1037,0.0364,0.062
"10871",228529,1996,"919",455,464,117,"35",82,0.1802,0.0754,0.1273
"10872",228705,1996,"916",406,510,55,"22",33,0.0813,0.0431,0.06
"10873",228723,1996,"6326",3218,3108,1931,"625",1306,0.4058,0.2011,0.3052
"10874",228769,1996,"1208",617,591,235,"90",145,0.235,0.1523,0.1945
"10875",228778,1996,"6281",3087,3194,2420,"985",1435,0.4649,0.3084,0.3853
"10876",228787,1996,"451",199,252,138,"59",79,0.397,0.2341,0.306
"10877",228796,1996,"1393",728,665,38,"13",25,0.0343,0.0195,0.0273
"10878",228875,1996,"1238",735,503,502,"181",321,0.4367,0.3598,0.4055
"10879",228981,1996,"210",132,78,79,"23",56,0.4242,0.2949,0.3762
"10880",229018,1996,"108",58,50,10,"6",4,0.069,0.12,0.0926
"10881",229027,1996,"1679",852,827,93,"39",54,0.0634,0.0472,0.0554
"10882",229115,1996,"3632",1860,1772,746,"252",494,0.2656,0.1422,0.2054
"10883",229780,1996,"228",134,94,41,"10",31,0.2313,0.1064,0.1798
"10884",229814,1996,"849",411,438,167,"69",98,0.2384,0.1575,0.1967
"10885",230603,1996,"626",443,183,69,"19",50,0.1129,0.1038,0.1102
"10886",230728,1996,"967",685,282,267,"41",226,0.3299,0.1454,0.2761
"10887",230764,1996,"1800",1019,781,436,"155",281,0.2758,0.1985,0.2422
"10888",230782,1996,"1237",833,404,136,"25",111,0.1333,0.0619,0.1099
"10889",231059,1996,"486",284,202,335,"138",197,0.6937,0.6832,0.6893
"10890",231174,1996,"1779",971,808,915,"374",541,0.5572,0.4629,0.5143
"10891",231420,1996,"149",81,68,42,"20",22,0.2716,0.2941,0.2819
"10892",231554,1996,"109",56,53,39,"20",19,0.3393,0.3774,0.3578
"10893",231624,1996,"1328",789,539,1053,"381",672,0.8517,0.7069,0.7929
"10894",231712,1996,"517",304,213,65,"16",49,0.1612,0.0751,0.1257
"10895",232025,1996,"256",121,135,123,"52",71,0.5868,0.3852,0.4805
"10896",232043,1996,"228",143,85,90,"26",64,0.4476,0.3059,0.3947
"10897",232089,1996,"309",111,198,59,"24",35,0.3153,0.1212,0.1909
"10898",232186,1996,"1875",1040,835,480,"150",330,0.3173,0.1796,0.256
"10899",232265,1996,"917",591,326,358,"70",288,0.4873,0.2147,0.3904
"10900",232423,1996,"3258",1878,1380,1958,"704",1254,0.6677,0.5101,0.601
"10901",232557,1996,"1253",635,618,253,"91",162,0.2551,0.1472,0.2019
"10902",232566,1996,"657",447,210,242,"53",189,0.4228,0.2524,0.3683
"10903",232609,1996,"287",169,118,151,"51",100,0.5917,0.4322,0.5261
"10904",232681,1996,"729",504,225,450,"112",338,0.6706,0.4978,0.6173
"10905",232706,1996,"212",145,67,102,"27",75,0.5172,0.403,0.4811
"10906",232937,1996,"1329",809,520,124,"34",90,0.1112,0.0654,0.0933
"10907",232982,1996,"1478",803,675,210,"60",150,0.1868,0.0889,0.1421
"10908",233277,1996,"1419",867,552,476,"141",335,0.3864,0.2554,0.3354
"10909",233374,1996,"793",399,394,610,"284",326,0.817,0.7208,0.7692
"10910",233426,1996,"437",278,159,263,"84",179,0.6439,0.5283,0.6018
"10911",233541,1996,"251",149,102,59,"14",45,0.302,0.1373,0.2351
"10912",233897,1996,"247",132,115,69,"31",38,0.2879,0.2696,0.2794
"10913",233921,1996,"5057",2061,2996,2120,"970",1150,0.558,0.3238,0.4192
"10914",234030,1996,"1875",1146,729,352,"103",249,0.2173,0.1413,0.1877
"10915",234085,1996,"339",0,339,170,"170",0,NA,0.5015,0.5015
"10916",234155,1996,"782",465,317,186,"47",139,0.2989,0.1483,0.2379
"10917",234164,1996,"380",211,169,75,"16",59,0.2796,0.0947,0.1974
"10918",235097,1996,"639",399,240,114,"29",85,0.213,0.1208,0.1784
"10919",235167,1996,"530",308,222,200,"74",126,0.4091,0.3333,0.3774
"10920",236230,1996,"610",359,251,284,"97",187,0.5209,0.3865,0.4656
"10921",236328,1996,"740",445,295,459,"171",288,0.6472,0.5797,0.6203
"10922",236577,1996,"465",323,142,173,"52",121,0.3746,0.3662,0.372
"10923",236595,1996,"576",358,218,245,"78",167,0.4665,0.3578,0.4253
"10924",236896,1996,"292",144,148,40,"18",22,0.1528,0.1216,0.137
"10925",236939,1996,"2272",1169,1103,694,"263",431,0.3687,0.2384,0.3055
"10926",236948,1996,"3789",1964,1825,1613,"648",965,0.4913,0.3551,0.4257
"10927",237011,1996,"2026",1177,849,507,"176",331,0.2812,0.2073,0.2502
"10928",237057,1996,"355",207,148,274,"111",163,0.7874,0.75,0.7718
"10929",237066,1996,"315",193,122,177,"56",121,0.6269,0.459,0.5619
"10930",237215,1996,"384",207,177,4,"1",3,0.0145,0.0056,0.0104
"10931",237330,1996,"582",301,281,107,"34",73,0.2425,0.121,0.1838
"10932",237358,1996,"120",66,54,27,"16",11,0.1667,0.2963,0.225
"10933",237367,1996,"1049",570,479,119,"43",76,0.1333,0.0898,0.1134
"10934",237792,1996,"617",363,254,97,"24",73,0.2011,0.0945,0.1572
"10935",237899,1996,"529",254,275,28,"10",18,0.0709,0.0364,0.0529
"10936",237932,1996,"464",250,214,77,"20",57,0.228,0.0935,0.1659
"10937",237969,1996,"377",204,173,161,"57",104,0.5098,0.3295,0.4271
"10938",238032,1996,"3065",1499,1566,817,"335",482,0.3215,0.2139,0.2666
"10939",238333,1996,"284",147,137,175,"76",99,0.6735,0.5547,0.6162
"10940",238430,1996,"253",174,79,40,"16",24,0.1379,0.2025,0.1581
"10941",238458,1996,"450",295,155,214,"67",147,0.4983,0.4323,0.4756
"10942",238476,1996,"401",210,191,215,"87",128,0.6095,0.4555,0.5362
"10943",238616,1996,"254",138,116,117,"44",73,0.529,0.3793,0.4606
"10944",238661,1996,"210",152,58,40,"4",36,0.2368,0.069,0.1905
"10945",239080,1996,"199",126,73,53,"21",32,0.254,0.2877,0.2663
"10946",239105,1996,"1420",799,621,803,"303",500,0.6258,0.4879,0.5655
"10947",239628,1996,"169",97,72,81,"28",53,0.5464,0.3889,0.4793
"10948",239716,1996,"508",321,187,339,"121",218,0.6791,0.6471,0.6673
"10949",240107,1996,"284",195,89,70,"10",60,0.3077,0.1124,0.2465
"10950",240189,1996,"1825",995,830,369,"137",232,0.2332,0.1651,0.2022
"10951",240277,1996,"939",581,358,138,"48",90,0.1549,0.1341,0.147
"10952",240329,1996,"1721",1074,647,393,"109",284,0.2644,0.1685,0.2284
"10953",240338,1996,"101",71,30,55,"12",43,0.6056,0.4,0.5446
"10954",240365,1996,"1501",855,646,227,"65",162,0.1895,0.1006,0.1512
"10955",240374,1996,"606",354,252,49,"14",35,0.0989,0.0556,0.0809
"10956",240417,1996,"1275",644,631,194,"61",133,0.2065,0.0967,0.1522
"10957",240426,1996,"308",158,150,42,"13",29,0.1835,0.0867,0.1364
"10958",240444,1996,"5394",2954,2440,2090,"769",1321,0.4472,0.3152,0.3875
"10959",240453,1996,"2033",1113,920,233,"88",145,0.1303,0.0957,0.1146
"10960",240462,1996,"933",300,633,120,"59",61,0.2033,0.0932,0.1286
"10961",240471,1996,"1149",688,461,249,"82",167,0.2427,0.1779,0.2167
"10962",240480,1996,"1555",806,749,301,"97",204,0.2531,0.1295,0.1936
"10963",240727,1996,"1203",628,575,297,"101",196,0.3121,0.1757,0.2469
"10964",243443,1996,"780",483,297,46,"11",35,0.0725,0.037,0.059
"10965",243780,1996,"6339",2713,3626,1843,"903",940,0.3465,0.249,0.2907
"10966",100654,1995,"849",434,415,185,"47",138,0.318,0.1133,0.2179
"10967",100663,1995,"1052",599,453,128,"37",91,0.1519,0.0817,0.1217
"10968",100751,1995,"2493",1387,1106,748,"246",502,0.3619,0.2224,0.3
"10969",100858,1995,"3486",1832,1654,1106,"345",761,0.4154,0.2086,0.3173
"10970",101435,1995,"160",106,54,56,"17",39,0.3679,0.3148,0.35
"10971",101480,1995,"798",435,363,136,"36",100,0.2299,0.0992,0.1704
"10972",101675,1995,"229",114,115,120,"50",70,0.614,0.4348,0.524
"10973",101879,1995,"762",444,318,167,"44",123,0.277,0.1384,0.2192
"10974",102049,1995,"647",399,248,331,"118",213,0.5338,0.4758,0.5116
"10975",102094,1995,"1192",674,518,167,"54",113,0.1677,0.1042,0.1401
"10976",102234,1995,"232",141,91,113,"34",79,0.5603,0.3736,0.4871
"10977",102368,1995,"877",477,400,354,"120",234,0.4906,0.3,0.4036
"10978",102377,1995,"645",383,262,139,"35",104,0.2715,0.1336,0.2155
"10979",104151,1995,"3945",2096,1849,854,"299",555,0.2648,0.1617,0.2165
"10980",104179,1995,"4370",2382,1988,1160,"405",755,0.317,0.2037,0.2654
"10981",105330,1995,"2015",1120,895,436,"133",303,0.2705,0.1486,0.2164
"10982",106245,1995,"675",390,285,103,"37",66,0.1692,0.1298,0.1526
"10983",106342,1995,"168",90,78,82,"32",50,0.5556,0.4103,0.4881
"10984",106397,1995,"2249",1148,1101,425,"155",270,0.2352,0.1408,0.189
"10985",106412,1995,"565",302,263,39,"11",28,0.0927,0.0418,0.069
"10986",106458,1995,"1448",803,645,218,"65",153,0.1905,0.1008,0.1506
"10987",106467,1995,"756",386,370,133,"46",87,0.2254,0.1243,0.1759
"10988",106485,1995,"489",254,235,46,"14",32,0.126,0.0596,0.0941
"10989",106704,1995,"1469",920,549,207,"46",161,0.175,0.0838,0.1409
"10990",107044,1995,"779",437,342,250,"92",158,0.3616,0.269,0.3209
"10991",107080,1995,"273",166,107,148,"58",90,0.5422,0.5421,0.5421
"10992",107141,1995,"224",115,109,71,"28",43,0.3739,0.2569,0.317
"10993",107512,1995,"380",206,174,173,"75",98,0.4757,0.431,0.4553
"10994",107558,1995,"133",66,67,29,"14",15,0.2273,0.209,0.218
"10995",110097,1995,"407",278,129,168,"45",123,0.4424,0.3488,0.4128
"10996",110404,1995,"218",52,166,156,"108",48,0.9231,0.6506,0.7156
"10997",110422,1995,"2418",1092,1326,356,"114",242,0.2216,0.086,0.1472
"10998",110486,1995,"397",236,161,43,"11",32,0.1356,0.0683,0.1083
"10999",110495,1995,"353",242,111,75,"12",63,0.2603,0.1081,0.2125
"11000",110510,1995,"799",505,294,58,"16",42,0.0832,0.0544,0.0726
"11001",110529,1995,"1422",621,801,96,"37",59,0.095,0.0462,0.0675
"11002",110538,1995,"1401",832,569,161,"22",139,0.1671,0.0387,0.1149
"11003",110547,1995,"467",335,132,19,"4",15,0.0448,0.0303,0.0407
"11004",110556,1995,"1571",915,656,176,"44",132,0.1443,0.0671,0.112
"11005",110565,1995,"1832",1036,796,148,"41",107,0.1033,0.0515,0.0808
"11006",110574,1995,"542",331,211,55,"22",33,0.0997,0.1043,0.1015
"11007",110583,1995,"2057",1307,750,88,"26",62,0.0474,0.0347,0.0428
"11008",110592,1995,"1243",766,477,49,"12",37,0.0483,0.0252,0.0394
"11009",110617,1995,"1219",735,484,96,"24",72,0.098,0.0496,0.0788
"11010",113698,1995,"69",51,18,27,"5",22,0.4314,0.2778,0.3913
"11011",115755,1995,"908",503,405,69,"18",51,0.1014,0.0444,0.076
"11012",119173,1995,"222",220,2,50,"2",48,0.2182,1,0.2252
"11013",120184,1995,"115",79,36,44,"9",35,0.443,0.25,0.3826
"11014",121309,1995,"475",313,162,185,"57",128,0.4089,0.3519,0.3895
"11015",121345,1995,"392",190,202,336,"166",170,0.8947,0.8218,0.8571
"11016",122409,1995,"2840",1716,1124,212,"58",154,0.0897,0.0516,0.0746
"11017",122436,1995,"978",597,381,500,"186",314,0.526,0.4882,0.5112
"11018",122597,1995,"1539",966,573,89,"26",63,0.0652,0.0454,0.0578
"11019",122612,1995,"550",350,200,237,"71",166,0.4743,0.355,0.4309
"11020",122931,1995,"1043",558,485,757,"329",428,0.767,0.6784,0.7258
"11021",123554,1995,"474",256,218,306,"141",165,0.6445,0.6468,0.6456
"11022",123572,1995,"681",441,240,131,"41",90,0.2041,0.1708,0.1924
"11023",126562,1995,"266",166,100,41,"14",27,0.1627,0.14,0.1541
"11024",126580,1995,"363",197,166,88,"36",52,0.264,0.2169,0.2424
"11025",126614,1995,"4170",2020,2150,1454,"602",852,0.4218,0.28,0.3487
"11026",126818,1995,"2546",1354,1192,805,"287",518,0.3826,0.2408,0.3162
"11027",127060,1995,"654",330,324,376,"175",201,0.6091,0.5401,0.5749
"11028",127185,1995,"1010",434,576,96,"26",70,0.1613,0.0451,0.095
"11029",127565,1995,"1239",691,548,48,"19",29,0.042,0.0347,0.0387
"11030",127741,1995,"1763",1091,672,404,"90",314,0.2878,0.1339,0.2292
"11031",128106,1995,"590",299,291,69,"31",38,0.1271,0.1065,0.1169
"11032",128744,1995,"123",73,50,38,"14",24,0.3288,0.28,0.3089
"11033",128771,1995,"1076",566,510,68,"28",40,0.0707,0.0549,0.0632
"11034",129020,1995,"2010",1051,959,855,"341",514,0.4891,0.3556,0.4254
"11035",129242,1995,"784",450,334,602,"248",354,0.7867,0.7425,0.7679
"11036",129941,1995,"352",115,237,110,"74",36,0.313,0.3122,0.3125
"11037",130253,1995,"639",357,282,269,"107",162,0.4538,0.3794,0.421
"11038",130314,1995,"153",152,1,82,"0",82,0.5395,0,0.5359
"11039",130493,1995,"917",526,391,121,"36",85,0.1616,0.0921,0.132
"11040",130590,1995,"507",246,261,388,"174",214,0.8699,0.6667,0.7653
"11041",130697,1995,"710",356,354,584,"288",296,0.8315,0.8136,0.8225
"11042",130776,1995,"460",237,223,79,"35",44,0.1857,0.157,0.1717
"11043",130794,1995,"1360",692,668,1198,"575",623,0.9003,0.8608,0.8809
"11044",130934,1995,"563",333,230,76,"27",49,0.1471,0.1174,0.135
"11045",130943,1995,"3155",1883,1272,1719,"621",1098,0.5831,0.4882,0.5448
"11046",131159,1995,"1221",794,427,789,"288",501,0.631,0.6745,0.6462
"11047",131283,1995,"514",265,249,290,"125",165,0.6226,0.502,0.5642
"11048",131450,1995,"225",120,105,10,"2",8,0.0667,0.019,0.0444
"11049",131469,1995,"1367",803,564,905,"346",559,0.6961,0.6135,0.662
"11050",131496,1995,"1403",742,661,1207,"568",639,0.8612,0.8593,0.8603
"11051",131520,1995,"834",540,294,438,"117",321,0.5944,0.398,0.5252
"11052",132471,1995,"177",103,74,46,"10",36,0.3495,0.1351,0.2599
"11053",132602,1995,"729",393,336,106,"31",75,0.1908,0.0923,0.1454
"11054",132903,1995,"2411",1295,1116,661,"217",444,0.3429,0.1944,0.2742
"11055",133492,1995,"334",184,150,199,"83",116,0.6304,0.5533,0.5958
"11056",133553,1995,"665",100,565,128,"105",23,0.23,0.1858,0.1925
"11057",133650,1995,"1574",952,622,245,"63",182,0.1912,0.1013,0.1557
"11058",133669,1995,"901",504,397,162,"51",111,0.2202,0.1285,0.1798
"11059",133711,1995,"355",217,138,143,"45",98,0.4516,0.3261,0.4028
"11060",133881,1995,"370",111,259,113,"70",43,0.3874,0.2703,0.3054
"11061",133951,1995,"1752",1003,749,270,"74",196,0.1954,0.0988,0.1541
"11062",134079,1995,"527",302,225,230,"76",154,0.5099,0.3378,0.4364
"11063",134097,1995,"3826",2210,1616,1534,"530",1004,0.4543,0.328,0.4009
"11064",134130,1995,"5655",3023,2632,2443,"903",1540,0.5094,0.3431,0.432
"11065",134945,1995,"356",197,159,129,"51",78,0.3959,0.3208,0.3624
"11066",135726,1995,"1684",913,771,832,"348",484,0.5301,0.4514,0.4941
"11067",136172,1995,"762",463,299,145,"26",119,0.257,0.087,0.1903
"11068",136950,1995,"412",248,164,250,"88",162,0.6532,0.5366,0.6068
"11069",137546,1995,"464",253,211,228,"89",139,0.5494,0.4218,0.4914
"11070",138354,1995,"509",279,230,101,"30",71,0.2545,0.1304,0.1984
"11071",138716,1995,"530",291,239,37,"10",27,0.0928,0.0418,0.0698
"11072",138789,1995,"773",497,276,50,"13",37,0.0744,0.0471,0.0647
"11073",139144,1995,"522",316,206,184,"68",116,0.3671,0.3301,0.3525
"11074",139366,1995,"633",390,243,54,"17",37,0.0949,0.07,0.0853
"11075",139393,1995,"155",90,65,75,"33",42,0.4667,0.5077,0.4839
"11076",139658,1995,"1587",896,691,1093,"441",652,0.7277,0.6382,0.6887
"11077",139719,1995,"522",261,261,38,"8",30,0.1149,0.0307,0.0728
"11078",139755,1995,"2120",600,1520,451,"271",180,0.3,0.1783,0.2127
"11079",139764,1995,"328",211,117,26,"3",23,0.109,0.0256,0.0793
"11080",139861,1995,"754",467,287,123,"28",95,0.2034,0.0976,0.1631
"11081",139931,1995,"3193",1825,1368,407,"112",295,0.1616,0.0819,0.1275
"11082",139940,1995,"1276",750,526,127,"51",76,0.1013,0.097,0.0995
"11083",139959,1995,"3996",2376,1620,1702,"570",1132,0.4764,0.3519,0.4259
"11084",140447,1995,"630",381,249,199,"65",134,0.3517,0.261,0.3159
"11085",140960,1995,"676",358,318,25,"2",23,0.0642,0.0063,0.037
"11086",140988,1995,"167",118,49,76,"24",52,0.4407,0.4898,0.4551
"11087",141185,1995,"210",124,86,8,"2",6,0.0484,0.0233,0.0381
"11088",141264,1995,"1665",985,680,247,"71",176,0.1787,0.1044,0.1483
"11089",141334,1995,"1430",841,589,128,"32",96,0.1141,0.0543,0.0895
"11090",141486,1995,"123",72,51,31,"12",19,0.2639,0.2353,0.252
"11091",141565,1995,"359",216,143,32,"5",27,0.125,0.035,0.0891
"11092",141574,1995,"1671",967,704,184,"57",127,0.1313,0.081,0.1101
"11093",142276,1995,"1363",783,580,37,"6",31,0.0396,0.0103,0.0271
"11094",142285,1995,"1242",602,640,225,"78",147,0.2442,0.1219,0.1812
"11095",142461,1995,"320",183,137,86,"27",59,0.3224,0.1971,0.2688
"11096",143084,1995,"605",352,253,394,"151",243,0.6903,0.5968,0.6512
"11097",143288,1995,"157",66,91,37,"17",20,0.303,0.1868,0.2357
"11098",144005,1995,"613",410,203,35,"3",32,0.078,0.0148,0.0571
"11099",144281,1995,"939",464,475,131,"67",64,0.1379,0.1411,0.1395
"11100",144740,1995,"1225",700,525,447,"177",270,0.3857,0.3371,0.3649
"11101",144892,1995,"1538",973,565,468,"117",351,0.3607,0.2071,0.3043
"11102",144962,1995,"253",147,106,128,"41",87,0.5918,0.3868,0.5059
"11103",144971,1995,"139",58,81,68,"35",33,0.569,0.4321,0.4892
"11104",145600,1995,"2469",1401,1068,309,"110",199,0.142,0.103,0.1252
"11105",145619,1995,"245",123,122,95,"38",57,0.4634,0.3115,0.3878
"11106",145637,1995,"6101",2944,3157,3312,"1492",1820,0.6182,0.4726,0.5429
"11107",145691,1995,"223",139,84,98,"30",68,0.4892,0.3571,0.4395
"11108",145813,1995,"2950",1798,1152,823,"240",583,0.3242,0.2083,0.279
"11109",146481,1995,"266",155,111,156,"58",98,0.6323,0.5225,0.5865
"11110",146612,1995,"331",158,173,104,"49",55,0.3481,0.2832,0.3142
"11111",146719,1995,"1182",733,449,544,"167",377,0.5143,0.3719,0.4602
"11112",146825,1995,"175",75,100,50,"12",38,0.5067,0.12,0.2857
"11113",147013,1995,"188",109,79,54,"16",38,0.3486,0.2025,0.2872
"11114",147244,1995,"494",272,222,248,"98",150,0.5515,0.4414,0.502
"11115",147341,1995,"308",187,121,156,"54",102,0.5455,0.4463,0.5065
"11116",147703,1995,"2429",1368,1061,582,"200",382,0.2792,0.1885,0.2396
"11117",147767,1995,"1948",1066,882,1595,"672",923,0.8659,0.7619,0.8188
"11118",147776,1995,"812",488,324,20,"7",13,0.0266,0.0216,0.0246
"11119",147828,1995,"389",217,172,150,"60",90,0.4147,0.3488,0.3856
"11120",148131,1995,"259",126,133,89,"30",59,0.4683,0.2256,0.3436
"11121",148496,1995,"124",95,29,67,"13",54,0.5684,0.4483,0.5403
"11122",148584,1995,"165",82,83,67,"30",37,0.4512,0.3614,0.4061
"11123",148627,1995,"226",139,87,67,"19",48,0.3453,0.2184,0.2965
"11124",149222,1995,"2277",1006,1271,371,"162",209,0.2078,0.1275,0.1629
"11125",149231,1995,"1085",644,441,154,"40",114,0.177,0.0907,0.1419
"11126",149772,1995,"1538",757,781,392,"168",224,0.2959,0.2151,0.2549
"11127",149781,1995,"546",281,265,425,"198",227,0.8078,0.7472,0.7784
"11128",150066,1995,"498",298,200,169,"59",110,0.3691,0.295,0.3394
"11129",150136,1995,"3855",2068,1787,787,"262",525,0.2539,0.1466,0.2042
"11130",150145,1995,"184",118,66,63,"18",45,0.3814,0.2727,0.3424
"11131",150163,1995,"847",510,337,409,"145",264,0.5176,0.4303,0.4829
"11132",150400,1995,"580",328,252,434,"187",247,0.753,0.7421,0.7483
"11133",150534,1995,"826",504,322,370,"131",239,0.4742,0.4068,0.4479
"11134",150668,1995,"213",111,102,104,"40",64,0.5766,0.3922,0.4883
"11135",150941,1995,"191",113,78,87,"27",60,0.531,0.3462,0.4555
"11136",151102,1995,"1063",577,486,43,"14",29,0.0503,0.0288,0.0405
"11137",151111,1995,"1860",1024,836,148,"65",83,0.0811,0.0778,0.0796
"11138",151306,1995,"1407",813,594,138,"30",108,0.1328,0.0505,0.0981
"11139",151324,1995,"1980",1032,948,350,"132",218,0.2112,0.1392,0.1768
"11140",151333,1995,"294",184,110,27,"7",20,0.1087,0.0636,0.0918
"11141",151342,1995,"626",374,252,51,"19",32,0.0856,0.0754,0.0815
"11142",151351,1995,"5705",3293,2412,3057,"1182",1875,0.5694,0.49,0.5358
"11143",151360,1995,"599",383,216,42,"13",29,0.0757,0.0602,0.0701
"11144",151379,1995,"593",357,236,74,"27",47,0.1317,0.1144,0.1248
"11145",151388,1995,"242",144,98,12,"5",7,0.0486,0.051,0.0496
"11146",151777,1995,"321",158,163,136,"61",75,0.4747,0.3742,0.4237
"11147",151786,1995,"255",168,87,90,"28",62,0.369,0.3218,0.3529
"11148",152080,1995,"1902",870,1032,1667,"887",780,0.8966,0.8595,0.8764
"11149",152248,1995,"906",487,419,71,"21",50,0.1027,0.0501,0.0784
"11150",152363,1995,"237",106,131,99,"52",47,0.4434,0.3969,0.4177
"11151",152530,1995,"419",224,195,270,"112",158,0.7054,0.5744,0.6444
"11152",152600,1995,"673",370,303,405,"141",264,0.7135,0.4653,0.6018
"11153",153001,1995,"352",167,185,168,"71",97,0.5808,0.3838,0.4773
"11154",153108,1995,"410",249,161,247,"92",155,0.6225,0.5714,0.6024
"11155",153269,1995,"734",435,299,365,"144",221,0.508,0.4816,0.4973
"11156",153384,1995,"307",168,139,238,"106",132,0.7857,0.7626,0.7752
"11157",153603,1995,"3274",1490,1784,822,"341",481,0.3228,0.1911,0.2511
"11158",153834,1995,"590",372,218,375,"122",253,0.6801,0.5596,0.6356
"11159",154095,1995,"2007",1244,763,604,"170",434,0.3489,0.2228,0.3009
"11160",155089,1995,"200",109,91,43,"19",24,0.2202,0.2088,0.215
"11161",155317,1995,"3474",1857,1617,905,"351",554,0.2983,0.2171,0.2605
"11162",155335,1995,"118",74,44,23,"6",17,0.2297,0.1364,0.1949
"11163",155399,1995,"2877",1380,1497,558,"219",339,0.2457,0.1463,0.194
"11164",155520,1995,"246",124,122,62,"17",45,0.3629,0.1393,0.252
"11165",155627,1995,"137",44,93,21,"9",12,0.2727,0.0968,0.1533
"11166",155937,1995,"120",63,57,42,"12",30,0.4762,0.2105,0.35
"11167",156213,1995,"298",180,118,140,"65",75,0.4167,0.5508,0.4698
"11168",156286,1995,"329",189,140,151,"49",102,0.5397,0.35,0.459
"11169",156295,1995,"416",220,196,146,"64",82,0.3727,0.3265,0.351
"11170",156365,1995,"322",156,166,84,"34",50,0.3205,0.2048,0.2609
"11171",156541,1995,"377",204,173,107,"33",74,0.3627,0.1908,0.2838
"11172",156745,1995,"304",201,103,134,"30",104,0.5174,0.2913,0.4408
"11173",157058,1995,"370",189,181,13,"10",3,0.0159,0.0552,0.0351
"11174",157076,1995,"151",79,72,49,"17",32,0.4051,0.2361,0.3245
"11175",157085,1995,"2612",1383,1229,620,"235",385,0.2784,0.1912,0.2374
"11176",157289,1995,"1835",903,932,193,"69",124,0.1373,0.074,0.1052
"11177",157386,1995,"1119",646,473,104,"7",97,0.1502,0.0148,0.0929
"11178",157401,1995,"1201",661,540,262,"82",180,0.2723,0.1519,0.2182
"11179",157447,1995,"1545",873,672,79,"22",57,0.0653,0.0327,0.0511
"11180",157535,1995,"227",154,73,34,"8",26,0.1688,0.1096,0.1498
"11181",157951,1995,"2454",1364,1090,496,"159",337,0.2471,0.1459,0.2021
"11182",158477,1995,"213",134,79,91,"26",65,0.4851,0.3291,0.4272
"11183",159009,1995,"1121",569,552,107,"23",84,0.1476,0.0417,0.0955
"11184",159391,1995,"3646",2007,1639,746,"257",489,0.2436,0.1568,0.2046
"11185",159647,1995,"1278",598,680,281,"103",178,0.2977,0.1515,0.2199
"11186",159717,1995,"1376",775,601,71,"22",49,0.0632,0.0366,0.0516
"11187",159966,1995,"1170",672,498,76,"19",57,0.0848,0.0382,0.065
"11188",160038,1995,"1556",947,609,165,"41",124,0.1309,0.0673,0.106
"11189",160612,1995,"2367",1387,980,94,"21",73,0.0526,0.0214,0.0397
"11190",160621,1995,"1846",991,855,101,"21",80,0.0807,0.0246,0.0547
"11191",160658,1995,"2609",1453,1156,110,"24",86,0.0592,0.0208,0.0422
"11192",161004,1995,"446",225,221,369,"180",189,0.84,0.8145,0.8274
"11193",161226,1995,"473",335,138,153,"35",118,0.3522,0.2536,0.3235
"11194",161235,1995,"74",34,40,6,"2",4,0.1176,0.05,0.0811
"11195",161244,1995,"129",73,56,10,"5",5,0.0685,0.0893,0.0775
"11196",161253,1995,"1118",526,592,322,"148",174,0.3308,0.25,0.288
"11197",161554,1995,"620",358,262,66,"23",43,0.1201,0.0878,0.1065
"11198",162007,1995,"435",260,175,62,"11",51,0.1962,0.0629,0.1425
"11199",162210,1995,"137",84,53,24,"9",15,0.1786,0.1698,0.1752
"11200",162283,1995,"439",303,136,31,"8",23,0.0759,0.0588,0.0706
"11201",162584,1995,"909",433,476,194,"68",126,0.291,0.1429,0.2134
"11202",162654,1995,"277",193,84,154,"41",113,0.5855,0.4881,0.556
"11203",162760,1995,"177",172,5,103,"2",101,0.5872,0.4,0.5819
"11204",162928,1995,"873",332,541,683,"401",282,0.8494,0.7412,0.7824
"11205",163046,1995,"798",450,348,581,"240",341,0.7578,0.6897,0.7281
"11206",163268,1995,"968",485,483,295,"115",180,0.3711,0.2381,0.3048
"11207",163286,1995,"3577",1722,1855,1343,"539",804,0.4669,0.2906,0.3755
"11208",163453,1995,"959",580,379,166,"30",136,0.2345,0.0792,0.1731
"11209",163462,1995,"315",169,146,205,"95",110,0.6509,0.6507,0.6508
"11210",163851,1995,"642",412,230,322,"101",221,0.5364,0.4391,0.5016
"11211",163912,1995,"352",201,151,207,"81",126,0.6269,0.5364,0.5881
"11212",164076,1995,"1488",934,554,468,"121",347,0.3715,0.2184,0.3145
"11213",164173,1995,"253",180,73,94,"26",68,0.3778,0.3562,0.3715
"11214",164216,1995,"241",134,107,144,"60",84,0.6269,0.5607,0.5975
"11215",164270,1995,"316",163,153,206,"80",126,0.773,0.5229,0.6519
"11216",164447,1995,"260",104,156,84,"37",47,0.4519,0.2372,0.3231
"11217",164492,1995,"69",43,26,28,"7",21,0.4884,0.2692,0.4058
"11218",164562,1995,"446",262,184,295,"119",176,0.6718,0.6467,0.6614
"11219",165015,1995,"874",483,391,702,"306",396,0.8199,0.7826,0.8032
"11220",165024,1995,"1087",620,467,211,"57",154,0.2484,0.1221,0.1941
"11221",165334,1995,"505",318,187,311,"103",208,0.6541,0.5508,0.6158
"11222",165662,1995,"526",313,213,310,"121",189,0.6038,0.5681,0.5894
"11223",165671,1995,"100",100,0,43,"0",43,0.43,NA,0.43
"11224",165820,1995,"574",329,245,106,"20",86,0.2614,0.0816,0.1847
"11225",165866,1995,"600",404,196,122,"28",94,0.2327,0.1429,0.2033
"11226",165936,1995,"330",226,104,152,"43",109,0.4823,0.4135,0.4606
"11227",166027,1995,"1606",738,868,1343,"705",638,0.8645,0.8122,0.8362
"11228",166124,1995,"710",384,326,618,"287",331,0.862,0.8804,0.8704
"11229",166513,1995,"1102",422,680,195,"90",105,0.2488,0.1324,0.177
"11230",166629,1995,"3959",1946,2013,1429,"583",846,0.4347,0.2896,0.3609
"11231",166638,1995,"502",222,280,38,"17",21,0.0946,0.0607,0.0757
"11232",166683,1995,"1115",468,647,921,"517",404,0.8632,0.7991,0.826
"11233",167288,1995,"290",171,119,80,"15",65,0.3801,0.1261,0.2759
"11234",167987,1995,"886",420,466,253,"90",163,0.3881,0.1931,0.2856
"11235",167996,1995,"547",328,219,443,"166",277,0.8445,0.758,0.8099
"11236",168005,1995,"386",214,172,110,"39",71,0.3318,0.2267,0.285
"11237",168148,1995,"1147",594,553,944,"439",505,0.8502,0.7939,0.823
"11238",168254,1995,"580",222,358,223,"116",107,0.482,0.324,0.3845
"11239",168281,1995,"359",249,110,241,"72",169,0.6787,0.6545,0.6713
"11240",168342,1995,"524",243,281,453,"237",216,0.8889,0.8434,0.8645
"11241",168546,1995,"473",238,235,334,"150",184,0.7731,0.6383,0.7061
"11242",168786,1995,"241",139,102,69,"28",41,0.295,0.2745,0.2863
"11243",169080,1995,"1013",571,442,506,"215",291,0.5096,0.4864,0.4995
"11244",169798,1995,"2172",1230,942,198,"65",133,0.1081,0.069,0.0912
"11245",169910,1995,"1893",752,1141,55,"28",27,0.0359,0.0245,0.0291
"11246",170082,1995,"1773",1087,686,287,"95",192,0.1766,0.1385,0.1619
"11247",170301,1995,"709",418,291,412,"143",269,0.6435,0.4914,0.5811
"11248",170532,1995,"350",197,153,221,"90",131,0.665,0.5882,0.6314
"11249",170639,1995,"593",281,312,80,"39",41,0.1459,0.125,0.1349
"11250",170976,1995,"5265",2658,2607,3223,"1428",1795,0.6753,0.5478,0.6122
"11251",171100,1995,"6396",3546,2850,2076,"693",1383,0.39,0.2432,0.3246
"11252",171128,1995,"1072",285,787,218,"134",84,0.2947,0.1703,0.2034
"11253",171137,1995,"600",320,280,49,"23",26,0.0812,0.0821,0.0817
"11254",171146,1995,"263",169,94,116,"45",71,0.4201,0.4787,0.4411
"11255",171599,1995,"209",69,140,28,"20",8,0.1159,0.1429,0.134
"11256",172051,1995,"752",412,340,40,"14",26,0.0631,0.0412,0.0532
"11257",172699,1995,"3165",1851,1314,524,"148",376,0.2031,0.1126,0.1656
"11258",173160,1995,"475",303,172,282,"90",192,0.6337,0.5233,0.5937
"11259",173258,1995,"463",232,231,393,"191",202,0.8707,0.8268,0.8488
"11260",173328,1995,"153",91,62,42,"13",29,0.3187,0.2097,0.2745
"11261",173647,1995,"690",380,310,478,"196",282,0.7421,0.6323,0.6928
"11262",173902,1995,"437",231,206,322,"143",179,0.7749,0.6942,0.7368
"11263",174066,1995,"4128",2100,2028,984,"418",566,0.2695,0.2061,0.2384
"11264",174233,1995,"1462",688,774,361,"146",215,0.3125,0.1886,0.2469
"11265",174251,1995,"503",297,206,202,"66",136,0.4579,0.3204,0.4016
"11266",174491,1995,"378",245,133,155,"43",112,0.4571,0.3233,0.4101
"11267",174792,1995,"430",0,430,286,"286",0,NA,0.6651,0.6651
"11268",174844,1995,"742",431,311,557,"223",334,0.7749,0.717,0.7507
"11269",174899,1995,"270",201,69,142,"30",112,0.5572,0.4348,0.5259
"11270",174914,1995,"852",454,398,430,"181",249,0.5485,0.4548,0.5047
"11271",175342,1995,"746",410,336,148,"38",110,0.2683,0.1131,0.1984
"11272",175421,1995,"112",67,45,39,"13",26,0.3881,0.2889,0.3482
"11273",175616,1995,"464",301,163,102,"25",77,0.2558,0.1534,0.2198
"11274",175856,1995,"1212",679,533,162,"39",123,0.1811,0.0732,0.1337
"11275",175980,1995,"261",128,133,180,"74",106,0.8281,0.5564,0.6897
"11276",176017,1995,"1526",825,701,490,"180",310,0.3758,0.2568,0.3211
"11277",176035,1995,"288",238,50,59,"7",52,0.2185,0.14,0.2049
"11278",176044,1995,"448",244,204,87,"23",64,0.2623,0.1127,0.1942
"11279",176080,1995,"1826",845,981,382,"158",224,0.2651,0.1611,0.2092
"11280",176406,1995,"218",141,77,65,"19",46,0.3262,0.2468,0.2982
"11281",176628,1995,"101",61,40,31,"11",20,0.3279,0.275,0.3069
"11282",176947,1995,"229",95,134,73,"36",37,0.3895,0.2687,0.3188
"11283",176965,1995,"1428",755,673,243,"79",164,0.2172,0.1174,0.1702
"11284",177418,1995,"143",110,33,51,"11",40,0.3636,0.3333,0.3566
"11285",178059,1995,"167",123,44,77,"16",61,0.4959,0.3636,0.4611
"11286",178341,1995,"720",359,361,77,"37",40,0.1114,0.1025,0.1069
"11287",178387,1995,"923",530,393,92,"24",68,0.1283,0.0611,0.0997
"11288",178396,1995,"3782",2099,1683,1210,"420",790,0.3764,0.2496,0.3199
"11289",178402,1995,"568",318,250,70,"25",45,0.1415,0.1,0.1232
"11290",178411,1995,"804",190,614,121,"75",46,0.2421,0.1221,0.1505
"11291",178420,1995,"552",315,237,85,"31",54,0.1714,0.1308,0.154
"11292",178615,1995,"1498",883,615,577,"183",394,0.4462,0.2976,0.3852
"11293",179043,1995,"288",161,127,174,"74",100,0.6211,0.5827,0.6042
"11294",179159,1995,"1055",604,451,501,"195",306,0.5066,0.4324,0.4749
"11295",179557,1995,"1385",824,561,334,"90",244,0.2961,0.1604,0.2412
"11296",179566,1995,"2479",1394,1085,440,"156",284,0.2037,0.1438,0.1775
"11297",179867,1995,"1180",608,572,911,"411",500,0.8224,0.7185,0.772
"11298",179894,1995,"227",105,122,90,"52",38,0.3619,0.4262,0.3965
"11299",179946,1995,"190",88,102,91,"47",44,0.5,0.4608,0.4789
"11300",180179,1995,"384",255,129,12,"2",10,0.0392,0.0155,0.0312
"11301",180461,1995,"1744",714,1030,224,"101",123,0.1723,0.0981,0.1284
"11302",180522,1995,"192",99,93,38,"16",22,0.2222,0.172,0.1979
"11303",180984,1995,"227",128,99,92,"37",55,0.4297,0.3737,0.4053
"11304",181002,1995,"746",441,305,421,"157",264,0.5986,0.5148,0.5643
"11305",181020,1995,"243",130,113,140,"56",84,0.6462,0.4956,0.5761
"11306",181127,1995,"271",134,137,117,"44",73,0.5448,0.3212,0.4317
"11307",181215,1995,"1306",729,577,138,"46",92,0.1262,0.0797,0.1057
"11308",181394,1995,"1123",607,516,64,"20",44,0.0725,0.0388,0.057
"11309",181446,1995,"362",214,148,164,"57",107,0.5,0.3851,0.453
"11310",181464,1995,"3891",1925,1966,620,"256",364,0.1891,0.1302,0.1593
"11311",181534,1995,"225",122,103,45,"19",26,0.2131,0.1845,0.2
"11312",181783,1995,"722",382,340,146,"45",101,0.2644,0.1324,0.2022
"11313",182281,1995,"1324",748,576,161,"54",107,0.143,0.0938,0.1216
"11314",182290,1995,"1035",591,444,170,"52",118,0.1997,0.1171,0.1643
"11315",182634,1995,"240",154,86,115,"46",69,0.4481,0.5349,0.4792
"11316",182795,1995,"464",220,244,174,"75",99,0.45,0.3074,0.375
"11317",183062,1995,"988",588,400,251,"86",165,0.2806,0.215,0.254
"11318",183080,1995,"872",426,446,204,"80",124,0.2911,0.1794,0.2339
"11319",183239,1995,"612",369,243,424,"163",261,0.7073,0.6708,0.6928
"11320",183822,1995,"275",196,79,40,"11",29,0.148,0.1392,0.1455
"11321",183974,1995,"73",53,20,19,"3",16,0.3019,0.15,0.2603
"11322",184348,1995,"433",255,178,312,"122",190,0.7451,0.6854,0.7206
"11323",184603,1995,"781",396,385,128,"57",71,0.1793,0.1481,0.1639
"11324",184612,1995,"87",70,17,18,"9",9,0.1286,0.5294,0.2069
"11325",184782,1995,"927",516,411,226,"69",157,0.3043,0.1679,0.2438
"11326",185129,1995,"457",246,211,40,"11",29,0.1179,0.0521,0.0875
"11327",185572,1995,"764",412,352,234,"82",152,0.3689,0.233,0.3063
"11328",185590,1995,"1068",651,417,216,"69",147,0.2258,0.1655,0.2022
"11329",185828,1995,"552",131,421,60,"35",25,0.1908,0.0831,0.1087
"11330",186131,1995,"1207",569,638,1105,"579",526,0.9244,0.9075,0.9155
"11331",186201,1995,"319",190,129,67,"20",47,0.2474,0.155,0.21
"11332",186283,1995,"612",329,283,242,"103",139,0.4225,0.364,0.3954
"11333",186584,1995,"955",527,428,371,"145",226,0.4288,0.3388,0.3885
"11334",186876,1995,"726",438,288,258,"86",172,0.3927,0.2986,0.3554
"11335",187134,1995,"1087",670,417,638,"212",426,0.6358,0.5084,0.5869
"11336",187444,1995,"831",476,355,87,"23",64,0.1345,0.0648,0.1047
"11337",187985,1995,"1712",956,756,221,"76",145,0.1517,0.1005,0.1291
"11338",188030,1995,"1419",726,693,146,"51",95,0.1309,0.0736,0.1029
"11339",188429,1995,"370",212,158,140,"52",88,0.4151,0.3291,0.3784
"11340",188641,1995,"326",158,168,153,"56",97,0.6139,0.3333,0.4693
"11341",190044,1995,"645",170,475,305,"221",84,0.4941,0.4653,0.4729
"11342",190099,1995,"722",361,361,604,"290",314,0.8698,0.8033,0.8366
"11343",190150,1995,"1157",505,652,918,"501",417,0.8257,0.7684,0.7934
"11344",190248,1995,"118",63,55,29,"13",16,0.254,0.2364,0.2458
"11345",190415,1995,"2070",842,1228,1625,"931",694,0.8242,0.7581,0.785
"11346",190512,1995,"1445",839,606,149,"55",94,0.112,0.0908,0.1031
"11347",190549,1995,"1167",685,482,182,"60",122,0.1781,0.1245,0.156
"11348",190558,1995,"1426",728,698,33,"17",16,0.022,0.0244,0.0231
"11349",190567,1995,"865",449,416,31,"18",13,0.029,0.0433,0.0358
"11350",190594,1995,"1091",807,284,82,"13",69,0.0855,0.0458,0.0752
"11351",190637,1995,"506",345,161,32,"7",25,0.0725,0.0435,0.0632
"11352",190664,1995,"1444",805,639,228,"81",147,0.1826,0.1268,0.1579
"11353",190691,1995,"486",294,192,22,"7",15,0.051,0.0365,0.0453
"11354",190725,1995,"398",269,129,77,"20",57,0.2119,0.155,0.1935
"11355",191241,1995,"1120",620,500,794,"323",471,0.7597,0.646,0.7089
"11356",191515,1995,"488",237,251,392,"194",198,0.8354,0.7729,0.8033
"11357",191533,1995,"453",229,224,227,"88",139,0.607,0.3929,0.5011
"11358",191630,1995,"458",244,214,318,"137",181,0.7418,0.6402,0.6943
"11359",191649,1995,"1518",830,688,559,"201",358,0.4313,0.2922,0.3682
"11360",191676,1995,"293",213,80,171,"52",119,0.5587,0.65,0.5836
"11361",191931,1995,"609",288,321,203,"73",130,0.4514,0.2274,0.3333
"11362",191968,1995,"1625",878,747,1052,"440",612,0.697,0.589,0.6474
"11363",192192,1995,"200",154,46,69,"10",59,0.3831,0.2174,0.345
"11364",192323,1995,"397",236,161,258,"98",160,0.678,0.6087,0.6499
"11365",192439,1995,"1043",700,343,55,"17",38,0.0543,0.0496,0.0527
"11366",192703,1995,"572",256,316,321,"160",161,0.6289,0.5063,0.5612
"11367",192749,1995,"161",115,46,87,"18",69,0.6,0.3913,0.5404
"11368",192819,1995,"926",527,399,472,"181",291,0.5522,0.4536,0.5097
"11369",192925,1995,"78",50,28,15,"5",10,0.2,0.1786,0.1923
"11370",193016,1995,"1002",623,379,4,"2",2,0.0032,0.0053,0.004
"11371",193292,1995,"135",108,27,30,"5",25,0.2315,0.1852,0.2222
"11372",193353,1995,"258",196,62,114,"24",90,0.4592,0.3871,0.4419
"11373",193399,1995,"217",164,53,107,"27",80,0.4878,0.5094,0.4931
"11374",193584,1995,"302",227,75,182,"36",146,0.6432,0.48,0.6026
"11375",193645,1995,"718",595,123,120,"13",107,0.1798,0.1057,0.1671
"11376",193654,1995,"445",275,170,178,"54",124,0.4509,0.3176,0.4
"11377",193900,1995,"3156",1851,1305,1652,"681",971,0.5246,0.5218,0.5234
"11378",193973,1995,"424",264,160,204,"67",137,0.5189,0.4188,0.4811
"11379",194161,1995,"160",92,68,56,"21",35,0.3804,0.3088,0.35
"11380",194310,1995,"1139",681,458,420,"139",281,0.4126,0.3035,0.3687
"11381",194824,1995,"962",243,719,425,"296",129,0.5309,0.4117,0.4418
"11382",195003,1995,"1634",502,1132,621,"379",242,0.4821,0.3348,0.38
"11383",195030,1995,"1205",583,622,751,"354",397,0.681,0.5691,0.6232
"11384",195164,1995,"547",278,269,285,"127",158,0.5683,0.4721,0.521
"11385",195173,1995,"281",145,136,89,"48",41,0.2828,0.3529,0.3167
"11386",195216,1995,"571",287,284,382,"176",206,0.7178,0.6197,0.669
"11387",195234,1995,"248",170,78,111,"34",77,0.4529,0.4359,0.4476
"11388",195243,1995,"276",162,114,74,"22",52,0.321,0.193,0.2681
"11389",195304,1995,"233",183,50,118,"29",89,0.4863,0.58,0.5064
"11390",195474,1995,"590",317,273,393,"182",211,0.6656,0.6667,0.6661
"11391",195526,1995,"606",373,233,438,"152",286,0.7668,0.6524,0.7228
"11392",195544,1995,"84",64,20,56,"9",47,0.7344,0.45,0.6667
"11393",195809,1995,"2206",1181,1025,629,"234",395,0.3345,0.2283,0.2851
"11394",196413,1995,"2392",1259,1133,1467,"631",836,0.664,0.5569,0.6133
"11395",196592,1995,"1899",1266,633,136,"70",66,0.0521,0.1106,0.0716
"11396",197045,1995,"255",162,93,100,"27",73,0.4506,0.2903,0.3922
"11397",197133,1995,"632",381,251,509,"193",316,0.8294,0.7689,0.8054
"11398",197869,1995,"2205",1198,1007,749,"273",476,0.3973,0.2711,0.3397
"11399",197984,1995,"114",45,69,47,"26",21,0.4667,0.3768,0.4123
"11400",198385,1995,"429",209,220,373,"186",187,0.8947,0.8455,0.8695
"11401",198464,1995,"2635",1550,1085,630,"189",441,0.2845,0.1742,0.2391
"11402",198507,1995,"381",222,159,162,"47",115,0.518,0.2956,0.4252
"11403",198516,1995,"907",545,362,548,"198",350,0.6422,0.547,0.6042
"11404",198835,1995,"287",157,130,132,"47",85,0.5414,0.3615,0.4599
"11405",198969,1995,"370",121,249,67,"37",30,0.2479,0.1486,0.1811
"11406",199102,1995,"1396",706,690,339,"117",222,0.3144,0.1696,0.2428
"11407",199111,1995,"393",235,158,123,"35",88,0.3745,0.2215,0.313
"11408",199120,1995,"3229",1982,1247,2101,"732",1369,0.6907,0.587,0.6507
"11409",199139,1995,"1663",974,689,396,"115",281,0.2885,0.1669,0.2381
"11410",199148,1995,"1804",1234,570,376,"77",299,0.2423,0.1351,0.2084
"11411",199157,1995,"510",309,201,139,"34",105,0.3398,0.1692,0.2725
"11412",199193,1995,"3607",1523,2084,900,"395",505,0.3316,0.1895,0.2495
"11413",199218,1995,"1370",863,507,463,"133",330,0.3824,0.2623,0.338
"11414",199281,1995,"410",199,211,81,"34",47,0.2362,0.1611,0.1976
"11415",199306,1995,"146",66,80,31,"10",21,0.3182,0.125,0.2123
"11416",199412,1995,"146",110,36,72,"19",53,0.4818,0.5278,0.4932
"11417",199582,1995,"385",203,182,61,"17",44,0.2167,0.0934,0.1584
"11418",199643,1995,"518",305,213,127,"29",98,0.3213,0.1362,0.2452
"11419",199847,1995,"962",458,504,720,"357",363,0.7926,0.7083,0.7484
"11420",199962,1995,"334",157,177,113,"45",68,0.4331,0.2542,0.3383
"11421",199999,1995,"446",298,148,121,"32",89,0.2987,0.2162,0.2713
"11422",200004,1995,"1156",608,548,259,"78",181,0.2977,0.1423,0.224
"11423",200059,1995,"296",140,156,27,"10",17,0.1214,0.0641,0.0912
"11424",200156,1995,"289",144,145,89,"32",57,0.3958,0.2207,0.308
"11425",200217,1995,"412",234,178,115,"32",83,0.3547,0.1798,0.2791
"11426",200226,1995,"193",80,113,25,"10",15,0.1875,0.0885,0.1295
"11427",200253,1995,"525",322,203,36,"11",25,0.0776,0.0542,0.0686
"11428",200280,1995,"1407",665,742,190,"81",109,0.1639,0.1092,0.135
"11429",200332,1995,"1482",661,821,189,"87",102,0.1543,0.106,0.1275
"11430",200572,1995,"166",80,86,32,"11",21,0.2625,0.1279,0.1928
"11431",201104,1995,"549",269,280,214,"67",147,0.5465,0.2393,0.3898
"11432",201371,1995,"248",163,85,125,"39",86,0.5276,0.4588,0.504
"11433",201548,1995,"474",296,178,306,"108",198,0.6689,0.6067,0.6456
"11434",201645,1995,"729",275,454,388,"205",183,0.6655,0.4515,0.5322
"11435",201690,1995,"597",262,335,25,"5",20,0.0763,0.0149,0.0419
"11436",202134,1995,"856",463,393,71,"26",45,0.0972,0.0662,0.0829
"11437",202480,1995,"1610",836,774,890,"342",548,0.6555,0.4419,0.5528
"11438",202523,1995,"701",357,344,488,"221",267,0.7479,0.6424,0.6961
"11439",202763,1995,"591",306,285,205,"78",127,0.415,0.2737,0.3469
"11440",203085,1995,"220",87,133,94,"46",48,0.5517,0.3459,0.4273
"11441",203128,1995,"217",119,98,124,"47",77,0.6471,0.4796,0.5714
"11442",203368,1995,"844",424,420,587,"257",330,0.7783,0.6119,0.6955
"11443",203517,1995,"2623",1580,1043,353,"85",268,0.1696,0.0815,0.1346
"11444",203535,1995,"438",223,215,350,"161",189,0.8475,0.7488,0.7991
"11445",203580,1995,"66",50,16,26,"5",21,0.42,0.3125,0.3939
"11446",203775,1995,"408",261,147,131,"39",92,0.3525,0.2653,0.3211
"11447",203845,1995,"292",120,172,124,"51",73,0.6083,0.2965,0.4247
"11448",204024,1995,"3211",1817,1394,1990,"750",1240,0.6824,0.538,0.6197
"11449",204185,1995,"478",229,249,248,"107",141,0.6157,0.4297,0.5188
"11450",204194,1995,"379",228,151,121,"51",70,0.307,0.3377,0.3193
"11451",204617,1995,"172",110,62,46,"12",34,0.3091,0.1935,0.2674
"11452",204796,1995,"5788",2951,2837,1354,"478",876,0.2968,0.1685,0.2339
"11453",204857,1995,"3358",1939,1419,1459,"479",980,0.5054,0.3376,0.4345
"11454",206330,1995,"213",87,126,28,"12",16,0.1839,0.0952,0.1315
"11455",206589,1995,"433",228,205,347,"147",200,0.8772,0.7171,0.8014
"11456",206604,1995,"1910",1033,877,214,"68",146,0.1413,0.0775,0.112
"11457",206622,1995,"698",396,302,394,"177",217,0.548,0.5861,0.5645
"11458",206695,1995,"1905",1004,901,208,"85",123,0.1225,0.0943,0.1092
"11459",206914,1995,"620",358,262,61,"26",35,0.0978,0.0992,0.0984
"11460",207209,1995,"485",220,265,24,"7",17,0.0773,0.0264,0.0495
"11461",207306,1995,"240",127,113,39,"11",28,0.2205,0.0973,0.1625
"11462",207324,1995,"320",158,162,78,"28",50,0.3165,0.1728,0.2438
"11463",207388,1995,"2362",1185,1177,475,"186",289,0.2439,0.158,0.2011
"11464",207500,1995,"2712",1321,1391,519,"191",328,0.2483,0.1373,0.1914
"11465",207722,1995,"259",164,95,33,"6",27,0.1646,0.0632,0.1274
"11466",207847,1995,"570",282,288,91,"48",43,0.1525,0.1667,0.1596
"11467",207865,1995,"769",470,299,123,"34",89,0.1894,0.1137,0.1599
"11468",208822,1995,"347",232,115,162,"54",108,0.4655,0.4696,0.4669
"11469",209056,1995,"455",280,175,228,"85",143,0.5107,0.4857,0.5011
"11470",209065,1995,"438",260,178,276,"105",171,0.6577,0.5899,0.6301
"11471",209542,1995,"2018",965,1053,561,"194",367,0.3803,0.1842,0.278
"11472",209551,1995,"2583",1429,1154,950,"329",621,0.4346,0.2851,0.3678
"11473",209612,1995,"242",153,89,108,"33",75,0.4902,0.3708,0.4463
"11474",209807,1995,"682",358,324,82,"29",53,0.148,0.0895,0.1202
"11475",209922,1995,"352",188,164,166,"78",88,0.4681,0.4756,0.4716
"11476",210146,1995,"661",362,299,89,"33",56,0.1547,0.1104,0.1346
"11477",210401,1995,"432",248,184,330,"132",198,0.7984,0.7174,0.7639
"11478",210429,1995,"641",380,261,95,"22",73,0.1921,0.0843,0.1482
"11479",210571,1995,"312",153,159,169,"66",103,0.6732,0.4151,0.5417
"11480",210669,1995,"564",284,280,353,"162",191,0.6725,0.5786,0.6259
"11481",210775,1995,"150",76,74,46,"14",32,0.4211,0.1892,0.3067
"11482",211088,1995,"257",186,71,145,"36",109,0.586,0.507,0.5642
"11483",211158,1995,"1054",689,365,372,"88",284,0.4122,0.2411,0.3529
"11484",211291,1995,"910",474,436,736,"342",394,0.8312,0.7844,0.8088
"11485",211352,1995,"218",150,68,110,"25",85,0.5667,0.3676,0.5046
"11486",211361,1995,"892",465,427,124,"45",79,0.1699,0.1054,0.139
"11487",211431,1995,"125",122,3,57,"2",55,0.4508,0.6667,0.456
"11488",211440,1995,"1233",376,857,772,"515",257,0.6835,0.6009,0.6261
"11489",211468,1995,"164",164,0,90,"0",90,0.5488,NA,0.5488
"11490",211556,1995,"109",109,0,48,"0",48,0.4404,NA,0.4404
"11491",211583,1995,"83",83,0,53,"0",53,0.6386,NA,0.6386
"11492",211608,1995,"256",131,125,20,"5",15,0.1145,0.04,0.0781
"11493",211644,1995,"1241",768,473,210,"46",164,0.2135,0.0973,0.1692
"11494",211981,1995,"384",193,191,138,"45",93,0.4819,0.2356,0.3594
"11495",212009,1995,"520",286,234,393,"174",219,0.7657,0.7436,0.7558
"11496",212054,1995,"935",341,594,111,"40",71,0.2082,0.0673,0.1187
"11497",212106,1995,"1215",703,512,523,"193",330,0.4694,0.377,0.4305
"11498",212115,1995,"820",457,363,169,"45",124,0.2713,0.124,0.2061
"11499",212133,1995,"226",171,55,103,"21",82,0.4795,0.3818,0.4558
"11500",212160,1995,"1332",763,569,213,"69",144,0.1887,0.1213,0.1599
"11501",212197,1995,"434",307,127,282,"72",210,0.684,0.5669,0.6498
"11502",212577,1995,"498",234,264,372,"179",193,0.8248,0.678,0.747
"11503",212601,1995,"394",225,169,174,"73",101,0.4489,0.432,0.4416
"11504",212832,1995,"40",35,5,16,"0",16,0.4571,0,0.4
"11505",212911,1995,"306",162,144,269,"126",143,0.8827,0.875,0.8791
"11506",213020,1995,"2661",1552,1109,652,"187",465,0.2996,0.1686,0.245
"11507",213251,1995,"282",175,107,196,"73",123,0.7029,0.6822,0.695
"11508",213321,1995,"426",180,246,247,"126",121,0.6722,0.5122,0.5798
"11509",213349,1995,"1229",715,514,192,"52",140,0.1958,0.1012,0.1562
"11510",213358,1995,"147",85,62,37,"9",28,0.3294,0.1452,0.2517
"11511",213367,1995,"741",438,303,404,"140",264,0.6027,0.462,0.5452
"11512",213385,1995,"525",241,284,415,"208",207,0.8589,0.7324,0.7905
"11513",213507,1995,"297",155,142,183,"79",104,0.671,0.5563,0.6162
"11514",213543,1995,"1045",412,633,734,"404",330,0.801,0.6382,0.7024
"11515",213613,1995,"693",359,334,133,"43",90,0.2507,0.1287,0.1919
"11516",213668,1995,"366",210,156,237,"82",155,0.7381,0.5256,0.6475
"11517",213783,1995,"577",340,237,135,"41",94,0.2765,0.173,0.234
"11518",213826,1995,"245",193,52,99,"13",86,0.4456,0.25,0.4041
"11519",213996,1995,"671",416,255,428,"163",265,0.637,0.6392,0.6379
"11520",214041,1995,"1157",700,457,389,"132",257,0.3671,0.2888,0.3362
"11521",214069,1995,"280",204,76,88,"28",60,0.2941,0.3684,0.3143
"11522",214157,1995,"319",169,150,217,"97",120,0.7101,0.6467,0.6803
"11523",214175,1995,"486",277,209,392,"161",231,0.8339,0.7703,0.8066
"11524",214272,1995,"159",114,45,15,"5",10,0.0877,0.1111,0.0943
"11525",214777,1995,"5400",2712,2688,2410,"947",1463,0.5395,0.3523,0.4463
"11526",215062,1995,"2349",1158,1191,1954,"952",1002,0.8653,0.7993,0.8318
"11527",215743,1995,"334",145,189,135,"61",74,0.5103,0.3228,0.4042
"11528",215798,1995,"260",129,131,161,"72",89,0.6899,0.5496,0.6192
"11529",215929,1995,"907",515,392,590,"261",329,0.6388,0.6658,0.6505
"11530",216010,1995,"1278",665,613,497,"188",309,0.4647,0.3067,0.3889
"11531",216038,1995,"1279",715,564,254,"82",172,0.2406,0.1454,0.1986
"11532",216287,1995,"354",190,164,308,"134",174,0.9158,0.8171,0.8701
"11533",216339,1995,"2302",1366,936,440,"143",297,0.2174,0.1528,0.1911
"11534",216524,1995,"315",170,145,230,"106",124,0.7294,0.731,0.7302
"11535",216694,1995,"295",141,154,109,"46",63,0.4468,0.2987,0.3695
"11536",216764,1995,"1384",873,511,363,"85",278,0.3184,0.1663,0.2623
"11537",216807,1995,"376",230,146,250,"86",164,0.713,0.589,0.6649
"11538",216852,1995,"421",175,246,141,"64",77,0.44,0.2602,0.3349
"11539",216931,1995,"369",167,202,118,"60",58,0.3473,0.297,0.3198
"11540",217059,1995,"851",483,368,350,"121",229,0.4741,0.3288,0.4113
"11541",217156,1995,"1370",739,631,1106,"492",614,0.8309,0.7797,0.8073
"11542",217402,1995,"954",589,365,795,"297",498,0.8455,0.8137,0.8333
"11543",217536,1995,"354",258,96,190,"49",141,0.5465,0.5104,0.5367
"11544",217776,1995,"69",32,37,11,"3",8,0.25,0.0811,0.1594
"11545",217819,1995,"1748",1190,558,596,"136",460,0.3866,0.2437,0.341
"11546",217882,1995,"2556",1255,1301,905,"319",586,0.4669,0.2452,0.3541
"11547",217998,1995,"143",77,66,93,"42",51,0.6623,0.6364,0.6503
"11548",218061,1995,"757",405,352,140,"43",97,0.2395,0.1222,0.1849
"11549",218229,1995,"477",301,176,155,"46",109,0.3621,0.2614,0.3249
"11550",218238,1995,"164",82,82,40,"18",22,0.2683,0.2195,0.2439
"11551",218399,1995,"241",167,74,35,"8",27,0.1617,0.1081,0.1452
"11552",218414,1995,"166",70,96,50,"19",31,0.4429,0.1979,0.3012
"11553",218663,1995,"2593",1477,1116,799,"282",517,0.35,0.2527,0.3081
"11554",218724,1995,"734",411,323,117,"27",90,0.219,0.0836,0.1594
"11555",218733,1995,"859",447,412,279,"100",179,0.4004,0.2427,0.3248
"11556",218742,1995,"427",264,163,66,"15",51,0.1932,0.092,0.1546
"11557",218973,1995,"286",140,146,219,"99",120,0.8571,0.6781,0.7657
"11558",219000,1995,"372",242,130,168,"52",116,0.4793,0.4,0.4516
"11559",219046,1995,"435",234,201,33,"8",25,0.1068,0.0398,0.0759
"11560",219082,1995,"256",125,131,22,"5",17,0.136,0.0382,0.0859
"11561",219198,1995,"95",62,33,27,"11",16,0.2581,0.3333,0.2842
"11562",219259,1995,"574",343,231,75,"19",56,0.1633,0.0823,0.1307
"11563",219356,1995,"1659",813,846,359,"135",224,0.2755,0.1596,0.2164
"11564",219471,1995,"1160",660,500,224,"60",164,0.2485,0.12,0.1931
"11565",219602,1995,"776",457,319,105,"26",79,0.1729,0.0815,0.1353
"11566",219709,1995,"347",221,126,14,"3",11,0.0498,0.0238,0.0403
"11567",219718,1995,"149",52,97,17,"5",12,0.2308,0.0515,0.1141
"11568",219949,1995,"171",64,107,38,"17",21,0.3281,0.1589,0.2222
"11569",220075,1995,"1505",867,638,178,"59",119,0.1373,0.0925,0.1183
"11570",220215,1995,"294",170,124,90,"37",53,0.3118,0.2984,0.3061
"11571",220613,1995,"493",287,206,115,"37",78,0.2718,0.1796,0.2333
"11572",220631,1995,"204",131,73,31,"9",22,0.1679,0.1233,0.152
"11573",220710,1995,"217",106,111,86,"32",54,0.5094,0.2883,0.3963
"11574",221351,1995,"373",204,169,256,"105",151,0.7402,0.6213,0.6863
"11575",221519,1995,"370",197,173,275,"120",155,0.7868,0.6936,0.7432
"11576",221731,1995,"90",49,41,29,"7",22,0.449,0.1707,0.3222
"11577",221847,1995,"1113",513,600,130,"37",93,0.1813,0.0617,0.1168
"11578",221892,1995,"214",113,101,43,"14",29,0.2566,0.1386,0.2009
"11579",222178,1995,"917",506,411,250,"93",157,0.3103,0.2263,0.2726
"11580",222983,1995,"293",155,138,195,"90",105,0.6774,0.6522,0.6655
"11581",223232,1995,"2329",1390,939,1004,"337",667,0.4799,0.3589,0.4311
"11582",224004,1995,"90",55,35,18,"5",13,0.2364,0.1429,0.2
"11583",224323,1995,"244",146,98,134,"58",76,0.5205,0.5918,0.5492
"11584",225432,1995,"624",351,273,10,"3",7,0.0199,0.011,0.016
"11585",225548,1995,"325",170,155,82,"28",54,0.3176,0.1806,0.2523
"11586",225627,1995,"370",259,111,50,"11",39,0.1506,0.0991,0.1351
"11587",226231,1995,"218",66,152,68,"42",26,0.3939,0.2763,0.3119
"11588",226833,1995,"578",276,302,49,"16",33,0.1196,0.053,0.0848
"11589",227216,1995,"2134",1180,954,201,"50",151,0.128,0.0524,0.0942
"11590",227331,1995,"258",189,69,34,"8",26,0.1376,0.1159,0.1318
"11591",227526,1995,"1114",536,578,105,"29",76,0.1418,0.0502,0.0943
"11592",227757,1995,"688",338,350,472,"213",259,0.7663,0.6086,0.686
"11593",227845,1995,"387",230,157,119,"37",82,0.3565,0.2357,0.3075
"11594",227863,1995,"232",145,87,58,"17",41,0.2828,0.1954,0.25
"11595",228042,1995,"221",107,114,35,"15",20,0.1869,0.1316,0.1584
"11596",228149,1995,"452",254,198,123,"34",89,0.3504,0.1717,0.2721
"11597",228246,1995,"1228",662,566,743,"287",456,0.6888,0.5071,0.605
"11598",228343,1995,"326",188,138,188,"69",119,0.633,0.5,0.5767
"11599",228431,1995,"1714",986,728,275,"69",206,0.2089,0.0948,0.1604
"11600",228459,1995,"2426",1461,965,309,"80",229,0.1567,0.0829,0.1274
"11601",228501,1995,"393",140,253,34,"16",18,0.1286,0.0632,0.0865
"11602",228529,1995,"1021",531,490,140,"52",88,0.1657,0.1061,0.1371
"11603",228705,1995,"893",420,473,40,"17",23,0.0548,0.0359,0.0448
"11604",228723,1995,"5985",2986,2999,1643,"498",1145,0.3835,0.1661,0.2745
"11605",228769,1995,"1243",623,620,117,"47",70,0.1124,0.0758,0.0941
"11606",228778,1995,"6212",3139,3073,2207,"865",1342,0.4275,0.2815,0.3553
"11607",228787,1995,"351",154,197,113,"45",68,0.4416,0.2284,0.3219
"11608",228796,1995,"1618",887,731,36,"12",24,0.0271,0.0164,0.0222
"11609",228875,1995,"1325",813,512,511,"146",365,0.449,0.2852,0.3857
"11610",228981,1995,"213",142,71,78,"20",58,0.4085,0.2817,0.3662
"11611",229018,1995,"100",61,39,10,"3",7,0.1148,0.0769,0.1
"11612",229027,1995,"1528",821,707,79,"20",59,0.0719,0.0283,0.0517
"11613",229115,1995,"3461",1764,1697,747,"260",487,0.2761,0.1532,0.2158
"11614",229780,1995,"167",102,65,26,"7",19,0.1863,0.1077,0.1557
"11615",229814,1995,"901",506,395,108,"35",73,0.1443,0.0886,0.1199
"11616",230603,1995,"643",471,172,90,"16",74,0.1571,0.093,0.14
"11617",230728,1995,"1175",803,372,251,"43",208,0.259,0.1156,0.2136
"11618",230764,1995,"1356",837,519,284,"73",211,0.2521,0.1407,0.2094
"11619",230782,1995,"1338",889,449,109,"23",86,0.0967,0.0512,0.0815
"11620",231059,1995,"529",301,228,383,"160",223,0.7409,0.7018,0.724
"11621",231174,1995,"1853",1037,816,853,"338",515,0.4966,0.4142,0.4603
"11622",231420,1995,"147",79,68,35,"13",22,0.2785,0.1912,0.2381
"11623",231554,1995,"139",68,71,47,"22",25,0.3676,0.3099,0.3381
"11624",231624,1995,"1369",850,519,1086,"378",708,0.8329,0.7283,0.7933
"11625",231712,1995,"534",320,214,59,"18",41,0.1281,0.0841,0.1105
"11626",232025,1995,"221",107,114,103,"47",56,0.5234,0.4123,0.4661
"11627",232043,1995,"206",144,62,96,"27",69,0.4792,0.4355,0.466
"11628",232089,1995,"297",109,188,66,"28",38,0.3486,0.1489,0.2222
"11629",232186,1995,"1852",1065,787,486,"145",341,0.3202,0.1842,0.2624
"11630",232265,1995,"1272",780,492,418,"98",320,0.4103,0.1992,0.3286
"11631",232423,1995,"2537",1484,1053,1548,"523",1025,0.6907,0.4967,0.6102
"11632",232557,1995,"1165",600,565,224,"70",154,0.2567,0.1239,0.1923
"11633",232566,1995,"671",445,226,283,"57",226,0.5079,0.2522,0.4218
"11634",232609,1995,"262",181,81,142,"42",100,0.5525,0.5185,0.542
"11635",232681,1995,"758",497,261,443,"138",305,0.6137,0.5287,0.5844
"11636",232706,1995,"167",122,45,82,"22",60,0.4918,0.4889,0.491
"11637",232937,1995,"1257",706,551,91,"24",67,0.0949,0.0436,0.0724
"11638",232982,1995,"1514",827,687,149,"30",119,0.1439,0.0437,0.0984
"11639",233277,1995,"1381",833,548,425,"121",304,0.3649,0.2208,0.3077
"11640",233374,1995,"762",398,364,581,"251",330,0.8291,0.6896,0.7625
"11641",233426,1995,"431",247,184,223,"77",146,0.5911,0.4185,0.5174
"11642",233541,1995,"212",118,94,53,"16",37,0.3136,0.1702,0.25
"11643",233897,1995,"269",141,128,67,"27",40,0.2837,0.2109,0.2491
"11644",233921,1995,"4687",2050,2637,1819,"745",1074,0.5239,0.2825,0.3881
"11645",234030,1995,"1655",963,692,320,"104",216,0.2243,0.1503,0.1934
"11646",234085,1995,"335",0,335,182,"182",0,NA,0.5433,0.5433
"11647",234155,1995,"734",431,303,131,"35",96,0.2227,0.1155,0.1785
"11648",234164,1995,"441",234,207,2,"0",2,0.0085,0,0.0045
"11649",235097,1995,"687",464,223,109,"18",91,0.1961,0.0807,0.1587
"11650",235167,1995,"536",318,218,224,"88",136,0.4277,0.4037,0.4179
"11651",236230,1995,"667",394,273,264,"81",183,0.4645,0.2967,0.3958
"11652",236328,1995,"656",374,282,404,"162",242,0.6471,0.5745,0.6159
"11653",236577,1995,"397",254,143,138,"58",80,0.315,0.4056,0.3476
"11654",236595,1995,"426",245,181,165,"56",109,0.4449,0.3094,0.3873
"11655",236896,1995,"288",145,143,57,"22",35,0.2414,0.1538,0.1979
"11656",236939,1995,"2512",1217,1295,734,"315",419,0.3443,0.2432,0.2922
"11657",236948,1995,"3500",1783,1717,1405,"562",843,0.4728,0.3273,0.4014
"11658",237011,1995,"1745",1105,640,457,"120",337,0.305,0.1875,0.2619
"11659",237057,1995,"369",189,180,247,"119",128,0.6772,0.6611,0.6694
"11660",237066,1995,"395",229,166,198,"73",125,0.5459,0.4398,0.5013
"11661",237215,1995,"416",243,173,8,"5",3,0.0123,0.0289,0.0192
"11662",237330,1995,"542",282,260,148,"62",86,0.305,0.2385,0.2731
"11663",237358,1995,"180",101,79,35,"13",22,0.2178,0.1646,0.1944
"11664",237367,1995,"1123",618,505,96,"36",60,0.0971,0.0713,0.0855
"11665",237792,1995,"598",333,265,74,"20",54,0.1622,0.0755,0.1237
"11666",237899,1995,"572",292,280,28,"13",15,0.0514,0.0464,0.049
"11667",237932,1995,"509",273,236,108,"27",81,0.2967,0.1144,0.2122
"11668",237969,1995,"453",240,213,200,"77",123,0.5125,0.3615,0.4415
"11669",238032,1995,"2938",1457,1481,783,"324",459,0.315,0.2188,0.2665
"11670",238333,1995,"291",163,128,187,"74",113,0.6933,0.5781,0.6426
"11671",238430,1995,"139",93,46,20,"3",17,0.1828,0.0652,0.1439
"11672",238458,1995,"429",296,133,202,"41",161,0.5439,0.3083,0.4709
"11673",238476,1995,"395",175,220,190,"89",101,0.5771,0.4045,0.481
"11674",238616,1995,"234",132,102,59,"21",38,0.2879,0.2059,0.2521
"11675",238661,1995,"231",155,76,44,"10",34,0.2194,0.1316,0.1905
"11676",239080,1995,"184",117,67,44,"15",29,0.2479,0.2239,0.2391
"11677",239105,1995,"1627",883,744,870,"327",543,0.6149,0.4395,0.5347
"11678",239628,1995,"184",101,83,99,"42",57,0.5644,0.506,0.538
"11679",239716,1995,"520",296,224,319,"112",207,0.6993,0.5,0.6135
"11680",240107,1995,"335",224,111,92,"24",68,0.3036,0.2162,0.2746
"11681",240189,1995,"1856",989,867,294,"108",186,0.1881,0.1246,0.1584
"11682",240277,1995,"780",522,258,98,"30",68,0.1303,0.1163,0.1256
"11683",240329,1995,"1731",1035,696,324,"104",220,0.2126,0.1494,0.1872
"11684",240338,1995,"109",63,46,51,"18",33,0.5238,0.3913,0.4679
"11685",240365,1995,"1487",844,643,211,"74",137,0.1623,0.1151,0.1419
"11686",240374,1995,"637",369,268,42,"13",29,0.0786,0.0485,0.0659
"11687",240417,1995,"1133",542,591,143,"36",107,0.1974,0.0609,0.1262
"11688",240426,1995,"288",173,115,52,"17",35,0.2023,0.1478,0.1806
"11689",240444,1995,"5101",2779,2322,2037,"768",1269,0.4566,0.3307,0.3993
"11690",240453,1995,"1785",926,859,186,"75",111,0.1199,0.0873,0.1042
"11691",240462,1995,"926",315,611,125,"59",66,0.2095,0.0966,0.135
"11692",240471,1995,"957",548,409,204,"73",131,0.2391,0.1785,0.2132
"11693",240480,1995,"1474",817,657,285,"82",203,0.2485,0.1248,0.1934
"11694",240727,1995,"1267",661,606,276,"88",188,0.2844,0.1452,0.2178
"11695",243443,1995,"728",466,262,33,"8",25,0.0536,0.0305,0.0453
"11696",243780,1995,"6064",2696,3368,1625,"786",839,0.3112,0.2334,0.268
"11697",100654,1993,"1019",543,476,189,"55",134,0.2468,0.1155,0.1855
"11698",100663,1993,"938",518,420,99,"31",68,0.1313,0.0738,0.1055
"11699",100751,1993,"2516",1318,1198,638,"231",407,0.3088,0.1928,0.2536
"11700",100858,1993,"2997",1552,1445,878,"286",592,0.3814,0.1979,0.293
"11701",101435,1993,"125",80,45,40,"7",33,0.4125,0.1556,0.32
"11702",101480,1993,"845",436,409,89,"24",65,0.1491,0.0587,0.1053
"11703",101675,1993,"331",164,167,162,"67",95,0.5793,0.4012,0.4894
"11704",101879,1993,"651",371,280,83,"16",67,0.1806,0.0571,0.1275
"11705",102049,1993,"680",438,242,318,"117",201,0.4589,0.4835,0.4676
"11706",102094,1993,"1086",621,465,125,"38",87,0.1401,0.0817,0.1151
"11707",102234,1993,"229",129,100,106,"43",63,0.4884,0.43,0.4629
"11708",102368,1993,"926",526,400,303,"108",195,0.3707,0.27,0.3272
"11709",102377,1993,"595",302,293,104,"39",65,0.2152,0.1331,0.1748
"11710",104151,1993,"3298",1637,1661,561,"203",358,0.2187,0.1222,0.1701
"11711",104179,1993,"4287",2254,2033,968,"317",651,0.2888,0.1559,0.2258
"11712",105330,1993,"1930",1090,840,306,"103",203,0.1862,0.1226,0.1585
"11713",106245,1993,"966",565,401,59,"12",47,0.0832,0.0299,0.0611
"11714",106342,1993,"166",84,82,65,"29",36,0.4286,0.3537,0.3916
"11715",106397,1993,"2015",964,1051,401,"158",243,0.2521,0.1503,0.199
"11716",106412,1993,"735",379,356,52,"15",37,0.0976,0.0421,0.0707
"11717",106458,1993,"1487",812,675,190,"66",124,0.1527,0.0978,0.1278
"11718",106467,1993,"847",404,443,117,"43",74,0.1832,0.0971,0.1381
"11719",106485,1993,"508",249,259,31,"12",19,0.0763,0.0463,0.061
"11720",106704,1993,"1792",1098,694,283,"94",189,0.1721,0.1354,0.1579
"11721",107044,1993,"793",437,356,244,"101",143,0.3272,0.2837,0.3077
"11722",107080,1993,"273",165,108,152,"58",94,0.5697,0.537,0.5568
"11723",107141,1993,"245",139,106,76,"29",47,0.3381,0.2736,0.3102
"11724",107512,1993,"443",217,226,174,"86",88,0.4055,0.3805,0.3928
"11725",107558,1993,"162",96,66,37,"15",22,0.2292,0.2273,0.2284
"11726",110097,1993,"444",286,158,157,"48",109,0.3811,0.3038,0.3536
"11727",110404,1993,"209",63,146,151,"109",42,0.6667,0.7466,0.7225
"11728",110422,1993,"1600",722,878,155,"36",119,0.1648,0.041,0.0969
"11729",110486,1993,"317",200,117,38,"12",26,0.13,0.1026,0.1199
"11730",110495,1993,"387",232,155,60,"22",38,0.1638,0.1419,0.155
"11731",110510,1993,"692",433,259,37,"9",28,0.0647,0.0347,0.0535
"11732",110529,1993,"1309",536,773,105,"42",63,0.1175,0.0543,0.0802
"11733",110538,1993,"1244",754,490,169,"27",142,0.1883,0.0551,0.1359
"11734",110547,1993,"389",252,137,15,"5",10,0.0397,0.0365,0.0386
"11735",110556,1993,"1436",792,644,152,"32",120,0.1515,0.0497,0.1058
"11736",110565,1993,"1309",748,561,112,"40",72,0.0963,0.0713,0.0856
"11737",110574,1993,"553",371,182,59,"11",48,0.1294,0.0604,0.1067
"11738",110583,1993,"1835",1125,710,80,"21",59,0.0524,0.0296,0.0436
"11739",110592,1993,"1133",697,436,34,"11",23,0.033,0.0252,0.03
"11740",110617,1993,"1086",635,451,51,"8",43,0.0677,0.0177,0.047
"11741",113698,1993,"75",46,29,17,"4",13,0.2826,0.1379,0.2267
"11742",115755,1993,"553",324,229,60,"9",51,0.1574,0.0393,0.1085
"11743",119173,1993,"276",273,3,56,"0",56,0.2051,0,0.2029
"11744",120184,1993,"96",76,20,36,"5",31,0.4079,0.25,0.375
"11745",121309,1993,"425",255,170,127,"34",93,0.3647,0.2,0.2988
"11746",121345,1993,"390",183,207,317,"167",150,0.8197,0.8068,0.8128
"11747",122409,1993,"1973",1081,892,126,"25",101,0.0934,0.028,0.0639
"11748",122436,1993,"890",516,374,468,"171",297,0.5756,0.4572,0.5258
"11749",122597,1993,"1141",668,473,60,"16",44,0.0659,0.0338,0.0526
"11750",122612,1993,"530",359,171,225,"61",164,0.4568,0.3567,0.4245
"11751",122931,1993,"888",489,399,657,"287",370,0.7566,0.7193,0.7399
"11752",123554,1993,"464",249,215,294,"128",166,0.6667,0.5953,0.6336
"11753",123572,1993,"539",362,177,82,"18",64,0.1768,0.1017,0.1521
"11754",126562,1993,"243",141,102,38,"9",29,0.2057,0.0882,0.1564
"11755",126580,1993,"306",164,142,46,"18",28,0.1707,0.1268,0.1503
"11756",126614,1993,"3440",1693,1747,1215,"509",706,0.417,0.2914,0.3532
"11757",126818,1993,"2168",1160,1008,611,"210",401,0.3457,0.2083,0.2818
"11758",127060,1993,"576",306,270,332,"144",188,0.6144,0.5333,0.5764
"11759",127185,1993,"1078",438,640,95,"39",56,0.1279,0.0609,0.0881
"11760",127565,1993,"1380",682,698,43,"22",21,0.0308,0.0315,0.0312
"11761",127741,1993,"1704",1019,685,309,"81",228,0.2237,0.1182,0.1813
"11762",128106,1993,"678",321,357,78,"34",44,0.1371,0.0952,0.115
"11763",128744,1993,"137",66,71,58,"20",38,0.5758,0.2817,0.4234
"11764",128771,1993,"902",483,419,80,"18",62,0.1284,0.043,0.0887
"11765",129020,1993,"2052",1068,984,775,"297",478,0.4476,0.3018,0.3777
"11766",129242,1993,"773",392,381,595,"283",312,0.7959,0.7428,0.7697
"11767",129941,1993,"289",103,186,47,"27",20,0.1942,0.1452,0.1626
"11768",130253,1993,"515",274,241,197,"72",125,0.4562,0.2988,0.3825
"11769",130314,1993,"93",93,0,47,"0",47,0.5054,NA,0.5054
"11770",130493,1993,"1044",572,472,139,"38",101,0.1766,0.0805,0.1331
"11771",130590,1993,"476",242,234,362,"173",189,0.781,0.7393,0.7605
"11772",130697,1993,"703",365,338,547,"257",290,0.7945,0.7604,0.7781
"11773",130776,1993,"526",247,279,115,"50",65,0.2632,0.1792,0.2186
"11774",130794,1993,"1317",627,690,1135,"582",553,0.882,0.8435,0.8618
"11775",130934,1993,"686",386,300,68,"11",57,0.1477,0.0367,0.0991
"11776",130943,1993,"3181",1847,1334,1623,"573",1050,0.5685,0.4295,0.5102
"11777",131159,1993,"1039",660,379,641,"219",422,0.6394,0.5778,0.6169
"11778",131283,1993,"505",276,229,306,"130",176,0.6377,0.5677,0.6059
"11779",131450,1993,"306",164,142,18,"6",12,0.0732,0.0423,0.0588
"11780",131469,1993,"1492",801,691,887,"373",514,0.6417,0.5398,0.5945
"11781",131496,1993,"1377",720,657,1155,"551",604,0.8389,0.8387,0.8388
"11782",131520,1993,"1492",951,541,352,"88",264,0.2776,0.1627,0.2359
"11783",132471,1993,"232",143,89,77,"19",58,0.4056,0.2135,0.3319
"11784",132602,1993,"543",291,252,100,"28",72,0.2474,0.1111,0.1842
"11785",132903,1993,"1882",955,927,432,"144",288,0.3016,0.1553,0.2295
"11786",133492,1993,"364",185,179,201,"103",98,0.5297,0.5754,0.5522
"11787",133553,1993,"799",128,671,154,"122",32,0.25,0.1818,0.1927
"11788",133650,1993,"1507",908,599,210,"46",164,0.1806,0.0768,0.1393
"11789",133669,1993,"743",412,331,104,"34",70,0.1699,0.1027,0.14
"11790",133711,1993,"338",193,145,147,"59",88,0.456,0.4069,0.4349
"11791",133881,1993,"358",109,249,93,"65",28,0.2569,0.261,0.2598
"11792",133951,1993,"1306",751,555,216,"65",151,0.2011,0.1171,0.1654
"11793",134079,1993,"375",207,168,138,"58",80,0.3865,0.3452,0.368
"11794",134097,1993,"3603",2132,1471,1424,"480",944,0.4428,0.3263,0.3952
"11795",134130,1993,"5074",2520,2554,1728,"701",1027,0.4075,0.2745,0.3406
"11796",134945,1993,"310",139,171,92,"47",45,0.3237,0.2749,0.2968
"11797",135726,1993,"1612",791,821,741,"338",403,0.5095,0.4117,0.4597
"11798",136172,1993,"545",289,256,94,"25",69,0.2388,0.0977,0.1725
"11799",136950,1993,"377",210,167,195,"82",113,0.5381,0.491,0.5172
"11800",137546,1993,"481",292,189,238,"87",151,0.5171,0.4603,0.4948
"11801",138354,1993,"438",252,186,68,"17",51,0.2024,0.0914,0.1553
"11802",138716,1993,"649",367,282,47,"8",39,0.1063,0.0284,0.0724
"11803",138789,1993,"577",353,224,39,"7",32,0.0907,0.0312,0.0676
"11804",139144,1993,"484",306,178,183,"57",126,0.4118,0.3202,0.3781
"11805",139366,1993,"650",401,249,59,"20",39,0.0973,0.0803,0.0908
"11806",139393,1993,"168",93,75,75,"31",44,0.4731,0.4133,0.4464
"11807",139658,1993,"1406",762,644,999,"458",541,0.71,0.7112,0.7105
"11808",139719,1993,"539",290,249,27,"3",24,0.0828,0.012,0.0501
"11809",139755,1993,"1963",484,1479,398,"252",146,0.3017,0.1704,0.2028
"11810",139764,1993,"349",226,123,38,"6",32,0.1416,0.0488,0.1089
"11811",139861,1993,"809",520,289,122,"18",104,0.2,0.0623,0.1508
"11812",139931,1993,"2955",1602,1353,540,"158",382,0.2385,0.1168,0.1827
"11813",139940,1993,"1072",613,459,119,"33",86,0.1403,0.0719,0.111
"11814",139959,1993,"3808",2115,1693,1617,"630",987,0.4667,0.3721,0.4246
"11815",140447,1993,"639",378,261,243,"85",158,0.418,0.3257,0.3803
"11816",140960,1993,"760",391,369,48,"15",33,0.0844,0.0407,0.0632
"11817",140988,1993,"165",112,53,60,"15",45,0.4018,0.283,0.3636
"11818",141185,1993,"165",105,60,47,"15",32,0.3048,0.25,0.2848
"11819",141264,1993,"1357",807,550,211,"50",161,0.1995,0.0909,0.1555
"11820",141334,1993,"1263",738,525,97,"19",78,0.1057,0.0362,0.0768
"11821",141486,1993,"84",50,34,17,"5",12,0.24,0.1471,0.2024
"11822",141565,1993,"310",190,120,20,"4",16,0.0842,0.0333,0.0645
"11823",141574,1993,"1551",899,652,141,"44",97,0.1079,0.0675,0.0909
"11824",142276,1993,"1165",626,539,44,"12",32,0.0511,0.0223,0.0378
"11825",142285,1993,"1323",613,710,214,"71",143,0.2333,0.1,0.1618
"11826",142461,1993,"319",180,139,110,"42",68,0.3778,0.3022,0.3448
"11827",143084,1993,"498",290,208,309,"121",188,0.6483,0.5817,0.6205
"11828",143288,1993,"156",76,80,42,"15",27,0.3553,0.1875,0.2692
"11829",144005,1993,"641",432,209,7,"1",6,0.0139,0.0048,0.0109
"11830",144281,1993,"817",398,419,95,"34",61,0.1533,0.0811,0.1163
"11831",144740,1993,"1182",701,481,416,"159",257,0.3666,0.3306,0.3519
"11832",144892,1993,"1612",969,643,471,"112",359,0.3705,0.1742,0.2922
"11833",144962,1993,"252",140,112,99,"41",58,0.4143,0.3661,0.3929
"11834",144971,1993,"109",45,64,50,"26",24,0.5333,0.4062,0.4587
"11835",145600,1993,"2589",1360,1229,229,"85",144,0.1059,0.0692,0.0885
"11836",145619,1993,"270",125,145,104,"43",61,0.488,0.2966,0.3852
"11837",145637,1993,"5705",2588,3117,2665,"1307",1358,0.5247,0.4193,0.4671
"11838",145691,1993,"261",150,111,113,"34",79,0.5267,0.3063,0.433
"11839",145813,1993,"2387",1440,947,648,"183",465,0.3229,0.1932,0.2715
"11840",146481,1993,"271",140,131,148,"65",83,0.5929,0.4962,0.5461
"11841",146612,1993,"344",155,189,109,"49",60,0.3871,0.2593,0.3169
"11842",146719,1993,"856",511,345,366,"141",225,0.4403,0.4087,0.4276
"11843",146825,1993,"151",72,79,64,"21",43,0.5972,0.2658,0.4238
"11844",147013,1993,"119",72,47,34,"12",22,0.3056,0.2553,0.2857
"11845",147244,1993,"452",235,217,256,"111",145,0.617,0.5115,0.5664
"11846",147341,1993,"204",93,111,77,"31",46,0.4946,0.2793,0.3775
"11847",147703,1993,"2380",1320,1060,491,"163",328,0.2485,0.1538,0.2063
"11848",147767,1993,"1903",950,953,1566,"749",817,0.86,0.7859,0.8229
"11849",147776,1993,"641",374,267,14,"3",11,0.0294,0.0112,0.0218
"11850",147828,1993,"421",234,187,169,"61",108,0.4615,0.3262,0.4014
"11851",148131,1993,"297",134,163,71,"33",38,0.2836,0.2025,0.2391
"11852",148496,1993,"140",101,39,66,"17",49,0.4851,0.4359,0.4714
"11853",148584,1993,"149",79,70,61,"25",36,0.4557,0.3571,0.4094
"11854",148627,1993,"272",163,109,75,"20",55,0.3374,0.1835,0.2757
"11855",149222,1993,"2271",969,1302,318,"152",166,0.1713,0.1167,0.14
"11856",149231,1993,"912",523,389,113,"38",75,0.1434,0.0977,0.1239
"11857",149772,1993,"1531",793,738,347,"146",201,0.2535,0.1978,0.2266
"11858",149781,1993,"546",282,264,371,"159",212,0.7518,0.6023,0.6795
"11859",150066,1993,"423",251,172,131,"43",88,0.3506,0.25,0.3097
"11860",150136,1993,"3872",2104,1768,701,"230",471,0.2239,0.1301,0.181
"11861",150145,1993,"168",95,73,62,"23",39,0.4105,0.3151,0.369
"11862",150163,1993,"700",437,263,288,"94",194,0.4439,0.3574,0.4114
"11863",150400,1993,"495",250,245,361,"179",182,0.728,0.7306,0.7293
"11864",150534,1993,"746",424,322,296,"113",183,0.4316,0.3509,0.3968
"11865",150668,1993,"229",140,89,88,"34",54,0.3857,0.382,0.3843
"11866",150941,1993,"124",69,55,64,"26",38,0.5507,0.4727,0.5161
"11867",151102,1993,"1189",650,539,47,"17",30,0.0462,0.0315,0.0395
"11868",151111,1993,"1509",830,679,70,"29",41,0.0494,0.0427,0.0464
"11869",151306,1993,"1162",681,481,79,"21",58,0.0852,0.0437,0.068
"11870",151324,1993,"2221",1165,1056,334,"128",206,0.1768,0.1212,0.1504
"11871",151333,1993,"330",208,122,14,"7",7,0.0337,0.0574,0.0424
"11872",151342,1993,"554",360,194,32,"16",16,0.0444,0.0825,0.0578
"11873",151351,1993,"5833",3340,2493,2427,"906",1521,0.4554,0.3634,0.4161
"11874",151360,1993,"665",415,250,26,"13",13,0.0313,0.052,0.0391
"11875",151379,1993,"700",392,308,37,"12",25,0.0638,0.039,0.0529
"11876",151388,1993,"264",168,96,8,"2",6,0.0357,0.0208,0.0303
"11877",151777,1993,"238",118,120,94,"43",51,0.4322,0.3583,0.395
"11878",151786,1993,"239",150,89,74,"23",51,0.34,0.2584,0.3096
"11879",152080,1993,"1901",851,1050,1685,"910",775,0.9107,0.8667,0.8864
"11880",152248,1993,"847",475,372,64,"32",32,0.0674,0.086,0.0756
"11881",152363,1993,"292",140,152,110,"59",51,0.3643,0.3882,0.3767
"11882",152530,1993,"435",233,202,270,"107",163,0.6996,0.5297,0.6207
"11883",152600,1993,"487",251,236,278,"109",169,0.6733,0.4619,0.5708
"11884",153001,1993,"284",143,141,130,"47",83,0.5804,0.3333,0.4577
"11885",153108,1993,"397",210,187,211,"87",124,0.5905,0.4652,0.5315
"11886",153269,1993,"832",492,340,422,"158",264,0.5366,0.4647,0.5072
"11887",153384,1993,"434",224,210,321,"151",170,0.7589,0.719,0.7396
"11888",153603,1993,"3416",1435,1981,763,"327",436,0.3038,0.1651,0.2234
"11889",153834,1993,"586",341,245,411,"176",235,0.6891,0.7184,0.7014
"11890",154095,1993,"1808",1112,696,491,"152",339,0.3049,0.2184,0.2716
"11891",155089,1993,"230",125,105,55,"22",33,0.264,0.2095,0.2391
"11892",155317,1993,"3603",1849,1754,843,"335",508,0.2747,0.191,0.234
"11893",155335,1993,"98",72,26,20,"5",15,0.2083,0.1923,0.2041
"11894",155399,1993,"2739",1356,1383,550,"203",347,0.2559,0.1468,0.2008
"11895",155520,1993,"212",97,115,36,"16",20,0.2062,0.1391,0.1698
"11896",155627,1993,"130",51,79,39,"16",23,0.451,0.2025,0.3
"11897",155937,1993,"156",76,80,42,"18",24,0.3158,0.225,0.2692
"11898",156213,1993,"268",177,91,109,"36",73,0.4124,0.3956,0.4067
"11899",156286,1993,"309",172,137,135,"65",70,0.407,0.4745,0.4369
"11900",156295,1993,"453",230,223,150,"78",72,0.313,0.3498,0.3311
"11901",156365,1993,"286",122,164,48,"19",29,0.2377,0.1159,0.1678
"11902",156541,1993,"397",205,192,80,"24",56,0.2732,0.125,0.2015
"11903",156745,1993,"285",153,132,79,"20",59,0.3856,0.1515,0.2772
"11904",157058,1993,"335",163,172,18,"7",11,0.0675,0.0407,0.0537
"11905",157076,1993,"173",79,94,41,"17",24,0.3038,0.1809,0.237
"11906",157085,1993,"2662",1391,1271,599,"210",389,0.2797,0.1652,0.225
"11907",157289,1993,"1743",858,885,157,"57",100,0.1166,0.0644,0.0901
"11908",157386,1993,"1266",706,560,143,"41",102,0.1445,0.0732,0.113
"11909",157401,1993,"946",510,436,228,"77",151,0.2961,0.1766,0.241
"11910",157447,1993,"1517",890,627,55,"11",44,0.0494,0.0175,0.0363
"11911",157535,1993,"167",117,50,20,"7",13,0.1111,0.14,0.1198
"11912",157951,1993,"2201",1222,979,238,"80",158,0.1293,0.0817,0.1081
"11913",158477,1993,"211",121,90,80,"33",47,0.3884,0.3667,0.3791
"11914",159009,1993,"1620",859,761,160,"34",126,0.1467,0.0447,0.0988
"11915",159391,1993,"3178",1697,1481,586,"182",404,0.2381,0.1229,0.1844
"11916",159647,1993,"1411",672,739,258,"96",162,0.2411,0.1299,0.1828
"11917",159717,1993,"1307",702,605,66,"13",53,0.0755,0.0215,0.0505
"11918",159966,1993,"969",586,383,33,"12",21,0.0358,0.0313,0.0341
"11919",160038,1993,"1380",824,556,112,"28",84,0.1019,0.0504,0.0812
"11920",160612,1993,"2192",1222,970,77,"19",58,0.0475,0.0196,0.0351
"11921",160621,1993,"1658",862,796,80,"16",64,0.0742,0.0201,0.0483
"11922",160658,1993,"2524",1378,1146,110,"32",78,0.0566,0.0279,0.0436
"11923",161004,1993,"418",218,200,356,"163",193,0.8853,0.815,0.8517
"11924",161226,1993,"419",317,102,169,"24",145,0.4574,0.2353,0.4033
"11925",161235,1993,"81",46,35,6,"0",6,0.1304,0,0.0741
"11926",161244,1993,"133",84,49,10,"6",4,0.0476,0.1224,0.0752
"11927",161253,1993,"1211",522,689,320,"131",189,0.3621,0.1901,0.2642
"11928",161554,1993,"732",390,342,48,"18",30,0.0769,0.0526,0.0656
"11929",162007,1993,"257",152,105,30,"9",21,0.1382,0.0857,0.1167
"11930",162210,1993,"94",52,42,17,"7",10,0.1923,0.1667,0.1809
"11931",162283,1993,"500",264,236,26,"6",20,0.0758,0.0254,0.052
"11932",162584,1993,"910",433,477,210,"87",123,0.2841,0.1824,0.2308
"11933",162654,1993,"242",168,74,138,"34",104,0.619,0.4595,0.5702
"11934",162760,1993,"163",161,2,102,"0",102,0.6335,0,0.6258
"11935",162928,1993,"64",32,32,37,"16",21,0.6562,0.5,0.5781
"11936",163046,1993,"739",436,303,515,"181",334,0.7661,0.5974,0.6969
"11937",163268,1993,"929",419,510,215,"97",118,0.2816,0.1902,0.2314
"11938",163286,1993,"3153",1461,1692,1051,"447",604,0.4134,0.2642,0.3333
"11939",163453,1993,"944",567,377,138,"26",112,0.1975,0.069,0.1462
"11940",163462,1993,"325",166,159,218,"99",119,0.7169,0.6226,0.6708
"11941",163851,1993,"726",405,321,297,"92",205,0.5062,0.2866,0.4091
"11942",163912,1993,"284",153,131,166,"68",98,0.6405,0.5191,0.5845
"11943",164076,1993,"1215",721,494,348,"90",258,0.3578,0.1822,0.2864
"11944",164173,1993,"218",171,47,53,"10",43,0.2515,0.2128,0.2431
"11945",164216,1993,"213",123,90,132,"46",86,0.6992,0.5111,0.6197
"11946",164270,1993,"258",132,126,145,"62",83,0.6288,0.4921,0.562
"11947",164447,1993,"240",110,130,68,"32",36,0.3273,0.2462,0.2833
"11948",164492,1993,"94",62,32,50,"17",33,0.5323,0.5312,0.5319
"11949",164562,1993,"491",302,189,299,"108",191,0.6325,0.5714,0.609
"11950",165015,1993,"704",379,325,531,"238",293,0.7731,0.7323,0.7543
"11951",165024,1993,"1045",590,455,196,"68",128,0.2169,0.1495,0.1876
"11952",165334,1993,"443",257,186,251,"102",149,0.5798,0.5484,0.5666
"11953",165662,1993,"427",263,164,256,"100",156,0.5932,0.6098,0.5995
"11954",165671,1993,"133",133,0,59,"0",59,0.4436,NA,0.4436
"11955",165820,1993,"550",304,246,97,"18",79,0.2599,0.0732,0.1764
"11956",165866,1993,"517",339,178,117,"21",96,0.2832,0.118,0.2263
"11957",165936,1993,"298",186,112,98,"27",71,0.3817,0.2411,0.3289
"11958",166027,1993,"1601",715,886,1358,"743",615,0.8601,0.8386,0.8482
"11959",166124,1993,"658",350,308,598,"277",321,0.9171,0.8994,0.9088
"11960",166513,1993,"1033",392,641,217,"108",109,0.2781,0.1685,0.2101
"11961",166629,1993,"3926",1908,2018,1436,"577",859,0.4502,0.2859,0.3658
"11962",166638,1993,"546",253,293,44,"15",29,0.1146,0.0512,0.0806
"11963",166683,1993,"1074",366,708,874,"546",328,0.8962,0.7712,0.8138
"11964",167288,1993,"228",107,121,39,"11",28,0.2617,0.0909,0.1711
"11965",167987,1993,"985",489,496,234,"87",147,0.3006,0.1754,0.2376
"11966",167996,1993,"585",331,254,411,"159",252,0.7613,0.626,0.7026
"11967",168005,1993,"357",185,172,114,"43",71,0.3838,0.25,0.3193
"11968",168148,1993,"1193",632,561,923,"422",501,0.7927,0.7522,0.7737
"11969",168254,1993,"392",149,243,120,"64",56,0.3758,0.2634,0.3061
"11970",168281,1993,"417",300,117,263,"71",192,0.64,0.6068,0.6307
"11971",168342,1993,"527",269,258,467,"222",245,0.9108,0.8605,0.8861
"11972",168546,1993,"488",251,237,270,"145",125,0.498,0.6118,0.5533
"11973",168786,1993,"219",152,67,67,"14",53,0.3487,0.209,0.3059
"11974",169080,1993,"908",524,384,471,"194",277,0.5286,0.5052,0.5187
"11975",169798,1993,"2242",1217,1025,180,"67",113,0.0929,0.0654,0.0803
"11976",169910,1993,"2114",810,1304,51,"26",25,0.0309,0.0199,0.0241
"11977",170082,1993,"1511",916,595,262,"79",183,0.1998,0.1328,0.1734
"11978",170301,1993,"657",360,297,360,"157",203,0.5639,0.5286,0.5479
"11979",170532,1993,"338",198,140,217,"86",131,0.6616,0.6143,0.642
"11980",170639,1993,"593",290,303,95,"35",60,0.2069,0.1155,0.1602
"11981",170976,1993,"5016",2428,2588,3078,"1451",1627,0.6701,0.5607,0.6136
"11982",171100,1993,"6164",3372,2792,1851,"641",1210,0.3588,0.2296,0.3003
"11983",171128,1993,"1026",262,764,215,"133",82,0.313,0.1741,0.2096
"11984",171137,1993,"631",311,320,50,"21",29,0.0932,0.0656,0.0792
"11985",171146,1993,"504",322,182,41,"12",29,0.0901,0.0659,0.0813
"11986",171599,1993,"234",78,156,53,"30",23,0.2949,0.1923,0.2265
"11987",172051,1993,"633",337,296,112,"36",76,0.2255,0.1216,0.1769
"11988",172699,1993,"2810",1587,1223,538,"161",377,0.2376,0.1316,0.1915
"11989",173160,1993,"275",168,107,175,"64",111,0.6607,0.5981,0.6364
"11990",173258,1993,"488",252,236,391,"185",206,0.8175,0.7839,0.8012
"11991",173328,1993,"138",77,61,39,"16",23,0.2987,0.2623,0.2826
"11992",173647,1993,"630",369,261,485,"191",294,0.7967,0.7318,0.7698
"11993",173902,1993,"452",252,200,318,"128",190,0.754,0.64,0.7035
"11994",174066,1993,"2272",1080,1192,413,"171",242,0.2241,0.1435,0.1818
"11995",174233,1993,"1248",631,617,226,"88",138,0.2187,0.1426,0.1811
"11996",174251,1993,"519",284,235,209,"88",121,0.4261,0.3745,0.4027
"11997",174491,1993,"329",209,120,107,"38",69,0.3301,0.3167,0.3252
"11998",174792,1993,"444",0,444,265,"265",0,NA,0.5968,0.5968
"11999",174844,1993,"737",413,324,515,"215",300,0.7264,0.6636,0.6988
"12000",174899,1993,"254",193,61,120,"25",95,0.4922,0.4098,0.4724
"12001",174914,1993,"827",439,388,382,"155",227,0.5171,0.3995,0.4619
"12002",175342,1993,"506",299,207,100,"24",76,0.2542,0.1159,0.1976
"12003",175421,1993,"113",59,54,37,"16",21,0.3559,0.2963,0.3274
"12004",175616,1993,"450",255,195,81,"28",53,0.2078,0.1436,0.18
"12005",175856,1993,"1105",596,509,124,"35",89,0.1493,0.0688,0.1122
"12006",175980,1993,"319",161,158,189,"95",94,0.5839,0.6013,0.5925
"12007",176017,1993,"1538",796,742,461,"156",305,0.3832,0.2102,0.2997
"12008",176035,1993,"272",229,43,68,"5",63,0.2751,0.1163,0.25
"12009",176044,1993,"478",256,222,57,"19",38,0.1484,0.0856,0.1192
"12010",176080,1993,"1633",777,856,330,"118",212,0.2728,0.1379,0.2021
"12011",176406,1993,"311",223,88,79,"17",62,0.278,0.1932,0.254
"12012",176628,1993,"84",57,27,25,"3",22,0.386,0.1111,0.2976
"12013",176947,1993,"238",108,130,62,"21",41,0.3796,0.1615,0.2605
"12014",176965,1993,"1433",757,676,213,"72",141,0.1863,0.1065,0.1486
"12015",177418,1993,"126",95,31,50,"7",43,0.4526,0.2258,0.3968
"12016",178059,1993,"165",109,56,73,"20",53,0.4862,0.3571,0.4424
"12017",178341,1993,"701",362,339,51,"16",35,0.0967,0.0472,0.0728
"12018",178387,1993,"928",514,414,86,"30",56,0.1089,0.0725,0.0927
"12019",178396,1993,"2898",1511,1387,828,"320",508,0.3362,0.2307,0.2857
"12020",178402,1993,"515",266,249,53,"18",35,0.1316,0.0723,0.1029
"12021",178411,1993,"786",190,596,78,"58",20,0.1053,0.0973,0.0992
"12022",178420,1993,"458",231,227,52,"17",35,0.1515,0.0749,0.1135
"12023",178615,1993,"1614",962,652,597,"178",419,0.4356,0.273,0.3699
"12024",179043,1993,"345",194,151,169,"74",95,0.4897,0.4901,0.4899
"12025",179159,1993,"1066",578,488,500,"188",312,0.5398,0.3852,0.469
"12026",179557,1993,"1229",733,496,226,"58",168,0.2292,0.1169,0.1839
"12027",179566,1993,"2800",1493,1307,376,"109",267,0.1788,0.0834,0.1343
"12028",179867,1993,"1229",569,660,930,"460",470,0.826,0.697,0.7567
"12029",179894,1993,"227",132,95,81,"28",53,0.4015,0.2947,0.3568
"12030",179946,1993,"180",71,109,73,"39",34,0.4789,0.3578,0.4056
"12031",180179,1993,"386",261,125,25,"3",22,0.0843,0.024,0.0648
"12032",180461,1993,"1716",756,960,195,"89",106,0.1402,0.0927,0.1136
"12033",180522,1993,"223",106,117,20,"9",11,0.1038,0.0769,0.0897
"12034",180984,1993,"230",114,116,87,"31",56,0.4912,0.2672,0.3783
"12035",181002,1993,"833",492,341,438,"164",274,0.5569,0.4809,0.5258
"12036",181020,1993,"246",135,111,127,"52",75,0.5556,0.4685,0.5163
"12037",181127,1993,"266",147,119,119,"48",71,0.483,0.4034,0.4474
"12038",181215,1993,"936",501,435,124,"37",87,0.1737,0.0851,0.1325
"12039",181394,1993,"1220",664,556,52,"14",38,0.0572,0.0252,0.0426
"12040",181446,1993,"382",218,164,153,"62",91,0.4174,0.378,0.4005
"12041",181464,1993,"3325",1571,1754,449,"170",279,0.1776,0.0969,0.135
"12042",181534,1993,"211",112,99,22,"4",18,0.1607,0.0404,0.1043
"12043",181783,1993,"718",398,320,105,"25",80,0.201,0.0781,0.1462
"12044",182281,1993,"1281",669,612,127,"47",80,0.1196,0.0768,0.0991
"12045",182290,1993,"1140",563,577,155,"49",106,0.1883,0.0849,0.136
"12046",182634,1993,"179",115,64,72,"24",48,0.4174,0.375,0.4022
"12047",182795,1993,"410",186,224,117,"64",53,0.2849,0.2857,0.2854
"12048",183062,1993,"809",488,321,170,"43",127,0.2602,0.134,0.2101
"12049",183080,1993,"748",364,384,163,"63",100,0.2747,0.1641,0.2179
"12050",183239,1993,"510",284,226,323,"128",195,0.6866,0.5664,0.6333
"12051",183822,1993,"270",192,78,20,"5",15,0.0781,0.0641,0.0741
"12052",183974,1993,"95",77,18,20,"2",18,0.2338,0.1111,0.2105
"12053",184348,1993,"312",190,122,226,"84",142,0.7474,0.6885,0.7244
"12054",184603,1993,"860",422,438,128,"46",82,0.1943,0.105,0.1488
"12055",184612,1993,"129",105,24,10,"0",10,0.0952,0,0.0775
"12056",184782,1993,"713",408,305,152,"43",109,0.2672,0.141,0.2132
"12057",185129,1993,"514",276,238,27,"11",16,0.058,0.0462,0.0525
"12058",185572,1993,"477",220,257,94,"43",51,0.2318,0.1673,0.1971
"12059",185590,1993,"868",531,337,117,"34",83,0.1563,0.1009,0.1348
"12060",185828,1993,"476",90,386,33,"22",11,0.1222,0.057,0.0693
"12061",186131,1993,"1152",514,638,1032,"563",469,0.9125,0.8824,0.8958
"12062",186201,1993,"361",199,162,62,"21",41,0.206,0.1296,0.1717
"12063",186283,1993,"663",376,287,267,"104",163,0.4335,0.3624,0.4027
"12064",186584,1993,"996",522,474,376,"142",234,0.4483,0.2996,0.3775
"12065",186876,1993,"709",369,340,193,"77",116,0.3144,0.2265,0.2722
"12066",187134,1993,"1064",628,436,576,"186",390,0.621,0.4266,0.5414
"12067",187444,1993,"1091",608,483,89,"14",75,0.1234,0.029,0.0816
"12068",187985,1993,"1910",1067,843,171,"52",119,0.1115,0.0617,0.0895
"12069",188030,1993,"1602",780,822,153,"64",89,0.1141,0.0779,0.0955
"12070",188429,1993,"464",282,182,154,"48",106,0.3759,0.2637,0.3319
"12071",188641,1993,"314",148,166,165,"74",91,0.6149,0.4458,0.5255
"12072",190044,1993,"557",120,437,285,"221",64,0.5333,0.5057,0.5117
"12073",190099,1993,"726",378,348,603,"269",334,0.8836,0.773,0.8306
"12074",190150,1993,"1626",997,629,1243,"482",761,0.7633,0.7663,0.7645
"12075",190248,1993,"81",40,41,27,"12",15,0.375,0.2927,0.3333
"12076",190415,1993,"3172",1423,1749,2612,"1400",1212,0.8517,0.8005,0.8235
"12077",190512,1993,"1300",798,502,63,"25",38,0.0476,0.0498,0.0485
"12078",190549,1993,"1269",748,521,143,"40",103,0.1377,0.0768,0.1127
"12079",190558,1993,"1100",579,521,23,"9",14,0.0242,0.0173,0.0209
"12080",190567,1993,"1167",507,660,25,"13",12,0.0237,0.0197,0.0214
"12081",190594,1993,"1308",1011,297,62,"7",55,0.0544,0.0236,0.0474
"12082",190637,1993,"663",455,208,15,"1",14,0.0308,0.0048,0.0226
"12083",190664,1993,"1526",831,695,180,"55",125,0.1504,0.0791,0.118
"12084",190691,1993,"607",359,248,29,"13",16,0.0446,0.0524,0.0478
"12085",190725,1993,"405",271,134,58,"19",39,0.1439,0.1418,0.1432
"12086",191241,1993,"989",532,457,587,"271",316,0.594,0.593,0.5935
"12087",191515,1993,"452",195,257,361,"192",169,0.8667,0.7471,0.7987
"12088",191533,1993,"429",217,212,201,"80",121,0.5576,0.3774,0.4685
"12089",191630,1993,"493",236,257,325,"146",179,0.7585,0.5681,0.6592
"12090",191649,1993,"1349",705,644,524,"191",333,0.4723,0.2966,0.3884
"12091",191676,1993,"287",182,105,147,"50",97,0.533,0.4762,0.5122
"12092",191931,1993,"951",455,496,260,"117",143,0.3143,0.2359,0.2734
"12093",191968,1993,"1365",721,644,813,"345",468,0.6491,0.5357,0.5956
"12094",192192,1993,"172",124,48,47,"13",34,0.2742,0.2708,0.2733
"12095",192323,1993,"415",213,202,254,"107",147,0.6901,0.5297,0.612
"12096",192439,1993,"918",633,285,36,"13",23,0.0363,0.0456,0.0392
"12097",192703,1993,"546",254,292,307,"152",155,0.6102,0.5205,0.5623
"12098",192749,1993,"214",133,81,86,"30",56,0.4211,0.3704,0.4019
"12099",192819,1993,"806",460,346,371,"134",237,0.5152,0.3873,0.4603
"12100",192925,1993,"202",94,108,38,"16",22,0.234,0.1481,0.1881
"12101",193016,1993,"733",403,330,16,"6",10,0.0248,0.0182,0.0218
"12102",193292,1993,"175",139,36,74,"8",66,0.4748,0.2222,0.4229
"12103",193353,1993,"239",164,75,90,"29",61,0.372,0.3867,0.3766
"12104",193399,1993,"174",136,38,71,"9",62,0.4559,0.2368,0.408
"12105",193584,1993,"266",192,74,142,"29",113,0.5885,0.3919,0.5338
"12106",193645,1993,"821",677,144,89,"14",75,0.1108,0.0972,0.1084
"12107",193654,1993,"441",282,159,142,"50",92,0.3262,0.3145,0.322
"12108",193900,1993,"2752",1592,1160,1395,"546",849,0.5333,0.4707,0.5069
"12109",193973,1993,"432",259,173,202,"68",134,0.5174,0.3931,0.4676
"12110",194161,1993,"109",69,40,30,"8",22,0.3188,0.2,0.2752
"12111",194310,1993,"659",430,229,228,"64",164,0.3814,0.2795,0.346
"12112",194824,1993,"936",168,768,408,"303",105,0.625,0.3945,0.4359
"12113",195003,1993,"1343",425,918,310,"146",164,0.3859,0.159,0.2308
"12114",195030,1993,"1229",599,630,754,"365",389,0.6494,0.5794,0.6135
"12115",195164,1993,"370",187,183,215,"95",120,0.6417,0.5191,0.5811
"12116",195173,1993,"358",214,144,107,"40",67,0.3131,0.2778,0.2989
"12117",195216,1993,"507",260,247,353,"167",186,0.7154,0.6761,0.6963
"12118",195234,1993,"236",160,76,116,"24",92,0.575,0.3158,0.4915
"12119",195243,1993,"211",132,79,86,"24",62,0.4697,0.3038,0.4076
"12120",195304,1993,"255",195,60,131,"31",100,0.5128,0.5167,0.5137
"12121",195474,1993,"616",339,277,421,"185",236,0.6962,0.6679,0.6834
"12122",195526,1993,"588",355,233,414,"153",261,0.7352,0.6567,0.7041
"12123",195544,1993,"78",61,17,42,"10",32,0.5246,0.5882,0.5385
"12124",195809,1993,"2324",1174,1150,565,"223",342,0.2913,0.1939,0.2431
"12125",196413,1993,"2418",1270,1148,1386,"590",796,0.6268,0.5139,0.5732
"12126",196592,1993,"1236",815,421,70,"6",64,0.0785,0.0143,0.0566
"12127",197045,1993,"256",140,116,84,"35",49,0.35,0.3017,0.3281
"12128",197133,1993,"649",414,235,497,"169",328,0.7923,0.7191,0.7658
"12129",197869,1993,"1931",1098,833,603,"192",411,0.3743,0.2305,0.3123
"12130",197984,1993,"136",69,67,44,"20",24,0.3478,0.2985,0.3235
"12131",198385,1993,"452",195,257,381,"212",169,0.8667,0.8249,0.8429
"12132",198464,1993,"2428",1417,1011,558,"151",407,0.2872,0.1494,0.2298
"12133",198507,1993,"460",273,187,164,"47",117,0.4286,0.2513,0.3565
"12134",198516,1993,"857",492,365,478,"197",281,0.5711,0.5397,0.5578
"12135",198835,1993,"254",135,119,115,"39",76,0.563,0.3277,0.4528
"12136",198969,1993,"310",81,229,49,"28",21,0.2593,0.1223,0.1581
"12137",199102,1993,"1429",775,654,300,"85",215,0.2774,0.13,0.2099
"12138",199111,1993,"394",222,172,129,"42",87,0.3919,0.2442,0.3274
"12139",199120,1993,"3310",2048,1262,2089,"744",1345,0.6567,0.5895,0.6311
"12140",199139,1993,"1685",845,840,312,"111",201,0.2379,0.1321,0.1852
"12141",199148,1993,"1500",959,541,297,"61",236,0.2461,0.1128,0.198
"12142",199157,1993,"810",525,285,201,"40",161,0.3067,0.1404,0.2481
"12143",199193,1993,"3277",1248,2029,841,"397",444,0.3558,0.1957,0.2566
"12144",199218,1993,"1439",860,579,417,"131",286,0.3326,0.2263,0.2898
"12145",199281,1993,"422",216,206,71,"19",52,0.2407,0.0922,0.1682
"12146",199306,1993,"156",70,86,40,"14",26,0.3714,0.1628,0.2564
"12147",199412,1993,"169",134,35,60,"13",47,0.3507,0.3714,0.355
"12148",199582,1993,"361",196,165,49,"12",37,0.1888,0.0727,0.1357
"12149",199643,1993,"601",336,265,140,"43",97,0.2887,0.1623,0.2329
"12150",199847,1993,"904",443,461,676,"314",362,0.8172,0.6811,0.7478
"12151",199962,1993,"376",171,205,78,"31",47,0.2749,0.1512,0.2074
"12152",199999,1993,"369",225,144,79,"26",53,0.2356,0.1806,0.2141
"12153",200004,1993,"1051",509,542,226,"91",135,0.2652,0.1679,0.215
"12154",200059,1993,"300",148,152,22,"5",17,0.1149,0.0329,0.0733
"12155",200156,1993,"262",121,141,62,"27",35,0.2893,0.1915,0.2366
"12156",200217,1993,"350",224,126,91,"20",71,0.317,0.1587,0.26
"12157",200226,1993,"146",61,85,17,"4",13,0.2131,0.0471,0.1164
"12158",200253,1993,"579",346,233,48,"13",35,0.1012,0.0558,0.0829
"12159",200280,1993,"1465",747,718,205,"80",125,0.1673,0.1114,0.1399
"12160",200332,1993,"1433",571,862,182,"76",106,0.1856,0.0882,0.127
"12161",200572,1993,"196",80,116,34,"12",22,0.275,0.1034,0.1735
"12162",201104,1993,"510",268,242,134,"29",105,0.3918,0.1198,0.2627
"12163",201371,1993,"214",105,109,110,"43",67,0.6381,0.3945,0.514
"12164",201548,1993,"448",266,182,238,"81",157,0.5902,0.4451,0.5312
"12165",201645,1993,"712",249,463,354,"201",153,0.6145,0.4341,0.4972
"12166",201690,1993,"613",301,312,66,"18",48,0.1595,0.0577,0.1077
"12167",202134,1993,"942",479,463,77,"26",51,0.1065,0.0562,0.0817
"12168",202480,1993,"1507",730,777,769,"324",445,0.6096,0.417,0.5103
"12169",202523,1993,"535",290,245,342,"142",200,0.6897,0.5796,0.6393
"12170",202763,1993,"394",190,204,162,"76",86,0.4526,0.3725,0.4112
"12171",203085,1993,"217",105,112,86,"38",48,0.4571,0.3393,0.3963
"12172",203128,1993,"263",127,136,134,"64",70,0.5512,0.4706,0.5095
"12173",203368,1993,"813",422,391,487,"216",271,0.6422,0.5524,0.599
"12174",203517,1993,"2371",1476,895,540,"163",377,0.2554,0.1821,0.2278
"12175",203535,1993,"408",231,177,316,"129",187,0.8095,0.7288,0.7745
"12176",203580,1993,"51",39,12,12,"1",11,0.2821,0.0833,0.2353
"12177",203775,1993,"427",218,209,110,"34",76,0.3486,0.1627,0.2576
"12178",203845,1993,"342",145,197,174,"84",90,0.6207,0.4264,0.5088
"12179",204024,1993,"3264",1782,1482,1948,"739",1209,0.6785,0.4987,0.5968
"12180",204185,1993,"396",194,202,197,"89",108,0.5567,0.4406,0.4975
"12181",204194,1993,"335",201,134,108,"35",73,0.3632,0.2612,0.3224
"12182",204617,1993,"225",123,102,61,"16",45,0.3659,0.1569,0.2711
"12183",204796,1993,"5283",2710,2573,1074,"371",703,0.2594,0.1442,0.2033
"12184",204857,1993,"3148",1782,1366,1297,"433",864,0.4848,0.317,0.412
"12185",206330,1993,"200",61,139,33,"15",18,0.2951,0.1079,0.165
"12186",206589,1993,"548",291,257,346,"139",207,0.7113,0.5409,0.6314
"12187",206604,1993,"2002",1045,957,190,"73",117,0.112,0.0763,0.0949
"12188",206622,1993,"696",381,315,368,"170",198,0.5197,0.5397,0.5287
"12189",206695,1993,"1967",1005,962,180,"78",102,0.1015,0.0811,0.0915
"12190",206914,1993,"626",350,276,54,"26",28,0.08,0.0942,0.0863
"12191",207209,1993,"479",253,226,28,"10",18,0.0711,0.0442,0.0585
"12192",207306,1993,"228",119,109,33,"12",21,0.1765,0.1101,0.1447
"12193",207324,1993,"291",157,134,56,"31",25,0.1592,0.2313,0.1924
"12194",207388,1993,"2050",999,1051,377,"130",247,0.2472,0.1237,0.1839
"12195",207500,1993,"2235",1072,1163,337,"139",198,0.1847,0.1195,0.1508
"12196",207722,1993,"207",128,79,21,"6",15,0.1172,0.0759,0.1014
"12197",207847,1993,"541",295,246,77,"31",46,0.1559,0.126,0.1423
"12198",207865,1993,"791",409,382,68,"19",49,0.1198,0.0497,0.086
"12199",208822,1993,"343",198,145,159,"62",97,0.4899,0.4276,0.4636
"12200",209056,1993,"469",274,195,259,"113",146,0.5328,0.5795,0.5522
"12201",209065,1993,"436",235,201,254,"110",144,0.6128,0.5473,0.5826
"12202",209542,1993,"1625",705,920,395,"169",226,0.3206,0.1837,0.2431
"12203",209551,1993,"2513",1422,1091,951,"346",605,0.4255,0.3171,0.3784
"12204",209612,1993,"280",164,116,126,"47",79,0.4817,0.4052,0.45
"12205",209807,1993,"684",330,354,74,"31",43,0.1303,0.0876,0.1082
"12206",209922,1993,"328",171,157,148,"80",68,0.3977,0.5096,0.4512
"12207",210146,1993,"601",324,277,75,"19",56,0.1728,0.0686,0.1248
"12208",210401,1993,"381",218,163,249,"101",148,0.6789,0.6196,0.6535
"12209",210429,1993,"675",404,271,133,"31",102,0.2525,0.1144,0.197
"12210",210571,1993,"227",140,87,147,"50",97,0.6929,0.5747,0.6476
"12211",210669,1993,"481",247,234,301,"126",175,0.7085,0.5385,0.6258
"12212",210775,1993,"157",103,54,48,"14",34,0.3301,0.2593,0.3057
"12213",211088,1993,"227",166,61,131,"35",96,0.5783,0.5738,0.5771
"12214",211158,1993,"1017",615,402,379,"115",264,0.4293,0.2861,0.3727
"12215",211291,1993,"854",454,400,717,"324",393,0.8656,0.81,0.8396
"12216",211352,1993,"224",158,66,115,"29",86,0.5443,0.4394,0.5134
"12217",211361,1993,"951",401,550,145,"55",90,0.2244,0.1,0.1525
"12218",211431,1993,"169",158,11,80,"3",77,0.4873,0.2727,0.4734
"12219",211440,1993,"1189",358,831,752,"510",242,0.676,0.6137,0.6325
"12220",211468,1993,"198",196,2,83,"1",82,0.4184,0.5,0.4192
"12221",211556,1993,"87",87,0,41,"0",41,0.4713,NA,0.4713
"12222",211583,1993,"132",132,0,73,"0",73,0.553,NA,0.553
"12223",211608,1993,"287",128,159,23,"11",12,0.0938,0.0692,0.0801
"12224",211644,1993,"1081",650,431,246,"70",176,0.2708,0.1624,0.2276
"12225",211981,1993,"435",212,223,142,"65",77,0.3632,0.2915,0.3264
"12226",212009,1993,"482",277,205,330,"124",206,0.7437,0.6049,0.6846
"12227",212054,1993,"1126",383,743,86,"27",59,0.154,0.0363,0.0764
"12228",212106,1993,"971",547,424,418,"182",236,0.4314,0.4292,0.4305
"12229",212115,1993,"799",446,353,161,"39",122,0.2735,0.1105,0.2015
"12230",212133,1993,"162",113,49,76,"22",54,0.4779,0.449,0.4691
"12231",212160,1993,"1315",763,552,221,"65",156,0.2045,0.1178,0.1681
"12232",212197,1993,"424",276,148,270,"76",194,0.7029,0.5135,0.6368
"12233",212577,1993,"507",229,278,364,"190",174,0.7598,0.6835,0.7179
"12234",212601,1993,"450",257,193,177,"79",98,0.3813,0.4093,0.3933
"12235",212832,1993,"86",74,12,32,"2",30,0.4054,0.1667,0.3721
"12236",212911,1993,"292",143,149,243,"122",121,0.8462,0.8188,0.8322
"12237",213020,1993,"2366",1365,1001,495,"154",341,0.2498,0.1538,0.2092
"12238",213251,1993,"301",166,135,198,"87",111,0.6687,0.6444,0.6578
"12239",213321,1993,"380",166,214,241,"127",114,0.6867,0.5935,0.6342
"12240",213349,1993,"1309",771,538,236,"57",179,0.2322,0.1059,0.1803
"12241",213358,1993,"181",85,96,61,"31",30,0.3529,0.3229,0.337
"12242",213367,1993,"597",327,270,321,"125",196,0.5994,0.463,0.5377
"12243",213385,1993,"570",252,318,443,"226",217,0.8611,0.7107,0.7772
"12244",213507,1993,"314",170,144,191,"77",114,0.6706,0.5347,0.6083
"12245",213543,1993,"1095",394,701,706,"404",302,0.7665,0.5763,0.6447
"12246",213613,1993,"758",402,356,157,"43",114,0.2836,0.1208,0.2071
"12247",213668,1993,"361",203,158,191,"72",119,0.5862,0.4557,0.5291
"12248",213783,1993,"590",350,240,189,"59",130,0.3714,0.2458,0.3203
"12249",213826,1993,"292",228,64,101,"17",84,0.3684,0.2656,0.3459
"12250",213996,1993,"606",376,230,400,"155",245,0.6516,0.6739,0.6601
"12251",214041,1993,"946",593,353,339,"86",253,0.4266,0.2436,0.3584
"12252",214069,1993,"316",231,85,88,"24",64,0.2771,0.2824,0.2785
"12253",214157,1993,"304",157,147,216,"102",114,0.7261,0.6939,0.7105
"12254",214175,1993,"464",270,194,332,"131",201,0.7444,0.6753,0.7155
"12255",214272,1993,"84",64,20,33,"7",26,0.4062,0.35,0.3929
"12256",214777,1993,"4265",2107,2158,1846,"741",1105,0.5244,0.3434,0.4328
"12257",215062,1993,"2434",1086,1348,1923,"1008",915,0.8425,0.7478,0.7901
"12258",215743,1993,"285",136,149,115,"49",66,0.4853,0.3289,0.4035
"12259",215798,1993,"277",122,155,144,"74",70,0.5738,0.4774,0.5199
"12260",215929,1993,"899",496,403,582,"239",343,0.6915,0.5931,0.6474
"12261",216010,1993,"1114",603,511,443,"162",281,0.466,0.317,0.3977
"12262",216038,1993,"1239",739,500,247,"77",170,0.23,0.154,0.1994
"12263",216287,1993,"413",226,187,348,"149",199,0.8805,0.7968,0.8426
"12264",216339,1993,"2186",1209,977,355,"141",214,0.177,0.1443,0.1624
"12265",216524,1993,"308",159,149,226,"108",118,0.7421,0.7248,0.7338
"12266",216694,1993,"325",180,145,132,"51",81,0.45,0.3517,0.4062
"12267",216764,1993,"1386",876,510,346,"74",272,0.3105,0.1451,0.2496
"12268",216807,1993,"375",216,159,250,"93",157,0.7269,0.5849,0.6667
"12269",216852,1993,"473",215,258,182,"79",103,0.4791,0.3062,0.3848
"12270",216931,1993,"434",198,236,177,"85",92,0.4646,0.3602,0.4078
"12271",217059,1993,"691",397,294,274,"102",172,0.4332,0.3469,0.3965
"12272",217156,1993,"1424",770,654,1109,"494",615,0.7987,0.7554,0.7788
"12273",217402,1993,"968",503,465,775,"368",407,0.8091,0.7914,0.8006
"12274",217536,1993,"345",235,110,181,"57",124,0.5277,0.5182,0.5246
"12275",217776,1993,"90",48,42,23,"8",15,0.3125,0.1905,0.2556
"12276",217819,1993,"1519",1004,515,485,"123",362,0.3606,0.2388,0.3193
"12277",217882,1993,"2300",1053,1247,872,"323",549,0.5214,0.259,0.3791
"12278",217998,1993,"177",108,69,113,"36",77,0.713,0.5217,0.6384
"12279",218061,1993,"807",435,372,130,"40",90,0.2069,0.1075,0.1611
"12280",218229,1993,"491",327,164,80,"21",59,0.1804,0.128,0.1629
"12281",218238,1993,"214",88,126,43,"22",21,0.2386,0.1746,0.2009
"12282",218399,1993,"327",213,114,33,"10",23,0.108,0.0877,0.1009
"12283",218414,1993,"155",62,93,44,"24",20,0.3226,0.2581,0.2839
"12284",218663,1993,"2298",1269,1029,681,"246",435,0.3428,0.2391,0.2963
"12285",218724,1993,"732",379,353,86,"26",60,0.1583,0.0737,0.1175
"12286",218733,1993,"613",329,284,80,"20",60,0.1824,0.0704,0.1305
"12287",218742,1993,"327",216,111,46,"6",40,0.1852,0.0541,0.1407
"12288",218973,1993,"273",109,164,210,"117",93,0.8532,0.7134,0.7692
"12289",219000,1993,"306",208,98,128,"25",103,0.4952,0.2551,0.4183
"12290",219046,1993,"1078",586,492,243,"85",158,0.2696,0.1728,0.2254
"12291",219082,1993,"208",116,92,14,"2",12,0.1034,0.0217,0.0673
"12292",219198,1993,"117",96,21,39,"9",30,0.3125,0.4286,0.3333
"12293",219259,1993,"647",360,287,73,"14",59,0.1639,0.0488,0.1128
"12294",219356,1993,"1670",831,839,320,"128",192,0.231,0.1526,0.1916
"12295",219471,1993,"1227",704,523,247,"79",168,0.2386,0.1511,0.2013
"12296",219602,1993,"788",474,314,152,"50",102,0.2152,0.1592,0.1929
"12297",219709,1993,"328",182,146,137,"58",79,0.4341,0.3973,0.4177
"12298",219718,1993,"125",43,82,15,"4",11,0.2558,0.0488,0.12
"12299",219949,1993,"169",106,63,37,"6",31,0.2925,0.0952,0.2189
"12300",220075,1993,"1289",757,532,128,"51",77,0.1017,0.0959,0.0993
"12301",220215,1993,"296",169,127,83,"31",52,0.3077,0.2441,0.2804
"12302",220613,1993,"395",205,190,87,"37",50,0.2439,0.1947,0.2203
"12303",220631,1993,"217",134,83,59,"23",36,0.2687,0.2771,0.2719
"12304",220710,1993,"175",73,102,56,"28",28,0.3836,0.2745,0.32
"12305",221351,1993,"385",215,170,284,"124",160,0.7442,0.7294,0.7377
"12306",221519,1993,"322",157,165,250,"131",119,0.758,0.7939,0.7764
"12307",221731,1993,"90",28,62,8,"2",6,0.2143,0.0323,0.0889
"12308",221847,1993,"1330",608,722,172,"55",117,0.1924,0.0762,0.1293
"12309",221892,1993,"139",84,55,25,"9",16,0.1905,0.1636,0.1799
"12310",222178,1993,"650",343,307,165,"66",99,0.2886,0.215,0.2538
"12311",222983,1993,"294",175,119,165,"57",108,0.6171,0.479,0.5612
"12312",223232,1993,"2426",1420,1006,978,"350",628,0.4423,0.3479,0.4031
"12313",224004,1993,"107",62,45,26,"7",19,0.3065,0.1556,0.243
"12314",224323,1993,"246",138,108,118,"56",62,0.4493,0.5185,0.4797
"12315",225432,1993,"666",362,304,8,"2",6,0.0166,0.0066,0.012
"12316",225548,1993,"322",133,189,56,"31",25,0.188,0.164,0.1739
"12317",225627,1993,"297",202,95,29,"8",21,0.104,0.0842,0.0976
"12318",226231,1993,"202",33,169,46,"36",10,0.303,0.213,0.2277
"12319",226833,1993,"553",284,269,49,"23",26,0.0915,0.0855,0.0886
"12320",227216,1993,"1872",1045,827,211,"63",148,0.1416,0.0762,0.1127
"12321",227331,1993,"291",224,67,29,"0",29,0.1295,0,0.0997
"12322",227526,1993,"1208",610,598,110,"27",83,0.1361,0.0452,0.0911
"12323",227757,1993,"639",281,358,440,"228",212,0.7544,0.6369,0.6886
"12324",227845,1993,"370",235,135,98,"32",66,0.2809,0.237,0.2649
"12325",227863,1993,"192",129,63,53,"13",40,0.3101,0.2063,0.276
"12326",228042,1993,"134",77,57,26,"10",16,0.2078,0.1754,0.194
"12327",228149,1993,"402",231,171,125,"34",91,0.3939,0.1988,0.3109
"12328",228246,1993,"1161",630,531,657,"265",392,0.6222,0.4991,0.5659
"12329",228343,1993,"351",207,144,218,"79",139,0.6715,0.5486,0.6211
"12330",228431,1993,"2247",1255,992,308,"81",227,0.1809,0.0817,0.1371
"12331",228459,1993,"2281",1358,923,248,"62",186,0.137,0.0672,0.1087
"12332",228501,1993,"317",107,210,23,"9",14,0.1308,0.0429,0.0726
"12333",228529,1993,"923",432,491,82,"24",58,0.1343,0.0489,0.0888
"12334",228705,1993,"1012",481,531,50,"19",31,0.0644,0.0358,0.0494
"12335",228723,1993,"6341",3083,3258,1631,"524",1107,0.3591,0.1608,0.2572
"12336",228769,1993,"1314",638,676,81,"34",47,0.0737,0.0503,0.0616
"12337",228778,1993,"5872",2810,3062,1776,"741",1035,0.3683,0.242,0.3025
"12338",228787,1993,"414",156,258,125,"76",49,0.3141,0.2946,0.3019
"12339",228796,1993,"1948",1023,925,59,"22",37,0.0362,0.0238,0.0303
"12340",228875,1993,"1189",690,499,467,"162",305,0.442,0.3246,0.3928
"12341",228981,1993,"213",134,79,65,"24",41,0.306,0.3038,0.3052
"12342",229018,1993,"78",41,37,8,"3",5,0.122,0.0811,0.1026
"12343",229027,1993,"1591",855,736,84,"43",41,0.048,0.0584,0.0528
"12344",229115,1993,"3073",1525,1548,520,"196",324,0.2125,0.1266,0.1692
"12345",229780,1993,"166",106,60,26,"10",16,0.1509,0.1667,0.1566
"12346",229814,1993,"986",472,514,93,"25",68,0.1441,0.0486,0.0943
"12347",230603,1993,"588",416,172,83,"11",72,0.1731,0.064,0.1412
"12348",230728,1993,"1321",850,471,212,"42",170,0.2,0.0892,0.1605
"12349",230764,1993,"1794",1004,790,202,"59",143,0.1424,0.0747,0.1126
"12350",230782,1993,"1219",829,390,81,"23",58,0.07,0.059,0.0664
"12351",231059,1993,"454",238,216,291,"128",163,0.6849,0.5926,0.641
"12352",231174,1993,"1706",955,751,828,"319",509,0.533,0.4248,0.4853
"12353",231420,1993,"168",101,67,56,"17",39,0.3861,0.2537,0.3333
"12354",231554,1993,"210",119,91,88,"36",52,0.437,0.3956,0.419
"12355",231624,1993,"1201",690,511,913,"360",553,0.8014,0.7045,0.7602
"12356",231712,1993,"428",266,162,29,"7",22,0.0827,0.0432,0.0678
"12357",232025,1993,"230",120,110,91,"30",61,0.5083,0.2727,0.3957
"12358",232043,1993,"229",130,99,108,"42",66,0.5077,0.4242,0.4716
"12359",232089,1993,"332",131,201,68,"29",39,0.2977,0.1443,0.2048
"12360",232186,1993,"1670",934,736,442,"140",302,0.3233,0.1902,0.2647
"12361",232265,1993,"1427",879,548,410,"85",325,0.3697,0.1551,0.2873
"12362",232423,1993,"2079",1170,909,1239,"453",786,0.6718,0.4983,0.596
"12363",232557,1993,"1407",691,716,204,"81",123,0.178,0.1131,0.145
"12364",232566,1993,"724",509,215,275,"40",235,0.4617,0.186,0.3798
"12365",232609,1993,"361",221,140,120,"36",84,0.3801,0.2571,0.3324
"12366",232681,1993,"750",477,273,486,"161",325,0.6813,0.5897,0.648
"12367",232706,1993,"175",130,45,66,"10",56,0.4308,0.2222,0.3771
"12368",232937,1993,"1324",759,565,70,"24",46,0.0606,0.0425,0.0529
"12369",232982,1993,"1173",580,593,137,"39",98,0.169,0.0658,0.1168
"12370",233277,1993,"1736",1088,648,460,"128",332,0.3051,0.1975,0.265
"12371",233374,1993,"728",383,345,559,"251",308,0.8042,0.7275,0.7679
"12372",233426,1993,"438",275,163,242,"67",175,0.6364,0.411,0.5525
"12373",233541,1993,"185",88,97,47,"17",30,0.3409,0.1753,0.2541
"12374",233897,1993,"253",110,143,53,"22",31,0.2818,0.1538,0.2095
"12375",233921,1993,"4270",1776,2494,1459,"620",839,0.4724,0.2486,0.3417
"12376",234030,1993,"1466",874,592,281,"80",201,0.23,0.1351,0.1917
"12377",234085,1993,"278",0,278,131,"131",0,NA,0.4712,0.4712
"12378",234155,1993,"695",409,286,88,"33",55,0.1345,0.1154,0.1266
"12379",234164,1993,"435",240,195,49,"15",34,0.1417,0.0769,0.1126
"12380",235097,1993,"725",424,301,131,"45",86,0.2028,0.1495,0.1807
"12381",235167,1993,"435",253,182,158,"63",95,0.3755,0.3462,0.3632
"12382",236230,1993,"499",269,230,228,"90",138,0.513,0.3913,0.4569
"12383",236328,1993,"687",402,285,402,"159",243,0.6045,0.5579,0.5852
"12384",236577,1993,"395",263,132,117,"42",75,0.2852,0.3182,0.2962
"12385",236595,1993,"489",276,213,165,"61",104,0.3768,0.2864,0.3374
"12386",236896,1993,"263",138,125,70,"29",41,0.2971,0.232,0.2662
"12387",236939,1993,"2431",1234,1197,644,"235",409,0.3314,0.1963,0.2649
"12388",236948,1993,"3206",1576,1630,1217,"515",702,0.4454,0.316,0.3796
"12389",237011,1993,"1542",941,601,365,"91",274,0.2912,0.1514,0.2367
"12390",237057,1993,"341",196,145,249,"102",147,0.75,0.7034,0.7302
"12391",237066,1993,"361",206,155,160,"59",101,0.4903,0.3806,0.4432
"12392",237215,1993,"358",215,143,10,"5",5,0.0233,0.035,0.0279
"12393",237330,1993,"487",284,203,71,"25",46,0.162,0.1232,0.1458
"12394",237358,1993,"167",100,67,24,"10",14,0.14,0.1493,0.1437
"12395",237367,1993,"1053",553,500,93,"29",64,0.1157,0.058,0.0883
"12396",237792,1993,"557",310,247,59,"17",42,0.1355,0.0688,0.1059
"12397",237899,1993,"634",308,326,21,"8",13,0.0422,0.0245,0.0331
"12398",237932,1993,"474",238,236,85,"32",53,0.2227,0.1356,0.1793
"12399",237969,1993,"475",235,240,172,"64",108,0.4596,0.2667,0.3621
"12400",238032,1993,"2806",1370,1436,658,"252",406,0.2964,0.1755,0.2345
"12401",238333,1993,"284",161,123,158,"61",97,0.6025,0.4959,0.5563
"12402",238430,1993,"481",327,154,39,"12",27,0.0826,0.0779,0.0811
"12403",238458,1993,"345",211,134,130,"45",85,0.4028,0.3358,0.3768
"12404",238476,1993,"441",227,214,216,"99",117,0.5154,0.4626,0.4898
"12405",238616,1993,"289",139,150,81,"37",44,0.3165,0.2467,0.2803
"12406",238661,1993,"161",121,40,42,"7",35,0.2893,0.175,0.2609
"12407",239080,1993,"170",115,55,47,"12",35,0.3043,0.2182,0.2765
"12408",239105,1993,"1684",895,789,880,"339",541,0.6045,0.4297,0.5226
"12409",239628,1993,"211",102,109,113,"47",66,0.6471,0.4312,0.5355
"12410",239716,1993,"569",320,249,352,"142",210,0.6562,0.5703,0.6186
"12411",240107,1993,"270",205,65,67,"14",53,0.2585,0.2154,0.2481
"12412",240189,1993,"1823",1019,804,251,"78",173,0.1698,0.097,0.1377
"12413",240277,1993,"703",438,265,96,"29",67,0.153,0.1094,0.1366
"12414",240329,1993,"1695",1008,687,243,"83",160,0.1587,0.1208,0.1434
"12415",240338,1993,"80",55,25,31,"10",21,0.3818,0.4,0.3875
"12416",240365,1993,"1465",833,632,200,"53",147,0.1765,0.0839,0.1365
"12417",240374,1993,"668",355,313,51,"17",34,0.0958,0.0543,0.0763
"12418",240417,1993,"1023",488,535,143,"36",107,0.2193,0.0673,0.1398
"12419",240426,1993,"323",182,141,41,"14",27,0.1484,0.0993,0.1269
"12420",240444,1993,"4585",2396,2189,1686,"659",1027,0.4286,0.3011,0.3677
"12421",240453,1993,"1712",849,863,117,"51",66,0.0777,0.0591,0.0683
"12422",240462,1993,"917",276,641,109,"51",58,0.2101,0.0796,0.1189
"12423",240471,1993,"838",443,395,162,"64",98,0.2212,0.162,0.1933
"12424",240480,1993,"1359",702,657,201,"72",129,0.1838,0.1096,0.1479
"12425",240727,1993,"1212",560,652,207,"79",128,0.2286,0.1212,0.1708
"12426",243443,1993,"796",541,255,44,"8",36,0.0665,0.0314,0.0553
"12427",243780,1993,"5725",2560,3165,1625,"773",852,0.3328,0.2442,0.2838
"12428",100654,1992,"876",444,432,157,"46",111,0.25,0.1065,0.1792
"12429",100663,1992,"898",479,419,54,"19",35,0.0731,0.0453,0.0601
"12430",100751,1992,"2436",1310,1126,684,"240",444,0.3389,0.2131,0.2808
"12431",100858,1992,"3141",1621,1520,927,"295",632,0.3899,0.1941,0.2951
"12432",101435,1992,"166",91,75,53,"14",39,0.4286,0.1867,0.3193
"12433",101480,1992,"1106",615,491,116,"34",82,0.1333,0.0692,0.1049
"12434",101675,1992,"226",108,118,107,"52",55,0.5093,0.4407,0.4735
"12435",101879,1992,"554",321,233,74,"24",50,0.1558,0.103,0.1336
"12436",102049,1992,"662",405,257,295,"108",187,0.4617,0.4202,0.4456
"12437",102094,1992,"1170",668,502,123,"38",85,0.1272,0.0757,0.1051
"12438",102234,1992,"295",167,128,144,"58",86,0.515,0.4531,0.4881
"12439",102368,1992,"935",460,475,217,"73",144,0.313,0.1537,0.2321
"12440",102377,1992,"612",311,301,123,"36",87,0.2797,0.1196,0.201
"12441",104151,1992,"2901",1503,1398,452,"162",290,0.1929,0.1159,0.1558
"12442",104179,1992,"3803",1926,1877,814,"302",512,0.2658,0.1609,0.214
"12443",105330,1992,"2095",1203,892,315,"104",211,0.1754,0.1166,0.1504
"12444",106245,1992,"1092",600,492,61,"23",38,0.0633,0.0467,0.0559
"12445",106342,1992,"138",80,58,51,"21",30,0.375,0.3621,0.3696
"12446",106397,1992,"2327",1066,1261,394,"165",229,0.2148,0.1308,0.1693
"12447",106412,1992,"592",341,251,27,"9",18,0.0528,0.0359,0.0456
"12448",106458,1992,"1607",855,752,164,"48",116,0.1357,0.0638,0.1021
"12449",106467,1992,"812",438,374,112,"33",79,0.1804,0.0882,0.1379
"12450",106485,1992,"581",302,279,53,"15",38,0.1258,0.0538,0.0912
"12451",106704,1992,"1948",1150,798,352,"116",236,0.2052,0.1454,0.1807
"12452",107044,1992,"818",434,384,238,"91",147,0.3387,0.237,0.291
"12453",107080,1992,"335",183,152,174,"76",98,0.5355,0.5,0.5194
"12454",107141,1992,"196",109,87,70,"31",39,0.3578,0.3563,0.3571
"12455",107512,1992,"296",148,148,121,"36",85,0.5743,0.2432,0.4088
"12456",107558,1992,"120",53,67,11,"7",4,0.0755,0.1045,0.0917
"12457",110097,1992,"464",290,174,176,"64",112,0.3862,0.3678,0.3793
"12458",110404,1992,"233",60,173,165,"119",46,0.7667,0.6879,0.7082
"12459",110422,1992,"1295",566,729,136,"37",99,0.1749,0.0508,0.105
"12460",110486,1992,"323",181,142,32,"11",21,0.116,0.0775,0.0991
"12461",110495,1992,"307",191,116,33,"11",22,0.1152,0.0948,0.1075
"12462",110510,1992,"737",449,288,59,"23",36,0.0802,0.0799,0.0801
"12463",110529,1992,"1358",551,807,84,"34",50,0.0907,0.0421,0.0619
"12464",110538,1992,"1325",758,567,148,"34",114,0.1504,0.06,0.1117
"12465",110547,1992,"485",336,149,16,"6",10,0.0298,0.0403,0.033
"12466",110556,1992,"1559",860,699,165,"52",113,0.1314,0.0744,0.1058
"12467",110565,1992,"1589",926,663,108,"27",81,0.0875,0.0407,0.068
"12468",110574,1992,"572",394,178,76,"17",59,0.1497,0.0955,0.1329
"12469",110583,1992,"1565",961,604,79,"27",52,0.0541,0.0447,0.0505
"12470",110592,1992,"1206",738,468,45,"16",29,0.0393,0.0342,0.0373
"12471",110617,1992,"922",513,409,71,"20",51,0.0994,0.0489,0.077
"12472",113698,1992,"65",45,20,24,"8",16,0.3556,0.4,0.3692
"12473",115755,1992,"779",421,358,45,"16",29,0.0689,0.0447,0.0578
"12474",119173,1992,"217",217,0,64,"0",64,0.2949,NA,0.2949
"12475",120184,1992,"85",54,31,34,"14",20,0.3704,0.4516,0.4
"12476",121309,1992,"374",248,126,94,"27",67,0.2702,0.2143,0.2513
"12477",121345,1992,"382",192,190,316,"148",168,0.875,0.7789,0.8272
"12478",122409,1992,"1974",1129,845,154,"45",109,0.0965,0.0533,0.078
"12479",122436,1992,"929",524,405,462,"175",287,0.5477,0.4321,0.4973
"12480",122597,1992,"1125",693,432,73,"19",54,0.0779,0.044,0.0649
"12481",122612,1992,"492",319,173,233,"75",158,0.4953,0.4335,0.4736
"12482",122931,1992,"900",458,442,661,"303",358,0.7817,0.6855,0.7344
"12483",123554,1992,"472",257,215,289,"126",163,0.6342,0.586,0.6123
"12484",123572,1992,"591",380,211,97,"20",77,0.2026,0.0948,0.1641
"12485",126562,1992,"272",175,97,29,"6",23,0.1314,0.0619,0.1066
"12486",126580,1992,"313",174,139,29,"9",20,0.1149,0.0647,0.0927
"12487",126614,1992,"3559",1700,1859,1198,"514",684,0.4024,0.2765,0.3366
"12488",126818,1992,"2202",1150,1052,575,"205",370,0.3217,0.1949,0.2611
"12489",127060,1992,"555",284,271,303,"130",173,0.6092,0.4797,0.5459
"12490",127185,1992,"1004",439,565,118,"49",69,0.1572,0.0867,0.1175
"12491",127565,1992,"1227",614,613,49,"17",32,0.0521,0.0277,0.0399
"12492",127741,1992,"1464",921,543,232,"63",169,0.1835,0.116,0.1585
"12493",128106,1992,"656",342,314,58,"21",37,0.1082,0.0669,0.0884
"12494",128744,1992,"18",12,6,1,"0",1,0.0833,0,0.0556
"12495",128771,1992,"964",552,412,98,"31",67,0.1214,0.0752,0.1017
"12496",129020,1992,"2831",1454,1377,968,"354",614,0.4223,0.2571,0.3419
"12497",129242,1992,"861",506,355,672,"277",395,0.7806,0.7803,0.7805
"12498",129941,1992,"302",74,228,42,"30",12,0.1622,0.1316,0.1391
"12499",130253,1992,"491",240,251,114,"52",62,0.2583,0.2072,0.2322
"12500",130314,1992,"105",105,0,42,"0",42,0.4,NA,0.4
"12501",130493,1992,"933",493,440,134,"35",99,0.2008,0.0795,0.1436
"12502",130590,1992,"472",240,232,352,"161",191,0.7958,0.694,0.7458
"12503",130697,1992,"704",361,343,553,"263",290,0.8033,0.7668,0.7855
"12504",130776,1992,"372",161,211,88,"47",41,0.2547,0.2227,0.2366
"12505",130794,1992,"1326",640,686,1139,"561",578,0.9031,0.8178,0.859
"12506",130934,1992,"579",305,274,47,"22",25,0.082,0.0803,0.0812
"12507",130943,1992,"2944",1729,1215,1593,"590",1003,0.5801,0.4856,0.5411
"12508",131159,1992,"1025",629,396,629,"235",394,0.6264,0.5934,0.6137
"12509",131283,1992,"471",252,219,272,"121",151,0.5992,0.5525,0.5775
"12510",131450,1992,"339",177,162,15,"6",9,0.0508,0.037,0.0442
"12511",131469,1992,"1193",642,551,695,"291",404,0.6293,0.5281,0.5826
"12512",131496,1992,"1383",733,650,1179,"550",629,0.8581,0.8462,0.8525
"12513",131520,1992,"1264",797,467,264,"70",194,0.2434,0.1499,0.2089
"12514",132471,1992,"265",146,119,80,"28",52,0.3562,0.2353,0.3019
"12515",132602,1992,"597",326,271,99,"29",70,0.2147,0.107,0.1658
"12516",132903,1992,"1405",745,660,330,"92",238,0.3195,0.1394,0.2349
"12517",133492,1992,"348",182,166,187,"92",95,0.522,0.5542,0.5374
"12518",133553,1992,"801",132,669,190,"149",41,0.3106,0.2227,0.2372
"12519",133650,1992,"1383",815,568,206,"60",146,0.1791,0.1056,0.149
"12520",133669,1992,"795",417,378,115,"43",72,0.1727,0.1138,0.1447
"12521",133711,1992,"299",169,130,125,"43",82,0.4852,0.3308,0.4181
"12522",133881,1992,"457",121,336,147,"99",48,0.3967,0.2946,0.3217
"12523",133951,1992,"1124",625,499,197,"64",133,0.2128,0.1283,0.1753
"12524",134079,1992,"343",200,143,147,"45",102,0.51,0.3147,0.4286
"12525",134097,1992,"3313",1949,1364,1259,"378",881,0.452,0.2771,0.38
"12526",134130,1992,"4471",2097,2374,1377,"568",809,0.3858,0.2393,0.308
"12527",134945,1992,"304",128,176,81,"33",48,0.375,0.1875,0.2664
"12528",135726,1992,"1770",841,929,798,"395",403,0.4792,0.4252,0.4508
"12529",136172,1992,"487",277,210,68,"27",41,0.148,0.1286,0.1396
"12530",136950,1992,"394",215,179,194,"71",123,0.5721,0.3966,0.4924
"12531",137546,1992,"501",282,219,232,"87",145,0.5142,0.3973,0.4631
"12532",138354,1992,"396",208,188,70,"28",42,0.2019,0.1489,0.1768
"12533",138716,1992,"645",364,281,50,"14",36,0.0989,0.0498,0.0775
"12534",138789,1992,"496",292,204,25,"10",15,0.0514,0.049,0.0504
"12535",139144,1992,"425",286,139,191,"64",127,0.4441,0.4604,0.4494
"12536",139366,1992,"589",365,224,42,"14",28,0.0767,0.0625,0.0713
"12537",139393,1992,"155",98,57,56,"18",38,0.3878,0.3158,0.3613
"12538",139658,1992,"1478",872,606,1010,"406",604,0.6927,0.67,0.6834
"12539",139719,1992,"497",264,233,52,"18",34,0.1288,0.0773,0.1046
"12540",139755,1992,"1691",467,1224,472,"298",174,0.3726,0.2435,0.2791
"12541",139764,1992,"375",243,132,75,"28",47,0.1934,0.2121,0.2
"12542",139861,1992,"754",451,303,112,"23",89,0.1973,0.0759,0.1485
"12543",139931,1992,"2828",1530,1298,506,"174",332,0.217,0.1341,0.1789
"12544",139940,1992,"998",574,424,96,"36",60,0.1045,0.0849,0.0962
"12545",139959,1992,"3147",1823,1324,1456,"521",935,0.5129,0.3935,0.4627
"12546",140447,1992,"579",349,230,158,"45",113,0.3238,0.1957,0.2729
"12547",140960,1992,"636",346,290,50,"15",35,0.1012,0.0517,0.0786
"12548",140988,1992,"175",118,57,65,"20",45,0.3814,0.3509,0.3714
"12549",141185,1992,"201",114,87,53,"19",34,0.2982,0.2184,0.2637
"12550",141264,1992,"1057",608,449,146,"43",103,0.1694,0.0958,0.1381
"12551",141334,1992,"1182",657,525,141,"39",102,0.1553,0.0743,0.1193
"12552",141486,1992,"127",73,54,23,"8",15,0.2055,0.1481,0.1811
"12553",141565,1992,"286",173,113,23,"10",13,0.0751,0.0885,0.0804
"12554",141574,1992,"1485",823,662,158,"46",112,0.1361,0.0695,0.1064
"12555",142276,1992,"1091",556,535,66,"22",44,0.0791,0.0411,0.0605
"12556",142285,1992,"1290",574,716,173,"77",96,0.1672,0.1075,0.1341
"12557",142461,1992,"284",162,122,82,"31",51,0.3148,0.2541,0.2887
"12558",143084,1992,"538",309,229,318,"119",199,0.644,0.5197,0.5911
"12559",143288,1992,"148",74,74,52,"17",35,0.473,0.2297,0.3514
"12560",144005,1992,"576",351,225,3,"2",1,0.0028,0.0089,0.0052
"12561",144281,1992,"760",373,387,90,"42",48,0.1287,0.1085,0.1184
"12562",144740,1992,"927",520,407,350,"119",231,0.4442,0.2924,0.3776
"12563",144892,1992,"1463",893,570,464,"132",332,0.3718,0.2316,0.3172
"12564",144962,1992,"229",128,101,92,"29",63,0.4922,0.2871,0.4017
"12565",144971,1992,"119",60,59,53,"22",31,0.5167,0.3729,0.4454
"12566",145600,1992,"2475",1273,1202,240,"95",145,0.1139,0.079,0.097
"12567",145619,1992,"230",110,120,102,"43",59,0.5364,0.3583,0.4435
"12568",145637,1992,"5491",2566,2925,2656,"1267",1389,0.5413,0.4332,0.4837
"12569",145691,1992,"260",136,124,114,"35",79,0.5809,0.2823,0.4385
"12570",145813,1992,"2898",1706,1192,772,"229",543,0.3183,0.1921,0.2664
"12571",146481,1992,"235",123,112,145,"66",79,0.6423,0.5893,0.617
"12572",146612,1992,"345",161,184,84,"34",50,0.3106,0.1848,0.2435
"12573",146719,1992,"985",587,398,377,"143",234,0.3986,0.3593,0.3827
"12574",146825,1992,"171",84,87,67,"23",44,0.5238,0.2644,0.3918
"12575",147013,1992,"134",82,52,53,"19",34,0.4146,0.3654,0.3955
"12576",147244,1992,"516",302,214,289,"102",187,0.6192,0.4766,0.5601
"12577",147341,1992,"125",67,58,61,"23",38,0.5672,0.3966,0.488
"12578",147703,1992,"2742",1537,1205,607,"211",396,0.2576,0.1751,0.2214
"12579",147767,1992,"1889",948,941,1533,"719",814,0.8586,0.7641,0.8115
"12580",147776,1992,"688",408,280,21,"6",15,0.0368,0.0214,0.0305
"12581",147828,1992,"388",202,186,129,"48",81,0.401,0.2581,0.3325
"12582",148131,1992,"313",148,165,80,"24",56,0.3784,0.1455,0.2556
"12583",148496,1992,"142",117,25,67,"9",58,0.4957,0.36,0.4718
"12584",148584,1992,"144",67,77,52,"23",29,0.4328,0.2987,0.3611
"12585",148627,1992,"192",134,58,55,"11",44,0.3284,0.1897,0.2865
"12586",149222,1992,"2756",1203,1553,442,"195",247,0.2053,0.1256,0.1604
"12587",149231,1992,"965",558,407,100,"32",68,0.1219,0.0786,0.1036
"12588",149772,1992,"1566",763,803,315,"137",178,0.2333,0.1706,0.2011
"12589",149781,1992,"548",294,254,392,"172",220,0.7483,0.6772,0.7153
"12590",150066,1992,"507",297,210,162,"53",109,0.367,0.2524,0.3195
"12591",150136,1992,"3265",1841,1424,699,"236",463,0.2515,0.1657,0.2141
"12592",150145,1992,"152",88,64,48,"16",32,0.3636,0.25,0.3158
"12593",150163,1992,"666",383,283,257,"98",159,0.4151,0.3463,0.3859
"12594",150400,1992,"566",326,240,410,"169",241,0.7393,0.7042,0.7244
"12595",150534,1992,"754",435,319,322,"117",205,0.4713,0.3668,0.4271
"12596",150668,1992,"201",104,97,73,"37",36,0.3462,0.3814,0.3632
"12597",150941,1992,"150",92,58,75,"24",51,0.5543,0.4138,0.5
"12598",151102,1992,"1126",612,514,39,"14",25,0.0408,0.0272,0.0346
"12599",151111,1992,"1507",837,670,42,"18",24,0.0287,0.0269,0.0279
"12600",151306,1992,"1080",624,456,90,"27",63,0.101,0.0592,0.0833
"12601",151324,1992,"2187",1161,1026,339,"124",215,0.1852,0.1209,0.155
"12602",151333,1992,"304",200,104,15,"4",11,0.055,0.0385,0.0493
"12603",151342,1992,"564",337,227,34,"11",23,0.0682,0.0485,0.0603
"12604",151351,1992,"5529",3233,2296,2231,"840",1391,0.4303,0.3659,0.4035
"12605",151360,1992,"597",386,211,26,"9",17,0.044,0.0427,0.0436
"12606",151379,1992,"638",381,257,27,"6",21,0.0551,0.0233,0.0423
"12607",151388,1992,"263",197,66,8,"2",6,0.0305,0.0303,0.0304
"12608",151777,1992,"245",120,125,109,"51",58,0.4833,0.408,0.4449
"12609",151786,1992,"244",149,95,75,"32",43,0.2886,0.3368,0.3074
"12610",152080,1992,"1879",822,1057,1631,"900",731,0.8893,0.8515,0.868
"12611",152248,1992,"985",535,450,22,"8",14,0.0262,0.0178,0.0223
"12612",152363,1992,"258",129,129,94,"40",54,0.4186,0.3101,0.3643
"12613",152530,1992,"491",256,235,324,"153",171,0.668,0.6511,0.6599
"12614",152600,1992,"601",334,267,305,"117",188,0.5629,0.4382,0.5075
"12615",153001,1992,"290",132,158,129,"56",73,0.553,0.3544,0.4448
"12616",153108,1992,"428",235,193,242,"98",144,0.6128,0.5078,0.5654
"12617",153269,1992,"838",476,362,407,"150",257,0.5399,0.4144,0.4857
"12618",153384,1992,"295",168,127,234,"101",133,0.7917,0.7953,0.7932
"12619",153603,1992,"3333",1432,1901,723,"309",414,0.2891,0.1625,0.2169
"12620",153834,1992,"579",357,222,389,"144",245,0.6863,0.6486,0.6718
"12621",154095,1992,"1659",984,675,435,"143",292,0.2967,0.2119,0.2622
"12622",155089,1992,"150",101,49,31,"6",25,0.2475,0.1224,0.2067
"12623",155317,1992,"3495",1778,1717,814,"304",510,0.2868,0.1771,0.2329
"12624",155335,1992,"83",57,26,28,"8",20,0.3509,0.3077,0.3373
"12625",155399,1992,"2778",1357,1421,484,"189",295,0.2174,0.133,0.1742
"12626",155520,1992,"217",107,110,42,"16",26,0.243,0.1455,0.1935
"12627",155627,1992,"119",43,76,24,"9",15,0.3488,0.1184,0.2017
"12628",155937,1992,"118",52,66,33,"9",24,0.4615,0.1364,0.2797
"12629",156213,1992,"268",165,103,95,"38",57,0.3455,0.3689,0.3545
"12630",156286,1992,"283",155,128,98,"40",58,0.3742,0.3125,0.3463
"12631",156295,1992,"397",206,191,148,"66",82,0.3981,0.3455,0.3728
"12632",156365,1992,"208",85,123,27,"9",18,0.2118,0.0732,0.1298
"12633",156541,1992,"332",185,147,97,"36",61,0.3297,0.2449,0.2922
"12634",156745,1992,"325",174,151,109,"37",72,0.4138,0.245,0.3354
"12635",157058,1992,"393",226,167,16,"4",12,0.0531,0.024,0.0407
"12636",157076,1992,"147",71,76,41,"13",28,0.3944,0.1711,0.2789
"12637",157085,1992,"2562",1374,1188,528,"195",333,0.2424,0.1641,0.2061
"12638",157289,1992,"1745",843,902,133,"45",88,0.1044,0.0499,0.0762
"12639",157386,1992,"1349",769,580,133,"39",94,0.1222,0.0672,0.0986
"12640",157401,1992,"982",538,444,223,"76",147,0.2732,0.1712,0.2271
"12641",157447,1992,"1359",714,645,49,"12",37,0.0518,0.0186,0.0361
"12642",157535,1992,"198",139,59,17,"8",9,0.0647,0.1356,0.0859
"12643",157951,1992,"2192",1261,931,271,"80",191,0.1515,0.0859,0.1236
"12644",158477,1992,"249",146,103,84,"38",46,0.3151,0.3689,0.3373
"12645",159009,1992,"1385",775,610,109,"30",79,0.1019,0.0492,0.0787
"12646",159391,1992,"3503",1884,1619,651,"219",432,0.2293,0.1353,0.1858
"12647",159647,1992,"1473",703,770,264,"86",178,0.2532,0.1117,0.1792
"12648",159717,1992,"1272",705,567,64,"16",48,0.0681,0.0282,0.0503
"12649",159966,1992,"1059",613,446,53,"10",43,0.0701,0.0224,0.05
"12650",160038,1992,"1227",737,490,108,"30",78,0.1058,0.0612,0.088
"12651",160612,1992,"2199",1285,914,86,"21",65,0.0506,0.023,0.0391
"12652",160621,1992,"2033",1066,967,91,"20",71,0.0666,0.0207,0.0448
"12653",160658,1992,"2563",1396,1167,77,"25",52,0.0372,0.0214,0.03
"12654",161004,1992,"409",224,185,347,"154",193,0.8616,0.8324,0.8484
"12655",161226,1992,"441",302,139,126,"31",95,0.3146,0.223,0.2857
"12656",161235,1992,"97",43,54,8,"3",5,0.1163,0.0556,0.0825
"12657",161244,1992,"139",98,41,12,"3",9,0.0918,0.0732,0.0863
"12658",161253,1992,"1413",630,783,293,"128",165,0.2619,0.1635,0.2074
"12659",161554,1992,"682",365,317,51,"17",34,0.0932,0.0536,0.0748
"12660",162007,1992,"329",199,130,35,"6",29,0.1457,0.0462,0.1064
"12661",162210,1992,"69",46,23,12,"1",11,0.2391,0.0435,0.1739
"12662",162283,1992,"350",183,167,14,"1",13,0.071,0.006,0.04
"12663",162584,1992,"839",454,385,236,"68",168,0.37,0.1766,0.2813
"12664",162654,1992,"223",155,68,131,"27",104,0.671,0.3971,0.5874
"12665",162760,1992,"150",143,7,91,"4",87,0.6084,0.5714,0.6067
"12666",162928,1992,"847",325,522,685,"402",283,0.8708,0.7701,0.8087
"12667",163046,1992,"792",452,340,565,"229",336,0.7434,0.6735,0.7134
"12668",163268,1992,"884",437,447,200,"79",121,0.2769,0.1767,0.2262
"12669",163286,1992,"3032",1470,1562,966,"379",587,0.3993,0.2426,0.3186
"12670",163453,1992,"967",572,395,168,"37",131,0.229,0.0937,0.1737
"12671",163462,1992,"346",190,156,209,"89",120,0.6316,0.5705,0.604
"12672",163851,1992,"634",372,262,264,"78",186,0.5,0.2977,0.4164
"12673",163912,1992,"234",133,101,129,"53",76,0.5714,0.5248,0.5513
"12674",164076,1992,"1336",824,512,365,"99",266,0.3228,0.1934,0.2732
"12675",164173,1992,"200",154,46,44,"7",37,0.2403,0.1522,0.22
"12676",164216,1992,"276",145,131,160,"70",90,0.6207,0.5344,0.5797
"12677",164270,1992,"300",160,140,164,"62",102,0.6375,0.4429,0.5467
"12678",164447,1992,"225",95,130,71,"38",33,0.3474,0.2923,0.3156
"12679",164492,1992,"80",48,32,35,"16",19,0.3958,0.5,0.4375
"12680",164562,1992,"446",287,159,304,"102",202,0.7038,0.6415,0.6816
"12681",165015,1992,"757",413,344,556,"250",306,0.7409,0.7267,0.7345
"12682",165024,1992,"963",567,396,213,"54",159,0.2804,0.1364,0.2212
"12683",165334,1992,"527",317,210,280,"106",174,0.5489,0.5048,0.5313
"12684",165662,1992,"408",276,132,198,"70",128,0.4638,0.5303,0.4853
"12685",165671,1992,"149",149,0,52,"0",52,0.349,NA,0.349
"12686",165820,1992,"538",297,241,128,"32",96,0.3232,0.1328,0.2379
"12687",165866,1992,"577",382,195,154,"35",119,0.3115,0.1795,0.2669
"12688",165936,1992,"292",193,99,140,"39",101,0.5233,0.3939,0.4795
"12689",166027,1992,"1603",686,917,1380,"782",598,0.8717,0.8528,0.8609
"12690",166124,1992,"765",428,337,698,"308",390,0.9112,0.9139,0.9124
"12691",166513,1992,"964",340,624,239,"134",105,0.3088,0.2147,0.2479
"12692",166629,1992,"3993",1940,2053,1329,"538",791,0.4077,0.2621,0.3328
"12693",166638,1992,"534",256,278,48,"18",30,0.1172,0.0647,0.0899
"12694",166683,1992,"1137",398,739,919,"583",336,0.8442,0.7889,0.8083
"12695",167288,1992,"203",105,98,49,"18",31,0.2952,0.1837,0.2414
"12696",167987,1992,"869",453,416,223,"75",148,0.3267,0.1803,0.2566
"12697",167996,1992,"514",314,200,387,"135",252,0.8025,0.675,0.7529
"12698",168005,1992,"382",190,192,113,"43",70,0.3684,0.224,0.2958
"12699",168148,1992,"1211",638,573,921,"426",495,0.7759,0.7435,0.7605
"12700",168254,1992,"431",182,249,145,"82",63,0.3462,0.3293,0.3364
"12701",168281,1992,"412",274,138,265,"87",178,0.6496,0.6304,0.6432
"12702",168342,1992,"518",258,260,454,"225",229,0.8876,0.8654,0.8764
"12703",168546,1992,"508",242,266,330,"173",157,0.6488,0.6504,0.6496
"12704",168786,1992,"233",162,71,50,"14",36,0.2222,0.1972,0.2146
"12705",169080,1992,"803",474,329,369,"145",224,0.4726,0.4407,0.4595
"12706",169798,1992,"2149",1200,949,174,"50",124,0.1033,0.0527,0.081
"12707",169910,1992,"2051",835,1216,57,"28",29,0.0347,0.023,0.0278
"12708",170082,1992,"1557",982,575,289,"91",198,0.2016,0.1583,0.1856
"12709",170301,1992,"687",408,279,371,"134",237,0.5809,0.4803,0.54
"12710",170532,1992,"349",201,148,193,"77",116,0.5771,0.5203,0.553
"12711",170639,1992,"482",226,256,84,"35",49,0.2168,0.1367,0.1743
"12712",170976,1992,"5006",2342,2664,3058,"1490",1568,0.6695,0.5593,0.6109
"12713",171100,1992,"6086",3320,2766,1897,"669",1228,0.3699,0.2419,0.3117
"12714",171128,1992,"1260",321,939,253,"169",84,0.2617,0.18,0.2008
"12715",171137,1992,"625",323,302,46,"18",28,0.0867,0.0596,0.0736
"12716",171146,1992,"523",317,206,45,"8",37,0.1167,0.0388,0.086
"12717",171599,1992,"139",39,100,14,"5",9,0.2308,0.05,0.1007
"12718",172051,1992,"655",360,295,42,"8",34,0.0944,0.0271,0.0641
"12719",172699,1992,"2863",1614,1249,484,"165",319,0.1976,0.1321,0.1691
"12720",173160,1992,"236",143,93,153,"54",99,0.6923,0.5806,0.6483
"12721",173258,1992,"494",249,245,402,"204",198,0.7952,0.8327,0.8138
"12722",173328,1992,"149",90,59,39,"12",27,0.3,0.2034,0.2617
"12723",173647,1992,"620",327,293,455,"224",231,0.7064,0.7645,0.7339
"12724",173902,1992,"475",258,217,332,"139",193,0.7481,0.6406,0.6989
"12725",174066,1992,"1980",905,1075,329,"137",192,0.2122,0.1274,0.1662
"12726",174233,1992,"1163",566,597,221,"95",126,0.2226,0.1591,0.19
"12727",174251,1992,"497",291,206,187,"67",120,0.4124,0.3252,0.3763
"12728",174491,1992,"308",183,125,106,"40",66,0.3607,0.32,0.3442
"12729",174792,1992,"435",0,435,236,"236",0,NA,0.5425,0.5425
"12730",174844,1992,"701",409,292,501,"192",309,0.7555,0.6575,0.7147
"12731",174899,1992,"325",240,85,126,"36",90,0.375,0.4235,0.3877
"12732",174914,1992,"798",444,354,362,"141",221,0.4977,0.3983,0.4536
"12733",175342,1992,"531",310,221,73,"16",57,0.1839,0.0724,0.1375
"12734",175421,1992,"89",52,37,22,"10",12,0.2308,0.2703,0.2472
"12735",175616,1992,"443",247,196,98,"35",63,0.2551,0.1786,0.2212
"12736",175856,1992,"906",477,429,89,"21",68,0.1426,0.049,0.0982
"12737",175980,1992,"274",143,131,167,"75",92,0.6434,0.5725,0.6095
"12738",176017,1992,"1610",810,800,460,"175",285,0.3519,0.2188,0.2857
"12739",176035,1992,"259",210,49,52,"6",46,0.219,0.1224,0.2008
"12740",176044,1992,"563",290,273,64,"26",38,0.131,0.0952,0.1137
"12741",176080,1992,"1672",760,912,316,"130",186,0.2447,0.1425,0.189
"12742",176406,1992,"325",215,110,69,"15",54,0.2512,0.1364,0.2123
"12743",176628,1992,"91",50,41,21,"10",11,0.22,0.2439,0.2308
"12744",176947,1992,"209",79,130,42,"20",22,0.2785,0.1538,0.201
"12745",176965,1992,"1763",921,842,240,"105",135,0.1466,0.1247,0.1361
"12746",177418,1992,"144",110,34,56,"5",51,0.4636,0.1471,0.3889
"12747",178059,1992,"129",93,36,70,"19",51,0.5484,0.5278,0.5426
"12748",178341,1992,"702",381,321,63,"24",39,0.1024,0.0748,0.0897
"12749",178387,1992,"794",445,349,85,"22",63,0.1416,0.063,0.1071
"12750",178396,1992,"2904",1600,1304,828,"305",523,0.3269,0.2339,0.2851
"12751",178402,1992,"480",257,223,42,"13",29,0.1128,0.0583,0.0875
"12752",178411,1992,"809",174,635,64,"40",24,0.1379,0.063,0.0791
"12753",178420,1992,"474",224,250,49,"18",31,0.1384,0.072,0.1034
"12754",178615,1992,"1384",786,598,539,"167",372,0.4733,0.2793,0.3895
"12755",179043,1992,"198",121,77,92,"30",62,0.5124,0.3896,0.4646
"12756",179159,1992,"1051",546,505,473,"187",286,0.5238,0.3703,0.45
"12757",179557,1992,"1405",806,599,236,"67",169,0.2097,0.1119,0.168
"12758",179566,1992,"2925",1621,1304,420,"110",310,0.1912,0.0844,0.1436
"12759",179867,1992,"1070",513,557,831,"421",410,0.7992,0.7558,0.7766
"12760",179894,1992,"201",114,87,68,"22",46,0.4035,0.2529,0.3383
"12761",179946,1992,"203",89,114,75,"39",36,0.4045,0.3421,0.3695
"12762",180179,1992,"285",200,85,27,"9",18,0.09,0.1059,0.0947
"12763",180461,1992,"1530",646,884,155,"65",90,0.1393,0.0735,0.1013
"12764",180522,1992,"188",98,90,20,"13",7,0.0714,0.1444,0.1064
"12765",180984,1992,"202",114,88,73,"24",49,0.4298,0.2727,0.3614
"12766",181002,1992,"843",517,326,509,"190",319,0.617,0.5828,0.6038
"12767",181020,1992,"241",125,116,136,"55",81,0.648,0.4741,0.5643
"12768",181127,1992,"254",124,130,112,"43",69,0.5565,0.3308,0.4409
"12769",181215,1992,"1322",723,599,137,"38",99,0.1369,0.0634,0.1036
"12770",181394,1992,"1256",630,626,54,"19",35,0.0556,0.0304,0.043
"12771",181446,1992,"366",212,154,174,"72",102,0.4811,0.4675,0.4754
"12772",181464,1992,"3392",1651,1741,330,"124",206,0.1248,0.0712,0.0973
"12773",181534,1992,"264",135,129,27,"9",18,0.1333,0.0698,0.1023
"12774",181783,1992,"630",348,282,117,"39",78,0.2241,0.1383,0.1857
"12775",182281,1992,"1213",641,572,128,"44",84,0.131,0.0769,0.1055
"12776",182290,1992,"1058",523,535,119,"41",78,0.1491,0.0766,0.1125
"12777",182634,1992,"160",106,54,73,"23",50,0.4717,0.4259,0.4562
"12778",182795,1992,"469",236,233,178,"82",96,0.4068,0.3519,0.3795
"12779",183062,1992,"754",447,307,179,"50",129,0.2886,0.1629,0.2374
"12780",183080,1992,"775",403,372,206,"79",127,0.3151,0.2124,0.2658
"12781",183239,1992,"493",274,219,325,"141",184,0.6715,0.6438,0.6592
"12782",183822,1992,"266",170,96,15,"6",9,0.0529,0.0625,0.0564
"12783",183974,1992,"113",86,27,19,"4",15,0.1744,0.1481,0.1681
"12784",184348,1992,"332",203,129,246,"92",154,0.7586,0.7132,0.741
"12785",184603,1992,"938",466,472,114,"53",61,0.1309,0.1123,0.1215
"12786",184612,1992,"116",103,13,16,"1",15,0.1456,0.0769,0.1379
"12787",184782,1992,"771",453,318,154,"46",108,0.2384,0.1447,0.1997
"12788",185129,1992,"663",324,339,28,"16",12,0.037,0.0472,0.0422
"12789",185572,1992,"436",230,206,94,"39",55,0.2391,0.1893,0.2156
"12790",185590,1992,"913",530,383,106,"32",74,0.1396,0.0836,0.1161
"12791",185828,1992,"501",75,426,34,"25",9,0.12,0.0587,0.0679
"12792",186131,1992,"1135",516,619,1023,"544",479,0.9283,0.8788,0.9013
"12793",186201,1992,"419",216,203,77,"25",52,0.2407,0.1232,0.1838
"12794",186283,1992,"731",402,329,305,"113",192,0.4776,0.3435,0.4172
"12795",186584,1992,"985",484,501,384,"161",223,0.4607,0.3214,0.3898
"12796",186876,1992,"720",401,319,174,"70",104,0.2594,0.2194,0.2417
"12797",187134,1992,"1068",712,356,628,"174",454,0.6376,0.4888,0.588
"12798",187444,1992,"962",536,426,94,"24",70,0.1306,0.0563,0.0977
"12799",187985,1992,"1700",946,754,148,"53",95,0.1004,0.0703,0.0871
"12800",188030,1992,"1598",830,768,152,"58",94,0.1133,0.0755,0.0951
"12801",188429,1992,"591",356,235,153,"40",113,0.3174,0.1702,0.2589
"12802",188641,1992,"300",136,164,151,"73",78,0.5735,0.4451,0.5033
"12803",190044,1992,"549",138,411,294,"210",84,0.6087,0.5109,0.5355
"12804",190099,1992,"690",368,322,589,"257",332,0.9022,0.7981,0.8536
"12805",190150,1992,"1113",458,655,880,"511",369,0.8057,0.7802,0.7907
"12806",190248,1992,"106",62,44,28,"8",20,0.3226,0.1818,0.2642
"12807",190415,1992,"2893",1382,1511,2354,"1179",1175,0.8502,0.7803,0.8137
"12808",190512,1992,"1359",830,529,52,"20",32,0.0386,0.0378,0.0383
"12809",190549,1992,"1341",765,576,122,"40",82,0.1072,0.0694,0.091
"12810",190558,1992,"1126",593,533,17,"3",14,0.0236,0.0056,0.0151
"12811",190567,1992,"1071",454,617,18,"12",6,0.0132,0.0194,0.0168
"12812",190594,1992,"936",710,226,35,"10",25,0.0352,0.0442,0.0374
"12813",190637,1992,"692",468,224,21,"6",15,0.0321,0.0268,0.0303
"12814",190664,1992,"1448",819,629,146,"35",111,0.1355,0.0556,0.1008
"12815",190691,1992,"640",392,248,22,"12",10,0.0255,0.0484,0.0344
"12816",190725,1992,"302",205,97,45,"9",36,0.1756,0.0928,0.149
"12817",191241,1992,"1039",546,493,623,"294",329,0.6026,0.5963,0.5996
"12818",191515,1992,"461",223,238,373,"178",195,0.8744,0.7479,0.8091
"12819",191533,1992,"446",228,218,248,"108",140,0.614,0.4954,0.5561
"12820",191630,1992,"564",261,303,349,"167",182,0.6973,0.5512,0.6188
"12821",191649,1992,"1403",769,634,571,"196",375,0.4876,0.3091,0.407
"12822",191676,1992,"296",195,101,141,"44",97,0.4974,0.4356,0.4764
"12823",191931,1992,"1012",522,490,322,"136",186,0.3563,0.2776,0.3182
"12824",191968,1992,"1566",832,734,978,"425",553,0.6647,0.579,0.6245
"12825",192192,1992,"160",121,39,53,"12",41,0.3388,0.3077,0.3312
"12826",192323,1992,"371",215,156,254,"105",149,0.693,0.6731,0.6846
"12827",192439,1992,"837",552,285,34,"15",19,0.0344,0.0526,0.0406
"12828",192703,1992,"577",250,327,244,"120",124,0.496,0.367,0.4229
"12829",192749,1992,"183",139,44,106,"23",83,0.5971,0.5227,0.5792
"12830",192819,1992,"820",451,369,514,"201",313,0.694,0.5447,0.6268
"12831",192925,1992,"185",86,99,21,"4",17,0.1977,0.0404,0.1135
"12832",193016,1992,"867",534,333,19,"7",12,0.0225,0.021,0.0219
"12833",193292,1992,"1417",1055,362,65,"7",58,0.055,0.0193,0.0459
"12834",193353,1992,"254",180,74,97,"25",72,0.4,0.3378,0.3819
"12835",193399,1992,"185",153,32,88,"12",76,0.4967,0.375,0.4757
"12836",193584,1992,"211",159,52,129,"24",105,0.6604,0.4615,0.6114
"12837",193645,1992,"935",777,158,85,"7",78,0.1004,0.0443,0.0909
"12838",193654,1992,"423",275,148,155,"41",114,0.4145,0.277,0.3664
"12839",193900,1992,"2669",1511,1158,1355,"571",784,0.5189,0.4931,0.5077
"12840",193973,1992,"517",334,183,184,"60",124,0.3713,0.3279,0.3559
"12841",194161,1992,"104",60,44,37,"14",23,0.3833,0.3182,0.3558
"12842",194310,1992,"543",357,186,151,"42",109,0.3053,0.2258,0.2781
"12843",194824,1992,"1083",216,867,483,"368",115,0.5324,0.4245,0.446
"12844",195003,1992,"1482",432,1050,323,"172",151,0.3495,0.1638,0.2179
"12845",195030,1992,"1266",585,681,824,"425",399,0.6821,0.6241,0.6509
"12846",195164,1992,"441",216,225,226,"93",133,0.6157,0.4133,0.5125
"12847",195173,1992,"372",200,172,63,"26",37,0.185,0.1512,0.1694
"12848",195216,1992,"601",294,307,413,"207",206,0.7007,0.6743,0.6872
"12849",195234,1992,"233",177,56,122,"21",101,0.5706,0.375,0.5236
"12850",195243,1992,"214",125,89,53,"9",44,0.352,0.1011,0.2477
"12851",195304,1992,"220",168,52,127,"30",97,0.5774,0.5769,0.5773
"12852",195474,1992,"544",315,229,399,"153",246,0.781,0.6681,0.7335
"12853",195526,1992,"615",369,246,425,"144",281,0.7615,0.5854,0.6911
"12854",195544,1992,"55",42,13,32,"7",25,0.5952,0.5385,0.5818
"12855",195809,1992,"2326",1211,1115,526,"223",303,0.2502,0.2,0.2261
"12856",196413,1992,"2581",1329,1252,1465,"628",837,0.6298,0.5016,0.5676
"12857",196592,1992,"1037",676,361,63,"14",49,0.0725,0.0388,0.0608
"12858",197045,1992,"323",183,140,90,"37",53,0.2896,0.2643,0.2786
"12859",197133,1992,"597",370,227,478,"175",303,0.8189,0.7709,0.8007
"12860",197869,1992,"2060",1146,914,621,"215",406,0.3543,0.2352,0.3015
"12861",197984,1992,"145",67,78,42,"22",20,0.2985,0.2821,0.2897
"12862",198385,1992,"414",221,193,367,"170",197,0.8914,0.8808,0.8865
"12863",198464,1992,"2880",1673,1207,561,"166",395,0.2361,0.1375,0.1948
"12864",198507,1992,"541",317,224,181,"47",134,0.4227,0.2098,0.3346
"12865",198516,1992,"817",470,347,455,"175",280,0.5957,0.5043,0.5569
"12866",198835,1992,"255",162,93,104,"30",74,0.4568,0.3226,0.4078
"12867",198969,1992,"290",98,192,54,"36",18,0.1837,0.1875,0.1862
"12868",199102,1992,"1484",780,704,290,"86",204,0.2615,0.1222,0.1954
"12869",199111,1992,"364",195,169,101,"33",68,0.3487,0.1953,0.2775
"12870",199120,1992,"3200",1957,1243,2009,"733",1276,0.652,0.5897,0.6278
"12871",199139,1992,"1575",813,762,291,"111",180,0.2214,0.1457,0.1848
"12872",199148,1992,"1509",1000,509,363,"80",283,0.283,0.1572,0.2406
"12873",199157,1992,"759",452,307,134,"30",104,0.2301,0.0977,0.1765
"12874",199193,1992,"3176",1219,1957,759,"338",421,0.3454,0.1727,0.239
"12875",199218,1992,"1225",771,454,320,"95",225,0.2918,0.2093,0.2612
"12876",199281,1992,"417",199,218,68,"26",42,0.2111,0.1193,0.1631
"12877",199306,1992,"147",66,81,45,"18",27,0.4091,0.2222,0.3061
"12878",199412,1992,"127",95,32,45,"8",37,0.3895,0.25,0.3543
"12879",199582,1992,"401",232,169,61,"14",47,0.2026,0.0828,0.1521
"12880",199643,1992,"740",428,312,124,"33",91,0.2126,0.1058,0.1676
"12881",199847,1992,"909",445,464,639,"300",339,0.7618,0.6466,0.703
"12882",199962,1992,"365",179,186,84,"36",48,0.2682,0.1935,0.2301
"12883",199999,1992,"391",267,124,83,"20",63,0.236,0.1613,0.2123
"12884",200004,1992,"1065",543,522,208,"76",132,0.2431,0.1456,0.1953
"12885",200059,1992,"336",191,145,32,"9",23,0.1204,0.0621,0.0952
"12886",200156,1992,"292",140,152,86,"27",59,0.4214,0.1776,0.2945
"12887",200217,1992,"343",205,138,104,"30",74,0.361,0.2174,0.3032
"12888",200226,1992,"165",86,79,15,"5",10,0.1163,0.0633,0.0909
"12889",200253,1992,"624",398,226,30,"6",24,0.0603,0.0265,0.0481
"12890",200280,1992,"1579",724,855,189,"87",102,0.1409,0.1018,0.1197
"12891",200332,1992,"1550",674,876,155,"68",87,0.1291,0.0776,0.1
"12892",200572,1992,"193",90,103,28,"12",16,0.1778,0.1165,0.1451
"12893",201104,1992,"650",307,343,172,"69",103,0.3355,0.2012,0.2646
"12894",201371,1992,"181",104,77,92,"39",53,0.5096,0.5065,0.5083
"12895",201548,1992,"330",213,117,163,"56",107,0.5023,0.4786,0.4939
"12896",201645,1992,"762",321,441,350,"152",198,0.6168,0.3447,0.4593
"12897",201690,1992,"665",319,346,42,"12",30,0.094,0.0347,0.0632
"12898",202134,1992,"868",409,459,55,"21",34,0.0831,0.0458,0.0634
"12899",202480,1992,"1622",778,844,832,"343",489,0.6285,0.4064,0.5129
"12900",202523,1992,"570",301,269,392,"174",218,0.7243,0.6468,0.6877
"12901",202763,1992,"412",197,215,153,"62",91,0.4619,0.2884,0.3714
"12902",203085,1992,"229",88,141,86,"46",40,0.4545,0.3262,0.3755
"12903",203128,1992,"277",134,143,116,"116",0,0,0.8112,0.4188
"12904",203368,1992,"748",395,353,452,"184",268,0.6785,0.5212,0.6043
"12905",203517,1992,"2581",1580,1001,508,"135",373,0.2361,0.1349,0.1968
"12906",203535,1992,"413",218,195,319,"147",172,0.789,0.7538,0.7724
"12907",203580,1992,"36",29,7,14,"1",13,0.4483,0.1429,0.3889
"12908",203775,1992,"363",236,127,114,"33",81,0.3432,0.2598,0.314
"12909",203845,1992,"370",150,220,165,"82",83,0.5533,0.3727,0.4459
"12910",204024,1992,"2985",1653,1332,1815,"700",1115,0.6745,0.5255,0.608
"12911",204185,1992,"380",178,202,170,"73",97,0.5449,0.3614,0.4474
"12912",204194,1992,"283",168,115,86,"36",50,0.2976,0.313,0.3039
"12913",204617,1992,"208",121,87,56,"19",37,0.3058,0.2184,0.2692
"12914",204796,1992,"5389",2625,2764,1024,"351",673,0.2564,0.127,0.19
"12915",204857,1992,"3235",1952,1283,1396,"427",969,0.4964,0.3328,0.4315
"12916",206330,1992,"148",48,100,15,"7",8,0.1667,0.07,0.1014
"12917",206589,1992,"459",240,219,273,"118",155,0.6458,0.5388,0.5948
"12918",206604,1992,"1941",1028,913,159,"42",117,0.1138,0.046,0.0819
"12919",206622,1992,"672",331,341,345,"166",179,0.5408,0.4868,0.5134
"12920",206695,1992,"1908",962,946,129,"59",70,0.0728,0.0624,0.0676
"12921",206914,1992,"577",323,254,27,"6",21,0.065,0.0236,0.0468
"12922",207209,1992,"411",215,196,23,"4",19,0.0884,0.0204,0.056
"12923",207306,1992,"317",164,153,36,"13",23,0.1402,0.085,0.1136
"12924",207324,1992,"355",183,172,97,"41",56,0.306,0.2384,0.2732
"12925",207388,1992,"2148",1116,1032,400,"130",270,0.2419,0.126,0.1862
"12926",207500,1992,"2376",1164,1212,264,"110",154,0.1323,0.0908,0.1111
"12927",207722,1992,"219",151,68,33,"10",23,0.1523,0.1471,0.1507
"12928",207847,1992,"503",287,216,60,"19",41,0.1429,0.088,0.1193
"12929",207865,1992,"945",534,411,79,"21",58,0.1086,0.0511,0.0836
"12930",208822,1992,"282",176,106,134,"52",82,0.4659,0.4906,0.4752
"12931",209056,1992,"395",235,160,221,"78",143,0.6085,0.4875,0.5595
"12932",209065,1992,"428",265,163,234,"68",166,0.6264,0.4172,0.5467
"12933",209542,1992,"1703",771,932,442,"179",263,0.3411,0.1921,0.2595
"12934",209551,1992,"2279",1179,1100,808,"315",493,0.4182,0.2864,0.3545
"12935",209612,1992,"226",142,84,103,"39",64,0.4507,0.4643,0.4558
"12936",209807,1992,"651",343,308,94,"42",52,0.1516,0.1364,0.1444
"12937",209922,1992,"310",173,137,148,"58",90,0.5202,0.4234,0.4774
"12938",210146,1992,"588",301,287,63,"24",39,0.1296,0.0836,0.1071
"12939",210401,1992,"385",231,154,256,"103",153,0.6623,0.6688,0.6649
"12940",210429,1992,"626",394,232,112,"36",76,0.1929,0.1552,0.1789
"12941",210571,1992,"310",135,175,160,"81",79,0.5852,0.4629,0.5161
"12942",210669,1992,"471",251,220,295,"114",181,0.7211,0.5182,0.6263
"12943",210775,1992,"182",103,79,26,"7",19,0.1845,0.0886,0.1429
"12944",211088,1992,"163",120,43,81,"15",66,0.55,0.3488,0.4969
"12945",211158,1992,"1047",696,351,423,"87",336,0.4828,0.2479,0.404
"12946",211291,1992,"890",426,464,739,"376",363,0.8521,0.8103,0.8303
"12947",211352,1992,"161",115,46,91,"24",67,0.5826,0.5217,0.5652
"12948",211361,1992,"962",436,526,139,"45",94,0.2156,0.0856,0.1445
"12949",211431,1992,"159",148,11,50,"2",48,0.3243,0.1818,0.3145
"12950",211440,1992,"1141",354,787,666,"440",226,0.6384,0.5591,0.5837
"12951",211468,1992,"187",186,1,74,"0",74,0.3978,0,0.3957
"12952",211556,1992,"89",89,0,42,"0",42,0.4719,NA,0.4719
"12953",211583,1992,"145",145,0,76,"0",76,0.5241,NA,0.5241
"12954",211608,1992,"375",184,191,19,"2",17,0.0924,0.0105,0.0507
"12955",211644,1992,"1093",679,414,246,"60",186,0.2739,0.1449,0.2251
"12956",211981,1992,"347",146,201,132,"61",71,0.4863,0.3035,0.3804
"12957",212009,1992,"569",342,227,428,"178",250,0.731,0.7841,0.7522
"12958",212054,1992,"1054",340,714,94,"30",64,0.1882,0.042,0.0892
"12959",212106,1992,"1026",588,438,441,"165",276,0.4694,0.3767,0.4298
"12960",212115,1992,"628",368,260,143,"39",104,0.2826,0.15,0.2277
"12961",212133,1992,"183",130,53,82,"20",62,0.4769,0.3774,0.4481
"12962",212160,1992,"1500",857,643,257,"75",182,0.2124,0.1166,0.1713
"12963",212197,1992,"442",318,124,256,"52",204,0.6415,0.4194,0.5792
"12964",212577,1992,"486",222,264,351,"182",169,0.7613,0.6894,0.7222
"12965",212601,1992,"406",244,162,152,"54",98,0.4016,0.3333,0.3744
"12966",212832,1992,"89",72,17,34,"2",32,0.4444,0.1176,0.382
"12967",212911,1992,"301",145,156,253,"132",121,0.8345,0.8462,0.8405
"12968",213020,1992,"2423",1423,1000,665,"197",468,0.3289,0.197,0.2745
"12969",213251,1992,"258",132,126,161,"68",93,0.7045,0.5397,0.624
"12970",213321,1992,"467",213,254,310,"159",151,0.7089,0.626,0.6638
"12971",213349,1992,"1131",632,499,188,"40",148,0.2342,0.0802,0.1662
"12972",213358,1992,"118",84,34,33,"6",27,0.3214,0.1765,0.2797
"12973",213367,1992,"564",293,271,358,"159",199,0.6792,0.5867,0.6348
"12974",213385,1992,"575",263,312,455,"231",224,0.8517,0.7404,0.7913
"12975",213507,1992,"280",123,157,161,"84",77,0.626,0.535,0.575
"12976",213543,1992,"1089",385,704,720,"430",290,0.7532,0.6108,0.6612
"12977",213613,1992,"906",514,392,210,"61",149,0.2899,0.1556,0.2318
"12978",213668,1992,"359",179,180,174,"72",102,0.5698,0.4,0.4847
"12979",213783,1992,"485",294,191,148,"44",104,0.3537,0.2304,0.3052
"12980",213826,1992,"239",193,46,81,"5",76,0.3938,0.1087,0.3389
"12981",213996,1992,"568",357,211,376,"142",234,0.6555,0.673,0.662
"12982",214041,1992,"1002",635,367,375,"93",282,0.4441,0.2534,0.3743
"12983",214069,1992,"292",228,64,88,"20",68,0.2982,0.3125,0.3014
"12984",214157,1992,"296",142,154,187,"86",101,0.7113,0.5584,0.6318
"12985",214175,1992,"466",244,222,334,"141",193,0.791,0.6351,0.7167
"12986",214272,1992,"63",47,16,29,"8",21,0.4468,0.5,0.4603
"12987",214777,1992,"4227",1995,2232,2529,"1163",1366,0.6847,0.5211,0.5983
"12988",215062,1992,"2259",977,1282,1789,"972",817,0.8362,0.7582,0.7919
"12989",215743,1992,"297",145,152,121,"58",63,0.4345,0.3816,0.4074
"12990",215798,1992,"267",152,115,148,"50",98,0.6447,0.4348,0.5543
"12991",215929,1992,"898",495,403,605,"262",343,0.6929,0.6501,0.6737
"12992",216010,1992,"1238",675,563,441,"156",285,0.4222,0.2771,0.3562
"12993",216038,1992,"1164",658,506,242,"95",147,0.2234,0.1877,0.2079
"12994",216287,1992,"353",172,181,285,"143",142,0.8256,0.7901,0.8074
"12995",216339,1992,"2029",1068,961,337,"124",213,0.1994,0.129,0.1661
"12996",216524,1992,"403",199,204,285,"131",154,0.7739,0.6422,0.7072
"12997",216694,1992,"346",178,168,158,"65",93,0.5225,0.3869,0.4566
"12998",216764,1992,"1378",883,495,357,"90",267,0.3024,0.1818,0.2591
"12999",216807,1992,"362",213,149,227,"89",138,0.6479,0.5973,0.6271
"13000",216852,1992,"436",169,267,140,"66",74,0.4379,0.2472,0.3211
"13001",216931,1992,"404",164,240,153,"73",80,0.4878,0.3042,0.3787
"13002",217059,1992,"691",414,277,263,"87",176,0.4251,0.3141,0.3806
"13003",217156,1992,"1406",711,695,1121,"553",568,0.7989,0.7957,0.7973
"13004",217402,1992,"931",523,408,734,"322",412,0.7878,0.7892,0.7884
"13005",217536,1992,"381",264,117,208,"58",150,0.5682,0.4957,0.5459
"13006",217776,1992,"88",54,34,26,"6",20,0.3704,0.1765,0.2955
"13007",217819,1992,"1296",853,443,426,"100",326,0.3822,0.2257,0.3287
"13008",217882,1992,"2484",1179,1305,910,"330",580,0.4919,0.2529,0.3663
"13009",217998,1992,"185",98,87,110,"52",58,0.5918,0.5977,0.5946
"13010",218061,1992,"875",487,388,110,"42",68,0.1396,0.1082,0.1257
"13011",218229,1992,"402",273,129,65,"16",49,0.1795,0.124,0.1617
"13012",218238,1992,"115",48,67,9,"4",5,0.1042,0.0597,0.0783
"13013",218399,1992,"293",177,116,40,"16",24,0.1356,0.1379,0.1365
"13014",218414,1992,"177",82,95,36,"16",20,0.2439,0.1684,0.2034
"13015",218663,1992,"2460",1312,1148,643,"257",386,0.2942,0.2239,0.2614
"13016",218724,1992,"591",305,286,71,"17",54,0.177,0.0594,0.1201
"13017",218733,1992,"701",366,335,89,"25",64,0.1749,0.0746,0.127
"13018",218742,1992,"399",240,159,56,"16",40,0.1667,0.1006,0.1404
"13019",218973,1992,"287",132,155,206,"113",93,0.7045,0.729,0.7178
"13020",219000,1992,"347",228,119,162,"48",114,0.5,0.4034,0.4669
"13021",219046,1992,"1056",597,459,226,"79",147,0.2462,0.1721,0.214
"13022",219082,1992,"234",123,111,26,"12",14,0.1138,0.1081,0.1111
"13023",219198,1992,"107",72,35,31,"9",22,0.3056,0.2571,0.2897
"13024",219259,1992,"587",313,274,60,"20",40,0.1278,0.073,0.1022
"13025",219356,1992,"1495",701,794,293,"112",181,0.2582,0.1411,0.196
"13026",219471,1992,"1228",686,542,239,"79",160,0.2332,0.1458,0.1946
"13027",219602,1992,"752",471,281,164,"46",118,0.2505,0.1637,0.2181
"13028",219709,1992,"285",158,127,93,"41",52,0.3291,0.3228,0.3263
"13029",219718,1992,"104",65,39,12,"6",6,0.0923,0.1538,0.1154
"13030",219949,1992,"173",80,93,40,"18",22,0.275,0.1935,0.2312
"13031",220075,1992,"1610",971,639,150,"37",113,0.1164,0.0579,0.0932
"13032",220215,1992,"286",156,130,92,"32",60,0.3846,0.2462,0.3217
"13033",220613,1992,"359",207,152,63,"20",43,0.2077,0.1316,0.1755
"13034",220631,1992,"328",207,121,127,"47",80,0.3865,0.3884,0.3872
"13035",220710,1992,"194",94,100,67,"23",44,0.4681,0.23,0.3454
"13036",221351,1992,"360",202,158,256,"113",143,0.7079,0.7152,0.7111
"13037",221519,1992,"338",171,167,230,"111",119,0.6959,0.6647,0.6805
"13038",221731,1992,"74",20,54,13,"3",10,0.5,0.0556,0.1757
"13039",221847,1992,"1381",584,797,267,"113",154,0.2637,0.1418,0.1933
"13040",221892,1992,"180",96,84,27,"10",17,0.1771,0.119,0.15
"13041",222178,1992,"672",323,349,168,"66",102,0.3158,0.1891,0.25
"13042",222983,1992,"289",144,145,165,"76",89,0.6181,0.5241,0.5709
"13043",223232,1992,"2363",1400,963,930,"336",594,0.4243,0.3489,0.3936
"13044",224004,1992,"115",65,50,16,"2",14,0.2154,0.04,0.1391
"13045",224323,1992,"251",137,114,114,"42",72,0.5255,0.3684,0.4542
"13046",225432,1992,"540",275,265,3,"1",2,0.0073,0.0038,0.0056
"13047",225548,1992,"265",123,142,60,"31",29,0.2358,0.2183,0.2264
"13048",225627,1992,"310",224,86,33,"4",29,0.1295,0.0465,0.1065
"13049",226231,1992,"182",26,156,37,"30",7,0.2692,0.1923,0.2033
"13050",226833,1992,"641",313,328,43,"16",27,0.0863,0.0488,0.0671
"13051",227216,1992,"1794",1014,780,191,"41",150,0.1479,0.0526,0.1065
"13052",227331,1992,"315",241,74,40,"8",32,0.1328,0.1081,0.127
"13053",227526,1992,"1194",579,615,261,"97",164,0.2832,0.1577,0.2186
"13054",227757,1992,"598",266,332,437,"221",216,0.812,0.6657,0.7308
"13055",227845,1992,"337",196,141,57,"27",30,0.1531,0.1915,0.1691
"13056",227863,1992,"173",123,50,2,"0",2,0.0163,0,0.0116
"13057",228042,1992,"140",75,65,12,"3",9,0.12,0.0462,0.0857
"13058",228149,1992,"491",285,206,139,"43",96,0.3368,0.2087,0.2831
"13059",228246,1992,"1221",634,587,663,"274",389,0.6136,0.4668,0.543
"13060",228343,1992,"317",176,141,175,"62",113,0.642,0.4397,0.5521
"13061",228431,1992,"2183",1255,928,332,"95",237,0.1888,0.1024,0.1521
"13062",228459,1992,"2310",1372,938,229,"59",170,0.1239,0.0629,0.0991
"13063",228501,1992,"278",124,154,17,"6",11,0.0887,0.039,0.0612
"13064",228529,1992,"942",428,514,69,"28",41,0.0958,0.0545,0.0732
"13065",228705,1992,"987",484,503,72,"20",52,0.1074,0.0398,0.0729
"13066",228723,1992,"5968",2872,3096,2475,"953",1522,0.5299,0.3078,0.4147
"13067",228769,1992,"1523",724,799,105,"39",66,0.0912,0.0488,0.0689
"13068",228778,1992,"5633",2670,2963,1696,"691",1005,0.3764,0.2332,0.3011
"13069",228787,1992,"93",34,59,21,"9",12,0.3529,0.1525,0.2258
"13070",228796,1992,"1846",989,857,38,"18",20,0.0202,0.021,0.0206
"13071",228875,1992,"1261",746,515,506,"161",345,0.4625,0.3126,0.4013
"13072",228981,1992,"251",148,103,65,"22",43,0.2905,0.2136,0.259
"13073",229018,1992,"71",46,25,6,"3",3,0.0652,0.12,0.0845
"13074",229027,1992,"1558",834,724,120,"38",82,0.0983,0.0525,0.077
"13075",229115,1992,"2823",1418,1405,528,"195",333,0.2348,0.1388,0.187
"13076",229780,1992,"133",84,49,20,"7",13,0.1548,0.1429,0.1504
"13077",229814,1992,"848",421,427,98,"27",71,0.1686,0.0632,0.1156
"13078",230603,1992,"649",421,228,84,"18",66,0.1568,0.0789,0.1294
"13079",230728,1992,"1237",847,390,186,"31",155,0.183,0.0795,0.1504
"13080",230764,1992,"2026",996,1030,304,"119",185,0.1857,0.1155,0.15
"13081",230782,1992,"1211",729,482,52,"15",37,0.0508,0.0311,0.0429
"13082",231059,1992,"414",211,203,277,"121",156,0.7393,0.5961,0.6691
"13083",231174,1992,"1796",978,818,944,"378",566,0.5787,0.4621,0.5256
"13084",231420,1992,"104",62,42,25,"6",19,0.3065,0.1429,0.2404
"13085",231554,1992,"150",72,78,49,"29",20,0.2778,0.3718,0.3267
"13086",231624,1992,"1202",680,522,954,"386",568,0.8353,0.7395,0.7937
"13087",231712,1992,"478",300,178,44,"10",34,0.1133,0.0562,0.0921
"13088",232025,1992,"188",79,109,61,"25",36,0.4557,0.2294,0.3245
"13089",232043,1992,"205",117,88,87,"31",56,0.4786,0.3523,0.4244
"13090",232089,1992,"337",130,207,78,"46",32,0.2462,0.2222,0.2315
"13091",232186,1992,"1732",981,751,467,"146",321,0.3272,0.1944,0.2696
"13092",232265,1992,"1139",675,464,364,"80",284,0.4207,0.1724,0.3196
"13093",232423,1992,"2038",1171,867,1075,"361",714,0.6097,0.4164,0.5275
"13094",232557,1992,"766",369,397,156,"81",75,0.2033,0.204,0.2037
"13095",232566,1992,"687",473,214,268,"50",218,0.4609,0.2336,0.3901
"13096",232609,1992,"416",248,168,177,"52",125,0.504,0.3095,0.4255
"13097",232681,1992,"698",474,224,448,"132",316,0.6667,0.5893,0.6418
"13098",232706,1992,"212",165,47,77,"19",58,0.3515,0.4043,0.3632
"13099",232937,1992,"1492",893,599,76,"24",52,0.0582,0.0401,0.0509
"13100",232982,1992,"1491",764,727,158,"50",108,0.1414,0.0688,0.106
"13101",233277,1992,"1807",1128,679,445,"99",346,0.3067,0.1458,0.2463
"13102",233374,1992,"749",361,388,576,"294",282,0.7812,0.7577,0.769
"13103",233426,1992,"422",259,163,222,"65",157,0.6062,0.3988,0.5261
"13104",233541,1992,"221",141,80,46,"16",30,0.2128,0.2,0.2081
"13105",233897,1992,"232",110,122,41,"14",27,0.2455,0.1148,0.1767
"13106",233921,1992,"3851",1639,2212,1386,"603",783,0.4777,0.2726,0.3599
"13107",234030,1992,"1460",877,583,270,"92",178,0.203,0.1578,0.1849
"13108",234085,1992,"349",0,349,174,"174",0,NA,0.4986,0.4986
"13109",234155,1992,"911",496,415,46,"11",35,0.0706,0.0265,0.0505
"13110",234164,1992,"449",238,211,45,"12",33,0.1387,0.0569,0.1002
"13111",235097,1992,"753",480,273,124,"38",86,0.1792,0.1392,0.1647
"13112",235167,1992,"399",239,160,116,"39",77,0.3222,0.2438,0.2907
"13113",236230,1992,"500",295,205,214,"69",145,0.4915,0.3366,0.428
"13114",236328,1992,"725",446,279,433,"166",267,0.5987,0.595,0.5972
"13115",236577,1992,"380",253,127,103,"24",79,0.3123,0.189,0.2711
"13116",236595,1992,"439",236,203,161,"74",87,0.3686,0.3645,0.3667
"13117",236896,1992,"267",126,141,58,"27",31,0.246,0.1915,0.2172
"13118",236939,1992,"2027",1019,1008,527,"212",315,0.3091,0.2103,0.26
"13119",236948,1992,"3509",1769,1740,1315,"517",798,0.4511,0.2971,0.3748
"13120",237011,1992,"1455",883,572,341,"98",243,0.2752,0.1713,0.2344
"13121",237057,1992,"336",167,169,218,"104",114,0.6826,0.6154,0.6488
"13122",237066,1992,"266",151,115,113,"44",69,0.457,0.3826,0.4248
"13123",237215,1992,"371",192,179,9,"4",5,0.026,0.0223,0.0243
"13124",237330,1992,"393",233,160,50,"9",41,0.176,0.0562,0.1272
"13125",237358,1992,"201",108,93,49,"22",27,0.25,0.2366,0.2438
"13126",237367,1992,"1107",578,529,66,"18",48,0.083,0.034,0.0596
"13127",237792,1992,"490",270,220,3,"0",3,0.0111,0,0.0061
"13128",237899,1992,"400",188,212,17,"7",10,0.0532,0.033,0.0425
"13129",237932,1992,"488",263,225,104,"29",75,0.2852,0.1289,0.2131
"13130",237969,1992,"467",223,244,173,"72",101,0.4529,0.2951,0.3704
"13131",238032,1992,"2978",1444,1534,766,"296",470,0.3255,0.193,0.2572
"13132",238333,1992,"306",159,147,171,"68",103,0.6478,0.4626,0.5588
"13133",238430,1992,"199",133,66,20,"10",10,0.0752,0.1515,0.1005
"13134",238458,1992,"298",193,105,93,"27",66,0.342,0.2571,0.3121
"13135",238476,1992,"406",233,173,196,"80",116,0.4979,0.4624,0.4828
"13136",238616,1992,"183",103,80,69,"31",38,0.3689,0.3875,0.377
"13137",238661,1992,"131",90,41,25,"7",18,0.2,0.1707,0.1908
"13138",239080,1992,"190",125,65,52,"14",38,0.304,0.2154,0.2737
"13139",239105,1992,"1651",846,805,804,"322",482,0.5697,0.4,0.487
"13140",239628,1992,"180",92,88,88,"32",56,0.6087,0.3636,0.4889
"13141",239716,1992,"496",275,221,328,"142",186,0.6764,0.6425,0.6613
"13142",240107,1992,"218",151,67,61,"12",49,0.3245,0.1791,0.2798
"13143",240189,1992,"1746",933,813,204,"68",136,0.1458,0.0836,0.1168
"13144",240277,1992,"780",487,293,85,"22",63,0.1294,0.0751,0.109
"13145",240329,1992,"1486",921,565,161,"42",119,0.1292,0.0743,0.1083
"13146",240338,1992,"77",45,32,22,"7",15,0.3333,0.2188,0.2857
"13147",240365,1992,"1461",834,627,172,"32",140,0.1679,0.051,0.1177
"13148",240374,1992,"633",321,312,32,"14",18,0.0561,0.0449,0.0506
"13149",240417,1992,"988",530,458,114,"25",89,0.1679,0.0546,0.1154
"13150",240426,1992,"350",189,161,35,"14",21,0.1111,0.087,0.1
"13151",240444,1992,"4390",2244,2146,1514,"599",915,0.4078,0.2791,0.3449
"13152",240453,1992,"1187",566,621,113,"40",73,0.129,0.0644,0.0952
"13153",240462,1992,"878",304,574,98,"48",50,0.1645,0.0836,0.1116
"13154",240471,1992,"1009",543,466,151,"68",83,0.1529,0.1459,0.1497
"13155",240480,1992,"1388",772,616,229,"61",168,0.2176,0.099,0.165
"13156",240727,1992,"1281",640,641,221,"73",148,0.2312,0.1139,0.1725
"13157",243443,1992,"584",396,188,47,"7",40,0.101,0.0372,0.0805
"13158",243780,1992,"5583",2396,3187,1589,"761",828,0.3456,0.2388,0.2846
"13159",100654,1991,"1010",527,483,152,"32",120,0.2277,0.0663,0.1505
"13160",100663,1991,"937",500,437,82,"33",49,0.098,0.0755,0.0875
"13161",100751,1991,"2511",1348,1163,630,"213",417,0.3093,0.1831,0.2509
"13162",100858,1991,"3024",1496,1528,846,"312",534,0.357,0.2042,0.2798
"13163",101435,1991,"189",101,88,60,"25",35,0.3465,0.2841,0.3175
"13164",101480,1991,"1100",567,533,109,"42",67,0.1182,0.0788,0.0991
"13165",101675,1991,"365",144,221,73,"41",32,0.2222,0.1855,0.2
"13166",101879,1991,"755",387,368,66,"23",43,0.1111,0.0625,0.0874
"13167",102049,1991,"569",337,232,217,"89",128,0.3798,0.3836,0.3814
"13168",102094,1991,"1245",653,592,117,"32",85,0.1302,0.0541,0.094
"13169",102234,1991,"279",158,121,106,"42",64,0.4051,0.3471,0.3799
"13170",102368,1991,"793",437,356,205,"70",135,0.3089,0.1966,0.2585
"13171",102377,1991,"837",469,368,167,"70",97,0.2068,0.1902,0.1995
"13172",104151,1991,"2447",1214,1233,442,"174",268,0.2208,0.1411,0.1806
"13173",104179,1991,"3970",2063,1907,786,"297",489,0.237,0.1557,0.198
"13174",105330,1991,"1881",1064,817,294,"97",197,0.1852,0.1187,0.1563
"13175",106245,1991,"941",536,405,45,"14",31,0.0578,0.0346,0.0478
"13176",106342,1991,"121",79,42,48,"17",31,0.3924,0.4048,0.3967
"13177",106397,1991,"2327",1080,1247,381,"170",211,0.1954,0.1363,0.1637
"13178",106412,1991,"650",393,257,55,"15",40,0.1018,0.0584,0.0846
"13179",106458,1991,"1521",833,688,147,"44",103,0.1236,0.064,0.0966
"13180",106467,1991,"761",403,358,103,"32",71,0.1762,0.0894,0.1353
"13181",106485,1991,"478",256,222,33,"13",20,0.0781,0.0586,0.069
"13182",106704,1991,"1961",1129,832,171,"46",125,0.1107,0.0553,0.0872
"13183",107044,1991,"673",383,290,192,"65",127,0.3316,0.2241,0.2853
"13184",107080,1991,"281",146,135,141,"67",74,0.5068,0.4963,0.5018
"13185",107141,1991,"219",123,96,65,"29",36,0.2927,0.3021,0.2968
"13186",107512,1991,"338",182,156,115,"44",71,0.3901,0.2821,0.3402
"13187",107558,1991,"90",52,38,9,"4",5,0.0962,0.1053,0.1
"13188",110097,1991,"391",256,135,155,"45",110,0.4297,0.3333,0.3964
"13189",110404,1991,"225",73,152,146,"99",47,0.6438,0.6513,0.6489
"13190",110422,1991,"1526",717,809,121,"36",85,0.1185,0.0445,0.0793
"13191",110486,1991,"363",200,163,26,"16",10,0.05,0.0982,0.0716
"13192",110495,1991,"273",164,109,39,"8",31,0.189,0.0734,0.1429
"13193",110510,1991,"815",505,310,58,"17",41,0.0812,0.0548,0.0712
"13194",110529,1991,"1583",650,933,96,"28",68,0.1046,0.03,0.0606
"13195",110538,1991,"1284",731,553,171,"35",136,0.186,0.0633,0.1332
"13196",110547,1991,"337",227,110,9,"2",7,0.0308,0.0182,0.0267
"13197",110556,1991,"1648",902,746,173,"61",112,0.1242,0.0818,0.105
"13198",110565,1991,"1847",1094,753,137,"30",107,0.0978,0.0398,0.0742
"13199",110574,1991,"649",445,204,87,"22",65,0.1461,0.1078,0.1341
"13200",110583,1991,"2142",1283,859,88,"25",63,0.0491,0.0291,0.0411
"13201",110592,1991,"1491",938,553,41,"9",32,0.0341,0.0163,0.0275
"13202",110617,1991,"1210",694,516,108,"28",80,0.1153,0.0543,0.0893
"13203",113698,1991,"66",50,16,22,"3",19,0.38,0.1875,0.3333
"13204",115755,1991,"862",468,394,61,"19",42,0.0897,0.0482,0.0708
"13205",119173,1991,"190",190,0,32,"0",32,0.1684,NA,0.1684
"13206",120184,1991,"71",51,20,25,"6",19,0.3725,0.3,0.3521
"13207",121309,1991,"317",194,123,103,"34",69,0.3557,0.2764,0.3249
"13208",121345,1991,"359",164,195,294,"155",139,0.8476,0.7949,0.8189
"13209",122409,1991,"2479",1440,1039,151,"39",112,0.0778,0.0375,0.0609
"13210",122436,1991,"882",528,354,471,"181",290,0.5492,0.5113,0.534
"13211",122597,1991,"1219",774,445,72,"28",44,0.0568,0.0629,0.0591
"13212",122612,1991,"459",299,160,205,"72",133,0.4448,0.45,0.4466
"13213",122931,1991,"928",457,471,675,"335",340,0.744,0.7113,0.7274
"13214",123554,1991,"437",241,196,247,"101",146,0.6058,0.5153,0.5652
"13215",123572,1991,"680",429,251,95,"18",77,0.1795,0.0717,0.1397
"13216",126562,1991,"262",152,110,25,"7",18,0.1184,0.0636,0.0954
"13217",126580,1991,"319",183,136,36,"12",24,0.1311,0.0882,0.1129
"13218",126614,1991,"3421",1631,1790,1268,"550",718,0.4402,0.3073,0.3707
"13219",126818,1991,"2155",1144,1011,516,"173",343,0.2998,0.1711,0.2394
"13220",127060,1991,"504",265,239,280,"123",157,0.5925,0.5146,0.5556
"13221",127185,1991,"935",424,511,67,"30",37,0.0873,0.0587,0.0717
"13222",127565,1991,"1357",669,688,35,"12",23,0.0344,0.0174,0.0258
"13223",127741,1991,"1639",937,702,258,"78",180,0.1921,0.1111,0.1574
"13224",128106,1991,"579",287,292,59,"23",36,0.1254,0.0788,0.1019
"13225",128744,1991,"208",110,98,12,"5",7,0.0636,0.051,0.0577
"13226",128771,1991,"1088",627,461,115,"34",81,0.1292,0.0738,0.1057
"13227",129020,1991,"2904",1464,1440,977,"359",618,0.4221,0.2493,0.3364
"13228",129242,1991,"749",429,320,597,"255",342,0.7972,0.7969,0.7971
"13229",129941,1991,"320",84,236,60,"42",18,0.2143,0.178,0.1875
"13230",130253,1991,"485",196,289,93,"41",52,0.2653,0.1419,0.1918
"13231",130314,1991,"104",104,0,54,"0",54,0.5192,NA,0.5192
"13232",130493,1991,"1002",539,463,188,"49",139,0.2579,0.1058,0.1876
"13233",130590,1991,"481",226,255,387,"192",195,0.8628,0.7529,0.8046
"13234",130697,1991,"663",347,316,501,"223",278,0.8012,0.7057,0.7557
"13235",130776,1991,"349",187,162,96,"32",64,0.3422,0.1975,0.2751
"13236",130794,1991,"1290",592,698,1127,"608",519,0.8767,0.8711,0.8736
"13237",130934,1991,"585",330,255,53,"12",41,0.1242,0.0471,0.0906
"13238",130943,1991,"3170",1871,1299,1592,"524",1068,0.5708,0.4034,0.5022
"13239",131159,1991,"1027",633,394,622,"223",399,0.6303,0.566,0.6056
"13240",131283,1991,"532",308,224,309,"124",185,0.6006,0.5536,0.5808
"13241",131450,1991,"227",129,98,15,"2",13,0.1008,0.0204,0.0661
"13242",131469,1991,"1151",622,529,686,"282",404,0.6495,0.5331,0.596
"13243",131496,1991,"1369",710,659,1133,"547",586,0.8254,0.83,0.8276
"13244",131520,1991,"1089",687,402,261,"64",197,0.2868,0.1592,0.2397
"13245",132471,1991,"301",179,122,85,"34",51,0.2849,0.2787,0.2824
"13246",132602,1991,"619",348,271,134,"25",109,0.3132,0.0923,0.2165
"13247",132903,1991,"1577",813,764,332,"89",243,0.2989,0.1165,0.2105
"13248",133492,1991,"336",187,149,186,"80",106,0.5668,0.5369,0.5536
"13249",133553,1991,"875",134,741,190,"158",32,0.2388,0.2132,0.2171
"13250",133650,1991,"1608",945,663,188,"36",152,0.1608,0.0543,0.1169
"13251",133669,1991,"651",358,293,93,"29",64,0.1788,0.099,0.1429
"13252",133711,1991,"290",169,121,133,"50",83,0.4911,0.4132,0.4586
"13253",133881,1991,"350",78,272,98,"67",31,0.3974,0.2463,0.28
"13254",133951,1991,"1021",600,421,198,"62",136,0.2267,0.1473,0.1939
"13255",134079,1991,"378",210,168,147,"53",94,0.4476,0.3155,0.3889
"13256",134097,1991,"2899",1702,1197,1131,"410",721,0.4236,0.3425,0.3901
"13257",134130,1991,"4364",2116,2248,1284,"490",794,0.3752,0.218,0.2942
"13258",134945,1991,"388",147,241,102,"56",46,0.3129,0.2324,0.2629
"13259",135726,1991,"1832",826,1006,775,"383",392,0.4746,0.3807,0.423
"13260",136172,1991,"406",240,166,71,"24",47,0.1958,0.1446,0.1749
"13261",136950,1991,"401",227,174,233,"92",141,0.6211,0.5287,0.581
"13262",137546,1991,"460",256,204,237,"89",148,0.5781,0.4363,0.5152
"13263",138354,1991,"380",215,165,40,"16",24,0.1116,0.097,0.1053
"13264",138716,1991,"541",292,249,39,"7",32,0.1096,0.0281,0.0721
"13265",138789,1991,"567",340,227,50,"14",36,0.1059,0.0617,0.0882
"13266",139144,1991,"429",253,176,220,"85",135,0.5336,0.483,0.5128
"13267",139366,1991,"509",312,197,30,"9",21,0.0673,0.0457,0.0589
"13268",139393,1991,"136",73,63,56,"21",35,0.4795,0.3333,0.4118
"13269",139658,1991,"1415",772,643,950,"430",520,0.6736,0.6687,0.6714
"13270",139719,1991,"464",276,188,48,"22",26,0.0942,0.117,0.1034
"13271",139755,1991,"1750",415,1335,484,"335",149,0.359,0.2509,0.2766
"13272",139764,1991,"322",190,132,70,"35",35,0.1842,0.2652,0.2174
"13273",139861,1991,"770",476,294,126,"35",91,0.1912,0.119,0.1636
"13274",139931,1991,"2737",1457,1280,508,"172",336,0.2306,0.1344,0.1856
"13275",139940,1991,"1007",598,409,103,"34",69,0.1154,0.0831,0.1023
"13276",139959,1991,"3408",1927,1481,1191,"429",762,0.3954,0.2897,0.3495
"13277",140447,1991,"670",347,323,230,"100",130,0.3746,0.3096,0.3433
"13278",140960,1991,"737",394,343,75,"28",47,0.1193,0.0816,0.1018
"13279",140988,1991,"139",96,43,59,"18",41,0.4271,0.4186,0.4245
"13280",141185,1991,"218",113,105,51,"25",26,0.2301,0.2381,0.2339
"13281",141264,1991,"994",614,380,225,"78",147,0.2394,0.2053,0.2264
"13282",141334,1991,"1178",664,514,157,"43",114,0.1717,0.0837,0.1333
"13283",141486,1991,"122",73,49,23,"9",14,0.1918,0.1837,0.1885
"13284",141565,1991,"198",100,98,10,"2",8,0.08,0.0204,0.0505
"13285",141574,1991,"1462",794,668,117,"35",82,0.1033,0.0524,0.08
"13286",142276,1991,"1091",569,522,47,"14",33,0.058,0.0268,0.0431
"13287",142285,1991,"1273",524,749,140,"72",68,0.1298,0.0961,0.11
"13288",142461,1991,"237",129,108,51,"17",34,0.2636,0.1574,0.2152
"13289",143084,1991,"526",296,230,337,"145",192,0.6486,0.6304,0.6407
"13290",143288,1991,"116",44,72,23,"6",17,0.3864,0.0833,0.1983
"13291",144005,1991,"614",414,200,7,"3",4,0.0097,0.015,0.0114
"13292",144281,1991,"846",439,407,21,"8",13,0.0296,0.0197,0.0248
"13293",144740,1991,"1047",593,454,388,"147",241,0.4064,0.3238,0.3706
"13294",144892,1991,"1493",911,582,577,"185",392,0.4303,0.3179,0.3865
"13295",144962,1991,"247",130,117,99,"38",61,0.4692,0.3248,0.4008
"13296",144971,1991,"129",70,59,54,"21",33,0.4714,0.3559,0.4186
"13297",145600,1991,"2356",1233,1123,197,"83",114,0.0925,0.0739,0.0836
"13298",145619,1991,"246",117,129,87,"37",50,0.4274,0.2868,0.3537
"13299",145637,1991,"5649",2615,3034,2770,"1300",1470,0.5621,0.4285,0.4904
"13300",145691,1991,"241",117,124,85,"39",46,0.3932,0.3145,0.3527
"13301",145813,1991,"3055",1757,1298,849,"286",563,0.3204,0.2203,0.2779
"13302",146481,1991,"234",124,110,123,"53",70,0.5645,0.4818,0.5256
"13303",146612,1991,"387",166,221,122,"59",63,0.3795,0.267,0.3152
"13304",146719,1991,"922",593,329,347,"119",228,0.3845,0.3617,0.3764
"13305",146825,1991,"185",89,96,83,"28",55,0.618,0.2917,0.4486
"13306",147013,1991,"132",79,53,46,"15",31,0.3924,0.283,0.3485
"13307",147244,1991,"422",242,180,245,"94",151,0.624,0.5222,0.5806
"13308",147341,1991,"252",117,135,113,"48",65,0.5556,0.3556,0.4484
"13309",147703,1991,"3161",1646,1515,651,"251",400,0.243,0.1657,0.2059
"13310",147767,1991,"1945",955,990,1601,"782",819,0.8576,0.7899,0.8231
"13311",147776,1991,"724",447,277,17,"5",12,0.0268,0.0181,0.0235
"13312",147828,1991,"376",209,167,140,"42",98,0.4689,0.2515,0.3723
"13313",148131,1991,"296",153,143,105,"44",61,0.3987,0.3077,0.3547
"13314",148496,1991,"152",124,28,58,"11",47,0.379,0.3929,0.3816
"13315",148584,1991,"171",81,90,58,"22",36,0.4444,0.2444,0.3392
"13316",148627,1991,"160",109,51,50,"11",39,0.3578,0.2157,0.3125
"13317",149222,1991,"2376",1018,1358,302,"139",163,0.1601,0.1024,0.1271
"13318",149231,1991,"948",539,409,107,"30",77,0.1429,0.0733,0.1129
"13319",149772,1991,"1685",877,808,354,"155",199,0.2269,0.1918,0.2101
"13320",149781,1991,"544",277,267,373,"164",209,0.7545,0.6142,0.6857
"13321",150066,1991,"460",245,215,123,"47",76,0.3102,0.2186,0.2674
"13322",150136,1991,"3447",1976,1471,1555,"602",953,0.4823,0.4092,0.4511
"13323",150145,1991,"116",61,55,29,"17",12,0.1967,0.3091,0.25
"13324",150163,1991,"622",363,259,252,"94",158,0.4353,0.3629,0.4051
"13325",150400,1991,"475",258,217,367,"157",210,0.814,0.7235,0.7726
"13326",150534,1991,"694",403,291,281,"101",180,0.4467,0.3471,0.4049
"13327",150668,1991,"194",106,88,83,"30",53,0.5,0.3409,0.4278
"13328",150941,1991,"154",76,78,55,"30",25,0.3289,0.3846,0.3571
"13329",151102,1991,"1134",607,527,34,"17",17,0.028,0.0323,0.03
"13330",151111,1991,"1536",862,674,54,"24",30,0.0348,0.0356,0.0352
"13331",151306,1991,"1078",611,467,86,"24",62,0.1015,0.0514,0.0798
"13332",151324,1991,"1919",969,950,276,"114",162,0.1672,0.12,0.1438
"13333",151333,1991,"315",199,116,8,"1",7,0.0352,0.0086,0.0254
"13334",151342,1991,"554",352,202,40,"15",25,0.071,0.0743,0.0722
"13335",151351,1991,"5208",3013,2195,2205,"881",1324,0.4394,0.4014,0.4234
"13336",151360,1991,"614",396,218,35,"14",21,0.053,0.0642,0.057
"13337",151379,1991,"589",343,246,23,"6",17,0.0496,0.0244,0.039
"13338",151388,1991,"222",146,76,2,"0",2,0.0137,0,0.009
"13339",151777,1991,"277",146,131,121,"48",73,0.5,0.3664,0.4368
"13340",151786,1991,"217",154,63,53,"13",40,0.2597,0.2063,0.2442
"13341",152080,1991,"1880",717,1163,1635,"988",647,0.9024,0.8495,0.8697
"13342",152248,1991,"921",466,455,17,"6",11,0.0236,0.0132,0.0185
"13343",152363,1991,"252",94,158,95,"51",44,0.4681,0.3228,0.377
"13344",152530,1991,"466",248,218,247,"94",153,0.6169,0.4312,0.53
"13345",152600,1991,"615",340,275,327,"114",213,0.6265,0.4145,0.5317
"13346",153001,1991,"273",110,163,107,"57",50,0.4545,0.3497,0.3919
"13347",153108,1991,"414",239,175,224,"95",129,0.5397,0.5429,0.5411
"13348",153269,1991,"744",424,320,398,"154",244,0.5755,0.4812,0.5349
"13349",153384,1991,"324",184,140,248,"104",144,0.7826,0.7429,0.7654
"13350",153603,1991,"3228",1368,1860,665,"281",384,0.2807,0.1511,0.206
"13351",153834,1991,"578",349,229,368,"134",234,0.6705,0.5852,0.6367
"13352",154095,1991,"1949",1181,768,470,"151",319,0.2701,0.1966,0.2411
"13353",155089,1991,"165",99,66,44,"12",32,0.3232,0.1818,0.2667
"13354",155317,1991,"3287",1755,1532,749,"291",458,0.261,0.1899,0.2279
"13355",155335,1991,"82",61,21,15,"3",12,0.1967,0.1429,0.1829
"13356",155399,1991,"2670",1322,1348,480,"158",322,0.2436,0.1172,0.1798
"13357",155520,1991,"200",112,88,51,"15",36,0.3214,0.1705,0.255
"13358",155627,1991,"120",48,72,19,"11",8,0.1667,0.1528,0.1583
"13359",155937,1991,"131",55,76,42,"20",22,0.4,0.2632,0.3206
"13360",156213,1991,"250",144,106,78,"31",47,0.3264,0.2925,0.312
"13361",156286,1991,"267",157,110,122,"42",80,0.5096,0.3818,0.4569
"13362",156295,1991,"436",246,190,147,"58",89,0.3618,0.3053,0.3372
"13363",156365,1991,"255",122,133,29,"6",23,0.1885,0.0451,0.1137
"13364",156541,1991,"460",240,220,77,"29",48,0.2,0.1318,0.1674
"13365",156745,1991,"309",161,148,103,"38",65,0.4037,0.2568,0.3333
"13366",157058,1991,"390",215,175,33,"9",24,0.1116,0.0514,0.0846
"13367",157076,1991,"204",75,129,48,"24",24,0.32,0.186,0.2353
"13368",157085,1991,"2817",1434,1383,389,"138",251,0.175,0.0998,0.1381
"13369",157289,1991,"2050",1007,1043,105,"28",77,0.0765,0.0268,0.0512
"13370",157386,1991,"1261",674,587,99,"32",67,0.0994,0.0545,0.0785
"13371",157401,1991,"1147",633,514,120,"34",86,0.1359,0.0661,0.1046
"13372",157447,1991,"1282",698,584,42,"14",28,0.0401,0.024,0.0328
"13373",157535,1991,"181",134,47,25,"6",19,0.1418,0.1277,0.1381
"13374",157951,1991,"2263",1267,996,259,"77",182,0.1436,0.0773,0.1144
"13375",158477,1991,"207",124,83,87,"29",58,0.4677,0.3494,0.4203
"13376",159009,1991,"1325",741,584,121,"30",91,0.1228,0.0514,0.0913
"13377",159391,1991,"3342",1779,1563,579,"201",378,0.2125,0.1286,0.1732
"13378",159647,1991,"1834",827,1007,278,"108",170,0.2056,0.1072,0.1516
"13379",159717,1991,"1253",652,601,83,"23",60,0.092,0.0383,0.0662
"13380",159966,1991,"1204",698,506,57,"13",44,0.063,0.0257,0.0473
"13381",160038,1991,"1179",710,469,110,"24",86,0.1211,0.0512,0.0933
"13382",160612,1991,"1898",1075,823,53,"9",44,0.0409,0.0109,0.0279
"13383",160621,1991,"1907",985,922,59,"10",49,0.0497,0.0108,0.0309
"13384",160658,1991,"2383",1300,1083,88,"26",62,0.0477,0.024,0.0369
"13385",161004,1991,"398",185,213,341,"182",159,0.8595,0.8545,0.8568
"13386",161226,1991,"457",337,120,157,"30",127,0.3769,0.25,0.3435
"13387",161235,1991,"86",53,33,11,"3",8,0.1509,0.0909,0.1279
"13388",161244,1991,"146",91,55,11,"4",7,0.0769,0.0727,0.0753
"13389",161253,1991,"1589",710,879,324,"140",184,0.2592,0.1593,0.2039
"13390",161554,1991,"763",419,344,68,"23",45,0.1074,0.0669,0.0891
"13391",162007,1991,"310",189,121,37,"7",30,0.1587,0.0579,0.1194
"13392",162210,1991,"78",45,33,19,"6",13,0.2889,0.1818,0.2436
"13393",162283,1991,"311",195,116,29,"6",23,0.1179,0.0517,0.0932
"13394",162584,1991,"762",381,381,187,"67",120,0.315,0.1759,0.2454
"13395",162654,1991,"203",142,61,121,"31",90,0.6338,0.5082,0.5961
"13396",162760,1991,"145",143,2,70,"1",69,0.4825,0.5,0.4828
"13397",162928,1991,"846",304,542,707,"444",263,0.8651,0.8192,0.8357
"13398",163046,1991,"700",400,300,475,"171",304,0.76,0.57,0.6786
"13399",163268,1991,"910",467,443,185,"71",114,0.2441,0.1603,0.2033
"13400",163286,1991,"3069",1406,1663,928,"361",567,0.4033,0.2171,0.3024
"13401",163453,1991,"919",552,367,139,"29",110,0.1993,0.079,0.1513
"13402",163462,1991,"320",170,150,195,"85",110,0.6471,0.5667,0.6094
"13403",163851,1991,"711",387,324,293,"99",194,0.5013,0.3056,0.4121
"13404",163912,1991,"227",132,95,147,"51",96,0.7273,0.5368,0.6476
"13405",164076,1991,"1237",735,502,335,"78",257,0.3497,0.1554,0.2708
"13406",164173,1991,"269",233,36,44,"6",38,0.1631,0.1667,0.1636
"13407",164216,1991,"182",99,83,105,"40",65,0.6566,0.4819,0.5769
"13408",164270,1991,"278",132,146,160,"71",89,0.6742,0.4863,0.5755
"13409",164447,1991,"250",110,140,84,"43",41,0.3727,0.3071,0.336
"13410",164492,1991,"116",87,29,54,"9",45,0.5172,0.3103,0.4655
"13411",164562,1991,"447",286,161,298,"110",188,0.6573,0.6832,0.6667
"13412",165015,1991,"745",392,353,546,"247",299,0.7628,0.6997,0.7329
"13413",165024,1991,"982",568,414,265,"67",198,0.3486,0.1618,0.2699
"13414",165334,1991,"561",307,254,344,"137",207,0.6743,0.5394,0.6132
"13415",165662,1991,"399",269,130,217,"89",128,0.4758,0.6846,0.5439
"13416",165671,1991,"138",138,0,51,"0",51,0.3696,NA,0.3696
"13417",165820,1991,"759",462,297,183,"55",128,0.2771,0.1852,0.2411
"13418",165866,1991,"385",251,134,114,"22",92,0.3665,0.1642,0.2961
"13419",165936,1991,"282",171,111,122,"41",81,0.4737,0.3694,0.4326
"13420",166027,1991,"1601",669,932,1347,"759",588,0.8789,0.8144,0.8413
"13421",166124,1991,"728",344,384,631,"329",302,0.8779,0.8568,0.8668
"13422",166513,1991,"1075",386,689,276,"146",130,0.3368,0.2119,0.2567
"13423",166629,1991,"3435",1665,1770,1271,"511",760,0.4565,0.2887,0.37
"13424",166638,1991,"529",270,259,68,"27",41,0.1519,0.1042,0.1285
"13425",166683,1991,"1048",367,681,825,"516",309,0.842,0.7577,0.7872
"13426",167288,1991,"423",211,212,81,"26",55,0.2607,0.1226,0.1915
"13427",167987,1991,"989",515,474,285,"109",176,0.3417,0.23,0.2882
"13428",167996,1991,"518",279,239,359,"160",199,0.7133,0.6695,0.6931
"13429",168005,1991,"421",214,207,137,"55",82,0.3832,0.2657,0.3254
"13430",168148,1991,"1155",640,515,870,"378",492,0.7688,0.734,0.7532
"13431",168254,1991,"428",166,262,165,"81",84,0.506,0.3092,0.3855
"13432",168281,1991,"319",210,109,222,"62",160,0.7619,0.5688,0.6959
"13433",168342,1991,"517",246,271,467,"238",229,0.9309,0.8782,0.9033
"13434",168546,1991,"548",266,282,349,"179",170,0.6391,0.6348,0.6369
"13435",168786,1991,"231",134,97,65,"26",39,0.291,0.268,0.2814
"13436",169080,1991,"858",489,369,412,"168",244,0.499,0.4553,0.4802
"13437",169798,1991,"2232",1255,977,176,"65",111,0.0884,0.0665,0.0789
"13438",169910,1991,"2377",889,1488,90,"47",43,0.0484,0.0316,0.0379
"13439",170082,1991,"1545",941,604,240,"63",177,0.1881,0.1043,0.1553
"13440",170301,1991,"554",317,237,278,"99",179,0.5647,0.4177,0.5018
"13441",170532,1991,"336",179,157,192,"86",106,0.5922,0.5478,0.5714
"13442",170639,1991,"492",221,271,60,"28",32,0.1448,0.1033,0.122
"13443",170976,1991,"4908",2299,2609,2841,"1363",1478,0.6429,0.5224,0.5789
"13444",171100,1991,"6314",3456,2858,1480,"535",945,0.2734,0.1872,0.2344
"13445",171128,1991,"1283",319,964,234,"145",89,0.279,0.1504,0.1824
"13446",171137,1991,"597",308,289,50,"22",28,0.0909,0.0761,0.0838
"13447",171146,1991,"485",286,199,32,"7",25,0.0874,0.0352,0.066
"13448",171599,1991,"162",55,107,30,"18",12,0.2182,0.1682,0.1852
"13449",172051,1991,"564",296,268,26,"6",20,0.0676,0.0224,0.0461
"13450",172699,1991,"2778",1543,1235,432,"162",270,0.175,0.1312,0.1555
"13451",173160,1991,"272",183,89,157,"49",108,0.5902,0.5506,0.5772
"13452",173258,1991,"471",247,224,387,"175",212,0.8583,0.7812,0.8217
"13453",173328,1991,"151",94,57,31,"10",21,0.2234,0.1754,0.2053
"13454",173647,1991,"624",336,288,464,"210",254,0.756,0.7292,0.7436
"13455",173902,1991,"403",206,197,284,"126",158,0.767,0.6396,0.7047
"13456",174066,1991,"1979",917,1062,318,"134",184,0.2007,0.1262,0.1607
"13457",174233,1991,"1091",567,524,196,"69",127,0.224,0.1317,0.1797
"13458",174251,1991,"462",272,190,155,"55",100,0.3676,0.2895,0.3355
"13459",174491,1991,"267",165,102,84,"24",60,0.3636,0.2353,0.3146
"13460",174792,1991,"415",0,415,247,"247",0,NA,0.5952,0.5952
"13461",174844,1991,"733",391,342,534,"246",288,0.7366,0.7193,0.7285
"13462",174899,1991,"276",206,70,114,"28",86,0.4175,0.4,0.413
"13463",174914,1991,"854",457,397,393,"174",219,0.4792,0.4383,0.4602
"13464",175342,1991,"899",520,379,108,"25",83,0.1596,0.066,0.1201
"13465",175421,1991,"43",27,16,5,"2",3,0.1111,0.125,0.1163
"13466",175616,1991,"445",283,162,111,"33",78,0.2756,0.2037,0.2494
"13467",175856,1991,"1081",615,466,113,"34",79,0.1285,0.073,0.1045
"13468",175980,1991,"273",140,133,170,"73",97,0.6929,0.5489,0.6227
"13469",176017,1991,"1690",892,798,484,"169",315,0.3531,0.2118,0.2864
"13470",176035,1991,"339",282,57,99,"10",89,0.3156,0.1754,0.292
"13471",176044,1991,"386",223,163,34,"7",27,0.1211,0.0429,0.0881
"13472",176080,1991,"1569",715,854,320,"134",186,0.2601,0.1569,0.204
"13473",176406,1991,"317",205,112,61,"16",45,0.2195,0.1429,0.1924
"13474",176628,1991,"88",53,35,27,"8",19,0.3585,0.2286,0.3068
"13475",176947,1991,"240",109,131,52,"22",30,0.2752,0.1679,0.2167
"13476",176965,1991,"1952",1038,914,273,"107",166,0.1599,0.1171,0.1399
"13477",177418,1991,"114",87,27,38,"9",29,0.3333,0.3333,0.3333
"13478",178059,1991,"102",61,41,63,"22",41,0.6721,0.5366,0.6176
"13479",178341,1991,"758",397,361,71,"24",47,0.1184,0.0665,0.0937
"13480",178387,1991,"806",435,371,71,"27",44,0.1011,0.0728,0.0881
"13481",178396,1991,"3368",1820,1548,959,"356",603,0.3313,0.23,0.2847
"13482",178402,1991,"494",270,224,55,"26",29,0.1074,0.1161,0.1113
"13483",178411,1991,"711",135,576,58,"43",15,0.1111,0.0747,0.0816
"13484",178420,1991,"637",341,296,72,"28",44,0.129,0.0946,0.113
"13485",178615,1991,"1375",784,591,459,"153",306,0.3903,0.2589,0.3338
"13486",179043,1991,"228",142,86,121,"44",77,0.5423,0.5116,0.5307
"13487",179159,1991,"914",479,435,355,"121",234,0.4885,0.2782,0.3884
"13488",179557,1991,"1487",815,672,222,"70",152,0.1865,0.1042,0.1493
"13489",179566,1991,"2895",1571,1324,676,"241",435,0.2769,0.182,0.2335
"13490",179867,1991,"1131",544,587,863,"417",446,0.8199,0.7104,0.763
"13491",179894,1991,"187",110,77,65,"24",41,0.3727,0.3117,0.3476
"13492",179946,1991,"194",83,111,99,"56",43,0.5181,0.5045,0.5103
"13493",180179,1991,"248",168,80,17,"4",13,0.0774,0.05,0.0685
"13494",180461,1991,"1445",652,793,156,"60",96,0.1472,0.0757,0.108
"13495",180522,1991,"188",86,102,27,"18",9,0.1047,0.1765,0.1436
"13496",180984,1991,"204",117,87,58,"17",41,0.3504,0.1954,0.2843
"13497",181002,1991,"750",445,305,430,"170",260,0.5843,0.5574,0.5733
"13498",181020,1991,"230",116,114,117,"42",75,0.6466,0.3684,0.5087
"13499",181127,1991,"255",111,144,102,"55",47,0.4234,0.3819,0.4
"13500",181215,1991,"1230",665,565,141,"54",87,0.1308,0.0956,0.1146
"13501",181394,1991,"1275",635,640,70,"31",39,0.0614,0.0484,0.0549
"13502",181446,1991,"343",192,151,170,"72",98,0.5104,0.4768,0.4956
"13503",181464,1991,"3386",1641,1745,379,"121",258,0.1572,0.0693,0.1119
"13504",181534,1991,"235",129,106,24,"7",17,0.1318,0.066,0.1021
"13505",181783,1991,"681",357,324,103,"38",65,0.1821,0.1173,0.1512
"13506",182281,1991,"1172",604,568,125,"47",78,0.1291,0.0827,0.1067
"13507",182290,1991,"966",482,484,101,"43",58,0.1203,0.0888,0.1046
"13508",182634,1991,"215",137,78,99,"29",70,0.5109,0.3718,0.4605
"13509",182795,1991,"429",192,237,124,"57",67,0.349,0.2405,0.289
"13510",183062,1991,"731",444,287,159,"41",118,0.2658,0.1429,0.2175
"13511",183080,1991,"729",377,352,219,"83",136,0.3607,0.2358,0.3004
"13512",183239,1991,"545",303,242,365,"155",210,0.6931,0.6405,0.6697
"13513",183822,1991,"267",179,88,18,"6",12,0.067,0.0682,0.0674
"13514",183974,1991,"89",66,23,22,"3",19,0.2879,0.1304,0.2472
"13515",184348,1991,"269",166,103,188,"70",118,0.7108,0.6796,0.6989
"13516",184603,1991,"908",436,472,78,"32",46,0.1055,0.0678,0.0859
"13517",184612,1991,"93",79,14,9,"3",6,0.0759,0.2143,0.0968
"13518",184782,1991,"892",511,381,212,"77",135,0.2642,0.2021,0.2377
"13519",185129,1991,"618",322,296,34,"17",17,0.0528,0.0574,0.055
"13520",185572,1991,"387",216,171,74,"23",51,0.2361,0.1345,0.1912
"13521",185590,1991,"913",564,349,101,"31",70,0.1241,0.0888,0.1106
"13522",185828,1991,"541",96,445,30,"18",12,0.125,0.0404,0.0555
"13523",186131,1991,"1122",474,648,1002,"582",420,0.8861,0.8981,0.893
"13524",186201,1991,"423",205,218,55,"17",38,0.1854,0.078,0.13
"13525",186283,1991,"653",351,302,259,"98",161,0.4587,0.3245,0.3966
"13526",186584,1991,"984",474,510,429,"184",245,0.5169,0.3608,0.436
"13527",186876,1991,"683",364,319,194,"64",130,0.3571,0.2006,0.284
"13528",187134,1991,"860",560,300,445,"108",337,0.6018,0.36,0.5174
"13529",187444,1991,"967",551,416,100,"19",81,0.147,0.0457,0.1034
"13530",187985,1991,"1716",915,801,147,"61",86,0.094,0.0762,0.0857
"13531",188030,1991,"1656",846,810,127,"45",82,0.0969,0.0556,0.0767
"13532",188429,1991,"658",417,241,259,"74",185,0.4436,0.3071,0.3936
"13533",188641,1991,"256",110,146,132,"67",65,0.5909,0.4589,0.5156
"13534",190044,1991,"634",134,500,338,"266",72,0.5373,0.532,0.5331
"13535",190099,1991,"694",330,364,554,"265",289,0.8758,0.728,0.7983
"13536",190150,1991,"1085",464,621,851,"481",370,0.7974,0.7746,0.7843
"13537",190248,1991,"85",43,42,29,"10",19,0.4419,0.2381,0.3412
"13538",190415,1991,"2949",1345,1604,2336,"1218",1118,0.8312,0.7594,0.7921
"13539",190512,1991,"1170",746,424,56,"19",37,0.0496,0.0448,0.0479
"13540",190549,1991,"1475",843,632,135,"42",93,0.1103,0.0665,0.0915
"13541",190558,1991,"1153",599,554,16,"4",12,0.02,0.0072,0.0139
"13542",190567,1991,"1126",505,621,19,"11",8,0.0158,0.0177,0.0169
"13543",190594,1991,"808",617,191,30,"3",27,0.0438,0.0157,0.0371
"13544",190637,1991,"711",470,241,15,"8",7,0.0149,0.0332,0.0211
"13545",190664,1991,"1603",889,714,165,"49",116,0.1305,0.0686,0.1029
"13546",190691,1991,"431",276,155,22,"10",12,0.0435,0.0645,0.051
"13547",190725,1991,"244",164,80,40,"14",26,0.1585,0.175,0.1639
"13548",191241,1991,"952",507,445,641,"292",349,0.6884,0.6562,0.6733
"13549",191515,1991,"462",207,255,384,"204",180,0.8696,0.8,0.8312
"13550",191533,1991,"370",217,153,201,"74",127,0.5853,0.4837,0.5432
"13551",191630,1991,"503",211,292,334,"174",160,0.7583,0.5959,0.664
"13552",191649,1991,"1338",747,591,567,"190",377,0.5047,0.3215,0.4238
"13553",191676,1991,"244",152,92,119,"46",73,0.4803,0.5,0.4877
"13554",191931,1991,"1046",526,520,290,"122",168,0.3194,0.2346,0.2772
"13555",191968,1991,"1638",831,807,1036,"477",559,0.6727,0.5911,0.6325
"13556",192192,1991,"139",112,27,65,"15",50,0.4464,0.5556,0.4676
"13557",192323,1991,"404",212,192,261,"118",143,0.6745,0.6146,0.646
"13558",192439,1991,"665",436,229,30,"12",18,0.0413,0.0524,0.0451
"13559",192703,1991,"548",258,290,298,"137",161,0.624,0.4724,0.5438
"13560",192749,1991,"192",143,49,96,"22",74,0.5175,0.449,0.5
"13561",192819,1991,"881",489,392,441,"166",275,0.5624,0.4235,0.5006
"13562",192925,1991,"143",79,64,23,"6",17,0.2152,0.0938,0.1608
"13563",193016,1991,"619",329,290,19,"5",14,0.0426,0.0172,0.0307
"13564",193292,1991,"123",100,23,55,"6",49,0.49,0.2609,0.4472
"13565",193353,1991,"248",188,60,96,"16",80,0.4255,0.2667,0.3871
"13566",193399,1991,"188",147,41,91,"20",71,0.483,0.4878,0.484
"13567",193584,1991,"246",177,69,124,"27",97,0.548,0.3913,0.5041
"13568",193645,1991,"645",563,82,93,"2",91,0.1616,0.0244,0.1442
"13569",193654,1991,"265",182,83,81,"25",56,0.3077,0.3012,0.3057
"13570",193900,1991,"2338",1279,1059,1173,"508",665,0.5199,0.4797,0.5017
"13571",193973,1991,"447",272,175,176,"53",123,0.4522,0.3029,0.3937
"13572",194161,1991,"108",77,31,26,"4",22,0.2857,0.129,0.2407
"13573",194310,1991,"510",290,220,178,"56",122,0.4207,0.2545,0.349
"13574",194824,1991,"971",193,778,428,"334",94,0.487,0.4293,0.4408
"13575",195003,1991,"1265",370,895,287,"162",125,0.3378,0.181,0.2269
"13576",195030,1991,"1215",537,678,805,"440",365,0.6797,0.649,0.6626
"13577",195164,1991,"479",236,243,267,"117",150,0.6356,0.4815,0.5574
"13578",195173,1991,"353",207,146,68,"26",42,0.2029,0.1781,0.1926
"13579",195216,1991,"421",213,208,322,"142",180,0.8451,0.6827,0.7648
"13580",195234,1991,"207",152,55,106,"24",82,0.5395,0.4364,0.5121
"13581",195243,1991,"198",113,85,95,"28",67,0.5929,0.3294,0.4798
"13582",195304,1991,"228",168,60,125,"34",91,0.5417,0.5667,0.5482
"13583",195474,1991,"584",307,277,455,"220",235,0.7655,0.7942,0.7791
"13584",195526,1991,"652",392,260,401,"139",262,0.6684,0.5346,0.615
"13585",195544,1991,"65",47,18,41,"9",32,0.6809,0.5,0.6308
"13586",195809,1991,"2483",1282,1201,612,"253",359,0.28,0.2107,0.2465
"13587",196413,1991,"2513",1294,1219,1388,"596",792,0.6121,0.4889,0.5523
"13588",196592,1991,"503",330,173,37,"15",22,0.0667,0.0867,0.0736
"13589",197045,1991,"328",169,159,96,"42",54,0.3195,0.2642,0.2927
"13590",197133,1991,"592",364,228,460,"167",293,0.8049,0.7325,0.777
"13591",197869,1991,"1916",1025,891,562,"185",377,0.3678,0.2076,0.2933
"13592",197984,1991,"174",92,82,56,"21",35,0.3804,0.2561,0.3218
"13593",198385,1991,"397",179,218,339,"178",161,0.8994,0.8165,0.8539
"13594",198464,1991,"2338",1288,1050,386,"124",262,0.2034,0.1181,0.1651
"13595",198507,1991,"402",217,185,135,"48",87,0.4009,0.2595,0.3358
"13596",198516,1991,"780",461,319,381,"121",260,0.564,0.3793,0.4885
"13597",198835,1991,"279",153,126,113,"33",80,0.5229,0.2619,0.405
"13598",198969,1991,"254",86,168,59,"35",24,0.2791,0.2083,0.2323
"13599",199102,1991,"1469",803,666,275,"63",212,0.264,0.0946,0.1872
"13600",199111,1991,"336",199,137,77,"18",59,0.2965,0.1314,0.2292
"13601",199120,1991,"3133",1941,1192,1966,"672",1294,0.6667,0.5638,0.6275
"13602",199139,1991,"1552",876,676,347,"86",261,0.2979,0.1272,0.2236
"13603",199148,1991,"1345",890,455,358,"82",276,0.3101,0.1802,0.2662
"13604",199157,1991,"531",336,195,93,"21",72,0.2143,0.1077,0.1751
"13605",199193,1991,"3296",1290,2006,773,"370",403,0.3124,0.1844,0.2345
"13606",199218,1991,"1545",923,622,385,"111",274,0.2969,0.1785,0.2492
"13607",199281,1991,"379",195,184,58,"21",37,0.1897,0.1141,0.153
"13608",199306,1991,"166",82,84,45,"17",28,0.3415,0.2024,0.2711
"13609",199412,1991,"144",102,42,47,"9",38,0.3725,0.2143,0.3264
"13610",199582,1991,"418",237,181,44,"10",34,0.1435,0.0552,0.1053
"13611",199643,1991,"579",330,249,190,"82",108,0.3273,0.3293,0.3282
"13612",199847,1991,"857",425,432,659,"299",360,0.8471,0.6921,0.769
"13613",199962,1991,"371",181,190,93,"28",65,0.3591,0.1474,0.2507
"13614",199999,1991,"431",287,144,59,"7",52,0.1812,0.0486,0.1369
"13615",200004,1991,"1011",522,489,210,"84",126,0.2414,0.1718,0.2077
"13616",200059,1991,"315",165,150,30,"12",18,0.1091,0.08,0.0952
"13617",200156,1991,"288",134,154,68,"21",47,0.3507,0.1364,0.2361
"13618",200217,1991,"317",179,138,96,"33",63,0.352,0.2391,0.3028
"13619",200226,1991,"162",83,79,21,"3",18,0.2169,0.038,0.1296
"13620",200253,1991,"546",363,183,52,"14",38,0.1047,0.0765,0.0952
"13621",200280,1991,"1288",588,700,161,"78",83,0.1412,0.1114,0.125
"13622",200332,1991,"1192",491,701,134,"58",76,0.1548,0.0827,0.1124
"13623",200572,1991,"186",100,86,21,"2",19,0.19,0.0233,0.1129
"13624",201104,1991,"542",238,304,145,"52",93,0.3908,0.1711,0.2675
"13625",201371,1991,"193",93,100,85,"30",55,0.5914,0.3,0.4404
"13626",201548,1991,"370",218,152,232,"87",145,0.6651,0.5724,0.627
"13627",201645,1991,"647",245,402,327,"173",154,0.6286,0.4303,0.5054
"13628",201690,1991,"661",327,334,92,"34",58,0.1774,0.1018,0.1392
"13629",202134,1991,"959",435,524,70,"34",36,0.0828,0.0649,0.073
"13630",202480,1991,"1499",744,755,758,"322",436,0.586,0.4265,0.5057
"13631",202523,1991,"501",271,230,351,"150",201,0.7417,0.6522,0.7006
"13632",202763,1991,"342",152,190,95,"46",49,0.3224,0.2421,0.2778
"13633",203085,1991,"252",100,152,100,"56",44,0.44,0.3684,0.3968
"13634",203128,1991,"287",148,139,159,"69",90,0.6081,0.4964,0.554
"13635",203368,1991,"765",386,379,465,"212",253,0.6554,0.5594,0.6078
"13636",203517,1991,"2692",1609,1083,579,"168",411,0.2554,0.1551,0.2151
"13637",203535,1991,"420",218,202,347,"167",180,0.8257,0.8267,0.8262
"13638",203580,1991,"61",49,12,18,"3",15,0.3061,0.25,0.2951
"13639",203775,1991,"312",206,106,89,"21",68,0.3301,0.1981,0.2853
"13640",203845,1991,"215",108,107,102,"41",61,0.5648,0.3832,0.4744
"13641",204024,1991,"3241",1858,1383,2040,"736",1304,0.7018,0.5322,0.6294
"13642",204185,1991,"417",194,223,189,"80",109,0.5619,0.3587,0.4532
"13643",204194,1991,"231",145,86,82,"31",51,0.3517,0.3605,0.355
"13644",204617,1991,"205",108,97,54,"24",30,0.2778,0.2474,0.2634
"13645",204796,1991,"5502",2705,2797,1061,"375",686,0.2536,0.1341,0.1928
"13646",204857,1991,"3187",1819,1368,1308,"448",860,0.4728,0.3275,0.4104
"13647",206330,1991,"188",66,122,16,"9",7,0.1061,0.0738,0.0851
"13648",206589,1991,"466",219,247,290,"135",155,0.7078,0.5466,0.6223
"13649",206604,1991,"2111",1061,1050,199,"66",133,0.1254,0.0629,0.0943
"13650",206622,1991,"719",380,339,383,"193",190,0.5,0.5693,0.5327
"13651",206695,1991,"1904",981,923,88,"31",57,0.0581,0.0336,0.0462
"13652",206914,1991,"466",220,246,23,"9",14,0.0636,0.0366,0.0494
"13653",207209,1991,"525",295,230,19,"2",17,0.0576,0.0087,0.0362
"13654",207306,1991,"356",176,180,43,"18",25,0.142,0.1,0.1208
"13655",207324,1991,"304",160,144,76,"37",39,0.2438,0.2569,0.25
"13656",207388,1991,"2092",1038,1054,399,"144",255,0.2457,0.1366,0.1907
"13657",207500,1991,"2249",1082,1167,277,"101",176,0.1627,0.0865,0.1232
"13658",207722,1991,"203",143,60,16,"2",14,0.0979,0.0333,0.0788
"13659",207847,1991,"537",291,246,55,"21",34,0.1168,0.0854,0.1024
"13660",207865,1991,"867",502,365,70,"24",46,0.0916,0.0658,0.0807
"13661",208822,1991,"258",154,104,91,"33",58,0.3766,0.3173,0.3527
"13662",209056,1991,"357",213,144,191,"72",119,0.5587,0.5,0.535
"13663",209065,1991,"429",242,187,234,"89",145,0.5992,0.4759,0.5455
"13664",209542,1991,"1543",696,847,403,"184",219,0.3147,0.2172,0.2612
"13665",209551,1991,"1919",1068,851,683,"238",445,0.4167,0.2797,0.3559
"13666",209612,1991,"261",154,107,93,"38",55,0.3571,0.3551,0.3563
"13667",209807,1991,"670",330,340,86,"34",52,0.1576,0.1,0.1284
"13668",209922,1991,"292",146,146,139,"71",68,0.4658,0.4863,0.476
"13669",210146,1991,"553",303,250,66,"26",40,0.132,0.104,0.1193
"13670",210401,1991,"390",221,169,253,"99",154,0.6968,0.5858,0.6487
"13671",210429,1991,"576",367,209,98,"22",76,0.2071,0.1053,0.1701
"13672",210571,1991,"236",120,116,143,"58",85,0.7083,0.5,0.6059
"13673",210669,1991,"606",289,317,354,"173",181,0.6263,0.5457,0.5842
"13674",210775,1991,"194",128,66,56,"16",40,0.3125,0.2424,0.2887
"13675",211088,1991,"140",110,30,92,"13",79,0.7182,0.4333,0.6571
"13676",211158,1991,"1080",664,416,443,"132",311,0.4684,0.3173,0.4102
"13677",211291,1991,"907",410,497,776,"408",368,0.8976,0.8209,0.8556
"13678",211352,1991,"137",93,44,73,"19",54,0.5806,0.4318,0.5328
"13679",211361,1991,"1107",565,542,141,"48",93,0.1646,0.0886,0.1274
"13680",211431,1991,"144",138,6,59,"2",57,0.413,0.3333,0.4097
"13681",211440,1991,"1170",335,835,657,"464",193,0.5761,0.5557,0.5615
"13682",211468,1991,"120",120,0,62,"0",62,0.5167,NA,0.5167
"13683",211556,1991,"100",100,0,52,"0",52,0.52,NA,0.52
"13684",211583,1991,"111",111,0,54,"0",54,0.4865,NA,0.4865
"13685",211608,1991,"324",139,185,33,"14",19,0.1367,0.0757,0.1019
"13686",211644,1991,"973",584,389,232,"64",168,0.2877,0.1645,0.2384
"13687",211981,1991,"332",140,192,98,"43",55,0.3929,0.224,0.2952
"13688",212009,1991,"557",317,240,433,"184",249,0.7855,0.7667,0.7774
"13689",212054,1991,"1207",364,843,115,"31",84,0.2308,0.0368,0.0953
"13690",212106,1991,"870",475,395,381,"166",215,0.4526,0.4203,0.4379
"13691",212115,1991,"699",382,317,129,"31",98,0.2565,0.0978,0.1845
"13692",212133,1991,"134",87,47,55,"16",39,0.4483,0.3404,0.4104
"13693",212160,1991,"1456",853,603,243,"65",178,0.2087,0.1078,0.1669
"13694",212197,1991,"455",309,146,265,"78",187,0.6052,0.5342,0.5824
"13695",212577,1991,"504",228,276,355,"173",182,0.7982,0.6268,0.7044
"13696",212601,1991,"465",264,201,186,"79",107,0.4053,0.393,0.4
"13697",212832,1991,"89",79,10,25,"1",24,0.3038,0.1,0.2809
"13698",212911,1991,"295",147,148,256,"124",132,0.898,0.8378,0.8678
"13699",213020,1991,"2516",1452,1064,604,"180",424,0.292,0.1692,0.2401
"13700",213251,1991,"261",129,132,164,"78",86,0.6667,0.5909,0.6284
"13701",213321,1991,"359",164,195,232,"115",117,0.7134,0.5897,0.6462
"13702",213349,1991,"1427",813,614,295,"59",236,0.2903,0.0961,0.2067
"13703",213358,1991,"120",76,44,34,"10",24,0.3158,0.2273,0.2833
"13704",213367,1991,"594",293,301,331,"152",179,0.6109,0.505,0.5572
"13705",213385,1991,"519",243,276,426,"212",214,0.8807,0.7681,0.8208
"13706",213507,1991,"180",77,103,98,"50",48,0.6234,0.4854,0.5444
"13707",213543,1991,"1117",411,706,749,"435",314,0.764,0.6161,0.6705
"13708",213613,1991,"737",447,290,187,"52",135,0.302,0.1793,0.2537
"13709",213668,1991,"374",190,184,153,"67",86,0.4526,0.3641,0.4091
"13710",213783,1991,"461",283,178,168,"50",118,0.417,0.2809,0.3644
"13711",213826,1991,"281",237,44,95,"12",83,0.3502,0.2727,0.3381
"13712",213996,1991,"560",343,217,361,"136",225,0.656,0.6267,0.6446
"13713",214041,1991,"1089",672,417,429,"127",302,0.4494,0.3046,0.3939
"13714",214069,1991,"246",187,59,86,"23",63,0.3369,0.3898,0.3496
"13715",214157,1991,"288",143,145,192,"92",100,0.6993,0.6345,0.6667
"13716",214175,1991,"463",258,205,336,"140",196,0.7597,0.6829,0.7257
"13717",214272,1991,"84",58,26,30,"5",25,0.431,0.1923,0.3571
"13718",214777,1991,"3615",1712,1903,2808,"1417",1391,0.8125,0.7446,0.7768
"13719",215062,1991,"2286",986,1300,1791,"981",810,0.8215,0.7546,0.7835
"13720",215743,1991,"279",144,135,97,"38",59,0.4097,0.2815,0.3477
"13721",215798,1991,"228",118,110,129,"51",78,0.661,0.4636,0.5658
"13722",215929,1991,"897",457,440,646,"294",352,0.7702,0.6682,0.7202
"13723",216010,1991,"1163",631,532,474,"153",321,0.5087,0.2876,0.4076
"13724",216038,1991,"1191",690,501,232,"76",156,0.2261,0.1517,0.1948
"13725",216287,1991,"319",148,171,266,"138",128,0.8649,0.807,0.8339
"13726",216339,1991,"2084",1071,1013,287,"115",172,0.1606,0.1135,0.1377
"13727",216524,1991,"234",124,110,155,"69",86,0.6935,0.6273,0.6624
"13728",216694,1991,"317",185,132,112,"33",79,0.427,0.25,0.3533
"13729",216764,1991,"1467",960,507,337,"79",258,0.2688,0.1558,0.2297
"13730",216807,1991,"319",175,144,223,"99",124,0.7086,0.6875,0.6991
"13731",216852,1991,"464",206,258,172,"81",91,0.4417,0.314,0.3707
"13732",216931,1991,"395",170,225,154,"71",83,0.4882,0.3156,0.3899
"13733",217059,1991,"697",396,301,265,"88",177,0.447,0.2924,0.3802
"13734",217156,1991,"1358",658,700,1048,"543",505,0.7675,0.7757,0.7717
"13735",217402,1991,"963",529,434,764,"330",434,0.8204,0.7604,0.7934
"13736",217536,1991,"400",281,119,196,"49",147,0.5231,0.4118,0.49
"13737",217776,1991,"78",41,37,16,"6",10,0.2439,0.1622,0.2051
"13738",217819,1991,"1434",943,491,483,"104",379,0.4019,0.2118,0.3368
"13739",217882,1991,"2474",1120,1354,871,"321",550,0.4911,0.2371,0.3521
"13740",217998,1991,"101",64,37,66,"21",45,0.7031,0.5676,0.6535
"13741",218061,1991,"735",388,347,79,"23",56,0.1443,0.0663,0.1075
"13742",218229,1991,"421",286,135,83,"18",65,0.2273,0.1333,0.1971
"13743",218238,1991,"232",126,106,17,"5",12,0.0952,0.0472,0.0733
"13744",218399,1991,"196",135,61,38,"6",32,0.237,0.0984,0.1939
"13745",218414,1991,"189",77,112,45,"21",24,0.3117,0.1875,0.2381
"13746",218663,1991,"2591",1398,1193,643,"242",401,0.2868,0.2028,0.2482
"13747",218724,1991,"584",328,256,84,"26",58,0.1768,0.1016,0.1438
"13748",218733,1991,"888",486,402,85,"17",68,0.1399,0.0423,0.0957
"13749",218742,1991,"485",277,208,58,"13",45,0.1625,0.0625,0.1196
"13750",218973,1991,"295",117,178,217,"124",93,0.7949,0.6966,0.7356
"13751",219000,1991,"323",221,102,151,"41",110,0.4977,0.402,0.4675
"13752",219046,1991,"492",285,207,23,"5",18,0.0632,0.0242,0.0467
"13753",219082,1991,"209",110,99,9,"2",7,0.0636,0.0202,0.0431
"13754",219198,1991,"126",95,31,38,"8",30,0.3158,0.2581,0.3016
"13755",219259,1991,"511",258,253,45,"15",30,0.1163,0.0593,0.0881
"13756",219356,1991,"1306",657,649,189,"77",112,0.1705,0.1186,0.1447
"13757",219471,1991,"1150",661,489,223,"78",145,0.2194,0.1595,0.1939
"13758",219602,1991,"771",492,279,70,"14",56,0.1138,0.0502,0.0908
"13759",219709,1991,"238",146,92,68,"21",47,0.3219,0.2283,0.2857
"13760",219718,1991,"107",68,39,12,"6",6,0.0882,0.1538,0.1121
"13761",219949,1991,"165",88,77,26,"13",13,0.1477,0.1688,0.1576
"13762",220075,1991,"1599",950,649,149,"47",102,0.1074,0.0724,0.0932
"13763",220215,1991,"295",147,148,80,"38",42,0.2857,0.2568,0.2712
"13764",220613,1991,"368",185,183,62,"24",38,0.2054,0.1311,0.1685
"13765",220631,1991,"311",209,102,126,"40",86,0.4115,0.3922,0.4051
"13766",220710,1991,"154",80,74,50,"16",34,0.425,0.2162,0.3247
"13767",221351,1991,"379",208,171,258,"108",150,0.7212,0.6316,0.6807
"13768",221519,1991,"327",159,168,236,"118",118,0.7421,0.7024,0.7217
"13769",221731,1991,"90",38,52,18,"6",12,0.3158,0.1154,0.2
"13770",221847,1991,"1362",637,725,185,"57",128,0.2009,0.0786,0.1358
"13771",221892,1991,"193",113,80,46,"23",23,0.2035,0.2875,0.2383
"13772",222178,1991,"656",338,318,176,"75",101,0.2988,0.2358,0.2683
"13773",222983,1991,"307",173,134,187,"77",110,0.6358,0.5746,0.6091
"13774",223232,1991,"2150",1240,910,947,"347",600,0.4839,0.3813,0.4405
"13775",224004,1991,"116",72,44,26,"7",19,0.2639,0.1591,0.2241
"13776",224323,1991,"280",163,117,138,"50",88,0.5399,0.4274,0.4929
"13777",225432,1991,"570",299,271,10,"6",4,0.0134,0.0221,0.0175
"13778",225548,1991,"266",125,141,42,"14",28,0.224,0.0993,0.1579
"13779",225627,1991,"330",246,84,35,"4",31,0.126,0.0476,0.1061
"13780",226231,1991,"207",26,181,51,"44",7,0.2692,0.2431,0.2464
"13781",226833,1991,"708",332,376,14,"8",6,0.0181,0.0213,0.0198
"13782",227216,1991,"2085",1169,916,210,"62",148,0.1266,0.0677,0.1007
"13783",227331,1991,"361",278,83,38,"6",32,0.1151,0.0723,0.1053
"13784",227526,1991,"1116",534,582,91,"24",67,0.1255,0.0412,0.0815
"13785",227757,1991,"625",257,368,437,"239",198,0.7704,0.6495,0.6992
"13786",227845,1991,"347",198,149,67,"22",45,0.2273,0.1477,0.1931
"13787",227863,1991,"170",114,56,64,"22",42,0.3684,0.3929,0.3765
"13788",228042,1991,"156",79,77,27,"15",12,0.1519,0.1948,0.1731
"13789",228149,1991,"429",260,169,131,"43",88,0.3385,0.2544,0.3054
"13790",228246,1991,"1229",652,577,671,"289",382,0.5859,0.5009,0.546
"13791",228343,1991,"324",173,151,191,"89",102,0.5896,0.5894,0.5895
"13792",228431,1991,"2047",1234,813,353,"74",279,0.2261,0.091,0.1724
"13793",228459,1991,"2916",1634,1282,201,"61",140,0.0857,0.0476,0.0689
"13794",228501,1991,"335",123,212,19,"9",10,0.0813,0.0425,0.0567
"13795",228529,1991,"924",421,503,88,"35",53,0.1259,0.0696,0.0952
"13796",228705,1991,"979",465,514,49,"16",33,0.071,0.0311,0.0501
"13797",228723,1991,"6034",2816,3218,1454,"510",944,0.3352,0.1585,0.241
"13798",228769,1991,"1608",759,849,116,"45",71,0.0935,0.053,0.0721
"13799",228778,1991,"5850",2743,3107,1722,"723",999,0.3642,0.2327,0.2944
"13800",228787,1991,"99",50,49,21,"10",11,0.22,0.2041,0.2121
"13801",228796,1991,"1897",1005,892,45,"16",29,0.0289,0.0179,0.0237
"13802",228875,1991,"1212",745,467,417,"128",289,0.3879,0.2741,0.3441
"13803",228981,1991,"241",156,85,63,"20",43,0.2756,0.2353,0.2614
"13804",229018,1991,"46",26,20,5,"4",1,0.0385,0.2,0.1087
"13805",229027,1991,"1479",799,680,69,"27",42,0.0526,0.0397,0.0467
"13806",229115,1991,"2838",1439,1399,468,"167",301,0.2092,0.1194,0.1649
"13807",229780,1991,"133",79,54,28,"9",19,0.2405,0.1667,0.2105
"13808",229814,1991,"767",434,333,76,"16",60,0.1382,0.048,0.0991
"13809",230603,1991,"550",370,180,59,"11",48,0.1297,0.0611,0.1073
"13810",230728,1991,"1359",857,502,1,"1",0,0,0.002,7e-04
"13811",230764,1991,"1924",914,1010,268,"107",161,0.1761,0.1059,0.1393
"13812",230782,1991,"1403",810,593,100,"32",68,0.084,0.054,0.0713
"13813",231059,1991,"485",253,232,329,"145",184,0.7273,0.625,0.6784
"13814",231174,1991,"1821",929,892,884,"385",499,0.5371,0.4316,0.4854
"13815",231420,1991,"106",67,39,7,"2",5,0.0746,0.0513,0.066
"13816",231554,1991,"126",61,65,35,"15",20,0.3279,0.2308,0.2778
"13817",231624,1991,"1222",609,613,920,"413",507,0.8325,0.6737,0.7529
"13818",231712,1991,"443",287,156,44,"14",30,0.1045,0.0897,0.0993
"13819",232025,1991,"143",78,65,82,"36",46,0.5897,0.5538,0.5734
"13820",232043,1991,"201",129,72,95,"29",66,0.5116,0.4028,0.4726
"13821",232089,1991,"339",122,217,58,"29",29,0.2377,0.1336,0.1711
"13822",232186,1991,"1678",927,751,348,"106",242,0.2611,0.1411,0.2074
"13823",232265,1991,"1188",718,470,445,"112",333,0.4638,0.2383,0.3746
"13824",232423,1991,"2121",1223,898,1105,"381",724,0.592,0.4243,0.521
"13825",232557,1991,"849",451,398,146,"53",93,0.2062,0.1332,0.172
"13826",232566,1991,"634",465,169,223,"43",180,0.3871,0.2544,0.3517
"13827",232609,1991,"327",200,127,142,"47",95,0.475,0.3701,0.4343
"13828",232681,1991,"712",496,216,458,"123",335,0.6754,0.5694,0.6433
"13829",232706,1991,"211",159,52,81,"21",60,0.3774,0.4038,0.3839
"13830",232937,1991,"1543",920,623,95,"24",71,0.0772,0.0385,0.0616
"13831",232982,1991,"1363",685,678,161,"48",113,0.165,0.0708,0.1181
"13832",233277,1991,"1857",1122,735,365,"88",277,0.2469,0.1197,0.1966
"13833",233374,1991,"805",409,396,623,"294",329,0.8044,0.7424,0.7739
"13834",233426,1991,"421",267,154,188,"58",130,0.4869,0.3766,0.4466
"13835",233541,1991,"180",104,76,35,"10",25,0.2404,0.1316,0.1944
"13836",233897,1991,"326",155,171,52,"16",36,0.2323,0.0936,0.1595
"13837",233921,1991,"4407",1878,2529,1566,"697",869,0.4627,0.2756,0.3553
"13838",234030,1991,"1318",799,519,216,"65",151,0.189,0.1252,0.1639
"13839",234085,1991,"351",0,351,127,"127",0,NA,0.3618,0.3618
"13840",234155,1991,"1161",692,469,107,"12",95,0.1373,0.0256,0.0922
"13841",234164,1991,"382",196,186,53,"9",44,0.2245,0.0484,0.1387
"13842",235097,1991,"730",421,309,114,"40",74,0.1758,0.1294,0.1562
"13843",235167,1991,"445",263,182,173,"59",114,0.4335,0.3242,0.3888
"13844",236230,1991,"489",291,198,215,"63",152,0.5223,0.3182,0.4397
"13845",236328,1991,"696",395,301,401,"162",239,0.6051,0.5382,0.5761
"13846",236577,1991,"370",253,117,95,"27",68,0.2688,0.2308,0.2568
"13847",236595,1991,"390",229,161,133,"51",82,0.3581,0.3168,0.341
"13848",236896,1991,"282",132,150,55,"26",29,0.2197,0.1733,0.195
"13849",236939,1991,"1852",982,870,470,"171",299,0.3045,0.1966,0.2538
"13850",236948,1991,"3484",1788,1696,1287,"482",805,0.4502,0.2842,0.3694
"13851",237011,1991,"1547",921,626,288,"86",202,0.2193,0.1374,0.1862
"13852",237057,1991,"319",167,152,201,"82",119,0.7126,0.5395,0.6301
"13853",237066,1991,"240",141,99,94,"29",65,0.461,0.2929,0.3917
"13854",237215,1991,"305",163,142,9,"2",7,0.0429,0.0141,0.0295
"13855",237330,1991,"401",229,172,87,"32",55,0.2402,0.186,0.217
"13856",237358,1991,"141",80,61,13,"4",9,0.1125,0.0656,0.0922
"13857",237367,1991,"1034",567,467,83,"35",48,0.0847,0.0749,0.0803
"13858",237792,1991,"395",208,187,46,"16",30,0.1442,0.0856,0.1165
"13859",237899,1991,"475",227,248,15,"7",8,0.0352,0.0282,0.0316
"13860",237932,1991,"437",227,210,75,"25",50,0.2203,0.119,0.1716
"13861",237969,1991,"363",195,168,155,"44",111,0.5692,0.2619,0.427
"13862",238032,1991,"3307",1550,1757,796,"325",471,0.3039,0.185,0.2407
"13863",238333,1991,"261",147,114,135,"50",85,0.5782,0.4386,0.5172
"13864",238430,1991,"125",89,36,24,"7",17,0.191,0.1944,0.192
"13865",238458,1991,"275",168,107,132,"35",97,0.5774,0.3271,0.48
"13866",238476,1991,"401",227,174,183,"65",118,0.5198,0.3736,0.4564
"13867",238616,1991,"205",104,101,64,"27",37,0.3558,0.2673,0.3122
"13868",238661,1991,"126",96,30,17,"1",16,0.1667,0.0333,0.1349
"13869",239080,1991,"146",105,41,52,"10",42,0.4,0.2439,0.3562
"13870",239105,1991,"1598",852,746,870,"349",521,0.6115,0.4678,0.5444
"13871",239628,1991,"164",84,80,86,"35",51,0.6071,0.4375,0.5244
"13872",239716,1991,"442",262,180,288,"95",193,0.7366,0.5278,0.6516
"13873",240107,1991,"201",145,56,63,"14",49,0.3379,0.25,0.3134
"13874",240189,1991,"1765",990,775,200,"60",140,0.1414,0.0774,0.1133
"13875",240277,1991,"775",506,269,75,"21",54,0.1067,0.0781,0.0968
"13876",240329,1991,"1648",959,689,159,"57",102,0.1064,0.0827,0.0965
"13877",240338,1991,"71",45,26,20,"8",12,0.2667,0.3077,0.2817
"13878",240365,1991,"1411",787,624,136,"31",105,0.1334,0.0497,0.0964
"13879",240374,1991,"627",333,294,29,"11",18,0.0541,0.0374,0.0463
"13880",240417,1991,"1158",606,552,77,"19",58,0.0957,0.0344,0.0665
"13881",240426,1991,"443",220,223,24,"10",14,0.0636,0.0448,0.0542
"13882",240444,1991,"4582",2387,2195,1516,"589",927,0.3884,0.2683,0.3309
"13883",240453,1991,"1392",730,662,145,"53",92,0.126,0.0801,0.1042
"13884",240462,1991,"986",339,647,110,"56",54,0.1593,0.0866,0.1116
"13885",240471,1991,"1022",557,465,122,"48",74,0.1329,0.1032,0.1194
"13886",240480,1991,"1494",763,731,183,"62",121,0.1586,0.0848,0.1225
"13887",240727,1991,"1257",534,723,174,"73",101,0.1891,0.101,0.1384
"13888",243443,1991,"518",370,148,1,"0",1,0.0027,0,0.0019
"13889",243780,1991,"5754",2516,3238,1682,"790",892,0.3545,0.244,0.2923
