"","unitid","instnm","semester","quarter","year","instatetuition","costs","faculty","white_cohortsize","totcohortsize","w_cohortsize","m_cohortsize","tot4yrgrads","m_4yrgrads","w_4yrgrads","women_gradrate_4yr","men_gradrate_4yr","tot_gradrate_4yr","white_rate"
"1",100654,"ALABAMA A&M UNIVERSITY",1,0,1991,"1298","53.121007","223","11","1010",527,483,152,"32",120,0.2277,0.0663,0.1505,0.0109
"2",100654,"ALABAMA A&M UNIVERSITY",1,0,1992,"1600","52.536624","267","5","876",444,432,157,"46",111,0.25,0.1065,0.1792,0.0057
"3",100654,"ALABAMA A & M UNIVERSITY",1,0,1993,"1600","50.39972","262","7","1019",543,476,189,"55",134,0.2468,0.1155,0.1855,0.0069
"4",100654,"ALABAMA A & M UNIVERSITY",1,0,1995,"2022","68.024267","298","18","849",434,415,185,"47",138,0.318,0.1133,0.2179,0.0212
"5",100654,"ALABAMA A & M UNIVERSITY",1,0,1996,"2312","66.424951","311","17","716",372,344,147,"44",103,0.2769,0.1279,0.2053,0.0237
"6",100654,"ALABAMA A & M UNIVERSITY",1,0,1997,"2420","72.461862","306","22","789",412,377,159,"41",118,0.2864,0.1088,0.2015,0.0279
"7",100654,"ALABAMA A & M UNIVERSITY",1,0,1998,"2332","78.356177","237","25","995",518,477,182,"38",144,0.278,0.0797,0.1829,0.0251
"8",100654,"ALABAMA A & M UNIVERSITY",1,0,1999,"1932","75.868666","243","26","1111",550,561,97,"16",81,0.1473,0.0285,0.0873,0.0234
"9",100654,"ALABAMA A & M UNIVERSITY",1,0,2000,"2400","79.084093","273.5","26","1020",504,516,118,"24",94,0.1865,0.0465,0.1157,0.0255
"10",100654,"ALABAMA A & M UNIVERSITY",1,0,2001,"2400","96.538667","304","18","1038",541,497,138,"34",104,0.1922,0.0684,0.1329,0.0173
"11",100654,"ALABAMA A & M UNIVERSITY",1,0,2002,"2520","90.776734","284","18","1043",506,537,118,"37",81,0.1601,0.0689,0.1131,0.0173
"12",100654,"ALABAMA A & M UNIVERSITY",1,0,2003,"2832","107.761966","294","17","1287",673,614,112,"30",82,0.1218,0.0489,0.087,0.0132
"13",100654,"ALABAMA A & M UNIVERSITY",1,0,2004,"3120","110.994174","307","10","1198",611,587,146,"31",115,0.1882,0.0528,0.1219,0.0083
"14",100654,"Alabama A & M University",1,0,2005,"3120","118.90095","319","13","1088",572,516,116,"27",89,0.1556,0.0523,0.1066,0.0119
"15",100654,"Alabama A & M University",1,0,2006,"3120","123.859683","319","12","1133",584,549,110,"29",81,0.1387,0.0528,0.0971,0.0106
"16",100654,"Alabama A & M University",1,0,2007,"3432","126.371645","311","9","882",475,407,88,"21",67,0.1411,0.0516,0.0998,0.0102
"17",100654,"Alabama A & M University",1,0,2008,"3432","132.165814","309","7","1044",568,476,115,"23",92,0.162,0.0483,0.1102,0.0067
"18",100654,"Alabama A & M University",1,0,2009,"3948","122.977893","311","24","1042",537,505,115,"22",93,0.1732,0.0436,0.1104,0.023
"19",100654,"Alabama A & M University",1,0,2010,"4872","138.956247","276","15","1073",549,524,69,"18",51,0.0929,0.0344,0.0643,0.014
"20",100663,"UNIVERSITY OF ALABAMA AT BIRMINGHAM",0,1,1991,"2050","712.376923","709","600","937",500,437,82,"33",49,0.098,0.0755,0.0875,0.6403
"21",100663,"UNIVERSITY OF ALABAMA AT BIRMINGHAM",0,1,1992,"2238","812.820108","786","576","898",479,419,54,"19",35,0.0731,0.0453,0.0601,0.6414
"22",100663,"UNIVERSITY OF ALABAMA AT BIRMINGHAM",0,1,1993,"2358","910.784994","802","613","938",518,420,99,"31",68,0.1313,0.0738,0.1055,0.6535
"23",100663,"UNIVERSITY OF ALABAMA AT BIRMINGHAM",0,1,1995,"2604","937.402922","707","602","1052",599,453,128,"37",91,0.1519,0.0817,0.1217,0.5722
"24",100663,"UNIVERSITY OF ALABAMA AT BIRMINGHAM",0,1,1996,"2700","1024.898335","680","568","1027",597,430,134,"35",99,0.1658,0.0814,0.1305,0.5531
"25",100663,"UNIVERSITY OF ALABAMA AT BIRMINGHAM",0,1,1997,"2850","1075.711679","690","631","1115",657,458,161,"52",109,0.1659,0.1135,0.1444,0.5659
"26",100663,"UNIVERSITY OF ALABAMA AT BIRMINGHAM",0,1,1998,"3060","1188.3903","691","611","1076",646,430,164,"48",116,0.1796,0.1116,0.1524,0.5678
"27",100663,"UNIVERSITY OF ALABAMA AT BIRMINGHAM",0,1,1999,"2730","1180.033219","708","667","1143",678,465,163,"59",104,0.1534,0.1269,0.1426,0.5836
"28",100663,"UNIVERSITY OF ALABAMA AT BIRMINGHAM",0,1,2000,"2820","1215.222121","564.5","653","1234",748,486,173,"51",122,0.1631,0.1049,0.1402,0.5292
"29",100663,"UNIVERSITY OF ALABAMA AT BIRMINGHAM",1,0,2001,"2970","1334.286573","421","648","1224",765,459,175,"57",118,0.1542,0.1242,0.143,0.5294
"30",100663,"UNIVERSITY OF ALABAMA AT BIRMINGHAM",1,0,2002,"3150","1335.089128","804","775","1398",820,578,228,"86",142,0.1732,0.1488,0.1631,0.5544
"31",100663,"UNIVERSITY OF ALABAMA AT BIRMINGHAM",1,0,2003,"3480","1440.737915","833","781","1607",1042,565,266,"61",205,0.1967,0.108,0.1655,0.486
"32",100663,"UNIVERSITY OF ALABAMA AT BIRMINGHAM",1,0,2004,"3840","1571.319289","810","846","1536",973,563,284,"82",202,0.2076,0.1456,0.1849,0.5508
"33",100663,"University of Alabama at Birmingham",1,0,2005,"3960","1604.47474","824","875","1515",895,620,350,"110",240,0.2682,0.1774,0.231,0.5776
"34",100663,"University of Alabama at Birmingham",1,0,2006,"3960","1707.177796","824","905","1485",895,590,378,"124",254,0.2838,0.2102,0.2545,0.6094
"35",100663,"University of Alabama at Birmingham",1,0,2007,"3384","1824.09488","852","835","1378",807,571,404,"137",267,0.3309,0.2399,0.2932,0.606
"36",100663,"University of Alabama at Birmingham",1,0,2008,"3792","2213.659961","849","790","1246",710,536,406,"140",266,0.3746,0.2612,0.3258,0.634
"37",100663,"University of Alabama at Birmingham",1,0,2009,"4224","2223.549388","832","932","1494",819,675,474,"188",286,0.3492,0.2785,0.3173,0.6238
"38",100663,"University of Alabama at Birmingham",1,0,2010,"5806","2338.666019","861","921","1537",851,686,463,"176",287,0.3373,0.2566,0.3012,0.5992
"39",100751,"THE UNIVERSITY OF ALABAMA",1,0,1991,"1936","237.693778","818","2174","2511",1348,1163,630,"213",417,0.3093,0.1831,0.2509,0.8658
"40",100751,"THE UNIVERSITY OF ALABAMA",1,0,1992,"2068","237.079401","773","2075","2436",1310,1126,684,"240",444,0.3389,0.2131,0.2808,0.8518
"41",100751,"THE UNIVERSITY OF ALABAMA",1,0,1993,"2172","257.63431","762","2148","2516",1318,1198,638,"231",407,0.3088,0.1928,0.2536,0.8537
"42",100751,"THE UNIVERSITY OF ALABAMA",1,0,1995,"2374","294.397959","770","2133","2493",1387,1106,748,"246",502,0.3619,0.2224,0.3,0.8556
"43",100751,"THE UNIVERSITY OF ALABAMA",1,0,1996,"2470","295.929705","738","1777","2049",1195,854,744,"240",504,0.4218,0.281,0.3631,0.8673
"44",100751,"THE UNIVERSITY OF ALABAMA",1,0,1997,"2594","306.024341","750","2111","2572",1403,1169,859,"307",552,0.3934,0.2626,0.334,0.8208
"45",100751,"UNIVERSITY OF ALABAMA",1,0,1998,"2684","320.186995","781","2088","2597",1437,1160,857,"269",588,0.4092,0.2319,0.33,0.804
"46",100751,"UNIVERSITY OF ALABAMA",1,0,1999,"2872","341.218829","795","2216","2687",1499,1188,948,"309",639,0.4263,0.2601,0.3528,0.8247
"47",100751,"UNIVERSITY OF ALABAMA",1,0,2000,"3014","357.569083","787","2357","2886",1653,1233,1038,"303",735,0.4446,0.2457,0.3597,0.8167
"48",100751,"UNIVERSITY OF ALABAMA",1,0,2001,"3292","380.9844","779","2047","2384",1342,1042,920,"313",607,0.4523,0.3004,0.3859,0.8586
"49",100751,"UNIVERSITY OF ALABAMA",1,0,2002,"3556","372.067854","794","2230","2585",1441,1144,932,"318",614,0.4261,0.278,0.3605,0.8627
"50",100751,"UNIVERSITY OF ALABAMA",1,0,2003,"4134","392.176082","810","2584","2982",1685,1297,1121,"364",757,0.4493,0.2806,0.3759,0.8665
"51",100751,"THE UNIVERSITY OF ALABAMA",1,0,2004,"4630","404.323227","800","2873","3290",1853,1437,1248,"426",822,0.4436,0.2965,0.3793,0.8733
"52",100751,"The University of Alabama",1,0,2005,"4864","449.794843","813","3048","3642",2038,1604,1373,"491",882,0.4328,0.3061,0.377,0.8369
"53",100751,"The University of Alabama",1,0,2006,"5278","496.55614","850","3609","4275",2377,1898,1757,"660",1097,0.4615,0.3477,0.411,0.8442
"54",100751,"The University of Alabama",1,0,2007,"5700","565.427668","904","3890","4438",2461,1977,1897,"708",1189,0.4831,0.3581,0.4274,0.8765
"55",100751,"The University of Alabama",1,0,2008,"6400","629.500088","1067","4280","5009",2776,2233,1942,"703",1239,0.4463,0.3148,0.3877,0.8545
"56",100751,"The University of Alabama",1,0,2009,"7000","658.67213","1106","4221","5062",2746,2316,2093,"772",1321,0.4811,0.3333,0.4135,0.8339
"57",100751,"The University of Alabama",1,0,2010,"7900","760.107259","1175","4332","5443",3006,2437,2387,"856",1531,0.5093,0.3513,0.4385,0.7959
"58",100858,"AUBURN UNIVERSITY MAIN CAMPUS",0,1,1991,"1596","306.252082","1128","2704","3024",1496,1528,846,"312",534,0.357,0.2042,0.2798,0.8942
"59",100858,"AUBURN UNIVERSITY MAIN CAMPUS",0,1,1992,"1755","304.074934","1098","2864","3141",1621,1520,927,"295",632,0.3899,0.1941,0.2951,0.9118
"60",100858,"AUBURN UNIVERSITY MAIN CAMPUS",0,1,1993,"1950","321.990528","1109","2703","2997",1552,1445,878,"286",592,0.3814,0.1979,0.293,0.9019
"61",100858,"AUBURN UNIVERSITY MAIN CAMPUS",0,1,1995,"2250","368.840182","1131","3175","3486",1832,1654,1106,"345",761,0.4154,0.2086,0.3173,0.9108
"62",100858,"AUBURN UNIVERSITY MAIN CAMPUS",0,1,1996,"2355","372.270174","1145","2985","3287",1746,1541,1321,"446",875,0.5011,0.2894,0.4019,0.9081
"63",100858,"AUBURN UNIVERSITY MAIN CAMPUS",0,1,1997,"2565","376.471708","1145","2879","3140",1676,1464,1165,"385",780,0.4654,0.263,0.371,0.9169
"64",100858,"AUBURN UNIVERSITY MAIN CAMPUS",0,1,1998,"2760","393.068124","1139","3278","3654",1913,1741,1229,"415",814,0.4255,0.2384,0.3363,0.8971
"65",100858,"AUBURN UNIVERSITY MAIN CAMPUS",0,1,1999,"2895","425.358257","1146","3253","3693",1875,1818,1189,"393",796,0.4245,0.2162,0.322,0.8809
"66",100858,"AUBURN UNIVERSITY MAIN CAMPUS",1,0,2000,"3050","488.80635","1130.5","3459","3861",1990,1871,1277,"451",826,0.4151,0.241,0.3307,0.8959
"67",100858,"AUBURN UNIVERSITY MAIN CAMPUS",1,0,2001,"3260","506.522984","1115","3258","3739",1949,1790,1284,"468",816,0.4187,0.2615,0.3434,0.8714
"68",100858,"AUBURN UNIVERSITY MAIN CAMPUS",1,0,2002,"3650","481.701655","1142","3596","4148",2184,1964,1424,"498",926,0.424,0.2536,0.3433,0.8669
"69",100858,"AUBURN UNIVERSITY MAIN CAMPUS",1,0,2003,"4230","526.647346","1171","3174","3692",1965,1727,1352,"444",908,0.4621,0.2571,0.3662,0.8597
"70",100858,"AUBURN UNIVERSITY MAIN CAMPUS",1,0,2004,"4610","552.886023","1177","3032","3579",1849,1730,1279,"445",834,0.4511,0.2572,0.3574,0.8472
"71",100858,"Auburn University Main Campus",1,0,2005,"4800","573.09999","1176","3543","4179",2180,1999,1491,"511",980,0.4495,0.2556,0.3568,0.8478
"72",100858,"Auburn University Main Campus",1,0,2006,"5000","580.566562","1139","3328","4072",2168,1904,1556,"549",1007,0.4645,0.2883,0.3821,0.8173
"73",100858,"Auburn University Main Campus",1,0,2007,"5250","642.808641","1132","3414","4165",2207,1958,1565,"548",1017,0.4608,0.2799,0.3758,0.8197
"74",100858,"Auburn University Main Campus",1,0,2008,"5880","703.588583","1176","3493","3967",2049,1918,1676,"627",1049,0.512,0.3269,0.4225,0.8805
"75",100858,"Auburn University Main Campus",1,0,2009,"6240","722.464527","1184","3363","3911",2007,1904,1733,"617",1116,0.5561,0.3241,0.4431,0.8599
"76",100858,"Auburn University",1,0,2010,"7008","717.034324","1196","3523","4193",2204,1989,1963,"730",1233,0.5594,0.367,0.4682,0.8402
"77",101435,"HUNTINGDON COLLEGE",1,0,1991,"6400","9.473699","44","158","189",101,88,60,"25",35,0.3465,0.2841,0.3175,0.836
"78",101435,"HUNTINGDON COLLEGE",1,0,1992,"7140","10.171244","43","135","166",91,75,53,"14",39,0.4286,0.1867,0.3193,0.8133
"79",101435,"HUNTINGDON COLLEGE",1,0,1993,"7540","9.918171","44","107","125",80,45,40,"7",33,0.4125,0.1556,0.32,0.856
"80",101435,"HUNTINGDON COLLEGE",1,0,1995,"8645","10.530401","41","146","160",106,54,56,"17",39,0.3679,0.3148,0.35,0.9125
"81",101435,"HUNTINGDON COLLEGE",1,0,1996,"10140","12.489609","43","140","165",95,70,62,"16",46,0.4842,0.2286,0.3758,0.8485
"82",101435,"HUNTINGDON COLLEGE",1,0,1997,"10600","9.579237","43","177","191",114,77,89,"28",61,0.5351,0.3636,0.466,0.9267
"83",101435,"HUNTINGDON COLLEGE",1,0,1998,"11010","10.739266","44","158","175",96,79,88,"31",57,0.5938,0.3924,0.5029,0.9029
"84",101435,"HUNTINGDON COLLEGE",1,0,1999,"10500","11.769099","47","144","163",103,60,58,"14",44,0.4272,0.2333,0.3558,0.8834
"85",101435,"HUNTINGDON COLLEGE",1,0,2000,"11000","12.917579","44.5","134","151",95,56,67,"21",46,0.4842,0.375,0.4437,0.8874
"86",101435,"HUNTINGDON COLLEGE",1,0,2001,"11500","12.94124","42","128","146",96,50,58,"13",45,0.4688,0.26,0.3973,0.8767
"87",101435,"HUNTINGDON COLLEGE",1,0,2002,"13800","12.133992","41","146","165",108,57,76,"21",55,0.5093,0.3684,0.4606,0.8848
"88",101435,"HUNTINGDON COLLEGE",1,0,2003,"14560","13.021025","32","171","203",76,127,72,"30",42,0.5526,0.2362,0.3547,0.8424
"89",101435,"HUNTINGDON COLLEGE",1,0,2004,"15250","13.742147","32","160","192",72,120,71,"38",33,0.4583,0.3167,0.3698,0.8333
"90",101435,"Huntingdon College",1,0,2005,"15250","13.561949","33","159","185",90,95,78,"34",44,0.4889,0.3579,0.4216,0.8595
"91",101435,"Huntingdon College",1,0,2006,"15990","14.376885","34","172","214",85,129,72,"36",36,0.4235,0.2791,0.3364,0.8037
"92",101435,"Huntingdon College",1,0,2007,"17570","16.195889","42","201","257",117,140,78,"23",55,0.4701,0.1643,0.3035,0.7821
"93",101435,"Huntingdon College",1,0,2008,"19320","17.149742","44","196","253",106,147,76,"28",48,0.4528,0.1905,0.3004,0.7747
"94",101435,"Huntingdon College",1,0,2009,"19990","19.613024","45","169","237",99,138,58,"30",28,0.2828,0.2174,0.2447,0.7131
"95",101435,"Huntingdon College",1,0,2010,"18512","18.270813","47","184","271",113,158,71,"30",41,0.3628,0.1899,0.262,0.679
"96",101480,"JACKSONVILLE STATE UNIVERSITY",1,0,1991,"1420","44.735235","274","829","1100",567,533,109,"42",67,0.1182,0.0788,0.0991,0.7536
"97",101480,"JACKSONVILLE STATE UNIVERSITY",1,0,1992,"1550","44.403204","274","847","1106",615,491,116,"34",82,0.1333,0.0692,0.1049,0.7658
"98",101480,"JACKSONVILLE STATE UNIVERSITY",1,0,1993,"1680","44.253729","272","648","845",436,409,89,"24",65,0.1491,0.0587,0.1053,0.7669
"99",101480,"JACKSONVILLE STATE UNIVERSITY",1,0,1995,"1840","51.527144","268","618","798",435,363,136,"36",100,0.2299,0.0992,0.1704,0.7744
"100",101480,"JACKSONVILLE STATE UNIVERSITY",1,0,1996,"1940","52.688204","255","613","817",446,371,122,"23",99,0.222,0.062,0.1493,0.7503
"101",101480,"JACKSONVILLE STATE UNIVERSITY",1,0,1997,"2040","53.384594","261","582","764",401,363,123,"43",80,0.1995,0.1185,0.161,0.7618
"102",101480,"JACKSONVILLE STATE UNIVERSITY",1,0,1998,"2140","54.851891","262","573","752",392,360,112,"34",78,0.199,0.0944,0.1489,0.762
"103",101480,"JACKSONVILLE STATE UNIVERSITY",1,0,1999,"2440","59.640691","262","592","805",455,350,142,"44",98,0.2154,0.1257,0.1764,0.7354
"104",101480,"JACKSONVILLE STATE UNIVERSITY",1,0,2000,"2640","64.126745","263.5","587","850",443,407,127,"39",88,0.1986,0.0958,0.1494,0.6906
"105",101480,"JACKSONVILLE STATE UNIVERSITY",1,0,2001,"2940","68.845362","265","569","877",480,397,146,"40",106,0.2208,0.1008,0.1665,0.6488
"106",101480,"JACKSONVILLE STATE UNIVERSITY",1,0,2002,"3240","73.23187","289","748","1059",567,492,146,"41",105,0.1852,0.0833,0.1379,0.7063
"107",101480,"JACKSONVILLE STATE UNIVERSITY",1,0,2003,"3540","78.141276","294","686","1044",561,483,139,"45",94,0.1676,0.0932,0.1331,0.6571
"108",101480,"JACKSONVILLE STATE UNIVERSITY",1,0,2004,"4040","79.000229","300","657","1017",555,462,91,"20",71,0.1279,0.0433,0.0895,0.646
"109",101480,"Jacksonville State University",1,0,2005,"4040","88.692595","305","673","1120",595,525,120,"37",83,0.1395,0.0705,0.1071,0.6009
"110",101480,"Jacksonville State University",1,0,2006,"4056","94.012203","319","631","1106",626,480,106,"23",83,0.1326,0.0479,0.0958,0.5705
"111",101480,"Jacksonville State University",1,0,2007,"4056","102.010171","321","633","1252",696,556,127,"44",83,0.1193,0.0791,0.1014,0.5056
"112",101480,"Jacksonville State University",1,0,2008,"4560","106.1911","322","693","1243",663,580,108,"31",77,0.1161,0.0534,0.0869,0.5575
"113",101480,"Jacksonville State University",1,0,2009,"5970","107.21413","322","649","1220",695,525,137,"30",107,0.154,0.0571,0.1123,0.532
"114",101480,"Jacksonville State University",1,0,2010,"6780","111.994117","326","755","1246",685,561,180,"55",125,0.1825,0.098,0.1445,0.6059
"115",101675,"MILES COLLEGE",1,0,1991,"3760","6.785208","33","0","365",144,221,73,"41",32,0.2222,0.1855,0.2,0
"116",101675,"MILES COLLEGE",1,0,1992,"3800","7.000046","34","2","226",108,118,107,"52",55,0.5093,0.4407,0.4735,0.0088
"117",101675,"MILES COLLEGE",1,0,1993,"3800","7.467967","33","2","331",164,167,162,"67",95,0.5793,0.4012,0.4894,0.006
"118",101675,"MILES COLLEGE",1,0,1995,"4350","10.602918","41","0","229",114,115,120,"50",70,0.614,0.4348,0.524,0
"119",101675,"MILES COLLEGE",1,0,1996,"4500","11.588039","43","0","327",146,181,125,"58",67,0.4589,0.3204,0.3823,0
"120",101675,"MILES COLLEGE",1,0,1997,"4500","13.616614","45","0","374",169,205,3,"2",1,0.0059,0.0098,0.008,0
"121",101675,"MILES COLLEGE",1,0,1998,"4500","15.120712","47","2","340",177,163,133,"51",82,0.4633,0.3129,0.3912,0.0059
"122",101675,"MILES COLLEGE",1,0,1999,"4280","16.935835","59","1","319",170,149,113,"21",92,0.5412,0.1409,0.3542,0.0031
"123",101675,"MILES COLLEGE",1,0,2000,"4408","18.476231","62.5","0","425",220,205,85,"19",66,0.3,0.0927,0.2,0
"124",101675,"MILES COLLEGE",1,0,2001,"4408","19.047068","66","4","423",213,210,29,"9",20,0.0939,0.0429,0.0686,0.0095
"125",101675,"MILES COLLEGE",1,0,2002,"4628","21.703299","87","1","391",195,196,24,"7",17,0.0872,0.0357,0.0614,0.0026
"126",101675,"MILES COLLEGE",1,0,2003,"5090","20.421086","111","0","347",179,168,24,"6",18,0.1006,0.0357,0.0692,0
"127",101675,"MILES COLLEGE",1,0,2004,"5250","17.764171","89","2","427",203,224,49,"9",40,0.197,0.0402,0.1148,0.0047
"128",101675,"Miles College",1,0,2005,"5408","18.373152","92","1","389",177,212,25,"4",21,0.1186,0.0189,0.0643,0.0026
"129",101675,"Miles College",1,0,2006,"5950","19.562214","93","3","352",159,193,15,"3",12,0.0755,0.0155,0.0426,0.0085
"130",101675,"Miles College",1,0,2007,"6545","23.29124","94","10","486",246,240,29,"7",22,0.0894,0.0292,0.0597,0.0206
"131",101675,"Miles College",1,0,2008,"7396","22.606683","102","7","461",213,248,38,"5",33,0.1549,0.0202,0.0824,0.0152
"132",101675,"Miles College",1,0,2009,"8506","24.123076","102","3","392",179,213,21,"4",17,0.095,0.0188,0.0536,0.0077
"133",101675,"Miles College",1,0,2010,"9186","25.168124","97","2","343",141,202,44,"18",26,0.1844,0.0891,0.1283,0.0058
"134",101879,"UNIVERSITY OF NORTH ALABAMA",1,0,1991,"1296","28.93073","190","664","755",387,368,66,"23",43,0.1111,0.0625,0.0874,0.8795
"135",101879,"UNIVERSITY OF NORTH ALABAMA",1,0,1992,"1460","30.634016","196","490","554",321,233,74,"24",50,0.1558,0.103,0.1336,0.8845
"136",101879,"UNIVERSITY OF NORTH ALABAMA",1,0,1993,"1586","33.092961","200","567","651",371,280,83,"16",67,0.1806,0.0571,0.1275,0.871
"137",101879,"UNIVERSITY OF NORTH ALABAMA",1,0,1995,"1910","37.547819","197","638","762",444,318,167,"44",123,0.277,0.1384,0.2192,0.8373
"138",101879,"UNIVERSITY OF NORTH ALABAMA",1,0,1996,"1998","37.667269","200","650","790",459,331,99,"28",71,0.1547,0.0846,0.1253,0.8228
"139",101879,"UNIVERSITY OF NORTH ALABAMA",1,0,1997,"2166","38.513136","193","648","751",448,303,111,"20",91,0.2031,0.066,0.1478,0.8628
"140",101879,"UNIVERSITY OF NORTH ALABAMA",1,0,1998,"2256","41.281971","181","648","828",490,338,118,"28",90,0.1837,0.0828,0.1425,0.7826
"141",101879,"UNIVERSITY OF NORTH ALABAMA",1,0,1999,"2232","43.498762","203","650","809",473,336,127,"28",99,0.2093,0.0833,0.157,0.8035
"142",101879,"UNIVERSITY OF NORTH ALABAMA",1,0,2000,"2328","46.720676","199.5","677","824",481,343,143,"35",108,0.2245,0.102,0.1735,0.8216
"143",101879,"UNIVERSITY OF NORTH ALABAMA",1,0,2001,"2544","48.111718","196","636","816",465,351,147,"36",111,0.2387,0.1026,0.1801,0.7794
"144",101879,"UNIVERSITY OF NORTH ALABAMA",1,0,2002,"2784","47.26531","198","586","786",457,329,104,"27",77,0.1685,0.0821,0.1323,0.7455
"145",101879,"UNIVERSITY OF NORTH ALABAMA",1,0,2003,"3048","50.438912","199","597","789",479,310,142,"37",105,0.2192,0.1194,0.18,0.7567
"146",101879,"UNIVERSITY OF NORTH ALABAMA",1,0,2004,"3336","52.826544","200","668","856",469,387,107,"27",80,0.1706,0.0698,0.125,0.7804
"147",101879,"University of North Alabama",1,0,2005,"3432","58.125931","208","678","982",526,456,2,"1",1,0.0019,0.0022,0.002,0.6904
"148",101879,"University of North Alabama",1,0,2006,"3528","64.738869","222","622","1019",575,444,112,"26",86,0.1496,0.0586,0.1099,0.6104
"149",101879,"University of North Alabama",1,0,2007,"3288","72.409169","231","654","1023",558,465,126,"31",95,0.1703,0.0667,0.1232,0.6393
"150",101879,"University of North Alabama",1,0,2008,"4590","83.331019","242","639","988",533,455,119,"34",85,0.1595,0.0747,0.1204,0.6468
"151",101879,"University of North Alabama",1,0,2009,"4008","83.368742","236","775","1064",597,467,122,"33",89,0.1491,0.0707,0.1147,0.7284
"152",101879,"University of North Alabama",1,0,2010,"4440","83.854799","238","744","961",562,399,152,"43",109,0.194,0.1078,0.1582,0.7742
"153",102049,"SAMFORD UNIVERSITY",1,0,1991,"6540","48.240502","188","536","569",337,232,217,"89",128,0.3798,0.3836,0.3814,0.942
"154",102049,"SAMFORD UNIVERSITY",1,0,1992,"7064","52.026138","203","621","662",405,257,295,"108",187,0.4617,0.4202,0.4456,0.9381
"155",102049,"SAMFORD UNIVERSITY",1,0,1993,"7770","58.215039","215","648","680",438,242,318,"117",201,0.4589,0.4835,0.4676,0.9529
"156",102049,"SAMFORD UNIVERSITY",1,0,1995,"8648","61.973118","233","617","647",399,248,331,"118",213,0.5338,0.4758,0.5116,0.9536
"157",102049,"SAMFORD UNIVERSITY",1,0,1996,"9070","86.74612","236","606","646",388,258,329,"117",212,0.5464,0.4535,0.5093,0.9381
"158",102049,"SAMFORD UNIVERSITY",1,0,1997,"9432","76.461427","240","708","745",470,275,405,"139",266,0.566,0.5055,0.5436,0.9503
"159",102049,"SAMFORD UNIVERSITY",1,0,1998,"9904","72.105189","245","594","625",390,235,316,"110",206,0.5282,0.4681,0.5056,0.9504
"160",102049,"SAMFORD UNIVERSITY",1,0,1999,"10300","73.424281","243","627","674",420,254,353,"120",233,0.5548,0.4724,0.5237,0.9303
"161",102049,"SAMFORD UNIVERSITY",1,0,2000,"10738","78.166781","250","607","657",427,230,359,"122",237,0.555,0.5304,0.5464,0.9239
"162",102049,"SAMFORD UNIVERSITY",1,0,2001,"11490","78.71243","257","597","658",434,224,354,"109",245,0.5645,0.4866,0.538,0.9073
"163",102049,"SAMFORD UNIVERSITY",1,0,2002,"12294","85.76749","260","618","652",428,224,5,"0",5,0.0117,0,0.0077,0.9479
"164",102049,"SAMFORD UNIVERSITY",1,0,2003,"13154","86.860401","264","615","682",426,256,362,"123",239,0.561,0.4805,0.5308,0.9018
"165",102049,"SAMFORD UNIVERSITY",1,0,2004,"13944","92.465026","267","621","665",423,242,359,"111",248,0.5863,0.4587,0.5398,0.9338
"166",102049,"Samford University",1,0,2005,"14642","98.361913","278","634","699",457,242,358,"93",265,0.5799,0.3843,0.5122,0.907
"167",102049,"Samford University",1,0,2006,"16000","108.518914","280","591","644",392,252,326,"99",227,0.5791,0.3929,0.5062,0.9177
"168",102049,"Samford University",1,0,2007,"17920","121.606795","280","651","711",459,252,348,"112",236,0.5142,0.4444,0.4895,0.9156
"169",102049,"Samford University",1,0,2008,"19300","117.199761","290","616","705",442,263,336,"104",232,0.5249,0.3954,0.4766,0.8738
"170",102049,"Samford University",1,0,2009,"20200","121.097466","282","670","730",486,244,430,"132",298,0.6132,0.541,0.589,0.9178
"171",102049,"Samford University",1,0,2010,"21722","123.327778","294","616","711",455,256,417,"132",285,0.6264,0.5156,0.5865,0.8664
"172",102094,"UNIVERSITY OF SOUTH ALABAMA",0,1,1991,"2103","266.417287","430","1030","1245",653,592,117,"32",85,0.1302,0.0541,0.094,0.8273
"173",102094,"UNIVERSITY OF SOUTH ALABAMA",0,1,1992,"2295","290.55175","418","978","1170",668,502,123,"38",85,0.1272,0.0757,0.1051,0.8359
"174",102094,"UNIVERSITY OF SOUTH ALABAMA",0,1,1993,"2295","350.467594","434","898","1086",621,465,125,"38",87,0.1401,0.0817,0.1151,0.8269
"175",102094,"UNIVERSITY OF SOUTH ALABAMA",0,1,1995,"2541","367.218425","447","985","1192",674,518,167,"54",113,0.1677,0.1042,0.1401,0.8263
"176",102094,"UNIVERSITY OF SOUTH ALABAMA",0,1,1996,"2538","373.112188","442","883","1066",590,476,147,"37",110,0.1864,0.0777,0.1379,0.8283
"177",102094,"UNIVERSITY OF SOUTH ALABAMA",0,1,1997,"2673","394.685767","432","903","1132",663,469,138,"38",100,0.1508,0.081,0.1219,0.7977
"178",102094,"UNIVERSITY OF SOUTH ALABAMA",1,0,1998,"2673","416.897664","435","799","1044",618,426,143,"36",107,0.1731,0.0845,0.137,0.7653
"179",102094,"UNIVERSITY OF SOUTH ALABAMA",1,0,1999,"2670","409.090635","442","668","882",521,361,122,"22",100,0.1919,0.0609,0.1383,0.7574
"180",102094,"UNIVERSITY OF SOUTH ALABAMA",1,0,2000,"2670","452.443943","436","810","1064",679,385,167,"46",121,0.1782,0.1195,0.157,0.7613
"181",102094,"UNIVERSITY OF SOUTH ALABAMA",1,0,2001,"2910","449.822503","430","850","1116",634,482,160,"40",120,0.1893,0.083,0.1434,0.7616
"182",102094,"UNIVERSITY OF SOUTH ALABAMA",1,0,2002,"3090","477.3036","441","777","1004",597,407,135,"42",93,0.1558,0.1032,0.1345,0.7739
"183",102094,"UNIVERSITY OF SOUTH ALABAMA",1,0,2003,"3390","496.382826","475","851","1218",704,514,155,"42",113,0.1605,0.0817,0.1273,0.6987
"184",102094,"UNIVERSITY OF SOUTH ALABAMA",1,0,2004,"3810","436.46","483","882","1278",725,553,180,"60",120,0.1655,0.1085,0.1408,0.6901
"185",102094,"University of South Alabama",1,0,2005,"3810","450.544","499","836","1198",689,509,199,"62",137,0.1988,0.1218,0.1661,0.6978
"186",102094,"University of South Alabama",1,0,2006,"3810","469.628","516","941","1355",777,578,190,"55",135,0.1737,0.0952,0.1402,0.6945
"187",102094,"University of South Alabama",1,0,2007,"4020","493.508","527","991","1457",801,656,200,"68",132,0.1648,0.1037,0.1373,0.6802
"188",102094,"University of South Alabama",1,0,2008,"4410","548.782","530","1055","1543",875,668,230,"68",162,0.1851,0.1018,0.1491,0.6837
"189",102094,"University of South Alabama",1,0,2009,"4860","562.493","503","1146","1753",927,826,244,"83",161,0.1737,0.1005,0.1392,0.6537
"190",102094,"University of South Alabama",1,0,2010,"5448","573.547","514","1074","1707",950,757,262,"83",179,0.1884,0.1096,0.1535,0.6292
"191",102234,"SPRING HILL COLLEGE",1,0,1991,"10149","18.709855","64","229","279",158,121,106,"42",64,0.4051,0.3471,0.3799,0.8208
"192",102234,"SPRING HILL COLLEGE",1,0,1992,"10763","18.42923","57","255","295",167,128,144,"58",86,0.515,0.4531,0.4881,0.8644
"193",102234,"SPRING HILL COLLEGE",1,0,1993,"11425","19.042301","55","205","229",129,100,106,"43",63,0.4884,0.43,0.4629,0.8952
"194",102234,"SPRING HILL COLLEGE",1,0,1995,"12489","20.612518","61","198","232",141,91,113,"34",79,0.5603,0.3736,0.4871,0.8534
"195",102234,"SPRING HILL COLLEGE",1,0,1996,"13140","21.565846","61","176","201",121,80,96,"32",64,0.5289,0.4,0.4776,0.8756
"196",102234,"SPRING HILL COLLEGE",1,0,1997,"13890","17.727197","60","221","254",144,110,118,"55",63,0.4375,0.5,0.4646,0.8701
"197",102234,"SPRING HILL COLLEGE",1,0,1998,"14620","20.023521","64","210","242",119,123,120,"61",59,0.4958,0.4959,0.4959,0.8678
"198",102234,"SPRING HILL COLLEGE",1,0,1999,"14390","20.704","65","241","299",182,117,147,"43",104,0.5714,0.3675,0.4916,0.806
"199",102234,"SPRING HILL COLLEGE",1,0,2000,"15254","22.569348","66.5","244","284",186,98,158,"47",111,0.5968,0.4796,0.5563,0.8592
"200",102234,"SPRING HILL COLLEGE",1,0,2001,"16170","23.952361","68","190","251",137,114,112,"39",73,0.5328,0.3421,0.4462,0.757
"201",102234,"SPRING HILL COLLEGE",1,0,2002,"16980","24.734786","68","241","289",168,121,151,"60",91,0.5417,0.4959,0.5225,0.8339
"202",102234,"SPRING HILL COLLEGE",1,0,2003,"17830","25.78484","67","225","308",193,115,157,"61",96,0.4974,0.5304,0.5097,0.7305
"203",102234,"SPRING HILL COLLEGE",1,0,2004,"18722","26.409427","69","222","309",203,106,156,"44",112,0.5517,0.4151,0.5049,0.7184
"204",102234,"Spring Hill College",1,0,2005,"19658","28.409001","72","200","274",173,101,139,"49",90,0.5202,0.4851,0.5073,0.7299
"205",102234,"Spring Hill College",1,0,2006,"20650","32.584827","77","238","345",226,119,189,"62",127,0.5619,0.521,0.5478,0.6899
"206",102234,"Spring Hill College",1,0,2007,"21686","34.750036","80","289","380",243,137,179,"65",114,0.4691,0.4745,0.4711,0.7605
"207",102234,"Spring Hill College",1,0,2008,"22770","37.500046","82","234","344",213,131,175,"62",113,0.5305,0.4733,0.5087,0.6802
"208",102234,"Spring Hill College",1,0,2009,"23910","39.028934","82","248","355",203,152,152,"55",97,0.4778,0.3618,0.4282,0.6986
"209",102234,"Spring Hill College",1,0,2010,"25110","36.655935","78","268","392",252,140,180,"56",124,0.4921,0.4,0.4592,0.6837
"210",102368,"TROY STATE UNIVERSITY-MAIN CAMPUS",0,1,1991,"1470","36.500128","182","641","793",437,356,205,"70",135,0.3089,0.1966,0.2585,0.8083
"211",102368,"TROY STATE UNIVERSITY-MAIN CAMPUS",0,1,1992,"1617","39.403478","188","742","935",460,475,217,"73",144,0.313,0.1537,0.2321,0.7936
"212",102368,"TROY STATE UNIVERSITY-MAIN CAMPUS",0,1,1993,"1771","52.144416","204","731","926",526,400,303,"108",195,0.3707,0.27,0.3272,0.7894
"213",102368,"TROY STATE UNIVERSITY-MAIN CAMPUS",0,1,1995,"2007","59.881931","216","711","877",477,400,354,"120",234,0.4906,0.3,0.4036,0.8107
"214",102368,"TROY STATE UNIVERSITY-MAIN CAMPUS",0,1,1996,"2175","52.167403","221","658","877",483,394,340,"133",207,0.4286,0.3376,0.3877,0.7503
"215",102368,"TROY STATE UNIVERSITY-MAIN CAMPUS",0,1,1997,"2250","53.495511","218","612","803",474,329,307,"109",198,0.4177,0.3313,0.3823,0.7621
"216",102368,"TROY STATE UNIVERSITY-MAIN CAMPUS",0,1,1998,"2490","56.335477","167","501","768",437,331,251,"75",176,0.4027,0.2266,0.3268,0.6523
"217",102368,"TROY STATE UNIVERSITY-MAIN CAMPUS",1,0,1999,"2660","78.209915","169","571","845",510,335,271,"85",186,0.3647,0.2537,0.3207,0.6757
"218",102368,"TROY STATE UNIVERSITY-MAIN CAMPUS",1,0,2000,"2850","83.562191","217","568","941",513,428,271,"105",166,0.3236,0.2453,0.288,0.6036
"219",102368,"TROY STATE UNIVERSITY-MAIN CAMPUS",1,0,2001,"3020","88.22592","265","666","1054",572,482,211,"71",140,0.2448,0.1473,0.2002,0.6319
"220",102368,"TROY STATE UNIVERSITY-MAIN CAMPUS",1,0,2002,"3220","90.731765","307","810","1353",730,623,288,"101",187,0.2562,0.1621,0.2129,0.5987
"221",102368,"TROY STATE UNIVERSITY-MAIN CAMPUS",1,0,2003,"3530","104.401201","314","757","1229",672,557,215,"66",149,0.2217,0.1185,0.1749,0.6159
"222",102368,"TROY STATE UNIVERSITY-MAIN CAMPUS",1,0,2004,"3850","116.282391","316","866","1450",788,662,230,"67",163,0.2069,0.1012,0.1586,0.5972
"223",102368,"Troy University",1,0,2005,"4004","169.294425","443","834","1434",789,645,201,"64",137,0.1736,0.0992,0.1402,0.5816
"224",102368,"Troy University",1,0,2006,"4004","181.050422","444","930","1666",964,702,238,"77",161,0.167,0.1097,0.1429,0.5582
"225",102368,"Troy University",1,0,2007,"4164","201.157077","440","958","1763",1011,752,222,"75",147,0.1454,0.0997,0.1259,0.5434
"226",102368,"Troy University",1,0,2008,"4248","218.678633","449","988","1827",1081,746,246,"76",170,0.1573,0.1019,0.1346,0.5408
"227",102368,"Troy University",1,0,2009,"4632","242.41268","490","988","1997",1192,805,265,"78",187,0.1569,0.0969,0.1327,0.4947
"228",102368,"Troy University",1,0,2010,"5184","255.743537","577","949","1810",1083,727,295,"97",198,0.1828,0.1334,0.163,0.5243
"229",102377,"TUSKEGEE UNIVERSITY",1,0,1991,"6250","60.856009","249","2","837",469,368,167,"70",97,0.2068,0.1902,0.1995,0.0024
"230",102377,"TUSKEGEE UNIVERSITY",1,0,1992,"6535","65.595003","251","0","612",311,301,123,"36",87,0.2797,0.1196,0.201,0
"231",102377,"TUSKEGEE UNIVERSITY",1,0,1993,"6734","73.512513","254","0","595",302,293,104,"39",65,0.2152,0.1331,0.1748,0
"232",102377,"TUSKEGEE UNIVERSITY",1,0,1995,"7424","73.370861","274","0","645",383,262,139,"35",104,0.2715,0.1336,0.2155,0
"233",102377,"TUSKEGEE UNIVERSITY",1,0,1996,"8020","72.95511","256","1","810",497,313,180,"34",146,0.2938,0.1086,0.2222,0.0012
"234",102377,"TUSKEGEE UNIVERSITY",1,0,1997,"8662","68.289959","227","0","713",466,247,179,"29",150,0.3219,0.1174,0.2511,0
"235",102377,"TUSKEGEE UNIVERSITY",1,0,1998,"9060","84.325","231","0","683",412,271,154,"37",117,0.284,0.1365,0.2255,0
"236",102377,"TUSKEGEE UNIVERSITY",1,0,1999,"9500","79.664577","231","0","679",400,279,119,"27",92,0.23,0.0968,0.1753,0
"237",102377,"TUSKEGEE UNIVERSITY",1,0,2000,"9928","86.656778","233.5","0","591",354,237,149,"37",112,0.3164,0.1561,0.2521,0
"238",102377,"TUSKEGEE UNIVERSITY",1,0,2001,"10326","90.352899","236","0","645",375,270,108,"41",67,0.1787,0.1519,0.1674,0
"239",102377,"TUSKEGEE UNIVERSITY",1,0,2002,"10584","92.177733","271","0","738",426,312,168,"36",132,0.3099,0.1154,0.2276,0
"240",102377,"TUSKEGEE UNIVERSITY",1,0,2003,"11060","101.410121","261","0","528",272,256,82,"32",50,0.1838,0.125,0.1553,0
"241",102377,"TUSKEGEE UNIVERSITY",1,0,2004,"11290","101.317797","215","3","701",389,312,123,"35",88,0.2262,0.1122,0.1755,0.0043
"242",102377,"Tuskegee University",1,0,2005,"11690","102.716507","232","2","730",385,345,112,"30",82,0.213,0.087,0.1534,0.0027
"243",102377,"Tuskegee University",1,0,2006,"12400","102.156714","275","2","688",395,293,151,"33",118,0.2987,0.1126,0.2195,0.0029
"244",102377,"Tuskegee University",1,0,2007,"13520","104.148884","291","2","796",444,352,133,"31",102,0.2297,0.0881,0.1671,0.0025
"245",102377,"Tuskegee University",1,0,2008,"14740","109.385376","269","1","722",414,308,154,"44",110,0.2657,0.1429,0.2133,0.0014
"246",102377,"Tuskegee University",1,0,2009,"15630","115.530127","273","2","688",410,278,123,"25",98,0.239,0.0899,0.1788,0.0029
"247",102377,"Tuskegee University",1,0,2010,"16100","119.607385","281","0","701",393,308,228,"99",129,0.3282,0.3214,0.3252,0
"248",104151,"ARIZONA STATE UNIVERSITY",1,0,1991,"1528","473.9779","1514","1864","2447",1214,1233,442,"174",268,0.2208,0.1411,0.1806,0.7617
"249",104151,"ARIZONA STATE UNIVERSITY",1,0,1992,"1590","473.75","1556","2149","2901",1503,1398,452,"162",290,0.1929,0.1159,0.1558,0.7408
"250",104151,"ARIZONA STATE UNIVERSITY-MAIN CAMPUS",1,0,1993,"1844","441.428551","1383","2489","3298",1637,1661,561,"203",358,0.2187,0.1222,0.1701,0.7547
"251",104151,"ARIZONA STATE UNIVERSITY-MAIN CAMPUS",1,0,1995,"1950","500.596","1499","2893","3945",2096,1849,854,"299",555,0.2648,0.1617,0.2165,0.7333
"252",104151,"ARIZONA STATE UNIVERSITY-MAIN CAMPUS",1,0,1996,"2009","555.281","1487","2963","4001",2117,1884,1028,"398",630,0.2976,0.2113,0.2569,0.7406
"253",104151,"ARIZONA STATE UNIVERSITY-MAIN CAMPUS",1,0,1997,"2058","561.256","1530","3683","4938",2646,2292,1284,"448",836,0.3159,0.1955,0.26,0.7458
"254",104151,"ARIZONA STATE UNIVERSITY-MAIN CAMPUS",1,0,1998,"2158","620.425","1569","3471","4753",2561,2192,1270,"480",790,0.3085,0.219,0.2672,0.7303
"255",104151,"ARIZONA STATE UNIVERSITY-MAIN CAMPUS",1,0,1999,"2188","645.967","1554","3845","5625",3096,2529,1505,"522",983,0.3175,0.2064,0.2676,0.6836
"256",104151,"ARIZONA STATE UNIVERSITY-MAIN CAMPUS",1,0,2000,"2272","672.878","1561","4179","5763",3058,2705,1615,"596",1019,0.3332,0.2203,0.2802,0.7251
"257",104151,"ARIZONA STATE UNIVERSITY-MAIN CAMPUS",1,0,2001,"2412","725.092","1568","4379","5950",3157,2793,1649,"599",1050,0.3326,0.2145,0.2771,0.736
"258",104151,"ARIZONA STATE UNIVERSITY-MAIN CAMPUS",1,0,2002,"2508","724.043","1573","4323","6094",3323,2771,1813,"661",1152,0.3467,0.2385,0.2975,0.7094
"259",104151,"ARIZONA STATE UNIVERSITY-MAIN CAMPUS",1,0,2003,"3508","754.534","1565","4801","6815",3652,3163,1997,"730",1267,0.3469,0.2308,0.293,0.7045
"260",104151,"ARIZONA STATE UNIVERSITY AT THE TEMPE CAMPUS",1,0,2004,"3973","836.313","1637","5111","7293",3998,3295,2324,"816",1508,0.3772,0.2476,0.3187,0.7008
"261",104151,"Arizona State University at the Tempe Campus",1,0,2005,"4311","941.477","1693","5361","7927",4267,3660,2561,"996",1565,0.3668,0.2721,0.3231,0.6763
"262",104151,"Arizona State University at the Tempe Campus",1,0,2006,"4591","1032.345","1660","5722","8533",4556,3977,2837,"1145",1692,0.3714,0.2879,0.3325,0.6706
"263",104151,"Arizona State University at the Tempe Campus",1,0,2007,"4821","1105.217","1715","4900","7308",3775,3533,2753,"1126",1627,0.431,0.3187,0.3767,0.6705
"264",104151,"Arizona State University",1,0,2008,"5409","1467.051","2392","4273","6743",3320,3423,2886,"1224",1662,0.5006,0.3576,0.428,0.6337
"265",104151,"Arizona State University",1,0,2009,"5997","1465.566","2371","4270","6747",3279,3468,3054,"1335",1719,0.5242,0.3849,0.4526,0.6329
"266",104151,"Arizona State University",1,0,2010,"7793","1522.401","2416","3773","6210",2997,3213,3071,"1409",1662,0.5546,0.4385,0.4945,0.6076
"267",104179,"UNIVERSITY OF ARIZONA",1,0,1991,"1528","653.920638","1537","2959","3970",2063,1907,786,"297",489,0.237,0.1557,0.198,0.7453
"268",104179,"UNIVERSITY OF ARIZONA",1,0,1992,"1528","659.330337","1513","2847","3803",1926,1877,814,"302",512,0.2658,0.1609,0.214,0.7486
"269",104179,"UNIVERSITY OF ARIZONA",1,0,1993,"1778","697.957633","1349","3124","4287",2254,2033,968,"317",651,0.2888,0.1559,0.2258,0.7287
"270",104179,"UNIVERSITY OF ARIZONA",1,0,1995,"1884","756.377936","1360","3116","4370",2382,1988,1160,"405",755,0.317,0.2037,0.2654,0.713
"271",104179,"UNIVERSITY OF ARIZONA",1,0,1996,"2009","757.527117","1386","2899","4006",2102,1904,1145,"441",704,0.3349,0.2316,0.2858,0.7237
"272",104179,"UNIVERSITY OF ARIZONA",1,0,1997,"2058","788.321093","1370","3213","4431",2409,2022,1294,"463",831,0.345,0.229,0.292,0.7251
"273",104179,"UNIVERSITY OF ARIZONA",1,0,1998,"2158","823.883956","1352","3725","5088",2773,2315,1595,"590",1005,0.3624,0.2549,0.3135,0.7321
"274",104179,"UNIVERSITY OF ARIZONA",1,0,1999,"0","874.441223","1348","3721","5126",2745,2381,1626,"623",1003,0.3654,0.2617,0.3172,0.7259
"275",104179,"UNIVERSITY OF ARIZONA",1,0,2000,"0","931.689062","1364","3984","5443",2924,2519,1613,"618",995,0.3403,0.2453,0.2963,0.7319
"276",104179,"UNIVERSITY OF ARIZONA",1,0,2001,"0","982.115345","1380","4087","5727",3005,2722,1871,"717",1154,0.384,0.2634,0.3267,0.7136
"277",104179,"UNIVERSITY OF ARIZONA",1,0,2002,"0","978.144","1375","3946","5613",3008,2605,1805,"703",1102,0.3664,0.2699,0.3216,0.703
"278",104179,"UNIVERSITY OF ARIZONA",1,0,2003,"3508","1048.994","1362","3980","5780",3154,2626,1870,"708",1162,0.3684,0.2696,0.3235,0.6886
"279",104179,"UNIVERSITY OF ARIZONA",1,0,2004,"3998","1133.915","1364","3704","5566",3008,2558,1880,"723",1157,0.3846,0.2826,0.3378,0.6655
"280",104179,"University of Arizona",1,0,2005,"4394","1190.179","1538","3970","5785",3115,2670,2104,"820",1284,0.4122,0.3071,0.3637,0.6863
"281",104179,"University of Arizona",1,0,2006,"4594","1262.364","1578","3794","5788",3092,2696,2085,"813",1272,0.4114,0.3016,0.3602,0.6555
"282",104179,"University of Arizona",1,0,2007,"4824","1323.213","1590","4152","6231",3395,2836,2485,"976",1509,0.4445,0.3441,0.3988,0.6663
"283",104179,"University of Arizona",1,0,2008,"5274","1416.181","1593","4133","6331",3377,2954,2536,"1017",1519,0.4498,0.3443,0.4006,0.6528
"284",104179,"University of Arizona",1,0,2009,"6540","1446.773","1546","4241","6782",3697,3085,2922,"1146",1776,0.4804,0.3715,0.4308,0.6253
"285",104179,"University of Arizona",1,0,2010,"7614","1466.454","1527","3962","6797",3629,3168,2847,"1137",1710,0.4712,0.3589,0.4189,0.5829
"286",105330,"NORTHERN ARIZONA UNIVERSITY",1,0,1991,"1528","148.950758","623","1470","1881",1064,817,294,"97",197,0.1852,0.1187,0.1563,0.7815
"287",105330,"NORTHERN ARIZONA UNIVERSITY",1,0,1992,"1528","155.940767","608","1645","2095",1203,892,315,"104",211,0.1754,0.1166,0.1504,0.7852
"288",105330,"NORTHERN ARIZONA UNIVERSITY",1,0,1993,"1844","162.427337","608","1537","1930",1090,840,306,"103",203,0.1862,0.1226,0.1585,0.7964
"289",105330,"NORTHERN ARIZONA UNIVERSITY",1,0,1995,"1950","192.500577","673","1612","2015",1120,895,436,"133",303,0.2705,0.1486,0.2164,0.8
"290",105330,"NORTHERN ARIZONA UNIVERSITY",1,0,1996,"2009","205.629327","637","1867","2267",1288,979,538,"170",368,0.2857,0.1736,0.2373,0.8236
"291",105330,"NORTHERN ARIZONA UNIVERSITY",1,0,1997,"2058","219.898838","650","1676","1983",1169,814,530,"154",376,0.3216,0.1892,0.2673,0.8452
"292",105330,"NORTHERN ARIZONA UNIVERSITY",1,0,1998,"2160","234.6708","654","1695","2073",1188,885,554,"176",378,0.3182,0.1989,0.2672,0.8177
"293",105330,"NORTHERN ARIZONA UNIVERSITY",1,0,1999,"2188","240.092866","661","1772","2162",1278,884,562,"166",396,0.3099,0.1878,0.2599,0.8196
"294",105330,"NORTHERN ARIZONA UNIVERSITY",1,0,2000,"2272","248.33077","684.5","1870","2273",1384,889,613,"174",439,0.3172,0.1957,0.2697,0.8227
"295",105330,"NORTHERN ARIZONA UNIVERSITY",1,0,2001,"2412","260.664243","708","1769","2146",1299,847,609,"169",440,0.3387,0.1995,0.2838,0.8243
"296",105330,"NORTHERN ARIZONA UNIVERSITY",1,0,2002,"2507","267.07699","698","1718","2153",1327,826,681,"173",508,0.3828,0.2094,0.3163,0.798
"297",105330,"NORTHERN ARIZONA UNIVERSITY",1,0,2003,"3508","269.094817","711","1670","2114",1249,865,644,"196",448,0.3587,0.2266,0.3046,0.79
"298",105330,"NORTHERN ARIZONA UNIVERSITY",1,0,2004,"3983","279.23603","710","1769","2274",1309,965,652,"190",462,0.3529,0.1969,0.2867,0.7779
"299",105330,"Northern Arizona University",1,0,2005,"4223","287.261627","723","1622","2101",1268,833,645,"174",471,0.3715,0.2089,0.307,0.772
"300",105330,"Northern Arizona University",1,0,2006,"4376","321.198515","751","1931","2527",1488,1039,756,"224",532,0.3575,0.2156,0.2992,0.7641
"301",105330,"Northern Arizona University",1,0,2007,"4594","341.17368","767","2166","2880",1676,1204,868,"261",607,0.3622,0.2168,0.3014,0.7521
"302",105330,"Northern Arizona University",1,0,2008,"5144","369.979882","802","2437","3248",1899,1349,1078,"316",762,0.4013,0.2342,0.3319,0.7503
"303",105330,"Northern Arizona University",1,0,2009,"6092","368.342789","804","2390","3377",1951,1426,1122,"354",768,0.3936,0.2482,0.3322,0.7077
"304",105330,"Northern Arizona University",1,0,2010,"5431","369.372061","825","2486","3739",2209,1530,1354,"442",912,0.4129,0.2889,0.3621,0.6649
"305",106245,"UNIVERSITY OF ARKANSAS AT LITTLE ROCK",1,0,1991,"1806","66.930952","413","729","941",536,405,45,"14",31,0.0578,0.0346,0.0478,0.7747
"306",106245,"UNIVERSITY OF ARKANSAS AT LITTLE ROCK",1,0,1992,"1902","74.966885","387","781","1092",600,492,61,"23",38,0.0633,0.0467,0.0559,0.7152
"307",106245,"UNIVERSITY OF ARKANSAS AT LITTLE ROCK",1,0,1993,"2098","85.383784","398","613","966",565,401,59,"12",47,0.0832,0.0299,0.0611,0.6346
"308",106245,"UNIVERSITY OF ARKANSAS AT LITTLE ROCK",1,0,1995,"2368","91.48445","367","456","675",390,285,103,"37",66,0.1692,0.1298,0.1526,0.6756
"309",106245,"UNIVERSITY OF ARKANSAS AT LITTLE ROCK",1,0,1996,"2538","94.81335","351","437","691",429,262,65,"18",47,0.1096,0.0687,0.0941,0.6324
"310",106245,"UNIVERSITY OF ARKANSAS AT LITTLE ROCK",1,0,1997,"2538","99.547218","362","503","841",503,338,46,"13",33,0.0656,0.0385,0.0547,0.5981
"311",106245,"UNIVERSITY OF ARKANSAS AT LITTLE ROCK",1,0,1998,"2616","100.785364","369","506","865",539,326,93,"22",71,0.1317,0.0675,0.1075,0.585
"312",106245,"UNIVERSITY OF ARKANSAS AT LITTLE ROCK",1,0,1999,"2424","104.557569","371","466","826",518,308,51,"12",39,0.0753,0.039,0.0617,0.5642
"313",106245,"UNIVERSITY OF ARKANSAS AT LITTLE ROCK",1,0,2000,"2544","111.990298","407.5","424","836",484,352,73,"28",45,0.093,0.0795,0.0873,0.5072
"314",106245,"UNIVERSITY OF ARKANSAS AT LITTLE ROCK",1,0,2001,"2664","118.712945","444","392","703",410,293,57,"19",38,0.0927,0.0648,0.0811,0.5576
"315",106245,"UNIVERSITY OF ARKANSAS AT LITTLE ROCK",1,0,2002,"2850","135.560539","449","419","739",456,283,72,"19",53,0.1162,0.0671,0.0974,0.567
"316",106245,"UNIVERSITY OF ARKANSAS AT LITTLE ROCK",1,0,2003,"3024","125.262422","488","373","691",405,286,29,"9",20,0.0494,0.0315,0.042,0.5398
"317",106245,"UNIVERSITY OF ARKANSAS AT LITTLE ROCK",1,0,2004,"3216","129.817233","496","410","759",452,307,54,"18",36,0.0796,0.0586,0.0711,0.5402
"318",106245,"University of Arkansas at Little Rock",1,0,2005,"3384","137.975421","513","403","762",445,317,64,"24",40,0.0899,0.0757,0.084,0.5289
"319",106245,"University of Arkansas at Little Rock",1,0,2006,"3552","147.070389","505","334","603",317,286,40,"19",21,0.0662,0.0664,0.0663,0.5539
"320",106245,"University of Arkansas at Little Rock",1,0,2007,"4612","162.940924","474","449","812",471,341,57,"28",29,0.0616,0.0821,0.0702,0.553
"321",106245,"University of Arkansas at Little Rock",1,0,2008,"4890","165.415216","513","345","618",375,243,50,"23",27,0.072,0.0947,0.0809,0.5583
"322",106245,"University of Arkansas at Little Rock",1,0,2009,"5040","172.642915","542","367","674",387,287,74,"27",47,0.1214,0.0941,0.1098,0.5445
"323",106245,"University of Arkansas at Little Rock",1,0,2010,"5228","183.646086","507","370","683",376,307,80,"40",40,0.1064,0.1303,0.1171,0.5417
"324",106342,"ARKANSAS COLLEGE",1,0,1991,"7040","11.115733","47","109","121",79,42,48,"17",31,0.3924,0.4048,0.3967,0.9008
"325",106342,"ARKANSAS COLLEGE",1,0,1992,"7603","11.154947","43","118","138",80,58,51,"21",30,0.375,0.3621,0.3696,0.8551
"326",106342,"ARKANSAS COLLEGE",1,0,1993,"8060","12.06755","42","159","166",84,82,65,"29",36,0.4286,0.3537,0.3916,0.9578
"327",106342,"LYON COLLEGE",1,0,1995,"8990","14.551215","45","152","168",90,78,82,"32",50,0.5556,0.4103,0.4881,0.9048
"328",106342,"LYON COLLEGE",1,0,1996,"9490","15.341143","41","113","129",69,60,60,"22",38,0.5507,0.3667,0.4651,0.876
"329",106342,"LYON COLLEGE",1,0,1997,"10100","15.219613","42","110","125",63,62,54,"19",35,0.5556,0.3065,0.432,0.88
"330",106342,"LYON COLLEGE",1,0,1998,"10526","12.912261","44","96","107",65,42,56,"21",35,0.5385,0.5,0.5234,0.8972
"331",106342,"LYON COLLEGE",1,0,1999,"10272","11.973992","42","119","141",79,62,82,"33",49,0.6203,0.5323,0.5816,0.844
"332",106342,"LYON COLLEGE",1,0,2000,"10580","12.620318","41.5","113","127",71,56,74,"30",44,0.6197,0.5357,0.5827,0.8898
"333",106342,"LYON COLLEGE",1,0,2001,"11000","13.249037","41","116","129",80,49,68,"20",48,0.6,0.4082,0.5271,0.8992
"334",106342,"LYON COLLEGE",1,0,2002,"11540","14.038655","42","100","113",47,66,62,"33",29,0.617,0.5,0.5487,0.885
"335",106342,"LYON COLLEGE",1,0,2003,"11990","14.475051","44","102","120",67,53,53,"23",30,0.4478,0.434,0.4417,0.85
"336",106342,"LYON COLLEGE",1,0,2004,"12710","15.217678","44","114","141",66,75,62,"37",25,0.3788,0.4933,0.4397,0.8085
"337",106342,"Lyon College",1,0,2005,"13475","15.596827","44","100","111",61,50,45,"20",25,0.4098,0.4,0.4054,0.9009
"338",106342,"Lyon College",1,0,2006,"14420","16.768221","43","106","128",61,67,56,"27",29,0.4754,0.403,0.4375,0.8281
"339",106342,"Lyon College",1,0,2007,"15466","16.838872","44","117","143",84,59,62,"19",43,0.5119,0.322,0.4336,0.8182
"340",106342,"Lyon College",1,0,2008,"18500","17.219269","44","83","102",52,50,50,"25",25,0.4808,0.5,0.4902,0.8137
"341",106342,"Lyon College",1,0,2009,"19424","17.198309","41","181","216",114,102,75,"39",36,0.3158,0.3824,0.3472,0.838
"342",106342,"Lyon College",1,0,2010,"21100","16.384601","43","154","198",107,91,70,"29",41,0.3832,0.3187,0.3535,0.7778
"343",106397,"UNIVERSITY OF ARKANSAS-FAYETTEVILLE",1,0,1991,"1732","223.112331","771","1989","2327",1080,1247,381,"170",211,0.1954,0.1363,0.1637,0.8547
"344",106397,"UNIVERSITY OF ARKANSAS-FAYETTEVILLE",1,0,1992,"1838","235.65706","790","2047","2327",1066,1261,394,"165",229,0.2148,0.1308,0.1693,0.8797
"345",106397,"UNIVERSITY OF ARKANSAS AT FAYETTEVILLE",1,0,1993,"1946","258.492229","806","1753","2015",964,1051,401,"158",243,0.2521,0.1503,0.199,0.87
"346",106397,"UNIVERSITY OF ARKANSAS AT FAYETTEVILLE",1,0,1995,"2130","262.437478","808","1863","2249",1148,1101,425,"155",270,0.2352,0.1408,0.189,0.8284
"347",106397,"UNIVERSITY OF ARKANSAS AT FAYETTEVILLE",1,0,1996,"2639","273.752564","770","1784","2174",1105,1069,490,"184",306,0.2769,0.1721,0.2254,0.8206
"348",106397,"UNIVERSITY OF ARKANSAS AT FAYETTEVILLE",1,0,1997,"2896","295.246981","828","1770","2125",1077,1048,515,"191",324,0.3008,0.1823,0.2424,0.8329
"349",106397,"UNIVERSITY OF ARKANSAS AT FAYETTEVILLE",1,0,1998,"3119","304.079692","810","2085","2456",1245,1211,665,"246",419,0.3365,0.2031,0.2708,0.8489
"350",106397,"UNIVERSITY OF ARKANSAS AT FAYETTEVILLE",1,0,1999,"2800","328.070118","796","1791","2189",1123,1066,666,"235",431,0.3838,0.2205,0.3042,0.8182
"351",106397,"UNIVERSITY OF ARKANSAS MAIN CAMPUS",1,0,2000,"2968","358.103265","796.5","1848","2179",1092,1087,645,"246",399,0.3654,0.2263,0.296,0.8481
"352",106397,"UNIVERSITY OF ARKANSAS MAIN CAMPUS",1,0,2001,"3116","405.021129","797","1877","2190",1126,1064,718,"290",428,0.3801,0.2726,0.3279,0.8571
"353",106397,"UNIVERSITY OF ARKANSAS MAIN CAMPUS",1,0,2002,"3573","418.897605","791","1792","2137",1106,1031,707,"284",423,0.3825,0.2755,0.3308,0.8386
"354",106397,"UNIVERSITY OF ARKANSAS MAIN CAMPUS",1,0,2003,"3810","452.004811","792","1942","2260",1175,1085,775,"318",457,0.3889,0.2931,0.3429,0.8593
"355",106397,"UNIVERSITY OF ARKANSAS MAIN CAMPUS",1,0,2004,"4115","447.253852","797","2053","2420",1222,1198,835,"329",506,0.4141,0.2746,0.345,0.8483
"356",106397,"University of Arkansas Main Campus",1,0,2005,"4361","474.902451","905","2224","2662",1324,1338,913,"375",538,0.4063,0.2803,0.343,0.8355
"357",106397,"University of Arkansas Main Campus",1,0,2006,"4590","522.232149","922","2318","2719",1346,1373,945,"398",547,0.4064,0.2899,0.3476,0.8525
"358",106397,"University of Arkansas Main Campus",1,0,2007,"4772","538.384622","874","2421","2877",1425,1452,1055,"456",599,0.4204,0.314,0.3667,0.8415
"359",106397,"University of Arkansas Main Campus",1,0,2008,"5010","586.75709","908","2487","2977",1488,1489,1108,"475",633,0.4254,0.319,0.3722,0.8354
"360",106397,"University of Arkansas",1,0,2009,"5010","613.97157","908","2409","2890",1448,1442,1129,"466",663,0.4579,0.3232,0.3907,0.8336
"361",106397,"University of Arkansas",1,0,2010,"5211","634.57647","952","3079","3774",1929,1845,1596,"634",962,0.4987,0.3436,0.4229,0.8158
"362",106412,"UNIVERSITY OF ARKANSAS-PINE BLUFF",1,0,1991,"1451","34.656117","165","67","650",393,257,55,"15",40,0.1018,0.0584,0.0846,0.1031
"363",106412,"UNIVERSITY OF ARKANSAS-PINE BLUFF",1,0,1992,"1451","30.591311","167","57","592",341,251,27,"9",18,0.0528,0.0359,0.0456,0.0963
"364",106412,"UNIVERSITY OF ARKANSAS AT PINE BLUFF",1,0,1993,"1584","33.71504","192","40","735",379,356,52,"15",37,0.0976,0.0421,0.0707,0.0544
"365",106412,"UNIVERSITY OF ARKANSAS AT PINE BLUFF",1,0,1995,"1788","38.780538","185","15","565",302,263,39,"11",28,0.0927,0.0418,0.069,0.0265
"366",106412,"UNIVERSITY OF ARKANSAS AT PINE BLUFF",1,0,1996,"1860","40.701007","183","7","575",302,273,47,"12",35,0.1159,0.044,0.0817,0.0122
"367",106412,"UNIVERSITY OF ARKANSAS AT PINE BLUFF",1,0,1997,"2046","41.22223","176","12","608",297,311,51,"12",39,0.1313,0.0386,0.0839,0.0197
"368",106412,"UNIVERSITY OF ARKANSAS AT PINE BLUFF",1,0,1998,"2082","43.528471","175","13","721",372,349,70,"22",48,0.129,0.063,0.0971,0.018
"369",106412,"UNIVERSITY OF ARKANSAS AT PINE BLUFF",1,0,1999,"2058","47.659621","173","8","656",341,315,76,"20",56,0.1642,0.0635,0.1159,0.0122
"370",106412,"UNIVERSITY OF ARKANSAS AT PINE BLUFF",1,0,2000,"2400","51.173248","172","11","629",330,299,43,"13",30,0.0909,0.0435,0.0684,0.0175
"371",106412,"UNIVERSITY OF ARKANSAS AT PINE BLUFF",1,0,2001,"2490","62.741754","171","7","700",371,329,97,"21",76,0.2049,0.0638,0.1386,0.01
"372",106412,"UNIVERSITY OF ARKANSAS AT PINE BLUFF",1,0,2002,"2664","56.905131","168","10","712",358,354,63,"16",47,0.1313,0.0452,0.0885,0.014
"373",106412,"UNIVERSITY OF ARKANSAS AT PINE BLUFF",1,0,2003,"2820","58.111077","167","11","731",333,398,47,"12",35,0.1051,0.0302,0.0643,0.015
"374",106412,"UNIVERSITY OF ARKANSAS AT PINE BLUFF",1,0,2004,"3000","60.114488","168","10","690",365,325,47,"14",33,0.0904,0.0431,0.0681,0.0145
"375",106412,"University of Arkansas at Pine Bluff",1,0,2005,"3150","63.387112","164","13","714",349,365,74,"24",50,0.1433,0.0658,0.1036,0.0182
"376",106412,"University of Arkansas at Pine Bluff",1,0,2006,"3300","69.434213","160","7","688",340,348,55,"18",37,0.1088,0.0517,0.0799,0.0102
"377",106412,"University of Arkansas at Pine Bluff",1,0,2007,"3300","66.401932","164","8","786",411,375,44,"10",34,0.0827,0.0267,0.056,0.0102
"378",106412,"University of Arkansas at Pine Bluff",1,0,2008,"3450","68.436091","167","11","952",504,448,93,"21",72,0.1429,0.0469,0.0977,0.0116
"379",106412,"University of Arkansas at Pine Bluff",1,0,2009,"3540","71.718237","173","14","959",523,436,67,"16",51,0.0975,0.0367,0.0699,0.0146
"380",106412,"University of Arkansas at Pine Bluff",1,0,2010,"3750","73.752906","171","9","780",393,387,51,"13",38,0.0967,0.0336,0.0654,0.0115
"381",106458,"ARKANSAS STATE UNIVERSITY MAIN CAMPUS",1,0,1991,"1420","68.184205","403","1225","1521",833,688,147,"44",103,0.1236,0.064,0.0966,0.8054
"382",106458,"ARKANSAS STATE UNIVERSITY MAIN CAMPUS",1,0,1992,"1610","75.067613","410","1259","1607",855,752,164,"48",116,0.1357,0.0638,0.1021,0.7834
"383",106458,"ARKANSAS STATE UNIVERSITY-MAIN CAMPUS",1,0,1993,"1810","83.087326","393","1272","1487",812,675,190,"66",124,0.1527,0.0978,0.1278,0.8554
"384",106458,"ARKANSAS STATE UNIVERSITY-MAIN CAMPUS",1,0,1995,"1950","81.921797","404","1213","1448",803,645,218,"65",153,0.1905,0.1008,0.1506,0.8377
"385",106458,"ARKANSAS STATE UNIVERSITY-MAIN CAMPUS",1,0,1996,"1970","87.108046","405","1320","1592",893,699,216,"64",152,0.1702,0.0916,0.1357,0.8291
"386",106458,"ARKANSAS STATE UNIVERSITY-MAIN CAMPUS",1,0,1997,"2280","93.326043","435","1399","1687",922,765,249,"89",160,0.1735,0.1163,0.1476,0.8293
"387",106458,"ARKANSAS STATE UNIVERSITY-MAIN CAMPUS",1,0,1998,"2804","99.212246","422","1393","1705",928,777,270,"68",202,0.2177,0.0875,0.1584,0.817
"388",106458,"ARKANSAS STATE UNIVERSITY-MAIN CAMPUS",1,0,1999,"2352","108.026388","422","1347","1654",937,717,303,"92",211,0.2252,0.1283,0.1832,0.8144
"389",106458,"ARKANSAS STATE UNIVERSITY-MAIN CAMPUS",1,0,2000,"2520","118.268552","425.5","1301","1591",893,698,307,"97",210,0.2352,0.139,0.193,0.8177
"390",106458,"ARKANSAS STATE UNIVERSITY-MAIN CAMPUS",1,0,2001,"3360","125.768133","429","1325","1594",921,673,309,"86",223,0.2421,0.1278,0.1939,0.8312
"391",106458,"ARKANSAS STATE UNIVERSITY-MAIN CAMPUS",1,0,2002,"3570","131.818689","432","1254","1539",813,726,291,"109",182,0.2239,0.1501,0.1891,0.8148
"392",106458,"ARKANSAS STATE UNIVERSITY-MAIN CAMPUS",1,0,2003,"3750","127.872344","446","1111","1426",798,628,233,"70",163,0.2043,0.1115,0.1634,0.7791
"393",106458,"ARKANSAS STATE UNIVERSITY-MAIN CAMPUS",1,0,2004,"4035","134.879325","454","907","1296",749,547,212,"71",141,0.1883,0.1298,0.1636,0.6998
"394",106458,"Arkansas State University-Main Campus",1,0,2005,"4260","141.965861","447","1068","1483",826,657,288,"108",180,0.2179,0.1644,0.1942,0.7202
"395",106458,"Arkansas State University-Main Campus",1,0,2006,"4470","145.991553","485","1232","1659",946,713,345,"124",221,0.2336,0.1739,0.208,0.7426
"396",106458,"Arkansas State University-Main Campus",1,0,2007,"4620","154.934121","490","1203","1655",962,693,309,"102",207,0.2152,0.1472,0.1867,0.7269
"397",106458,"Arkansas State University-Main Campus",1,0,2008,"4890","163.827062","461","1037","1743",981,762,352,"129",223,0.2273,0.1693,0.202,0.595
"398",106458,"Arkansas State University-Main Campus",1,0,2009,"4890","178.265954","482","987","1645",874,771,349,"154",195,0.2231,0.1997,0.2122,0.6
"399",106458,"Arkansas State University-Main Campus",1,0,2010,"5100","182.021874","482","1152","1659",897,762,438,"167",271,0.3021,0.2192,0.264,0.6944
"400",106467,"ARKANSAS TECH UNIVERSITY",1,0,1991,"1460","26.002508","176","728","761",403,358,103,"32",71,0.1762,0.0894,0.1353,0.9566
"401",106467,"ARKANSAS TECH UNIVERSITY",1,0,1992,"1560","28.869859","180","773","812",438,374,112,"33",79,0.1804,0.0882,0.1379,0.952
"402",106467,"ARKANSAS TECH UNIVERSITY",1,0,1993,"1710","31.658172","180","800","847",404,443,117,"43",74,0.1832,0.0971,0.1381,0.9445
"403",106467,"ARKANSAS TECH UNIVERSITY",1,0,1995,"1910","34.490892","181","705","756",386,370,133,"46",87,0.2254,0.1243,0.1759,0.9325
"404",106467,"ARKANSAS TECH UNIVERSITY",1,0,1996,"1992","35.463554","185","619","668",339,329,94,"40",54,0.1593,0.1216,0.1407,0.9266
"405",106467,"ARKANSAS TECH UNIVERSITY",1,0,1997,"2126","35.226185","187","664","725",376,349,83,"32",51,0.1356,0.0917,0.1145,0.9159
"406",106467,"ARKANSAS TECH UNIVERSITY",1,0,1998,"2288","37.112382","186","754","821",401,420,105,"41",64,0.1596,0.0976,0.1279,0.9184
"407",106467,"ARKANSAS TECH UNIVERSITY",1,0,1999,"2352","40.266475","192","966","1055",508,547,146,"55",91,0.1791,0.1005,0.1384,0.9156
"408",106467,"ARKANSAS TECH UNIVERSITY",1,0,2000,"2588","47.436534","201","1030","1124",593,531,205,"70",135,0.2277,0.1318,0.1824,0.9164
"409",106467,"ARKANSAS TECH UNIVERSITY",1,0,2001,"2796","50.957369","210","1086","1202",564,638,235,"108",127,0.2252,0.1693,0.1955,0.9035
"410",106467,"ARKANSAS TECH UNIVERSITY",1,0,2002,"3076","51.870418","209","1058","1169",624,545,207,"80",127,0.2035,0.1468,0.1771,0.905
"411",106467,"ARKANSAS TECH UNIVERSITY",1,0,2003,"3312","52.922678","229","1312","1445",723,722,248,"96",152,0.2102,0.133,0.1716,0.908
"412",106467,"ARKANSAS TECH UNIVERSITY",1,0,2004,"3696","60.56906","240","1226","1398",728,670,199,"72",127,0.1745,0.1075,0.1423,0.877
"413",106467,"Arkansas Tech University",1,0,2005,"3432","64.422441","252","1265","1457",714,743,253,"104",149,0.2087,0.14,0.1736,0.8682
"414",106467,"Arkansas Tech University",1,0,2006,"3576","74.719344","265","1209","1426",711,715,234,"83",151,0.2124,0.1161,0.1641,0.8478
"415",106467,"Arkansas Tech University",1,0,2007,"3672","79.441581","277","1300","1548",762,786,278,"131",147,0.1929,0.1667,0.1796,0.8398
"416",106467,"Arkansas Tech University",1,0,2008,"3864","87.14127","290","1272","1450",763,687,305,"115",190,0.249,0.1674,0.2103,0.8772
"417",106467,"Arkansas Tech University",1,0,2009,"4008","88.982771","294","1517","1744",882,862,375,"139",236,0.2676,0.1613,0.215,0.8698
"418",106467,"Arkansas Tech University",1,0,2010,"4080","97.262093","290","1383","1681",823,858,259,"105",154,0.1871,0.1224,0.1541,0.8227
"419",106485,"UNIVERSITY OF ARKANSAS-MONTICELLO",1,0,1991,"1500","15.865681","107","387","478",256,222,33,"13",20,0.0781,0.0586,0.069,0.8096
"420",106485,"UNIVERSITY OF ARKANSAS-MONTICELLO",1,0,1992,"1500","18.33616","116","459","581",302,279,53,"15",38,0.1258,0.0538,0.0912,0.79
"421",106485,"UNIVERSITY OF ARKANSAS AT MONTICELLO",1,0,1993,"1500","18.597513","117","399","508",249,259,31,"12",19,0.0763,0.0463,0.061,0.7854
"422",106485,"UNIVERSITY OF ARKANSAS AT MONTICELLO",1,0,1995,"1786","19.243061","118","387","489",254,235,46,"14",32,0.126,0.0596,0.0941,0.7914
"423",106485,"UNIVERSITY OF ARKANSAS AT MONTICELLO",1,0,1996,"1906","20.398269","112","373","453",240,213,44,"19",25,0.1042,0.0892,0.0971,0.8234
"424",106485,"UNIVERSITY OF ARKANSAS AT MONTICELLO",1,0,1997,"2145","19.714496","107","486","620",342,278,47,"8",39,0.114,0.0288,0.0758,0.7839
"425",106485,"UNIVERSITY OF ARKANSAS AT MONTICELLO",1,0,1998,"2330","21.190306","114","423","558",292,266,52,"18",34,0.1164,0.0677,0.0932,0.7581
"426",106485,"UNIVERSITY OF ARKANSAS AT MONTICELLO",1,0,1999,"2100","22.692496","113","465","685",370,315,53,"15",38,0.1027,0.0476,0.0774,0.6788
"427",106485,"UNIVERSITY OF ARKANSAS AT MONTICELLO",1,0,2000,"2250","24.545274","113.5","447","628",346,282,51,"17",34,0.0983,0.0603,0.0812,0.7118
"428",106485,"UNIVERSITY OF ARKANSAS AT MONTICELLO",1,0,2001,"2370","26.598513","114","465","654",382,272,51,"15",36,0.0942,0.0551,0.078,0.711
"429",106485,"UNIVERSITY OF ARKANSAS AT MONTICELLO",1,0,2002,"2490","24.949695","119","440","645",368,277,46,"14",32,0.087,0.0505,0.0713,0.6822
"430",106485,"UNIVERSITY OF ARKANSAS AT MONTICELLO",1,0,2003,"2700","24.309914","152","432","674",371,303,57,"25",32,0.0863,0.0825,0.0846,0.6409
"431",106485,"UNIVERSITY OF ARKANSAS AT MONTICELLO",1,0,2004,"2850","31.026802","134","394","629",327,302,60,"25",35,0.107,0.0828,0.0954,0.6264
"432",106485,"University of Arkansas at Monticello",1,0,2005,"3000","32.133887","145","373","625",337,288,55,"20",35,0.1039,0.0694,0.088,0.5968
"433",106485,"University of Arkansas at Monticello",1,0,2006,"3150","33.968869","150","407","630",335,295,71,"28",43,0.1284,0.0949,0.1127,0.646
"434",106485,"University of Arkansas at Monticello",1,0,2007,"3240","35.284984","149","413","617",303,314,52,"19",33,0.1089,0.0605,0.0843,0.6694
"435",106485,"University of Arkansas at Monticello",1,0,2008,"3420","38.199157","146","457","661",361,300,89,"33",56,0.1551,0.11,0.1346,0.6914
"436",106485,"University of Arkansas at Monticello",1,0,2009,"3510","38.751492","148","440","740",373,367,63,"16",47,0.126,0.0436,0.0851,0.5946
"437",106485,"University of Arkansas at Monticello",1,0,2010,"3600","40.527455","151","374","689",338,351,69,"30",39,0.1154,0.0855,0.1001,0.5428
"438",106704,"UNIVERSITY OF CENTRAL ARKANSAS",1,0,1991,"1370","50.883237","325","1538","1961",1129,832,171,"46",125,0.1107,0.0553,0.0872,0.7843
"439",106704,"UNIVERSITY OF CENTRAL ARKANSAS",1,0,1992,"1546","58.901275","337","1535","1948",1150,798,352,"116",236,0.2052,0.1454,0.1807,0.788
"440",106704,"UNIVERSITY OF CENTRAL ARKANSAS",1,0,1993,"1730","65.239982","340","1388","1792",1098,694,283,"94",189,0.1721,0.1354,0.1579,0.7746
"441",106704,"UNIVERSITY OF CENTRAL ARKANSAS",1,0,1995,"2010","76.476851","356","1218","1469",920,549,207,"46",161,0.175,0.0838,0.1409,0.8291
"442",106704,"UNIVERSITY OF CENTRAL ARKANSAS",1,0,1996,"2392","84.725464","367","1211","1478",928,550,239,"69",170,0.1832,0.1255,0.1617,0.8194
"443",106704,"UNIVERSITY OF CENTRAL ARKANSAS",1,0,1997,"2692","76.121168","377","1335","1598",1031,567,284,"55",229,0.2221,0.097,0.1777,0.8354
"444",106704,"UNIVERSITY OF CENTRAL ARKANSAS",1,0,1998,"3038","80.447014","370","1302","1575",944,631,249,"58",191,0.2023,0.0919,0.1581,0.8267
"445",106704,"UNIVERSITY OF CENTRAL ARKANSAS",1,0,1999,"2758","84.305052","376","1413","1729",1030,699,272,"86",186,0.1806,0.123,0.1573,0.8172
"446",106704,"UNIVERSITY OF CENTRAL ARKANSAS",1,0,2000,"2856","94.728092","391.5","1286","1627",982,645,325,"80",245,0.2495,0.124,0.1998,0.7904
"447",106704,"UNIVERSITY OF CENTRAL ARKANSAS",1,0,2001,"3060","95.47688","407","1229","1668",1028,640,367,"102",265,0.2578,0.1594,0.22,0.7368
"448",106704,"UNIVERSITY OF CENTRAL ARKANSAS",1,0,2002,"3312","105.550564","413","1331","1766",1062,704,389,"108",281,0.2646,0.1534,0.2203,0.7537
"449",106704,"UNIVERSITY OF CENTRAL ARKANSAS",1,0,2003,"3770","98.957126","462","1741","2414",1450,964,527,"165",362,0.2497,0.1712,0.2183,0.7212
"450",106704,"UNIVERSITY OF CENTRAL ARKANSAS",1,0,2004,"4060","112.207654","450","1656","2216",1313,903,468,"131",337,0.2567,0.1451,0.2112,0.7473
"451",106704,"University of Central Arkansas",1,0,2005,"4500","120.911805","478","1641","2429",1376,1053,467,"136",331,0.2406,0.1292,0.1923,0.6756
"452",106704,"University of Central Arkansas",1,0,2006,"4695","143.10546","514","1532","2352",1340,1012,538,"187",351,0.2619,0.1848,0.2287,0.6514
"453",106704,"University of Central Arkansas",1,0,2007,"4830","160.872799","510","1247","1763",1054,709,362,"118",244,0.2315,0.1664,0.2053,0.7073
"454",106704,"University of Central Arkansas",1,0,2008,"5100","166.471572","510","1435","2075",1165,910,444,"157",287,0.2464,0.1725,0.214,0.6916
"455",106704,"University of Central Arkansas",1,0,2009,"5205","173.776445","512","1221","1753",1023,730,403,"136",267,0.261,0.1863,0.2299,0.6965
"456",106704,"University of Central Arkansas",1,0,2010,"5235","174.94657","515","1194","1828",1070,758,445,"155",290,0.271,0.2045,0.2434,0.6532
"457",107044,"HARDING UNIVERSITY",1,0,1991,"5205","38.827179","163","600","673",383,290,192,"65",127,0.3316,0.2241,0.2853,0.8915
"458",107044,"HARDING UNIVERSITY",1,0,1992,"5460","41.713286","167","688","818",434,384,238,"91",147,0.3387,0.237,0.291,0.8411
"459",107044,"HARDING UNIVERSITY",1,0,1993,"5790","42.659551","179","696","793",437,356,244,"101",143,0.3272,0.2837,0.3077,0.8777
"460",107044,"HARDING UNIVERSITY",1,0,1995,"6420","49.509745","173","696","779",437,342,250,"92",158,0.3616,0.269,0.3209,0.8935
"461",107044,"HARDING UNIVERSITY",1,0,1996,"6825","53.119249","178","753","846",497,349,266,"85",181,0.3642,0.2436,0.3144,0.8901
"462",107044,"HARDING UNIVERSITY",1,0,1997,"7230","47.98777","179","707","863",495,368,271,"85",186,0.3758,0.231,0.314,0.8192
"463",107044,"HARDING UNIVERSITY",1,0,1998,"7530","51.145275","182","793","908",535,373,285,"101",184,0.3439,0.2708,0.3139,0.8733
"464",107044,"HARDING UNIVERSITY",1,0,1999,"7755","54.658782","178","814","941",488,453,313,"130",183,0.375,0.287,0.3326,0.865
"465",107044,"HARDING UNIVERSITY",1,0,2000,"8175","57.356775","185.5","849","975",557,418,365,"137",228,0.4093,0.3278,0.3744,0.8708
"466",107044,"HARDING UNIVERSITY",1,0,2001,"8730","62.964882","193","851","979",547,432,365,"145",220,0.4022,0.3356,0.3728,0.8693
"467",107044,"HARDING UNIVERSITY",1,0,2002,"9180","67.377905","194","879","1011",580,431,383,"138",245,0.4224,0.3202,0.3788,0.8694
"468",107044,"HARDING UNIVERSITY",1,0,2003,"9720","67.34355","200","859","966",543,423,369,"132",237,0.4365,0.3121,0.382,0.8892
"469",107044,"HARDING UNIVERSITY",1,0,2004,"10380","70.412241","211","855","961",516,445,387,"161",226,0.438,0.3618,0.4027,0.8897
"470",107044,"Harding University",1,0,2005,"10800","74.934183","223","837","955",527,428,396,"132",264,0.5009,0.3084,0.4147,0.8764
"471",107044,"Harding University",1,0,2006,"11250","80.146444","231","783","901",477,424,365,"134",231,0.4843,0.316,0.4051,0.869
"472",107044,"Harding University",1,0,2007,"11940","86.633805","249","833","960",549,411,388,"124",264,0.4809,0.3017,0.4042,0.8677
"473",107044,"Harding University",1,0,2008,"12690","92.142217","251","870","980",537,443,425,"158",267,0.4972,0.3567,0.4337,0.8878
"474",107044,"Harding University",1,0,2009,"13140","96.701838","259","788","950",530,420,430,"143",287,0.5415,0.3405,0.4526,0.8295
"475",107044,"Harding University",1,0,2010,"13590","97.901264","263","848","988",506,482,426,"177",249,0.4921,0.3672,0.4312,0.8583
"476",107080,"HENDRIX COLLEGE",0,1,1991,"7150","15.117439","65","257","281",146,135,141,"67",74,0.5068,0.4963,0.5018,0.9146
"477",107080,"HENDRIX COLLEGE",0,1,1992,"7710","15.503843","66","299","335",183,152,174,"76",98,0.5355,0.5,0.5194,0.8925
"478",107080,"HENDRIX COLLEGE",0,1,1993,"8410","16.539889","65","242","273",165,108,152,"58",94,0.5697,0.537,0.5568,0.8864
"479",107080,"HENDRIX COLLEGE",0,1,1995,"9325","18.132539","68","248","273",166,107,148,"58",90,0.5422,0.5421,0.5421,0.9084
"480",107080,"HENDRIX COLLEGE",0,1,1996,"9750","18.083714","69","264","306",185,121,188,"78",110,0.5946,0.6446,0.6144,0.8627
"481",107080,"HENDRIX COLLEGE",0,1,1997,"10280","19.583776","71","275","329",193,136,184,"76",108,0.5596,0.5588,0.5593,0.8359
"482",107080,"HENDRIX COLLEGE",0,1,1998,"10835","20.937404","67","239","320",166,154,196,"89",107,0.6446,0.5779,0.6125,0.7469
"483",107080,"HENDRIX COLLEGE",0,1,1999,"11440","22.881544","71","271","330",181,149,183,"74",109,0.6022,0.4966,0.5545,0.8212
"484",107080,"HENDRIX COLLEGE",0,1,2000,"12340","24.405298","75","254","326",173,153,194,"85",109,0.6301,0.5556,0.5951,0.7791
"485",107080,"HENDRIX COLLEGE",0,1,2001,"13071","27.433984","79","191","279",164,115,157,"49",108,0.6585,0.4261,0.5627,0.6846
"486",107080,"HENDRIX COLLEGE",1,0,2002,"14900","27.832964","81","216","317",184,133,199,"73",126,0.6848,0.5489,0.6278,0.6814
"487",107080,"HENDRIX COLLEGE",1,0,2003,"15630","30.038278","81","183","267",155,112,157,"63",94,0.6065,0.5625,0.588,0.6854
"488",107080,"HENDRIX COLLEGE",1,0,2004,"16510","29.460726","83","223","295",165,130,159,"69",90,0.5455,0.5308,0.539,0.7559
"489",107080,"Hendrix College",1,0,2005,"19508","31.918819","85","236","280",156,124,179,"73",106,0.6795,0.5887,0.6393,0.8429
"490",107080,"Hendrix College",1,0,2006,"20679","33.178005","90","324","396",222,174,251,"99",152,0.6847,0.569,0.6338,0.8182
"491",107080,"Hendrix College",1,0,2007,"22125","31.955102","90","305","365",194,171,231,"99",132,0.6804,0.5789,0.6329,0.8356
"492",107080,"Hendrix College",1,0,2008,"23570","40.989538","103","351","430",238,192,284,"122",162,0.6807,0.6354,0.6605,0.8163
"493",107080,"Hendrix College",1,0,2009,"28713","44.122677","109","315","412",245,167,265,"107",158,0.6449,0.6407,0.6432,0.7646
"494",107080,"Hendrix College",1,0,2010,"30410","42.486189","109","283","403",237,166,259,"96",163,0.6878,0.5783,0.6427,0.7022
"495",107141,"JOHN BROWN UNIVERSITY",1,0,1991,"5390","12.047702","57","180","219",123,96,65,"29",36,0.2927,0.3021,0.2968,0.8219
"496",107141,"JOHN BROWN UNIVERSITY",1,0,1992,"5930","13.878844","58","154","196",109,87,70,"31",39,0.3578,0.3563,0.3571,0.7857
"497",107141,"JOHN BROWN UNIVERSITY",1,0,1993,"6390","13.999154","60","213","245",139,106,76,"29",47,0.3381,0.2736,0.3102,0.8694
"498",107141,"JOHN BROWN UNIVERSITY",1,0,1995,"7650","17.889197","64","210","224",115,109,71,"28",43,0.3739,0.2569,0.317,0.9375
"499",107141,"JOHN BROWN UNIVERSITY",1,0,1996,"8308","18.469611","62","240","266",148,118,101,"37",64,0.4324,0.3136,0.3797,0.9023
"500",107141,"JOHN BROWN UNIVERSITY",1,0,1997,"9120","16.115941","62","199","225",121,104,83,"37",46,0.3802,0.3558,0.3689,0.8844
"501",107141,"JOHN BROWN UNIVERSITY",1,0,1998,"9802","17.488617","65","209","250",138,112,112,"44",68,0.4928,0.3929,0.448,0.836
"502",107141,"JOHN BROWN UNIVERSITY",1,0,1999,"10232","18.989043","71","225","267",149,118,113,"39",74,0.4966,0.3305,0.4232,0.8427
"503",107141,"JOHN BROWN UNIVERSITY",1,0,2000,"11022","20.069122","73","229","276",164,112,140,"51",89,0.5427,0.4554,0.5072,0.8297
"504",107141,"JOHN BROWN UNIVERSITY",1,0,2001,"11892","22.018359","75","202","241",149,92,132,"50",82,0.5503,0.5435,0.5477,0.8382
"505",107141,"JOHN BROWN UNIVERSITY",1,0,2002,"12464","24.902737","73","251","303",186,117,176,"64",112,0.6022,0.547,0.5809,0.8284
"506",107141,"JOHN BROWN UNIVERSITY",1,0,2003,"13076","27.35797","80","227","274",140,134,145,"68",77,0.55,0.5075,0.5292,0.8285
"507",107141,"JOHN BROWN UNIVERSITY",1,0,2004,"13724","29.419045","80","240","296",156,140,155,"67",88,0.5641,0.4786,0.5236,0.8108
"508",107141,"John Brown University",1,0,2005,"14544","31.711621","83","227","262",132,130,143,"71",72,0.5455,0.5462,0.5458,0.8664
"509",107141,"John Brown University",1,0,2006,"15412","32.983269","80","279","326",168,158,190,"78",112,0.6667,0.4937,0.5828,0.8558
"510",107141,"John Brown University",1,0,2007,"16396","36.135983","79","303","361",206,155,200,"81",119,0.5777,0.5226,0.554,0.8393
"511",107141,"John Brown University",1,0,2008,"17256","37.587322","81","250","307",165,142,160,"72",88,0.5333,0.507,0.5212,0.8143
"512",107141,"John Brown University",1,0,2009,"18032","37.566662","82","250","305",170,135,167,"62",105,0.6176,0.4593,0.5475,0.8197
"513",107141,"John Brown University",1,0,2010,"18844","39.776978","83","265","322",175,147,180,"82",98,0.56,0.5578,0.559,0.823
"514",107512,"OUACHITA BAPTIST UNIVERSITY",1,0,1991,"5370","13.334562","86","312","338",182,156,115,"44",71,0.3901,0.2821,0.3402,0.9231
"515",107512,"OUACHITA BAPTIST UNIVERSITY",1,0,1992,"5800","13.992869","91","264","296",148,148,121,"36",85,0.5743,0.2432,0.4088,0.8919
"516",107512,"OUACHITA BAPTIST UNIVERSITY",1,0,1993,"6230","14.621967","97","404","443",217,226,174,"86",88,0.4055,0.3805,0.3928,0.912
"517",107512,"OUACHITA BAPTIST UNIVERSITY",1,0,1995,"7070","18.053772","104","351","380",206,174,173,"75",98,0.4757,0.431,0.4553,0.9237
"518",107512,"OUACHITA BAPTIST UNIVERSITY",1,0,1996,"7650","18.145047","98","433","451",237,214,184,"69",115,0.4852,0.3224,0.408,0.9601
"519",107512,"OUACHITA BAPTIST UNIVERSITY",1,0,1997,"8090","25.034847","108","359","404",230,174,164,"59",105,0.4565,0.3391,0.4059,0.8886
"520",107512,"OUACHITA BAPTIST UNIVERSITY",1,0,1998,"8550","26.238005","108","336","362",220,142,120,"36",84,0.3818,0.2535,0.3315,0.9282
"521",107512,"OUACHITA BAPTIST UNIVERSITY",1,0,1999,"8850","21.286941","103","405","443",256,187,197,"72",125,0.4883,0.385,0.4447,0.9142
"522",107512,"OUACHITA BAPTIST UNIVERSITY",1,0,2000,"9800","29.73249","106","404","440",247,193,187,"69",118,0.4777,0.3575,0.425,0.9182
"523",107512,"OUACHITA BAPTIST UNIVERSITY",1,0,2001,"11800","33.132684","109","371","400",214,186,183,"73",110,0.514,0.3925,0.4575,0.9275
"524",107512,"OUACHITA BAPTIST UNIVERSITY",1,0,2002,"11800","36.323264","117","360","396",229,167,166,"64",102,0.4454,0.3832,0.4192,0.9091
"525",107512,"OUACHITA BAPTIST UNIVERSITY",1,0,2003,"12013","28.826104","113","308","343",195,148,140,"52",88,0.4513,0.3514,0.4082,0.898
"526",107512,"OUACHITA BAPTIST UNIVERSITY",1,0,2004,"13023","29.330298","108","338","380",223,157,170,"49",121,0.5426,0.3121,0.4474,0.8895
"527",107512,"Ouachita Baptist University",1,0,2005,"14218","31.257335","114","327","365",213,152,181,"66",115,0.5399,0.4342,0.4959,0.8959
"528",107512,"Ouachita Baptist University",1,0,2006,"15235","31.958901","119","322","367",190,177,185,"73",112,0.5895,0.4124,0.5041,0.8774
"529",107512,"Ouachita Baptist University",1,0,2007,"16158","34.314378","115","334","372",202,170,179,"60",119,0.5891,0.3529,0.4812,0.8978
"530",107512,"Ouachita Baptist University",1,0,2008,"17058","34.896305","112","347","404",220,184,205,"80",125,0.5682,0.4348,0.5074,0.8589
"531",107512,"Ouachita Baptist University",1,0,2009,"18038","34.967832","113","326","389",198,191,208,"84",124,0.6263,0.4398,0.5347,0.838
"532",107512,"Ouachita Baptist University",1,0,2010,"18805","36.177753","107","401","450",243,207,264,"102",162,0.6667,0.4928,0.5867,0.8911
"533",107558,"UNIVERSITY OF THE OZARKS",1,0,1991,"3520","8.035326","40","83","90",52,38,9,"4",5,0.0962,0.1053,0.1,0.9222
"534",107558,"UNIVERSITY OF THE OZARKS",1,0,1992,"4220","8.382669","40","109","120",53,67,11,"7",4,0.0755,0.1045,0.0917,0.9083
"535",107558,"UNIVERSITY OF THE OZARKS",1,0,1993,"4920","8.701771","43","144","162",96,66,37,"15",22,0.2292,0.2273,0.2284,0.8889
"536",107558,"UNIVERSITY OF THE OZARKS",1,0,1995,"6540","10.464866","36","110","133",66,67,29,"14",15,0.2273,0.209,0.218,0.8271
"537",107558,"UNIVERSITY OF THE OZARKS",1,0,1996,"7140","10.219187","33","93","110",52,58,37,"14",23,0.4423,0.2414,0.3364,0.8455
"538",107558,"UNIVERSITY OF THE OZARKS",1,0,1997,"7390","7.951383","31","136","155",66,89,44,"21",23,0.3485,0.236,0.2839,0.8774
"539",107558,"UNIVERSITY OF THE OZARKS",1,0,1998,"7990","8.773542","31","102","137",69,68,43,"18",25,0.3623,0.2647,0.3139,0.7445
"540",107558,"UNIVERSITY OF THE OZARKS",1,0,1999,"8290","9.278387","33","119","164",93,71,53,"17",36,0.3871,0.2394,0.3232,0.7256
"541",107558,"UNIVERSITY OF THE OZARKS",1,0,2000,"8830","10.953803","37","141","166",100,66,52,"17",35,0.35,0.2576,0.3133,0.8494
"542",107558,"UNIVERSITY OF THE OZARKS",1,0,2001,"9348","12.395282","41","151","190",116,74,61,"22",39,0.3362,0.2973,0.3211,0.7947
"543",107558,"UNIVERSITY OF THE OZARKS",1,0,2002,"10282","13.65656","43","156","200",97,103,60,"28",32,0.3299,0.2718,0.3,0.78
"544",107558,"UNIVERSITY OF THE OZARKS",1,0,2003,"11520","15.439096","44","145","206",113,93,63,"20",43,0.3805,0.2151,0.3058,0.7039
"545",107558,"UNIVERSITY OF THE OZARKS",1,0,2004,"12902","15.543027","43","106","134",74,60,44,"18",26,0.3514,0.3,0.3284,0.791
"546",107558,"University of the Ozarks",1,0,2005,"13740","14.650277","44","117","168",89,79,48,"19",29,0.3258,0.2405,0.2857,0.6964
"547",107558,"University of the Ozarks",1,0,2006,"14470","15.402567","44","109","164",80,84,59,"29",30,0.375,0.3452,0.3598,0.6646
"548",107558,"University of the Ozarks",1,0,2007,"15630","16.775397","46","132","178",102,76,61,"17",44,0.4314,0.2237,0.3427,0.7416
"549",107558,"University of the Ozarks",1,0,2008,"16730","17.693073","48","152","195",113,82,72,"27",45,0.3982,0.3293,0.3692,0.7795
"550",107558,"University of the Ozarks",1,0,2009,"18300","17.749169","47","110","152",72,80,39,"12",27,0.375,0.15,0.2566,0.7237
"551",107558,"University of the Ozarks",1,0,2010,"19930","18.253058","49","152","204",114,90,61,"28",33,0.2895,0.3111,0.299,0.7451
"552",110097,"BIOLA UNIVERSITY",1,0,1991,"9902","36.259489","121","296","391",256,135,155,"45",110,0.4297,0.3333,0.3964,0.757
"553",110097,"BIOLA UNIVERSITY",1,0,1992,"10756","37.52584","131","331","464",290,174,176,"64",112,0.3862,0.3678,0.3793,0.7134
"554",110097,"BIOLA UNIVERSITY",1,0,1993,"11388","42.433418","126","301","444",286,158,157,"48",109,0.3811,0.3038,0.3536,0.6779
"555",110097,"BIOLA UNIVERSITY",1,0,1995,"12652","44.926465","121","299","407",278,129,168,"45",123,0.4424,0.3488,0.4128,0.7346
"556",110097,"BIOLA UNIVERSITY",1,0,1996,"13408","47.317141","125","309","407",268,139,184,"62",122,0.4552,0.446,0.4521,0.7592
"557",110097,"BIOLA UNIVERSITY",1,0,1997,"14286","41.069309","133","338","437",296,141,204,"60",144,0.4865,0.4255,0.4668,0.7735
"558",110097,"BIOLA UNIVERSITY",1,0,1998,"15214","45.300252","130","368","469",313,156,227,"75",152,0.4856,0.4808,0.484,0.7846
"559",110097,"BIOLA UNIVERSITY",1,0,1999,"15914","49.784999","143","426","563",373,190,370,"123",247,0.6622,0.6474,0.6572,0.7567
"560",110097,"BIOLA UNIVERSITY",1,0,2000,"16630","51.972","149","498","608",409,199,326,"88",238,0.5819,0.4422,0.5362,0.8191
"561",110097,"BIOLA UNIVERSITY",1,0,2001,"17410","55.949","155","514","649",426,223,360,"113",247,0.5798,0.5067,0.5547,0.792
"562",110097,"BIOLA UNIVERSITY",1,0,2002,"18456","64.383","162","525","656",414,242,345,"108",237,0.5725,0.4463,0.5259,0.8003
"563",110097,"BIOLA UNIVERSITY",1,0,2003,"19564","74.176","174","553","685",459,226,348,"104",244,0.5316,0.4602,0.508,0.8073
"564",110097,"BIOLA UNIVERSITY",1,0,2004,"20932","80.698","175","494","691",443,248,346,"120",226,0.5102,0.4839,0.5007,0.7149
"565",110097,"Biola University",1,0,2005,"22602","89.381","184","467","670",416,254,337,"111",226,0.5433,0.437,0.503,0.697
"566",110097,"Biola University",1,0,2006,"23782","98.206","198","553","799",521,278,364,"102",262,0.5029,0.3669,0.4556,0.6921
"567",110097,"Biola University",1,0,2007,"24998","106.129","205","536","789",514,275,385,"118",267,0.5195,0.4291,0.488,0.6793
"568",110097,"Biola University",1,0,2008,"26424","117.397","212","563","846",530,316,430,"157",273,0.5151,0.4968,0.5083,0.6655
"569",110097,"Biola University",1,0,2009,"27744","119.695887","218","489","775",508,267,402,"131",271,0.5335,0.4906,0.5187,0.631
"570",110097,"Biola University",1,0,2010,"28852","120.345","226","498","877",560,317,471,"159",312,0.5571,0.5016,0.5371,0.5678
"571",110404,"CALIFORNIA INSTITUTE OF TECHNOLOGY",0,1,1991,"14230","1334.416785","253","126","225",73,152,146,"99",47,0.6438,0.6513,0.6489,0.56
"572",110404,"CALIFORNIA INSTITUTE OF TECHNOLOGY",0,1,1992,"15080","1357.618","247","132","233",60,173,165,"119",46,0.7667,0.6879,0.7082,0.5665
"573",110404,"CALIFORNIA INSTITUTE OF TECHNOLOGY",0,1,1993,"16030","1325.141","257","117","209",63,146,151,"109",42,0.6667,0.7466,0.7225,0.5598
"574",110404,"CALIFORNIA INSTITUTE OF TECHNOLOGY",0,1,1995,"17370","1311.932","260","145","218",52,166,156,"108",48,0.9231,0.6506,0.7156,0.6651
"575",110404,"CALIFORNIA INSTITUTE OF TECHNOLOGY",0,1,1996,"18000","1322.808","266","140","216",64,152,156,"112",44,0.6875,0.7368,0.7222,0.6481
"576",110404,"CALIFORNIA INSTITUTE OF TECHNOLOGY",0,1,1997,"18736","1663.872","258","127","217",64,153,169,"119",50,0.7812,0.7778,0.7788,0.5853
"577",110404,"CALIFORNIA INSTITUTE OF TECHNOLOGY",0,1,1998,"19166","345.672","256","153","254",79,175,195,"136",59,0.7468,0.7771,0.7677,0.6024
"578",110404,"CALIFORNIA INSTITUTE OF TECHNOLOGY",0,1,1999,"19260","1720.378","252","150","234",83,151,195,"126",69,0.8313,0.8344,0.8333,0.641
"579",110404,"CALIFORNIA INSTITUTE OF TECHNOLOGY",0,1,2000,"19743","1671.464","280","110","205",74,131,166,"107",59,0.7973,0.8168,0.8098,0.5366
"580",110404,"CALIFORNIA INSTITUTE OF TECHNOLOGY",0,1,2001,"20904","1817.907","308","109","214",78,136,175,"110",65,0.8333,0.8088,0.8178,0.5093
"581",110404,"CALIFORNIA INSTITUTE OF TECHNOLOGY",0,1,2002,"21903","1898.092","301","148","252",73,179,203,"138",65,0.8904,0.7709,0.8056,0.5873
"582",110404,"CALIFORNIA INSTITUTE OF TECHNOLOGY",0,1,2003,"23901","1899.253","310","89","190",64,126,138,"90",48,0.75,0.7143,0.7263,0.4684
"583",110404,"CALIFORNIA INSTITUTE OF TECHNOLOGY",0,1,2004,"25335","2098.634","309","115","207",59,148,167,"117",50,0.8475,0.7905,0.8068,0.5556
"584",110404,"California Institute of Technology",0,1,2005,"27309","2135.498","311","105","233",69,164,178,"127",51,0.7391,0.7744,0.7639,0.4506
"585",110404,"California Institute of Technology",0,1,2006,"28515","2094.58","324","79","210",60,150,166,"113",53,0.8833,0.7533,0.7905,0.3762
"586",110404,"California Institute of Technology",0,1,2007,"29940","2287.291","320","97","231",86,145,190,"117",73,0.8488,0.8069,0.8225,0.4199
"587",110404,"California Institute of Technology",0,1,2008,"31437","2349.364","322","93","236",97,139,200,"112",88,0.9072,0.8058,0.8475,0.3941
"588",110404,"California Institute of Technology",0,1,2009,"33324","2470.986","312","92","251",106,145,212,"122",90,0.8491,0.8414,0.8446,0.3665
"589",110404,"California Institute of Technology",0,1,2010,"34989","2299.31","316","78","220",87,133,179,"105",74,0.8506,0.7895,0.8136,0.3545
"590",110422,"CALIFORNIA POLYTECHNIC STATE UNIV-SAN LUIS OBISPO",0,1,1991,"936","156.565365","760","868","1526",717,809,121,"36",85,0.1185,0.0445,0.0793,0.5688
"591",110422,"CALIFORNIA POLYTECHNIC STATE UNIV-SAN LUIS OBISPO",0,1,1992,"1616","162.440413","681","713","1295",566,729,136,"37",99,0.1749,0.0508,0.105,0.5506
"592",110422,"CALIFORNIA POLYTECHNIC STATE UNIV-SAN LUIS OBISPO",0,1,1993,"1674","157.148081","670","948","1600",722,878,155,"36",119,0.1648,0.041,0.0969,0.5925
"593",110422,"CALIFORNIA POLYTECHNIC STATE UNIV-SAN LUIS OBISPO",0,1,1995,"1891","161.389088","676","1492","2418",1092,1326,356,"114",242,0.2216,0.086,0.1472,0.617
"594",110422,"CALIFORNIA POLYTECHNIC STATE UNIV-SAN LUIS OBISPO",0,1,1996,"1935","165.611159","676","1769","2757",1202,1555,448,"132",316,0.2629,0.0849,0.1625,0.6416
"595",110422,"CALIFORNIA POLYTECHNIC STATE UNIV-SAN LUIS OBISPO",0,1,1997,"2228","176.103823","691","1243","2114",951,1163,318,"108",210,0.2208,0.0929,0.1504,0.588
"596",110422,"CALIFORNIA POLYTECHNIC STATE UNIV-SAN LUIS OBISPO",0,1,1998,"2204","180.395603","683","1505","2260",945,1315,367,"136",231,0.2444,0.1034,0.1624,0.6659
"597",110422,"CALIFORNIA POLYTECHNIC STATE UNIV-SAN LUIS OBISPO",0,1,1999,"0","189.779583","695","1169","2673",1277,1396,557,"167",390,0.3054,0.1196,0.2084,0.4373
"598",110422,"CALIFORNIA POLYTECHNIC STATE UNIV-SAN LUIS OBISPO",0,1,2000,"0","267.056525","692.5","1973","3053",1332,1721,607,"212",395,0.2965,0.1232,0.1988,0.6462
"599",110422,"CALIFORNIA POLYTECHNIC STATE UNIV-SAN LUIS OBISPO",0,1,2001,"0","281.470391","690","2041","2957",1374,1583,629,"220",409,0.2977,0.139,0.2127,0.6902
"600",110422,"CALIFORNIA POLYTECHNIC STATE UNIV-SAN LUIS OBISPO",0,1,2002,"0","225.242113","719","1748","2565",1158,1407,587,"209",378,0.3264,0.1485,0.2288,0.6815
"601",110422,"CALIFORNIA POLYTECHNIC STATE UNIV-SAN LUIS OBISPO",0,1,2003,"0","235.995505","698","1920","2798",1239,1559,673,"264",409,0.3301,0.1693,0.2405,0.6862
"602",110422,"CALIFORNIA POLYTECHNIC STATE UNIVERSITY-SAN LUIS OBISPO",0,1,2004,"0","236.59035","653","1962","2900",1169,1731,767,"304",463,0.3961,0.1756,0.2645,0.6766
"603",110422,"California Polytechnic State University-San Luis Obispo",0,1,2005,"0","232.341249","678","2270","3318",1599,1719,1021,"345",676,0.4228,0.2007,0.3077,0.6841
"604",110422,"California Polytechnic State University-San Luis Obispo",0,1,2006,"0","272.325785","704","2457","3761",1648,2113,1044,"362",682,0.4138,0.1713,0.2776,0.6533
"605",110422,"California Polytechnic State University-San Luis Obispo",0,1,2007,"0","276.305375","735","2860","4419",1885,2534,1282,"460",822,0.4361,0.1815,0.2901,0.6472
"606",110422,"California Polytechnic State University-San Luis Obispo",0,1,2008,"0","305.112556","761","2298","3448",1553,1895,1246,"458",788,0.5074,0.2417,0.3614,0.6665
"607",110422,"California Polytechnic State University-San Luis Obispo",0,1,2009,"0","314.89392","775","2461","3877",1803,2074,1557,"593",964,0.5347,0.2859,0.4016,0.6348
"608",110422,"California Polytechnic State University-San Luis Obispo",0,1,2010,"0","318.335175","726","2245","3459",1642,1817,1634,"636",998,0.6078,0.35,0.4724,0.649
"609",110486,"CALIFORNIA STATE COLLEGE-BAKERSFIELD",0,1,1991,"936","42.638242","218","143","363",200,163,26,"16",10,0.05,0.0982,0.0716,0.3939
"610",110486,"CALIFORNIA STATE BAKERSFIELD UNIVERSITY",0,1,1992,"1444","44.540643","202","117","323",181,142,32,"11",21,0.116,0.0775,0.0991,0.3622
"611",110486,"CALIFORNIA STATE UNIVERSITY-BAKERSFIELD",0,1,1993,"1674","44.328884","206","99","317",200,117,38,"12",26,0.13,0.1026,0.1199,0.3123
"612",110486,"CALIFORNIA STATE UNIVERSITY-BAKERSFIELD",0,1,1995,"1891","49.022654","209","132","397",236,161,43,"11",32,0.1356,0.0683,0.1083,0.3325
"613",110486,"CALIFORNIA STATE UNIVERSITY-BAKERSFIELD",0,1,1996,"1935","50.577676","212","150","418",253,165,56,"14",42,0.166,0.0848,0.134,0.3589
"614",110486,"CALIFORNIA STATE UNIVERSITY-BAKERSFIELD",0,1,1997,"1951","53.463466","203","169","467",288,179,49,"15",34,0.1181,0.0838,0.1049,0.3619
"615",110486,"CALIFORNIA STATE UNIVERSITY-BAKERSFIELD",0,1,1998,"1873","56.989716","219","168","471",298,173,54,"9",45,0.151,0.052,0.1146,0.3567
"616",110486,"CALIFORNIA STATE UNIVERSITY-BAKERSFIELD",0,1,1999,"0","63.929951","223","191","517",319,198,69,"14",55,0.1724,0.0707,0.1335,0.3694
"617",110486,"CALIFORNIA STATE UNIVERSITY-BAKERSFIELD",0,1,2000,"0","77.612216","243.5","212","545",349,196,77,"22",55,0.1576,0.1122,0.1413,0.389
"618",110486,"CALIFORNIA STATE UNIVERSITY-BAKERSFIELD",0,1,2001,"0","90.898211","264","210","610",393,217,86,"20",66,0.1679,0.0922,0.141,0.3443
"619",110486,"CALIFORNIA STATE UNIVERSITY-BAKERSFIELD",0,1,2002,"0","79.906701","283","220","679",408,271,99,"28",71,0.174,0.1033,0.1458,0.324
"620",110486,"CALIFORNIA STATE UNIVERSITY-BAKERSFIELD",0,1,2003,"0","86.752909","307","237","714",476,238,92,"23",69,0.145,0.0966,0.1289,0.3319
"621",110486,"CALIFORNIA STATE UNIVERSITY-BAKERSFIELD",0,1,2004,"0","88.302056","301","251","745",483,262,128,"32",96,0.1988,0.1221,0.1718,0.3369
"622",110486,"California State University-Bakersfield",0,1,2005,"0","90.906317","303","209","766",503,263,114,"21",93,0.1849,0.0798,0.1488,0.2728
"623",110486,"California State University-Bakersfield",0,1,2006,"0","96.185612","301","216","854",553,301,120,"29",91,0.1646,0.0963,0.1405,0.2529
"624",110486,"California State University-Bakersfield",0,1,2007,"0","105.440458","293","208","859",578,281,129,"25",104,0.1799,0.089,0.1502,0.2421
"625",110486,"California State University-Bakersfield",0,1,2008,"0","114.649172","268","142","901",592,309,144,"45",99,0.1672,0.1456,0.1598,0.1576
"626",110486,"California State University-Bakersfield",0,1,2009,"0","112.988415","253","158","1061",652,409,139,"39",100,0.1534,0.0954,0.131,0.1489
"627",110486,"California State University-Bakersfield",0,1,2010,"0","109.353736","241","158","1013",613,400,148,"50",98,0.1599,0.125,0.1461,0.156
"628",110495,"CALIFORNIA STATE UNIVERSITY-STANISLAUS",1,0,1991,"936","43.937304","201","130","273",164,109,39,"8",31,0.189,0.0734,0.1429,0.4762
"629",110495,"CALIFORNIA STATE UNIVERSITY-STANISLAUS",1,0,1992,"1434","43.246738","189","133","307",191,116,33,"11",22,0.1152,0.0948,0.1075,0.4332
"630",110495,"CALIFORNIA STATE UNIVERSITY-STANISLAUS",1,0,1993,"1674","45.79445","215","194","387",232,155,60,"22",38,0.1638,0.1419,0.155,0.5013
"631",110495,"CALIFORNIA STATE UNIVERSITY-STANISLAUS",1,0,1995,"1891","54.421864","235","167","353",242,111,75,"12",63,0.2603,0.1081,0.2125,0.4731
"632",110495,"CALIFORNIA STATE UNIVERSITY-STANISLAUS",1,0,1996,"1935","55.252559","239","172","381",244,137,85,"22",63,0.2582,0.1606,0.2231,0.4514
"633",110495,"CALIFORNIA STATE UNIVERSITY-STANISLAUS",1,0,1997,"1915","58.703827","238","191","409",270,139,84,"19",65,0.2407,0.1367,0.2054,0.467
"634",110495,"CALIFORNIA STATE UNIVERSITY-STANISLAUS",1,0,1998,"1830","61.551113","237","211","444",297,147,84,"16",68,0.229,0.1088,0.1892,0.4752
"635",110495,"CALIFORNIA STATE UNIVERSITY-STANISLAUS",1,0,1999,"0","68.733992","245","222","470",310,160,101,"16",85,0.2742,0.1,0.2149,0.4723
"636",110495,"CALIFORNIA STATE UNIVERSITY-STANISLAUS",1,0,2000,"0","76.845523","253.5","223","565",362,203,113,"27",86,0.2376,0.133,0.2,0.3947
"637",110495,"CALIFORNIA STATE UNIVERSITY-STANISLAUS",1,0,2001,"0","92.487631","262","225","516",352,164,96,"24",72,0.2045,0.1463,0.186,0.436
"638",110495,"CALIFORNIA STATE UNIVERSITY-STANISLAUS",1,0,2002,"0","82.086047","273","232","550",360,190,116,"20",96,0.2667,0.1053,0.2109,0.4218
"639",110495,"CALIFORNIA STATE UNIVERSITY-STANISLAUS",1,0,2003,"0","91.247534","282","232","551",365,186,119,"37",82,0.2247,0.1989,0.216,0.4211
"640",110495,"CALIFORNIA STATE UNIVERSITY-STANISLAUS",1,0,2004,"0","91.452441","264","288","653",456,197,153,"41",112,0.2456,0.2081,0.2343,0.441
"641",110495,"California State University-Stanislaus",1,0,2005,"0","89.326678","284","288","741",511,230,151,"31",120,0.2348,0.1348,0.2038,0.3887
"642",110495,"California State University-Stanislaus",1,0,2006,"0","98.077188","291","324","846",570,276,148,"37",111,0.1947,0.1341,0.1749,0.383
"643",110495,"California State University-Stanislaus",1,0,2007,"0","101.595211","309","347","910",592,318,166,"34",132,0.223,0.1069,0.1824,0.3813
"644",110495,"California State University-Stanislaus",1,0,2008,"0","123.578053","311","338","899",576,323,133,"33",100,0.1736,0.1022,0.1479,0.376
"645",110495,"California State University-Stanislaus",1,0,2009,"0","125.288591","289","258","798",555,243,124,"37",87,0.1568,0.1523,0.1554,0.3233
"646",110495,"California State University-Stanislaus",1,0,2010,"0","115.219024","265","265","998",670,328,156,"41",115,0.1716,0.125,0.1563,0.2655
"647",110510,"CALIFORNIA STATE UNIVERSITY-SAN BERNARDINO",0,1,1991,"936","70.793583","415","387","815",505,310,58,"17",41,0.0812,0.0548,0.0712,0.4748
"648",110510,"CALIFORNIA STATE UNIVERSITY-SAN BERNARDINO",0,1,1992,"1443","77.999888","399","321","737",449,288,59,"23",36,0.0802,0.0799,0.0801,0.4355
"649",110510,"CALIFORNIA STATE UNIVERSITY-SAN BERNARDINO",0,1,1993,"1674","82.994653","397","277","692",433,259,37,"9",28,0.0647,0.0347,0.0535,0.4003
"650",110510,"CALIFORNIA STATE UNIVERSITY-SAN BERNARDINO",0,1,1995,"1891","93.455513","406","280","799",505,294,58,"16",42,0.0832,0.0544,0.0726,0.3504
"651",110510,"CALIFORNIA STATE UNIVERSITY-SAN BERNARDINO",0,1,1996,"1935","92.759982","416","324","882",554,328,78,"18",60,0.1083,0.0549,0.0884,0.3673
"652",110510,"CALIFORNIA STATE UNIVERSITY-SAN BERNARDINO",0,1,1997,"1889","96.917633","416","315","890",559,331,83,"26",57,0.102,0.0785,0.0933,0.3539
"653",110510,"CALIFORNIA STATE UNIVERSITY-SAN BERNARDINO",0,1,1998,"1779","110.499936","421","390","1068",680,388,124,"39",85,0.125,0.1005,0.1161,0.3652
"654",110510,"CALIFORNIA STATE UNIVERSITY-SAN BERNARDINO",0,1,1999,"0","150.512913","440","342","1049",679,370,105,"30",75,0.1105,0.0811,0.1001,0.326
"655",110510,"CALIFORNIA STATE UNIVERSITY-SAN BERNARDINO",0,1,2000,"0","141.19961","451.5","373","1146",750,396,142,"33",109,0.1453,0.0833,0.1239,0.3255
"656",110510,"CALIFORNIA STATE UNIVERSITY-SAN BERNARDINO",0,1,2001,"0","168.344611","463","387","1273",774,499,127,"36",91,0.1176,0.0721,0.0998,0.304
"657",110510,"CALIFORNIA STATE UNIVERSITY-SAN BERNARDINO",0,1,2002,"0","149.034502","488","323","1161",751,410,142,"32",110,0.1465,0.078,0.1223,0.2782
"658",110510,"CALIFORNIA STATE UNIVERSITY-SAN BERNARDINO",0,1,2003,"0","167.08279","479","386","1335",918,417,178,"45",133,0.1449,0.1079,0.1333,0.2891
"659",110510,"CALIFORNIA STATE UNIVERSITY-SAN BERNARDINO",0,1,2004,"0","170.358516","447","351","1587",1099,488,208,"53",155,0.141,0.1086,0.1311,0.2212
"660",110510,"California State University-San Bernardino",0,1,2005,"0","158.937781","444","393","1645",1092,553,212,"75",137,0.1255,0.1356,0.1289,0.2389
"661",110510,"California State University-San Bernardino",0,1,2006,"0","179.806969","462","405","1774",1157,617,201,"55",146,0.1262,0.0891,0.1133,0.2283
"662",110510,"California State University-San Bernardino",0,1,2007,"0","196.272226","468","334","1656",1098,558,156,"43",113,0.1029,0.0771,0.0942,0.2017
"663",110510,"California State University-San Bernardino",0,1,2008,"0","218.074591","470","390","1916",1213,703,241,"77",164,0.1352,0.1095,0.1258,0.2035
"664",110510,"California State University-San Bernardino",0,1,2009,"0","231.239052","452","304","1968",1275,693,265,"75",190,0.149,0.1082,0.1347,0.1545
"665",110510,"California State University-San Bernardino",0,1,2010,"0","223.941975","433","263","1747",1114,633,251,"73",178,0.1598,0.1153,0.1437,0.1505
"666",110529,"CALIFORNIA STATE POLYTECHNIC UNIVERSITY POMONA",0,1,1991,"936","131.522942","662","470","1583",650,933,96,"28",68,0.1046,0.03,0.0606,0.2969
"667",110529,"CALIFORNIA STATE POLYTECHNIC UNIVERSITY POMONA",0,1,1992,"1384","134.477258","629","373","1358",551,807,84,"34",50,0.0907,0.0421,0.0619,0.2747
"668",110529,"CALIFORNIA STATE POLYTECHNIC UNIVERSITY-POMONA",0,1,1993,"1674","133.317412","610","383","1309",536,773,105,"42",63,0.1175,0.0543,0.0802,0.2926
"669",110529,"CALIFORNIA STATE POLYTECHNIC UNIVERSITY-POMONA",0,1,1995,"1891","147.28268","612","374","1422",621,801,96,"37",59,0.095,0.0462,0.0675,0.263
"670",110529,"CALIFORNIA STATE POLYTECHNIC UNIVERSITY-POMONA",0,1,1996,"1935","147.829531","595","393","1497",647,850,128,"56",72,0.1113,0.0659,0.0855,0.2625
"671",110529,"CALIFORNIA STATE POLYTECHNIC UNIVERSITY-POMONA",0,1,1997,"1903","159.547643","581","466","1856",810,1046,157,"56",101,0.1247,0.0535,0.0846,0.2511
"672",110529,"CALIFORNIA STATE POLYTECHNIC UNIVERSITY-POMONA",0,1,1998,"1855","167.6049","571","516","2033",855,1178,191,"80",111,0.1298,0.0679,0.0939,0.2538
"673",110529,"CALIFORNIA STATE POLYTECHNIC UNIVERSITY-POMONA",0,1,1999,"0","159.288942","585","599","2489",1008,1481,226,"90",136,0.1349,0.0608,0.0908,0.2407
"674",110529,"CALIFORNIA STATE POLYTECHNIC UNIVERSITY-POMONA",0,1,2000,"0","222.984408","595.5","578","2600",1121,1479,265,"113",152,0.1356,0.0764,0.1019,0.2223
"675",110529,"CALIFORNIA STATE POLYTECHNIC UNIVERSITY-POMONA",0,1,2001,"0","252.112049","606","535","2412",961,1451,229,"91",138,0.1436,0.0627,0.0949,0.2218
"676",110529,"CALIFORNIA STATE POLYTECHNIC UNIVERSITY-POMONA",0,1,2002,"0","221.714857","609","651","2674",1080,1594,345,"161",184,0.1704,0.101,0.129,0.2435
"677",110529,"CALIFORNIA STATE POLYTECHNIC UNIVERSITY-POMONA",0,1,2003,"0","216.002922","596","693","2558",1107,1451,384,"172",212,0.1915,0.1185,0.1501,0.2709
"678",110529,"CALIFORNIA STATE POLYTECHNIC UNIVERSITY-POMONA",0,1,2004,"0","270.12667","549","588","2115",921,1194,412,"188",224,0.2432,0.1575,0.1948,0.278
"679",110529,"California State Polytechnic University-Pomona",0,1,2005,"0","229.765884","559","773","3089",1296,1793,380,"157",223,0.1721,0.0876,0.123,0.2502
"680",110529,"California State Polytechnic University-Pomona",0,1,2006,"0","250.600751","563","769","3138",1357,1781,341,"128",213,0.157,0.0719,0.1087,0.2451
"681",110529,"California State Polytechnic University-Pomona",0,1,2007,"0","249.001386","594","770","3414",1459,1955,343,"118",225,0.1542,0.0604,0.1005,0.2255
"682",110529,"California State Polytechnic University-Pomona",0,1,2008,"0","275.571289","570","680","2538",1068,1470,299,"135",164,0.1536,0.0918,0.1178,0.2679
"683",110529,"California State Polytechnic University-Pomona",0,1,2009,"0","287.158907","562","714","2728",1192,1536,401,"134",267,0.224,0.0872,0.147,0.2617
"684",110529,"California State Polytechnic University-Pomona",0,1,2010,"0","268.825642","504","458","1923",835,1088,352,"150",202,0.2419,0.1379,0.183,0.2382
"685",110538,"CALIFORNIA STATE UNIVERSITY-CHICO",1,0,1991,"936","126.620513","639","1009","1284",731,553,171,"35",136,0.186,0.0633,0.1332,0.7858
"686",110538,"CALIFORNIA STATE UNIVERSITY-CHICO",1,0,1992,"1452","126.000536","587","1018","1325",758,567,148,"34",114,0.1504,0.06,0.1117,0.7683
"687",110538,"CALIFORNIA STATE UNIVERSITY-CHICO",1,0,1993,"1674","128.004272","574","899","1244",754,490,169,"27",142,0.1883,0.0551,0.1359,0.7227
"688",110538,"CALIFORNIA STATE UNIVERSITY-CHICO",1,0,1995,"1891","131.046633","545","940","1401",832,569,161,"22",139,0.1671,0.0387,0.1149,0.6709
"689",110538,"CALIFORNIA STATE UNIVERSITY-CHICO",1,0,1996,"1935","129.048657","541","1018","1524",874,650,173,"35",138,0.1579,0.0538,0.1135,0.668
"690",110538,"CALIFORNIA STATE UNIVERSITY-CHICO",1,0,1997,"2076","136.930637","536","1125","1618",948,670,246,"45",201,0.212,0.0672,0.152,0.6953
"691",110538,"CALIFORNIA STATE UNIVERSITY-CHICO",1,0,1998,"2026","143.103414","552","1263","1850",1069,781,299,"65",234,0.2189,0.0832,0.1616,0.6827
"692",110538,"CALIFORNIA STATE UNIVERSITY-CHICO",1,0,1999,"0","150.740839","571","1398","2007",1139,868,304,"67",237,0.2081,0.0772,0.1515,0.6966
"693",110538,"CALIFORNIA STATE UNIVERSITY-CHICO",1,0,2000,"0","203.91839","579","1336","1931",1079,852,336,"79",257,0.2382,0.0927,0.174,0.6919
"694",110538,"CALIFORNIA STATE UNIVERSITY-CHICO",1,0,2001,"0","230.327557","587","1444","2092",1175,917,314,"64",250,0.2128,0.0698,0.1501,0.6902
"695",110538,"CALIFORNIA STATE UNIVERSITY-CHICO",1,0,2002,"0","173.850884","572","1353","1995",1125,870,372,"95",277,0.2462,0.1092,0.1865,0.6782
"696",110538,"CALIFORNIA STATE UNIVERSITY-CHICO",1,0,2003,"0","179.096729","525","1385","1970",1140,830,322,"71",251,0.2202,0.0855,0.1635,0.703
"697",110538,"CALIFORNIA STATE UNIVERSITY-CHICO",1,0,2004,"0","179.076262","498","1485","2198",1266,932,436,"102",334,0.2638,0.1094,0.1984,0.6756
"698",110538,"California State University-Chico",1,0,2005,"0","182.717671","506","1452","2300",1237,1063,439,"118",321,0.2595,0.111,0.1909,0.6313
"699",110538,"California State University-Chico",1,0,2006,"0","182.506221","530","1597","2430",1326,1104,420,"103",317,0.2391,0.0933,0.1728,0.6572
"700",110538,"California State University-Chico",1,0,2007,"0","193.472002","559","1765","2710",1418,1292,458,"138",320,0.2257,0.1068,0.169,0.6513
"701",110538,"California State University-Chico",1,0,2008,"0","214.89036","565","1821","2727",1420,1307,537,"163",374,0.2634,0.1247,0.1969,0.6678
"702",110538,"California State University-Chico",1,0,2009,"0","218.118936","531","1488","2468",1338,1130,561,"159",402,0.3004,0.1407,0.2273,0.6029
"703",110538,"California State University-Chico",1,0,2010,"0","205.678336","500","1015","1880",1048,832,484,"160",324,0.3092,0.1923,0.2574,0.5399
"704",110547,"CALIFORNIA STATE UNIVERSITY-DOMINGUEZ HILLS",1,0,1991,"936","68.2213","285","50","337",227,110,9,"2",7,0.0308,0.0182,0.0267,0.1484
"705",110547,"CALIFORNIA STATE UNIVERSITY-DOMINGUEZ HILLS",1,0,1992,"1399","67.246795","277","53","485",336,149,16,"6",10,0.0298,0.0403,0.033,0.1093
"706",110547,"CALIFORNIA STATE UNIVERSITY-DOMINGUEZ HILLS",1,0,1993,"1674","70.393297","268","46","389",252,137,15,"5",10,0.0397,0.0365,0.0386,0.1183
"707",110547,"CALIFORNIA STATE UNIVERSITY-DOMINGUEZ HILLS",1,0,1995,"1891","78.89789","265","23","467",335,132,19,"4",15,0.0448,0.0303,0.0407,0.0493
"708",110547,"CALIFORNIA STATE UNIVERSITY-DOMINGUEZ HILLS",1,0,1996,"1935","82.073628","276","14","475",358,117,24,"3",21,0.0587,0.0256,0.0505,0.0295
"709",110547,"CALIFORNIA STATE UNIVERSITY-DOMINGUEZ HILLS",1,0,1997,"1791","84.988633","265","27","512",363,149,17,"2",15,0.0413,0.0134,0.0332,0.0527
"710",110547,"CALIFORNIA STATE UNIVERSITY-DOMINGUEZ HILLS",1,0,1998,"1748","89.067155","277","20","465",330,135,21,"3",18,0.0545,0.0222,0.0452,0.043
"711",110547,"CALIFORNIA STATE UNIVERSITY-DOMINGUEZ HILLS",1,0,1999,"0","96.499688","294","24","453",319,134,26,"5",21,0.0658,0.0373,0.0574,0.053
"712",110547,"CALIFORNIA STATE UNIVERSITY-DOMINGUEZ HILLS",1,0,2000,"0","118.132519","290.5","25","495",355,140,31,"7",24,0.0676,0.05,0.0626,0.0505
"713",110547,"CALIFORNIA STATE UNIVERSITY-DOMINGUEZ HILLS",1,0,2001,"0","125.841564","287","25","561",391,170,26,"6",20,0.0512,0.0353,0.0463,0.0446
"714",110547,"CALIFORNIA STATE UNIVERSITY-DOMINGUEZ HILLS",1,0,2002,"0","110.034192","295","30","630",466,164,28,"6",22,0.0472,0.0366,0.0444,0.0476
"715",110547,"CALIFORNIA STATE UNIVERSITY-DOMINGUEZ HILLS",1,0,2003,"0","121.297004","310","25","639",458,181,31,"5",26,0.0568,0.0276,0.0485,0.0391
"716",110547,"CALIFORNIA STATE UNIVERSITY-DOMINGUEZ HILLS",1,0,2004,"0","123.61311","288","36","673",459,214,35,"10",25,0.0545,0.0467,0.052,0.0535
"717",110547,"California State University-Dominguez Hills",1,0,2005,"0","122.340499","270","34","705",476,229,42,"9",33,0.0693,0.0393,0.0596,0.0482
"718",110547,"California State University-Dominguez Hills",1,0,2006,"0","124.895812","268","41","984",716,268,41,"8",33,0.0461,0.0299,0.0417,0.0417
"719",110547,"California State University-Dominguez Hills",1,0,2007,"0","131.00551","292","38","913",602,311,35,"11",24,0.0399,0.0354,0.0383,0.0416
"720",110547,"California State University-Dominguez Hills",1,0,2008,"0","142.008291","282","35","889",599,290,42,"14",28,0.0467,0.0483,0.0472,0.0394
"721",110547,"California State University-Dominguez Hills",1,0,2009,"0","149.52373","293","34","1069",703,366,66,"13",53,0.0754,0.0355,0.0617,0.0318
"722",110547,"California State University-Dominguez Hills",1,0,2010,"0","141.153995","279","41","982",633,349,50,"17",33,0.0521,0.0487,0.0509,0.0418
"723",110556,"CALIFORNIA STATE UNIVERSITY-FRESNO",1,0,1991,"936","144.795062","734","711","1648",902,746,173,"61",112,0.1242,0.0818,0.105,0.4314
"724",110556,"CALIFORNIA STATE UNIVERSITY-FRESNO",1,0,1992,"1446","151.33612","643","666","1559",860,699,165,"52",113,0.1314,0.0744,0.1058,0.4272
"725",110556,"CALIFORNIA STATE UNIVERSITY-FRESNO",1,0,1993,"1674","148.262589","649","522","1436",792,644,152,"32",120,0.1515,0.0497,0.1058,0.3635
"726",110556,"CALIFORNIA STATE UNIVERSITY-FRESNO",1,0,1995,"1891","155.563798","637","537","1571",915,656,176,"44",132,0.1443,0.0671,0.112,0.3418
"727",110556,"CALIFORNIA STATE UNIVERSITY-FRESNO",1,0,1996,"1935","154.720254","630","469","1503",846,657,198,"54",144,0.1702,0.0822,0.1317,0.312
"728",110556,"CALIFORNIA STATE UNIVERSITY-FRESNO",1,0,1997,"1802","163.274204","637","486","1510",901,609,180,"69",111,0.1232,0.1133,0.1192,0.3219
"729",110556,"CALIFORNIA STATE UNIVERSITY-FRESNO",1,0,1998,"1754","171.027393","625","488","1566",933,633,215,"44",171,0.1833,0.0695,0.1373,0.3116
"730",110556,"CALIFORNIA STATE UNIVERSITY-FRESNO",1,0,1999,"0","176.479125","646","573","1703",1002,701,225,"56",169,0.1687,0.0799,0.1321,0.3365
"731",110556,"CALIFORNIA STATE UNIVERSITY-FRESNO",1,0,2000,"0","262.284871","646","629","1885",1138,747,227,"67",160,0.1406,0.0897,0.1204,0.3337
"732",110556,"CALIFORNIA STATE UNIVERSITY-FRESNO",1,0,2001,"0","278.695","646","704","1946",1179,767,275,"74",201,0.1705,0.0965,0.1413,0.3618
"733",110556,"CALIFORNIA STATE UNIVERSITY-FRESNO",1,0,2002,"0","225.074315","677","825","2189",1274,915,346,"109",237,0.186,0.1191,0.1581,0.3769
"734",110556,"CALIFORNIA STATE UNIVERSITY-FRESNO",1,0,2003,"0","237.371519","648","915","2485",1503,982,353,"101",252,0.1677,0.1029,0.1421,0.3682
"735",110556,"CALIFORNIA STATE UNIVERSITY-FRESNO",1,0,2004,"0","234.268316","601","839","2243",1351,892,378,"102",276,0.2043,0.1143,0.1685,0.3741
"736",110556,"California State University-Fresno",1,0,2005,"0","219.52263","636","785","2356",1403,953,323,"106",217,0.1547,0.1112,0.1371,0.3332
"737",110556,"California State University-Fresno",1,0,2006,"0","259.430683","664","843","2528",1501,1027,344,"108",236,0.1572,0.1052,0.1361,0.3335
"738",110556,"California State University-Fresno",1,0,2007,"0","207.464641","704","797","2552",1526,1026,350,"112",238,0.156,0.1092,0.1371,0.3123
"739",110556,"California State University-Fresno",1,0,2008,"0","284.103506","703","847","2731",1604,1127,402,"121",281,0.1752,0.1074,0.1472,0.3101
"740",110556,"California State University-Fresno",1,0,2009,"0","285.931101","653","780","2619",1574,1045,407,"123",284,0.1804,0.1177,0.1554,0.2978
"741",110556,"California State University-Fresno",1,0,2010,"0","287.923239","642","667","2582",1551,1031,420,"116",304,0.196,0.1125,0.1627,0.2583
"742",110565,"CALIFORNIA STATE UNIVERSITY-FULLERTON",1,0,1991,"936","136.230621","686","714","1847",1094,753,137,"30",107,0.0978,0.0398,0.0742,0.3866
"743",110565,"CALIFORNIA STATE UNIVERSITY-FULLERTON",1,0,1992,"1480","141.783862","645","562","1589",926,663,108,"27",81,0.0875,0.0407,0.068,0.3537
"744",110565,"CALIFORNIA STATE UNIVERSITY-FULLERTON",1,0,1993,"1674","137.028144","623","431","1309",748,561,112,"40",72,0.0963,0.0713,0.0856,0.3293
"745",110565,"CALIFORNIA STATE UNIVERSITY-FULLERTON",1,0,1995,"1891","154.680793","612","556","1832",1036,796,148,"41",107,0.1033,0.0515,0.0808,0.3035
"746",110565,"CALIFORNIA STATE UNIVERSITY-FULLERTON",1,0,1996,"1935","149.541084","618","610","2028",1158,870,199,"48",151,0.1304,0.0552,0.0981,0.3008
"747",110565,"CALIFORNIA STATE UNIVERSITY-FULLERTON",1,0,1997,"1936","172.027669","602","625","2192",1317,875,215,"48",167,0.1268,0.0549,0.0981,0.2851
"748",110565,"CALIFORNIA STATE UNIVERSITY-FULLERTON",1,0,1998,"1858","177.699594","621","636","2146",1240,906,274,"65",209,0.1685,0.0717,0.1277,0.2964
"749",110565,"CALIFORNIA STATE UNIVERSITY-FULLERTON",1,0,1999,"0","234.680768","646","758","2544",1543,1001,349,"63",286,0.1854,0.0629,0.1372,0.298
"750",110565,"CALIFORNIA STATE UNIVERSITY-FULLERTON",1,0,2000,"0","248.305684","690.5","843","2655",1609,1046,381,"83",298,0.1852,0.0793,0.1435,0.3175
"751",110565,"CALIFORNIA STATE UNIVERSITY-FULLERTON",1,0,2001,"0","288.025163","735","846","2772",1673,1099,416,"86",330,0.1973,0.0783,0.1501,0.3052
"752",110565,"CALIFORNIA STATE UNIVERSITY-FULLERTON",1,0,2002,"0","302.424816","776","1076","3291",2039,1252,481,"111",370,0.1815,0.0887,0.1462,0.327
"753",110565,"CALIFORNIA STATE UNIVERSITY-FULLERTON",1,0,2003,"0","280.692214","755","1018","3098",1873,1225,481,"107",374,0.1997,0.0873,0.1553,0.3286
"754",110565,"CALIFORNIA STATE UNIVERSITY-FULLERTON",1,0,2004,"0","287.64523","719","1117","3539",2094,1445,583,"148",435,0.2077,0.1024,0.1647,0.3156
"755",110565,"California State University-Fullerton",1,0,2005,"0","271.180602","757","1127","3816",2241,1575,524,"134",390,0.174,0.0851,0.1373,0.2953
"756",110565,"California State University-Fullerton",1,0,2006,"0","302.357831","826","1045","3736",2262,1474,500,"122",378,0.1671,0.0828,0.1338,0.2797
"757",110565,"California State University-Fullerton",1,0,2007,"0","341.782013","894","1078","4040",2430,1610,550,"135",415,0.1708,0.0839,0.1361,0.2668
"758",110565,"California State University-Fullerton",1,0,2008,"0","387.685385","879","1275","4519",2673,1846,630,"180",450,0.1684,0.0975,0.1394,0.2821
"759",110565,"California State University-Fullerton",1,0,2009,"0","377.034019","866","1034","3842",2233,1609,666,"180",486,0.2176,0.1119,0.1733,0.2691
"760",110565,"California State University-Fullerton",1,0,2010,"0","368.020662","848","975","3749",2160,1589,660,"173",487,0.2255,0.1089,0.176,0.2601
"761",110574,"CALIFORNIA STATE UNIVERSITY-HAYWARD",0,1,1991,"936","89.330659","435","217","649",445,204,87,"22",65,0.1461,0.1078,0.1341,0.3344
"762",110574,"CALIFORNIA STATE UNIVERSITY-HAYWARD",0,1,1992,"1423","91.122411","388","135","572",394,178,76,"17",59,0.1497,0.0955,0.1329,0.236
"763",110574,"CALIFORNIA STATE UNIVERSITY-HAYWARD",0,1,1993,"1674","91.972147","383","134","553",371,182,59,"11",48,0.1294,0.0604,0.1067,0.2423
"764",110574,"CALIFORNIA STATE UNIVERSITY-HAYWARD",0,1,1995,"1891","105.835355","381","119","542",331,211,55,"22",33,0.0997,0.1043,0.1015,0.2196
"765",110574,"CALIFORNIA STATE UNIVERSITY-HAYWARD",0,1,1996,"1935","106.629523","384","129","661",420,241,83,"26",57,0.1357,0.1079,0.1256,0.1952
"766",110574,"CALIFORNIA STATE UNIVERSITY-HAYWARD",0,1,1997,"1812","113.048024","352","128","711",451,260,94,"26",68,0.1508,0.1,0.1322,0.18
"767",110574,"CALIFORNIA STATE UNIVERSITY-HAYWARD",0,1,1998,"1746","119.074689","350","159","732",470,262,106,"24",82,0.1745,0.0916,0.1448,0.2172
"768",110574,"CALIFORNIA STATE UNIVERSITY-HAYWARD",0,1,1999,"0","125.935615","355","147","714",466,248,119,"26",93,0.1996,0.1048,0.1667,0.2059
"769",110574,"CALIFORNIA STATE UNIVERSITY-HAYWARD",0,1,2000,"0","146.723655","353","156","669",452,217,109,"26",83,0.1836,0.1198,0.1629,0.2332
"770",110574,"CALIFORNIA STATE UNIVERSITY-HAYWARD",0,1,2001,"0","175.543366","351","131","692",435,257,75,"17",58,0.1333,0.0661,0.1084,0.1893
"771",110574,"CALIFORNIA STATE UNIVERSITY-HAYWARD",0,1,2002,"0","153.599935","336","164","746",473,273,119,"43",76,0.1607,0.1575,0.1595,0.2198
"772",110574,"CALIFORNIA STATE UNIVERSITY-HAYWARD",0,1,2003,"0","158.849789","330","140","672",415,257,111,"32",79,0.1904,0.1245,0.1652,0.2083
"773",110574,"CALIFORNIA STATE UNIVERSITY-EAST BAY",0,1,2004,"0","152.90706","312","159","840",516,324,122,"38",84,0.1628,0.1173,0.1452,0.1893
"774",110574,"California State University-East Bay",0,1,2005,"0","142.700631","322","138","686",414,272,110,"39",71,0.1715,0.1434,0.1603,0.2012
"775",110574,"California State University-East Bay",0,1,2006,"0","158.732382","334","126","881",506,375,131,"48",83,0.164,0.128,0.1487,0.143
"776",110574,"California State University-East Bay",0,1,2007,"0","171.032914","350","124","1032",602,430,111,"49",62,0.103,0.114,0.1076,0.1202
"777",110574,"California State University-East Bay",0,1,2008,"0","187.556246","372","188","1356",828,528,141,"45",96,0.1159,0.0852,0.104,0.1386
"778",110574,"California State University-East Bay",0,1,2009,"0","201.326638","354","187","1436",884,552,184,"54",130,0.1471,0.0978,0.1281,0.1302
"779",110574,"California State University-East Bay",0,1,2010,"0","179.489946","327","165","1192",751,441,168,"47",121,0.1611,0.1066,0.1409,0.1384
"780",110583,"CALIFORNIA STATE UNIVERSITY-LONG BEACH",1,0,1991,"936","196.148238","861","791","2142",1283,859,88,"25",63,0.0491,0.0291,0.0411,0.3693
"781",110583,"CALIFORNIA STATE UNIVERSITY-LONG BEACH",1,0,1992,"1425","191.674428","793","497","1565",961,604,79,"27",52,0.0541,0.0447,0.0505,0.3176
"782",110583,"CALIFORNIA STATE UNIVERSITY-LONG BEACH",1,0,1993,"1674","189.84985","780","439","1835",1125,710,80,"21",59,0.0524,0.0296,0.0436,0.2392
"783",110583,"CALIFORNIA STATE UNIVERSITY-LONG BEACH",1,0,1995,"1891","200.55184","773","515","2057",1307,750,88,"26",62,0.0474,0.0347,0.0428,0.2504
"784",110583,"CALIFORNIA STATE UNIVERSITY-LONG BEACH",1,0,1996,"1935","208.025075","775","641","2299",1407,892,152,"38",114,0.081,0.0426,0.0661,0.2788
"785",110583,"CALIFORNIA STATE UNIVERSITY-LONG BEACH",1,0,1997,"1844","213.942025","779","706","2498",1597,901,205,"60",145,0.0908,0.0666,0.0821,0.2826
"786",110583,"CALIFORNIA STATE UNIVERSITY-LONG BEACH",1,0,1998,"1766","227.711567","782","809","2652",1707,945,285,"61",224,0.1312,0.0646,0.1075,0.3051
"787",110583,"CALIFORNIA STATE UNIVERSITY-LONG BEACH",1,0,1999,"0","244.38148","815","1068","3309",2128,1181,361,"75",286,0.1344,0.0635,0.1091,0.3228
"788",110583,"CALIFORNIA STATE UNIVERSITY-LONG BEACH",1,0,2000,"0","328.493346","869.5","1078","3214",2038,1176,375,"87",288,0.1413,0.074,0.1167,0.3354
"789",110583,"CALIFORNIA STATE UNIVERSITY-LONG BEACH",1,0,2001,"0","376.701472","924","1474","4324",2751,1573,420,"117",303,0.1101,0.0744,0.0971,0.3409
"790",110583,"CALIFORNIA STATE UNIVERSITY-LONG BEACH",1,0,2002,"0","288.394134","947","1064","2912",1871,1041,365,"91",274,0.1464,0.0874,0.1253,0.3654
"791",110583,"CALIFORNIA STATE UNIVERSITY-LONG BEACH",1,0,2003,"0","312.360925","964","1233","3339",2236,1103,432,"103",329,0.1471,0.0934,0.1294,0.3693
"792",110583,"CALIFORNIA STATE UNIVERSITY-LONG BEACH",1,0,2004,"0","314.028114","918","1000","3300",2222,1078,406,"103",303,0.1364,0.0955,0.123,0.303
"793",110583,"California State University-Long Beach",1,0,2005,"0","313.724487","968","1348","4241",2666,1575,524,"153",371,0.1392,0.0971,0.1236,0.3178
"794",110583,"California State University-Long Beach",1,0,2006,"0","353.262581","987","1307","4334",2757,1577,550,"175",375,0.136,0.111,0.1269,0.3016
"795",110583,"California State University-Long Beach",1,0,2007,"0","363.611753","1030","1135","4134",2620,1514,581,"166",415,0.1584,0.1096,0.1405,0.2746
"796",110583,"California State University-Long Beach",1,0,2008,"0","397.871551","1012","1324","4536",2856,1680,676,"183",493,0.1726,0.1089,0.149,0.2919
"797",110583,"California State University-Long Beach",1,0,2009,"0","412.167584","1001","779","3473",2133,1340,551,"172",379,0.1777,0.1284,0.1587,0.2243
"798",110583,"California State University-Long Beach",1,0,2010,"0","388.372973","953","808","3913",2310,1603,585,"189",396,0.1714,0.1179,0.1495,0.2065
"799",110592,"CALIFORNIA STATE UNIVERSITY-LOS ANGELES",0,1,1991,"936","142.640395","616","75","1491",938,553,41,"9",32,0.0341,0.0163,0.0275,0.0503
"800",110592,"CALIFORNIA STATE UNIVERSITY-LOS ANGELES",0,1,1992,"1427","139.483913","550","47","1206",738,468,45,"16",29,0.0393,0.0342,0.0373,0.039
"801",110592,"CALIFORNIA STATE UNIVERSITY-LOS ANGELES",0,1,1993,"1674","133.528956","579","33","1133",697,436,34,"11",23,0.033,0.0252,0.03,0.0291
"802",110592,"CALIFORNIA STATE UNIVERSITY-LOS ANGELES",0,1,1995,"1891","142.597254","565","62","1243",766,477,49,"12",37,0.0483,0.0252,0.0394,0.0499
"803",110592,"CALIFORNIA STATE UNIVERSITY-LOS ANGELES",0,1,1996,"1935","146.499114","555","66","1313",763,550,51,"15",36,0.0472,0.0273,0.0388,0.0503
"804",110592,"CALIFORNIA STATE UNIVERSITY-LOS ANGELES",0,1,1997,"1758","145.874938","573","64","1274",828,446,82,"17",65,0.0785,0.0381,0.0644,0.0502
"805",110592,"CALIFORNIA STATE UNIVERSITY-LOS ANGELES",0,1,1998,"1679","158.578482","569","80","1255",789,466,103,"22",81,0.1027,0.0472,0.0821,0.0637
"806",110592,"CALIFORNIA STATE UNIVERSITY-LOS ANGELES",0,1,1999,"0","176.747372","592","86","1186",750,436,111,"32",79,0.1053,0.0734,0.0936,0.0725
"807",110592,"CALIFORNIA STATE UNIVERSITY-LOS ANGELES",0,1,2000,"0","207.29963","586.5","75","1184",755,429,126,"24",102,0.1351,0.0559,0.1064,0.0633
"808",110592,"CALIFORNIA STATE UNIVERSITY-LOS ANGELES",0,1,2001,"0","231.480958","581","70","1223",767,456,117,"26",91,0.1186,0.057,0.0957,0.0572
"809",110592,"CALIFORNIA STATE UNIVERSITY-LOS ANGELES",0,1,2002,"0","207.000523","599","97","1404",906,498,116,"34",82,0.0905,0.0683,0.0826,0.0691
"810",110592,"CALIFORNIA STATE UNIVERSITY-LOS ANGELES",0,1,2003,"0","216.148036","600","83","1305",845,460,115,"32",83,0.0982,0.0696,0.0881,0.0636
"811",110592,"CALIFORNIA STATE UNIVERSITY-LOS ANGELES",0,1,2004,"0","215.34514","558","61","1087",687,400,87,"22",65,0.0946,0.055,0.08,0.0561
"812",110592,"California State University-Los Angeles",0,1,2005,"0","209.329662","581","60","1253",823,430,111,"31",80,0.0972,0.0721,0.0886,0.0479
"813",110592,"California State University-Los Angeles",0,1,2006,"0","219.348374","565","76","1542",961,581,113,"36",77,0.0801,0.062,0.0733,0.0493
"814",110592,"California State University-Los Angeles",0,1,2007,"0","231.458669","566","65","1767",1106,661,119,"40",79,0.0714,0.0605,0.0673,0.0368
"815",110592,"California State University-Los Angeles",0,1,2008,"0","240.637994","579","67","1676",1014,662,105,"40",65,0.0641,0.0604,0.0626,0.04
"816",110592,"California State University-Los Angeles",0,1,2009,"0","259.144955","579","81","1877",1173,704,127,"40",87,0.0742,0.0568,0.0677,0.0432
"817",110592,"California State University-Los Angeles",0,1,2010,"0","228.505556","556","80","2013",1222,791,127,"48",79,0.0646,0.0607,0.0631,0.0397
"818",110617,"CALIFORNIA STATE UNIVERSITY-SACRAMENTO",1,0,1991,"936","159.230999","808","678","1210",694,516,108,"28",80,0.1153,0.0543,0.0893,0.5603
"819",110617,"CALIFORNIA STATE UNIVERSITY-SACRAMENTO",1,0,1992,"1460","160.762944","726","418","922",513,409,71,"20",51,0.0994,0.0489,0.077,0.4534
"820",110617,"CALIFORNIA STATE UNIVERSITY-SACRAMENTO",1,0,1993,"1674","163.371464","721","496","1086",635,451,51,"8",43,0.0677,0.0177,0.047,0.4567
"821",110617,"CALIFORNIA STATE UNIVERSITY-SACRAMENTO",1,0,1995,"1891","177.360771","717","473","1219",735,484,96,"24",72,0.098,0.0496,0.0788,0.388
"822",110617,"CALIFORNIA STATE UNIVERSITY-SACRAMENTO",1,0,1996,"1935","173.012076","720","524","1396",826,570,84,"23",61,0.0738,0.0404,0.0602,0.3754
"823",110617,"CALIFORNIA STATE UNIVERSITY-SACRAMENTO",1,0,1997,"1982","194.941513","713","505","1350",777,573,95,"31",64,0.0824,0.0541,0.0704,0.3741
"824",110617,"CALIFORNIA STATE UNIVERSITY-SACRAMENTO",1,0,1998,"1934","197.155335","706","589","1467",828,639,136,"30",106,0.128,0.0469,0.0927,0.4015
"825",110617,"CALIFORNIA STATE UNIVERSITY-SACRAMENTO",1,0,1999,"0","215.393825","731","704","1753",1013,740,159,"39",120,0.1185,0.0527,0.0907,0.4016
"826",110617,"CALIFORNIA STATE UNIVERSITY-SACRAMENTO",1,0,2000,"0","293.10579","728","741","2055",1198,857,178,"36",142,0.1185,0.042,0.0866,0.3606
"827",110617,"CALIFORNIA STATE UNIVERSITY-SACRAMENTO",1,0,2001,"0","321.154414","725","891","2278",1387,891,221,"49",172,0.124,0.055,0.097,0.3911
"828",110617,"CALIFORNIA STATE UNIVERSITY-SACRAMENTO",1,0,2002,"0","272.023344","801","944","2378",1395,983,221,"56",165,0.1183,0.057,0.0929,0.397
"829",110617,"CALIFORNIA STATE UNIVERSITY-SACRAMENTO",1,0,2003,"0","289.708599","811","941","2347",1415,932,227,"62",165,0.1166,0.0665,0.0967,0.4009
"830",110617,"CALIFORNIA STATE UNIVERSITY-SACRAMENTO",1,0,2004,"0","295.132439","800","884","2268",1375,893,240,"57",183,0.1331,0.0638,0.1058,0.3898
"831",110617,"California State University-Sacramento",1,0,2005,"0","294.165252","765","911","2436",1483,953,256,"73",183,0.1234,0.0766,0.1051,0.374
"832",110617,"California State University-Sacramento",1,0,2006,"0","288.806071","786","901","2590",1570,1020,263,"79",184,0.1172,0.0775,0.1015,0.3479
"833",110617,"California State University-Sacramento",1,0,2007,"0","310.747975","783","682","2357",1426,931,194,"64",130,0.0912,0.0687,0.0823,0.2894
"834",110617,"California State University-Sacramento",1,0,2008,"0","334.269539","779","869","2536",1493,1043,191,"50",141,0.0944,0.0479,0.0753,0.3427
"835",110617,"California State University-Sacramento",1,0,2009,"0","346.734388","776","906","2954",1712,1242,196,"50",146,0.0853,0.0403,0.0664,0.3067
"836",110617,"California State University-Sacramento",1,0,2010,"0","340.387529","723","783","2625",1548,1077,238,"69",169,0.1092,0.0641,0.0907,0.2983
"837",113698,"DOMINICAN COLLEGE OF SAN RAFAEL",1,0,1991,"10390","11.823311","42","44","66",50,16,22,"3",19,0.38,0.1875,0.3333,0.6667
"838",113698,"DOMINICAN COLLEGE OF SAN RAFAEL",1,0,1992,"11280","14.336986","42","44","65",45,20,24,"8",16,0.3556,0.4,0.3692,0.6769
"839",113698,"DOMINICAN COLLEGE OF SAN RAFAEL",1,0,1993,"12180","14.658314","40","49","75",46,29,17,"4",13,0.2826,0.1379,0.2267,0.6533
"840",113698,"DOMINICAN COLLEGE OF SAN RAFAEL",1,0,1995,"13890","18.581121","46","49","69",51,18,27,"5",22,0.4314,0.2778,0.3913,0.7101
"841",113698,"DOMINICAN COLLEGE OF SAN RAFAEL",1,0,1996,"14670","20.483669","39","31","58",41,17,23,"6",17,0.4146,0.3529,0.3966,0.5345
"842",113698,"DOMINICAN COLLEGE OF SAN RAFAEL",1,0,1997,"15424","19.668532","44","38","74",55,19,24,"5",19,0.3455,0.2632,0.3243,0.5135
"843",113698,"DOMINICAN COLLEGE OF SAN RAFAEL",1,0,1998,"16160","20.970784","49","45","72",58,14,30,"6",24,0.4138,0.4286,0.4167,0.625
"844",113698,"DOMINICAN COLLEGE OF SAN RAFAEL",1,0,1999,"16512","19.783485","43","67","111",88,23,50,"10",40,0.4545,0.4348,0.4505,0.6036
"845",113698,"DOMINICAN UNIVERSITY OF CALIFORNIA",1,0,2000,"17256","20.041422","48.5","58","113",86,27,48,"13",35,0.407,0.4815,0.4248,0.5133
"846",113698,"DOMINICAN UNIVERSITY OF CALIFORNIA",1,0,2001,"18648","23.328268","54","59","127",90,37,51,"13",38,0.4222,0.3514,0.4016,0.4646
"847",113698,"DOMINICAN UNIVERSITY OF CALIFORNIA",1,0,2002,"20320","26.339737","58","78","202",145,57,75,"19",56,0.3862,0.3333,0.3713,0.3861
"848",113698,"DOMINICAN UNIVERSITY OF CALIFORNIA",1,0,2003,"22250","28.86789","72","88","244",188,56,98,"24",74,0.3936,0.4286,0.4016,0.3607
"849",113698,"DOMINICAN UNIVERSITY OF CALIFORNIA",1,0,2004,"24254","29.978153","65","109","276",205,71,119,"24",95,0.4634,0.338,0.4312,0.3949
"850",113698,"Dominican University of California",1,0,2005,"25950","30.967719","67","82","227",168,59,98,"22",76,0.4524,0.3729,0.4317,0.3612
"851",113698,"Dominican University of California",1,0,2006,"27770","32.016529","78","99","263",193,70,100,"18",82,0.4249,0.2571,0.3802,0.3764
"852",113698,"Dominican University of California",1,0,2007,"30270","39.115926","73","100","297",225,72,107,"23",84,0.3733,0.3194,0.3603,0.3367
"853",113698,"Dominican University of California",1,0,2008,"32090","42.870539","79","71","267",202,65,146,"31",115,0.5693,0.4769,0.5468,0.2659
"854",113698,"Dominican University of California",1,0,2009,"33540","43.29243","81","98","289",207,82,152,"25",127,0.6135,0.3049,0.526,0.3391
"855",113698,"Dominican University of California",1,0,2010,"35220","48.183079","83","91","338",255,83,192,"45",147,0.5765,0.5422,0.568,0.2692
"856",115755,"HUMBOLDT STATE UNIVERSITY",1,0,1991,"936","72.689966","342","649","862",468,394,61,"19",42,0.0897,0.0482,0.0708,0.7529
"857",115755,"HUMBOLDT STATE UNIVERSITY",1,0,1992,"1467","75.491862","324","560","779",421,358,45,"16",29,0.0689,0.0447,0.0578,0.7189
"858",115755,"HUMBOLDT STATE UNIVERSITY",1,0,1993,"1674","76.200026","301","390","553",324,229,60,"9",51,0.1574,0.0393,0.1085,0.7052
"859",115755,"HUMBOLDT STATE UNIVERSITY",1,0,1995,"1891","78.302663","311","644","908",503,405,69,"18",51,0.1014,0.0444,0.076,0.7093
"860",115755,"HUMBOLDT STATE UNIVERSITY",1,0,1996,"1935","80.203681","315","529","823",471,352,62,"13",49,0.104,0.0369,0.0753,0.6428
"861",115755,"HUMBOLDT STATE UNIVERSITY",1,0,1997,"1923","86.336329","309","481","718",401,317,85,"14",71,0.1771,0.0442,0.1184,0.6699
"862",115755,"HUMBOLDT STATE UNIVERSITY",1,0,1998,"1905","89.242899","319","477","731",405,326,71,"24",47,0.116,0.0736,0.0971,0.6525
"863",115755,"HUMBOLDT STATE UNIVERSITY",1,0,1999,"0","93.20381","317","511","751",436,315,89,"25",64,0.1468,0.0794,0.1185,0.6804
"864",115755,"HUMBOLDT STATE UNIVERSITY",1,0,2000,"0","121.265421","313","535","769",460,309,94,"32",62,0.1348,0.1036,0.1222,0.6957
"865",115755,"HUMBOLDT STATE UNIVERSITY",1,0,2001,"0","128.869259","309","461","725",416,309,81,"18",63,0.1514,0.0583,0.1117,0.6359
"866",115755,"HUMBOLDT STATE UNIVERSITY",1,0,2002,"0","106.377971","303","499","836",505,331,97,"28",69,0.1366,0.0846,0.116,0.5969
"867",115755,"HUMBOLDT STATE UNIVERSITY",1,0,2003,"0","111.739847","288","506","853",481,372,97,"26",71,0.1476,0.0699,0.1137,0.5932
"868",115755,"HUMBOLDT STATE UNIVERSITY",1,0,2004,"0","114.092962","288","426","760",427,333,66,"18",48,0.1124,0.0541,0.0868,0.5605
"869",115755,"Humboldt State University",1,0,2005,"0","115.057739","289","433","813",461,352,99,"32",67,0.1453,0.0909,0.1218,0.5326
"870",115755,"Humboldt State University",1,0,2006,"0","114.082254","299","485","966",550,416,132,"46",86,0.1564,0.1106,0.1366,0.5021
"871",115755,"Humboldt State University",1,0,2007,"0","123.378558","284","472","1039",551,488,112,"39",73,0.1325,0.0799,0.1078,0.4543
"872",115755,"Humboldt State University",1,0,2008,"0","125.379857","279","555","1168",661,507,147,"37",110,0.1664,0.073,0.1259,0.4752
"873",115755,"Humboldt State University",1,0,2009,"0","136.422938","272","741","1345",745,600,214,"57",157,0.2107,0.095,0.1591,0.5509
"874",115755,"Humboldt State University",1,0,2010,"0","136.869009","250","644","1282",701,581,188,"65",123,0.1755,0.1119,0.1466,0.5023
"875",119173,"MOUNT SAINT MARY'S COLLEGE",1,0,1991,"9950","18.051735","54","29","190",190,0,32,"0",32,0.1684,NA,0.1684,0.1526
"876",119173,"MOUNT SAINT MARY'S COLLEGE",1,0,1992,"10830","19.564014","58","29","217",217,0,64,"0",64,0.2949,NA,0.2949,0.1336
"877",119173,"MOUNT SAINT MARYS COLLEGE",1,0,1993,"11690","22.30449","52","39","276",273,3,56,"0",56,0.2051,0,0.2029,0.1413
"878",119173,"MOUNT SAINT MARYS COLLEGE",1,0,1995,"13812","28.593324","72","30","222",220,2,50,"2",48,0.2182,1,0.2252,0.1351
"879",119173,"MOUNT SAINT MARYS COLLEGE",1,0,1996,"14014","30.130831","65","30","112",112,0,61,"0",61,0.5446,NA,0.5446,0.2679
"880",119173,"MOUNT SAINT MARYS COLLEGE",1,0,1997,"14716","30.30943","76","44","258",258,0,82,"0",82,0.3178,NA,0.3178,0.1705
"881",119173,"MOUNT SAINT MARYS COLLEGE",1,0,1998,"15452","27.281992","82","43","295",293,2,62,"0",62,0.2116,0,0.2102,0.1458
"882",119173,"MOUNT ST MARY'S COLLEGE",1,0,1999,"16776","30.176358","76","26","294",293,1,57,"0",57,0.1945,0,0.1939,0.0884
"883",119173,"MOUNT ST MARY'S COLLEGE",1,0,2000,"17036","31.923066","75.5","33","297",296,1,67,"1",66,0.223,1,0.2256,0.1111
"884",119173,"MOUNT ST MARY'S COLLEGE",1,0,2001,"17888","34.320554","75","38","328",325,3,47,"1",46,0.1415,0.3333,0.1433,0.1159
"885",119173,"MOUNT ST MARY'S COLLEGE",1,0,2002,"18782","33.796777","55","21","127",123,4,64,"1",63,0.5122,0.25,0.5039,0.1654
"886",119173,"MOUNT ST MARY'S COLLEGE",1,0,2003,"19722","36.499404","71","40","339",330,9,84,"4",80,0.2424,0.4444,0.2478,0.118
"887",119173,"MOUNT ST MARY'S COLLEGE",1,0,2004,"20708","38.197317","70","33","364",352,12,93,"4",89,0.2528,0.3333,0.2555,0.0907
"888",119173,"Mount St Mary's College",1,0,2005,"22054","40.521984","74","46","393",378,15,68,"3",65,0.172,0.2,0.173,0.117
"889",119173,"Mount St Mary's College",1,0,2006,"23380","46.609149","77","26","345",336,9,76,"1",75,0.2232,0.1111,0.2203,0.0754
"890",119173,"Mount St Mary's College",1,0,2007,"24550","46.291806","81","20","348",331,17,93,"7",86,0.2598,0.4118,0.2672,0.0575
"891",119173,"Mount St Mary's College",1,0,2008,"26280","48.985649","83","21","313",302,11,84,"2",82,0.2715,0.1818,0.2684,0.0671
"892",119173,"Mount St Mary's College",1,0,2009,"27840","54.179416","90","17","367",351,16,109,"5",104,0.2963,0.3125,0.297,0.0463
"893",119173,"Mount St Mary's College",1,0,2010,"29232","54.041751","95","29","525",507,18,140,"3",137,0.2702,0.1667,0.2667,0.0552
"894",120184,"COLLEGE OF NOTRE DAME",1,0,1991,"10165","10.793662","55","32","71",51,20,25,"6",19,0.3725,0.3,0.3521,0.4507
"895",120184,"COLLEGE OF NOTRE DAME",1,0,1992,"11015","11.41318","57","32","85",54,31,34,"14",20,0.3704,0.4516,0.4,0.3765
"896",120184,"COLLEGE OF NOTRE DAME",1,0,1993,"11750","13.193448","59","39","96",76,20,36,"5",31,0.4079,0.25,0.375,0.4062
"897",120184,"COLLEGE OF NOTRE DAME",1,0,1995,"13535","17.44828","60","42","115",79,36,44,"9",35,0.443,0.25,0.3826,0.3652
"898",120184,"COLLEGE OF NOTRE DAME",1,0,1996,"14400","18.73215","60","40","124",75,49,49,"16",33,0.44,0.3265,0.3952,0.3226
"899",120184,"COLLEGE OF NOTRE DAME",1,0,1997,"14976","16.843001","62","41","129",79,50,38,"15",23,0.2911,0.3,0.2946,0.3178
"900",120184,"COLLEGE OF NOTRE DAME",1,0,1998,"15576","18.456511","63","40","130",80,50,52,"14",38,0.475,0.28,0.4,0.3077
"901",120184,"COLLEGE OF NOTRE DAME",1,0,1999,"16200","18.976356","66","38","129",85,44,50,"17",33,0.3882,0.3864,0.3876,0.2946
"902",120184,"COLLEGE OF NOTRE DAME",1,0,2000,"16850","20.61308","61.5","49","137",99,38,54,"15",39,0.3939,0.3947,0.3942,0.3577
"903",120184,"NOTRE DAME DE NAMUR UNIVERSITY",1,0,2001,"18200","22.254229","57","29","111",85,26,55,"10",45,0.5294,0.3846,0.4955,0.2613
"904",120184,"NOTRE DAME DE NAMUR UNIVERSITY",1,0,2002,"19110","23.261017","51","43","97",57,40,42,"12",30,0.5263,0.3,0.433,0.4433
"905",120184,"NOTRE DAME DE NAMUR UNIVERSITY",1,0,2003,"20050","23.550623","57","70","190",106,84,90,"36",54,0.5094,0.4286,0.4737,0.3684
"906",120184,"NOTRE DAME DE NAMUR UNIVERSITY",1,0,2004,"21350","23.976562","52","78","161",108,53,68,"19",49,0.4537,0.3585,0.4224,0.4845
"907",120184,"Notre Dame de Namur University",1,0,2005,"22520","26.176489","50","50","144",95,49,59,"14",45,0.4737,0.2857,0.4097,0.3472
"908",120184,"Notre Dame de Namur University",1,0,2006,"23650","26.112578","53","59","134",93,41,51,"15",36,0.3871,0.3659,0.3806,0.4403
"909",120184,"Notre Dame de Namur University",1,0,2007,"24450","27.290143","54","30","96",57,39,35,"12",23,0.4035,0.3077,0.3646,0.3125
"910",120184,"Notre Dame de Namur University",1,0,2008,"25300","28.070661","54","32","147",85,62,63,"21",42,0.4941,0.3387,0.4286,0.2177
"911",120184,"Notre Dame de Namur University",1,0,2009,"26830","27.042563","55","26","116",78,38,33,"10",23,0.2949,0.2632,0.2845,0.2241
"912",120184,"Notre Dame de Namur University",1,0,2010,"28200","27.010381","59","31","145",94,51,50,"15",35,0.3723,0.2941,0.3448,0.2138
"913",121309,"POINT LOMA NAZARENE COLLEGE",0,1,1991,"8058","29.089436","92","243","317",194,123,103,"34",69,0.3557,0.2764,0.3249,0.7666
"914",121309,"POINT LOMA NAZARENE COLLEGE",1,0,1992,"8838","28.655224","91","317","374",248,126,94,"27",67,0.2702,0.2143,0.2513,0.8476
"915",121309,"POINT LOMA NAZARENE COLLEGE",1,0,1993,"9542","32.47261","94","361","425",255,170,127,"34",93,0.3647,0.2,0.2988,0.8494
"916",121309,"POINT LOMA NAZARENE COLLEGE",1,0,1995,"10880","37.197425","101","405","475",313,162,185,"57",128,0.4089,0.3519,0.3895,0.8526
"917",121309,"POINT LOMA NAZARENE COLLEGE",1,0,1996,"11824","39.405134","100","445","515",313,202,218,"70",148,0.4728,0.3465,0.4233,0.8641
"918",121309,"POINT LOMA NAZARENE COLLEGE",1,0,1997,"12464","33.023352","108","424","494",306,188,187,"64",123,0.402,0.3404,0.3785,0.8583
"919",121309,"POINT LOMA NAZARENE UNIVERSITY",1,0,1998,"12650","36.035182","109","499","598",375,223,261,"87",174,0.464,0.3901,0.4365,0.8344
"920",121309,"POINT LOMA NAZARENE UNIVERSITY",1,0,1999,"13186","41.540455","117","520","613",392,221,332,"117",215,0.5485,0.5294,0.5416,0.8483
"921",121309,"POINT LOMA NAZARENE UNIVERSITY",1,0,2000,"13900","43.74673","120.5","457","539",312,227,274,"101",173,0.5545,0.4449,0.5083,0.8479
"922",121309,"POINT LOMA NAZARENE UNIVERSITY",1,0,2001,"14800","47.813317","124","478","545",346,199,327,"106",221,0.6387,0.5327,0.6,0.8771
"923",121309,"POINT LOMA NAZARENE UNIVERSITY",1,0,2002,"15760","49.845379","128","459","535",324,211,321,"111",210,0.6481,0.5261,0.6,0.8579
"924",121309,"POINT LOMA NAZARENE UNIVERSITY",1,0,2003,"18000","53.769917","134","455","566",356,210,353,"119",234,0.6573,0.5667,0.6237,0.8039
"925",121309,"POINT LOMA NAZARENE UNIVERSITY",1,0,2004,"19040","58.209741","135","425","535",339,196,395,"141",254,0.7493,0.7194,0.7383,0.7944
"926",121309,"Point Loma Nazarene University",1,0,2005,"20200","61.344362","139","446","562",339,223,348,"125",223,0.6578,0.5605,0.6192,0.7936
"927",121309,"Point Loma Nazarene University",1,0,2006,"21620","64.712386","145","412","537",342,195,352,"118",234,0.6842,0.6051,0.6555,0.7672
"928",121309,"Point Loma Nazarene University",1,0,2007,"23200","70.395941","151","420","530",336,194,327,"109",218,0.6488,0.5619,0.617,0.7925
"929",121309,"Point Loma Nazarene University",1,0,2008,"24580","74.603572","146","425","538",327,211,318,"116",202,0.6177,0.5498,0.5911,0.79
"930",121309,"Point Loma Nazarene University",1,0,2009,"25300","75.869748","154","390","533",343,190,338,"113",225,0.656,0.5947,0.6341,0.7317
"931",121309,"Point Loma Nazarene University",1,0,2010,"26500","74.640141","142","409","588",360,228,367,"130",237,0.6583,0.5702,0.6241,0.6956
"932",121345,"POMONA COLLEGE",1,0,1991,"14800","51.18819","145","209","359",164,195,294,"155",139,0.8476,0.7949,0.8189,0.5822
"933",121345,"POMONA COLLEGE",1,0,1992,"15700","48.318258","160","212","382",192,190,316,"148",168,0.875,0.7789,0.8272,0.555
"934",121345,"POMONA COLLEGE",1,0,1993,"16720","50.93858","161","205","390",183,207,317,"167",150,0.8197,0.8068,0.8128,0.5256
"935",121345,"POMONA COLLEGE",1,0,1995,"18600","53.782854","154","209","392",190,202,336,"166",170,0.8947,0.8218,0.8571,0.5332
"936",121345,"POMONA COLLEGE",1,0,1996,"19530","59.827445","154","190","396",187,209,331,"173",158,0.8449,0.8278,0.8359,0.4798
"937",121345,"POMONA COLLEGE",1,0,1997,"20500","54.944","152","210","393",195,198,338,"166",172,0.8821,0.8384,0.8601,0.5344
"938",121345,"POMONA COLLEGE",1,0,1998,"21420","58.713","161","211","396",182,214,321,"168",153,0.8407,0.785,0.8106,0.5328
"939",121345,"POMONA COLLEGE",1,0,1999,"22940","61.649","155","224","390",194,196,338,"167",171,0.8814,0.852,0.8667,0.5744
"940",121345,"POMONA COLLEGE",1,0,2000,"23910","68.362","156","238","398",208,190,346,"163",183,0.8798,0.8579,0.8693,0.598
"941",121345,"POMONA COLLEGE",1,0,2001,"24750","73.691","157","234","393",192,201,339,"173",166,0.8646,0.8607,0.8626,0.5954
"942",121345,"POMONA COLLEGE",1,0,2002,"25730","79.614","168","224","374",191,183,338,"158",180,0.9424,0.8634,0.9037,0.5989
"943",121345,"POMONA COLLEGE",1,0,2003,"26890","81.475","174","208","398",202,196,354,"170",184,0.9109,0.8673,0.8894,0.5226
"944",121345,"POMONA COLLEGE",1,0,2004,"28100","85.903","181","204","393",196,197,356,"181",175,0.8929,0.9188,0.9059,0.5191
"945",121345,"Pomona College",1,0,2005,"29650","92.208","190","186","382",193,189,347,"169",178,0.9223,0.8942,0.9084,0.4869
"946",121345,"Pomona College",1,0,2006,"31580","97.923","197","185","378",190,188,337,"162",175,0.9211,0.8617,0.8915,0.4894
"947",121345,"Pomona College",1,0,2007,"33635","107.885","204","173","375",188,187,348,"172",176,0.9362,0.9198,0.928,0.4613
"948",121345,"Pomona College",1,0,2008,"35318","117.795","199","174","382",194,188,344,"168",176,0.9072,0.8936,0.9005,0.4555
"949",121345,"Pomona College",1,0,2009,"36710","122.066","200","166","389",190,199,355,"180",175,0.9211,0.9045,0.9126,0.4267
"950",121345,"Pomona College",1,0,2010,"38087","119.226","200","191","401",217,184,369,"169",200,0.9217,0.9185,0.9202,0.4763
"951",122409,"SAN DIEGO STATE UNIVERSITY",1,0,1991,"936","227.019824","1018","1325","2479",1440,1039,151,"39",112,0.0778,0.0375,0.0609,0.5345
"952",122409,"SAN DIEGO STATE UNIVERSITY",1,0,1992,"1500","227.233457","940","947","1974",1129,845,154,"45",109,0.0965,0.0533,0.078,0.4797
"953",122409,"SAN DIEGO STATE UNIVERSITY",1,0,1993,"1674","224.287564","909","842","1973",1081,892,126,"25",101,0.0934,0.028,0.0639,0.4268
"954",122409,"SAN DIEGO STATE UNIVERSITY",1,0,1995,"1891","232.012356","894","1238","2840",1716,1124,212,"58",154,0.0897,0.0516,0.0746,0.4359
"955",122409,"SAN DIEGO STATE UNIVERSITY",1,0,1996,"1935","239.045921","891","1234","2908",1752,1156,208,"55",153,0.0873,0.0476,0.0715,0.4243
"956",122409,"SAN DIEGO STATE UNIVERSITY",1,0,1997,"1932","259.9739","904","1347","3008",1766,1242,280,"73",207,0.1172,0.0588,0.0931,0.4478
"957",122409,"SAN DIEGO STATE UNIVERSITY",1,0,1998,"1784","270.970122","907","1419","3128",1815,1313,308,"79",229,0.1262,0.0602,0.0985,0.4536
"958",122409,"SAN DIEGO STATE UNIVERSITY",1,0,1999,"0","455.657919","934","1433","2834",1574,1260,394,"119",275,0.1747,0.0944,0.139,0.5056
"959",122409,"SAN DIEGO STATE UNIVERSITY",1,0,2000,"0","491.896381","984.5","1441","2719",1598,1121,472,"130",342,0.214,0.116,0.1736,0.53
"960",122409,"SAN DIEGO STATE UNIVERSITY",1,0,2001,"0","552.161941","1035","1694","3338",1986,1352,664,"178",486,0.2447,0.1317,0.1989,0.5075
"961",122409,"SAN DIEGO STATE UNIVERSITY",1,0,2002,"0","358.4087","1042","1890","3662",2217,1445,879,"237",642,0.2896,0.164,0.24,0.5161
"962",122409,"SAN DIEGO STATE UNIVERSITY",1,0,2003,"0","376.491591","977","1859","3418",2106,1312,973,"286",687,0.3262,0.218,0.2847,0.5439
"963",122409,"SAN DIEGO STATE UNIVERSITY",1,0,2004,"0","375.735184","886","1905","3527",2128,1399,1073,"307",766,0.36,0.2194,0.3042,0.5401
"964",122409,"San Diego State University",1,0,2005,"0","380.037223","931","1807","3439",2039,1400,1011,"323",688,0.3374,0.2307,0.294,0.5254
"965",122409,"San Diego State University",1,0,2006,"0","409.635765","964","2158","4109",2458,1651,1309,"382",927,0.3771,0.2314,0.3186,0.5252
"966",122409,"San Diego State University",1,0,2007,"0","442.960243","959","2312","4506",2685,1821,1472,"449",1023,0.381,0.2466,0.3267,0.5131
"967",122409,"San Diego State University",1,0,2008,"0","461.274537","966","1577","3578",2086,1492,1053,"346",707,0.3389,0.2319,0.2943,0.4407
"968",122409,"San Diego State University",1,0,2009,"0","485.907668","900","1389","3291",1881,1410,990,"332",658,0.3498,0.2355,0.3008,0.4221
"969",122409,"San Diego State University",1,0,2010,"0","448.380833","849","1332","3031",1802,1229,1017,"352",665,0.369,0.2864,0.3355,0.4395
"970",122436,"UNIVERSITY OF SAN DIEGO",1,0,1991,"11440","87.507968","254","645","882",528,354,471,"181",290,0.5492,0.5113,0.534,0.7313
"971",122436,"UNIVERSITY OF SAN DIEGO",1,0,1992,"12240","95.281353","263","636","929",524,405,462,"175",287,0.5477,0.4321,0.4973,0.6846
"972",122436,"UNIVERSITY OF SAN DIEGO",1,0,1993,"12970","101.857006","265","619","890",516,374,468,"171",297,0.5756,0.4572,0.5258,0.6955
"973",122436,"UNIVERSITY OF SAN DIEGO",1,0,1995,"14320","114.33794","271","674","978",597,381,500,"186",314,0.526,0.4882,0.5112,0.6892
"974",122436,"UNIVERSITY OF SAN DIEGO",1,0,1996,"14960","113.301942","274","734","1042",569,473,542,"213",329,0.5782,0.4503,0.5202,0.7044
"975",122436,"UNIVERSITY OF SAN DIEGO",1,0,1997,"15780","118.7915","283","736","1036",630,406,589,"194",395,0.627,0.4778,0.5685,0.7104
"976",122436,"UNIVERSITY OF SAN DIEGO",1,0,1998,"16470","104.398779","288","719","1028",614,414,610,"222",388,0.6319,0.5362,0.5934,0.6994
"977",122436,"UNIVERSITY OF SAN DIEGO",1,0,1999,"17780","100.223179","294","726","990",621,369,611,"204",407,0.6554,0.5528,0.6172,0.7333
"978",122436,"UNIVERSITY OF SAN DIEGO",1,0,2000,"19020","126.694407","305","745","1024",642,382,656,"225",431,0.6713,0.589,0.6406,0.7275
"979",122436,"UNIVERSITY OF SAN DIEGO",1,0,2001,"20350","140.623237","316","677","1003",646,357,635,"217",418,0.6471,0.6078,0.6331,0.675
"980",122436,"UNIVERSITY OF SAN DIEGO",1,0,2002,"21880","159.117364","328","732","1049",681,368,672,"219",453,0.6652,0.5951,0.6406,0.6978
"981",122436,"UNIVERSITY OF SAN DIEGO",1,0,2003,"23410","172.482766","341","726","1059",718,341,695,"208",487,0.6783,0.61,0.6563,0.6856
"982",122436,"UNIVERSITY OF SAN DIEGO",1,0,2004,"24860","186.105454","340","830","1174",705,469,706,"259",447,0.634,0.5522,0.6014,0.707
"983",122436,"University of San Diego",1,0,2005,"26350","202.442757","359","760","1131",710,421,726,"238",488,0.6873,0.5653,0.6419,0.672
"984",122436,"University of San Diego",1,0,2006,"30480","217.95647","363","702","1103",703,400,714,"214",500,0.7112,0.535,0.6473,0.6364
"985",122436,"University of San Diego",1,0,2007,"32300","228.228196","367","654","1089",635,454,704,"254",450,0.7087,0.5595,0.6465,0.6006
"986",122436,"University of San Diego",1,0,2008,"34000","240.35038","369","810","1259",771,488,838,"289",549,0.7121,0.5922,0.6656,0.6434
"987",122436,"University of San Diego",1,0,2009,"35870","250.522","381","645","1081",621,460,714,"259",455,0.7327,0.563,0.6605,0.5967
"988",122436,"University of San Diego",1,0,2010,"36950","249.17","393","729","1148",662,486,752,"280",472,0.713,0.5761,0.6551,0.635
"989",122597,"SAN FRANCISCO STATE UNIVERSITY",1,0,1991,"936","173.74552","807","308","1219",774,445,72,"28",44,0.0568,0.0629,0.0591,0.2527
"990",122597,"SAN FRANCISCO STATE UNIVERSITY",1,0,1992,"1444","177.144916","727","276","1125",693,432,73,"19",54,0.0779,0.044,0.0649,0.2453
"991",122597,"SAN FRANCISCO STATE UNIVERSITY",1,0,1993,"1674","177.210792","709","263","1141",668,473,60,"16",44,0.0659,0.0338,0.0526,0.2305
"992",122597,"SAN FRANCISCO STATE UNIVERSITY",1,0,1995,"1891","213.031231","728","349","1539",966,573,89,"26",63,0.0652,0.0454,0.0578,0.2268
"993",122597,"SAN FRANCISCO STATE UNIVERSITY",1,0,1996,"1935","221.825775","760","393","1727",1102,625,111,"35",76,0.069,0.056,0.0643,0.2276
"994",122597,"SAN FRANCISCO STATE UNIVERSITY",1,0,1997,"1978","260.352475","767","380","1732",1086,646,115,"36",79,0.0727,0.0557,0.0664,0.2194
"995",122597,"SAN FRANCISCO STATE UNIVERSITY",1,0,1998,"1884","270.610503","772","413","1805",1143,662,134,"23",111,0.0971,0.0347,0.0742,0.2288
"996",122597,"SAN FRANCISCO STATE UNIVERSITY",1,0,1999,"0","270.28207","793","491","1898",1158,740,178,"54",124,0.1071,0.073,0.0938,0.2587
"997",122597,"SAN FRANCISCO STATE UNIVERSITY",1,0,2000,"0","321.215251","781","474","1870",1212,658,205,"54",151,0.1246,0.0821,0.1096,0.2535
"998",122597,"SAN FRANCISCO STATE UNIVERSITY",1,0,2001,"0","330.565769","769","477","1820",1157,663,209,"58",151,0.1305,0.0875,0.1148,0.2621
"999",122597,"SAN FRANCISCO STATE UNIVERSITY",1,0,2002,"0","318.102245","784","510","2130",1378,752,211,"52",159,0.1154,0.0691,0.0991,0.2394
"1000",122597,"SAN FRANCISCO STATE UNIVERSITY",1,0,2003,"0","334.352479","792","685","2291",1474,817,267,"69",198,0.1343,0.0845,0.1165,0.299
"1001",122597,"SAN FRANCISCO STATE UNIVERSITY",1,0,2004,"0","349.783837","767","843","2739",1770,969,390,"114",276,0.1559,0.1176,0.1424,0.3078
"1002",122597,"San Francisco State University",1,0,2005,"0","363.029773","775","981","2999",1942,1057,360,"105",255,0.1313,0.0993,0.12,0.3271
"1003",122597,"San Francisco State University",1,0,2006,"0","372.458625","787","1019","3117",2017,1100,418,"128",290,0.1438,0.1164,0.1341,0.3269
"1004",122597,"San Francisco State University",1,0,2007,"0","401.986541","845","1118","3341",2123,1218,424,"118",306,0.1441,0.0969,0.1269,0.3346
"1005",122597,"San Francisco State University",1,0,2008,"0","431.055092","860","1157","3512",2334,1178,524,"145",379,0.1624,0.1231,0.1492,0.3294
"1006",122597,"San Francisco State University",1,0,2009,"0","437.219606","852","1182","3855",2497,1358,704,"178",526,0.2107,0.1311,0.1826,0.3066
"1007",122597,"San Francisco State University",1,0,2010,"0","425.501559","803","1049","3609",2179,1430,648,"210",438,0.201,0.1469,0.1796,0.2907
"1008",122612,"UNIVERSITY OF SAN FRANCISCO",1,0,1991,"11040","76.347","240","227","459",299,160,205,"72",133,0.4448,0.45,0.4466,0.4946
"1009",122612,"UNIVERSITY OF SAN FRANCISCO",1,0,1992,"11816","91.964","261","219","492",319,173,233,"75",158,0.4953,0.4335,0.4736,0.4451
"1010",122612,"UNIVERSITY OF SAN FRANCISCO",1,0,1993,"12578","99.669","262","208","530",359,171,225,"61",164,0.4568,0.3567,0.4245,0.3925
"1011",122612,"UNIVERSITY OF SAN FRANCISCO",1,0,1995,"14108","115.33","284","196","550",350,200,237,"71",166,0.4743,0.355,0.4309,0.3564
"1012",122612,"UNIVERSITY OF SAN FRANCISCO",1,0,1996,"14920","118.647501","290","214","616",413,203,307,"89",218,0.5278,0.4384,0.4984,0.3474
"1013",122612,"UNIVERSITY OF SAN FRANCISCO",1,0,1997,"15850","130.843","303","210","600",385,215,285,"96",189,0.4909,0.4465,0.475,0.35
"1014",122612,"UNIVERSITY OF SAN FRANCISCO",1,0,1998,"16630","134.134","303","249","640",436,204,296,"80",216,0.4954,0.3922,0.4625,0.3891
"1015",122612,"UNIVERSITY OF SAN FRANCISCO",1,0,1999,"17710","142.61","332","328","757",500,257,379,"109",270,0.54,0.4241,0.5007,0.4333
"1016",122612,"UNIVERSITY OF SAN FRANCISCO",1,0,2000,"18860","151.306","321","315","757",518,239,363,"100",263,0.5077,0.4184,0.4795,0.4161
"1017",122612,"UNIVERSITY OF SAN FRANCISCO",1,0,2001,"20190","137.386","310","357","840",572,268,411,"114",297,0.5192,0.4254,0.4893,0.425
"1018",122612,"UNIVERSITY OF SAN FRANCISCO",1,0,2002,"21660","151.415","326","303","839",582,257,431,"132",299,0.5137,0.5136,0.5137,0.3611
"1019",122612,"UNIVERSITY OF SAN FRANCISCO",1,0,2003,"23220","160.713","345","351","914",632,282,452,"131",321,0.5079,0.4645,0.4945,0.384
"1020",122612,"UNIVERSITY OF SAN FRANCISCO",1,0,2004,"24800","176.31","344","358","929",614,315,518,"151",367,0.5977,0.4794,0.5576,0.3854
"1021",122612,"University of San Francisco",1,0,2005,"26680","186.497","348","372","932",665,267,542,"131",411,0.618,0.4906,0.5815,0.3991
"1022",122612,"University of San Francisco",1,0,2006,"28420","196.554","367","417","1073",733,340,582,"166",416,0.5675,0.4882,0.5424,0.3886
"1023",122612,"University of San Francisco",1,0,2007,"30840","209.197","371","428","1052",680,372,595,"179",416,0.6118,0.4812,0.5656,0.4068
"1024",122612,"University of San Francisco",1,0,2008,"33160","227.664","380","439","1036",686,350,632,"196",436,0.6356,0.56,0.61,0.4237
"1025",122612,"University of San Francisco",1,0,2009,"34430","242.267","386","416","1073",744,329,648,"172",476,0.6398,0.5228,0.6039,0.3877
"1026",122612,"University of San Francisco",1,0,2010,"36000","241.025","394","413","1171",750,421,721,"233",488,0.6507,0.5534,0.6157,0.3527
"1027",122931,"SANTA CLARA UNIVERSITY",0,1,1991,"11271","100.83","317","620","928",457,471,675,"335",340,0.744,0.7113,0.7274,0.6681
"1028",122931,"SANTA CLARA UNIVERSITY",0,1,1992,"12150","104.169999","326","552","900",458,442,661,"303",358,0.7817,0.6855,0.7344,0.6133
"1029",122931,"SANTA CLARA UNIVERSITY",0,1,1993,"12879","114.575","324","492","888",489,399,657,"287",370,0.7566,0.7193,0.7399,0.5541
"1030",122931,"SANTA CLARA UNIVERSITY",0,1,1995,"14604","126.403","322","580","1043",558,485,757,"329",428,0.767,0.6784,0.7258,0.5561
"1031",122931,"SANTA CLARA UNIVERSITY",0,1,1996,"15450","135.478","344","618","1075",586,489,798,"349",449,0.7662,0.7137,0.7423,0.5749
"1032",122931,"SANTA CLARA UNIVERSITY",0,1,1997,"16455","116.713","359","592","1004",543,461,766,"328",438,0.8066,0.7115,0.7629,0.5896
"1033",122931,"SANTA CLARA UNIVERSITY",0,1,1998,"17442","123.907","369","588","1032",570,462,783,"331",452,0.793,0.7165,0.7587,0.5698
"1034",122931,"SANTA CLARA UNIVERSITY",0,1,1999,"19095","129.263","399","649","1101",619,482,854,"358",496,0.8013,0.7427,0.7757,0.5895
"1035",122931,"SANTA CLARA UNIVERSITY",0,1,2000,"20337","140.502","405","601","1025",544,481,814,"366",448,0.8235,0.7609,0.7941,0.5863
"1036",122931,"SANTA CLARA UNIVERSITY",0,1,2001,"22572","153.908","411","597","1017",556,461,799,"339",460,0.8273,0.7354,0.7856,0.587
"1037",122931,"SANTA CLARA UNIVERSITY",0,1,2002,"23925","166.079","413","694","1116",659,457,873,"342",531,0.8058,0.7484,0.7823,0.6219
"1038",122931,"SANTA CLARA UNIVERSITY",0,1,2003,"25365","176.398","416","566","892",509,383,690,"284",406,0.7976,0.7415,0.7735,0.6345
"1039",122931,"SANTA CLARA UNIVERSITY",0,1,2004,"27135","185.846","423","693","1171",658,513,941,"392",549,0.8343,0.7641,0.8036,0.5918
"1040",122931,"Santa Clara University",0,1,2005,"28899","192.145","447","699","1197",667,530,917,"384",533,0.7991,0.7245,0.7661,0.584
"1041",122931,"Santa Clara University",0,1,2006,"30900","202.454","474","655","1340",740,600,1055,"448",607,0.8203,0.7467,0.7873,0.4888
"1042",122931,"Santa Clara University",0,1,2007,"33000","216.959","506","548","1201",619,582,923,"431",492,0.7948,0.7405,0.7685,0.4563
"1043",122931,"Santa Clara University",0,1,2008,"34950","233.935","512","471","1220",623,597,951,"436",515,0.8266,0.7303,0.7795,0.3861
"1044",122931,"Santa Clara University",0,1,2009,"36000","251.943","434","412","1084",571,513,830,"371",459,0.8039,0.7232,0.7657,0.3801
"1045",122931,"Santa Clara University",0,1,2010,"37368","253.701","448","639","1295",644,651,1056,"498",558,0.8665,0.765,0.8154,0.4934
"1046",123554,"SAINT MARY'S COLLEGE OF CALIFORNIA",1,0,1991,"11036","42.020652","123","292","437",241,196,247,"101",146,0.6058,0.5153,0.5652,0.6682
"1047",123554,"SAINT MARY'S COLLEGE OF CALIFORNIA",1,0,1992,"11966","43.954359","135","324","472",257,215,289,"126",163,0.6342,0.586,0.6123,0.6864
"1048",123554,"SAINT MARYS COLLEGE OF CALIFORNIA",1,0,1993,"12636","49.22622","135","301","464",249,215,294,"128",166,0.6667,0.5953,0.6336,0.6487
"1049",123554,"SAINT MARYS COLLEGE OF CALIFORNIA",1,0,1995,"14250","55.791762","160","326","474",256,218,306,"141",165,0.6445,0.6468,0.6456,0.6878
"1050",123554,"SAINT MARYS COLLEGE OF CALIFORNIA",1,0,1996,"15098","53.887764","155","317","488",288,200,307,"102",205,0.7118,0.51,0.6291,0.6496
"1051",123554,"SAINT MARYS COLLEGE OF CALIFORNIA",1,0,1997,"15880","52.776669","164","388","596",348,248,390,"144",246,0.7069,0.5806,0.6544,0.651
"1052",123554,"SAINT MARYS COLLEGE OF CALIFORNIA",1,0,1998,"16809","55.857277","172","386","573",343,230,352,"125",227,0.6618,0.5435,0.6143,0.6736
"1053",123554,"SAINT MARYS COLLEGE OF CALIFORNIA",1,0,1999,"17340","59.771396","175","404","629",363,266,369,"142",227,0.6253,0.5338,0.5866,0.6423
"1054",123554,"SAINT MARYS COLLEGE OF CALIFORNIA",1,0,2000,"18120","62.471787","178.5","388","620",366,254,368,"149",219,0.5984,0.5866,0.5935,0.6258
"1055",123554,"SAINT MARYS COLLEGE OF CALIFORNIA",1,0,2001,"19390","67.548924","182","344","580",352,228,350,"129",221,0.6278,0.5658,0.6034,0.5931
"1056",123554,"SAINT MARYS COLLEGE OF CALIFORNIA",1,0,2002,"20750","72.524608","185","389","663",408,255,381,"141",240,0.5882,0.5529,0.5747,0.5867
"1057",123554,"SAINT MARYS COLLEGE OF CALIFORNIA",1,0,2003,"23640","81.45585","199","327","562",317,245,285,"106",179,0.5647,0.4327,0.5071,0.5819
"1058",123554,"SAINT MARYS COLLEGE OF CALIFORNIA",1,0,2004,"25000","88.519819","198","299","603",388,215,319,"102",217,0.5593,0.4744,0.529,0.4959
"1059",123554,"Saint Marys College of California",1,0,2005,"27130","91.396151","197","347","659",399,260,313,"107",206,0.5163,0.4115,0.475,0.5266
"1060",123554,"Saint Marys College of California",1,0,2006,"28900","88.95581","200","299","600",384,216,292,"105",187,0.487,0.4861,0.4867,0.4983
"1061",123554,"Saint Marys College of California",1,0,2007,"30930","93.168485","207","342","600",366,234,283,"102",181,0.4945,0.4359,0.4717,0.57
"1062",123554,"Saint Marys College of California",1,0,2008,"33100","99.117713","207","326","665",436,229,349,"100",249,0.5711,0.4367,0.5248,0.4902
"1063",123554,"Saint Marys College of California",1,0,2009,"33760","103.393226","202","254","567",354,213,320,"101",219,0.6186,0.4742,0.5644,0.448
"1064",123554,"Saint Marys College of California",1,0,2010,"35280","100.850075","189","308","694",421,273,387,"139",248,0.5891,0.5092,0.5576,0.4438
"1065",123572,"SONOMA STATE UNIVERSITY",1,0,1991,"936","57.300334","260","459","680",429,251,95,"18",77,0.1795,0.0717,0.1397,0.675
"1066",123572,"SONOMA STATE UNIVERSITY",1,0,1992,"1474","59.863135","241","407","591",380,211,97,"20",77,0.2026,0.0948,0.1641,0.6887
"1067",123572,"SONOMA STATE UNIVERSITY",1,0,1993,"1674","57.564295","233","355","539",362,177,82,"18",64,0.1768,0.1017,0.1521,0.6586
"1068",123572,"SONOMA STATE UNIVERSITY",1,0,1995,"1891","61.241571","238","459","681",441,240,131,"41",90,0.2041,0.1708,0.1924,0.674
"1069",123572,"SONOMA STATE UNIVERSITY",1,0,1996,"1935","65.546205","243","538","781",502,279,156,"36",120,0.239,0.129,0.1997,0.6889
"1070",123572,"SONOMA STATE UNIVERSITY",1,0,1997,"2110","75.034695","234","586","872",581,291,192,"43",149,0.2565,0.1478,0.2202,0.672
"1071",123572,"SONOMA STATE UNIVERSITY",1,0,1998,"2082","72.938255","249","545","823",557,266,177,"37",140,0.2513,0.1391,0.2151,0.6622
"1072",123572,"SONOMA STATE UNIVERSITY",1,0,1999,"0","83.36342","243","551","844",555,289,161,"24",137,0.2468,0.083,0.1908,0.6528
"1073",123572,"SONOMA STATE UNIVERSITY",1,0,2000,"0","110.049097","248.5","705","1064",714,350,236,"46",190,0.2661,0.1314,0.2218,0.6626
"1074",123572,"SONOMA STATE UNIVERSITY",1,0,2001,"0","118.653292","254","691","1018",673,345,258,"53",205,0.3046,0.1536,0.2534,0.6788
"1075",123572,"SONOMA STATE UNIVERSITY",1,0,2002,"0","124.088983","254","825","1210",816,394,289,"53",236,0.2892,0.1345,0.2388,0.6818
"1076",123572,"SONOMA STATE UNIVERSITY",1,0,2003,"0","132.820586","267","918","1287",838,449,341,"80",261,0.3115,0.1782,0.265,0.7133
"1077",123572,"SONOMA STATE UNIVERSITY",1,0,2004,"0","146.481549","240","778","1102",713,389,344,"76",268,0.3759,0.1954,0.3122,0.706
"1078",123572,"Sonoma State University",1,0,2005,"0","141.976344","263","719","1043",697,346,309,"69",240,0.3443,0.1994,0.2963,0.6894
"1079",123572,"Sonoma State University",1,0,2006,"0","142.28714","266","985","1513",1033,480,410,"104",306,0.2962,0.2167,0.271,0.651
"1080",123572,"Sonoma State University",1,0,2007,"0","153.148951","273","1150","1673",1073,600,434,"97",337,0.3141,0.1617,0.2594,0.6874
"1081",123572,"Sonoma State University",1,0,2008,"0","148.127205","274","1136","1631",1058,573,444,"96",348,0.3289,0.1675,0.2722,0.6965
"1082",123572,"Sonoma State University",1,0,2009,"0","150.164562","272","913","1465",953,512,413,"94",319,0.3347,0.1836,0.2819,0.6232
"1083",123572,"Sonoma State University",1,0,2010,"0","143.959652","254","878","1547",925,622,430,"106",324,0.3503,0.1704,0.278,0.5676
"1084",126562,"UNIVERSITY OF COLORADO AT DENVER",1,0,1991,"1808","63.855438","347","128","262",152,110,25,"7",18,0.1184,0.0636,0.0954,0.4885
"1085",126562,"UNIVERSITY OF COLORADO AT DENVER",1,0,1992,"1917","66.475499","355","131","272",175,97,29,"6",23,0.1314,0.0619,0.1066,0.4816
"1086",126562,"UNIVERSITY OF COLORADO AT DENVER",1,0,1993,"1955","75.246309","368","131","243",141,102,38,"9",29,0.2057,0.0882,0.1564,0.5391
"1087",126562,"UNIVERSITY OF COLORADO AT DENVER",1,0,1995,"2098","81.810342","374","124","266",166,100,41,"14",27,0.1627,0.14,0.1541,0.4662
"1088",126562,"UNIVERSITY OF COLORADO AT DENVER",1,0,1996,"2183","88.277184","382","229","373",215,158,54,"20",34,0.1581,0.1266,0.1448,0.6139
"1089",126562,"UNIVERSITY OF COLORADO AT DENVER",1,0,1997,"2191","94.893815","411","231","439",245,194,63,"23",40,0.1633,0.1186,0.1435,0.5262
"1090",126562,"UNIVERSITY OF COLORADO AT DENVER",1,0,1998,"2255","100.272768","392","202","394",223,171,58,"17",41,0.1839,0.0994,0.1472,0.5127
"1091",126562,"UNIVERSITY OF COLORADO AT DENVER",1,0,1999,"2068","107.993826","417","253","478",259,219,76,"30",46,0.1776,0.137,0.159,0.5293
"1092",126562,"UNIVERSITY OF COLORADO AT DENVER",1,0,2000,"2298","114.467118","423","271","515",296,219,71,"23",48,0.1622,0.105,0.1379,0.5262
"1093",126562,"UNIVERSITY OF COLORADO AT DENVER",1,0,2001,"2934","128.631791","429","287","492",288,204,63,"27",36,0.125,0.1324,0.128,0.5833
"1094",126562,"UNIVERSITY OF COLORADO AT DENVER",1,0,2002,"2752","131.699303","509","356","580",326,254,86,"26",60,0.184,0.1024,0.1483,0.6138
"1095",126562,"UNIVERSITY OF COLORADO AT DENVER",1,0,2003,"3028","118.976774","465","380","624",353,271,104,"36",68,0.1926,0.1328,0.1667,0.609
"1096",126562,"UNIVERSITY OF COLORADO AT DENVER",1,0,2004,"3300","118.223896","450","414","686",387,299,101,"34",67,0.1731,0.1137,0.1472,0.6035
"1097",126562,"University of Colorado at Denver and Health Sciences Center",1,0,2005,"4224","831.954148","616","435","744",414,330,108,"30",78,0.1884,0.0909,0.1452,0.5847
"1098",126562,"University of Colorado at Denver and Health Sciences Center",1,0,2006,"4330","906.798442","637","514","885",510,375,155,"52",103,0.202,0.1387,0.1751,0.5808
"1099",126562,"University of Colorado Denver",1,0,2007,"5054","984.695531","639","565","1010",571,439,163,"66",97,0.1699,0.1503,0.1614,0.5594
"1100",126562,"University of Colorado Denver",1,0,2008,"5484","1067.328874","705","597","1036",603,433,156,"68",88,0.1459,0.157,0.1506,0.5763
"1101",126562,"University of Colorado Denver",1,0,2009,"5712","1161.661412","755","524","1037",556,481,172,"64",108,0.1942,0.1331,0.1659,0.5053
"1102",126562,"University of Colorado Denver",1,0,2010,"6216","1198.312863","816","522","1020",551,469,210,"76",134,0.2432,0.162,0.2059,0.5118
"1103",126580,"UNIVERSITY OF COLORADO-COLORADO SPRINGS",1,0,1991,"2044","33.201361","156","270","319",183,136,36,"12",24,0.1311,0.0882,0.1129,0.8464
"1104",126580,"UNIVERSITY OF COLORADO-COLORADO SPRINGS",1,0,1992,"2167","35.05173","159","241","313",174,139,29,"9",20,0.1149,0.0647,0.0927,0.77
"1105",126580,"UNIVERSITY OF COLORADO AT COLORADO SPRINGS",1,0,1993,"2225","36.420682","161","252","306",164,142,46,"18",28,0.1707,0.1268,0.1503,0.8235
"1106",126580,"UNIVERSITY OF COLORADO AT COLORADO SPRINGS",1,0,1995,"2375","38.215483","181","283","363",197,166,88,"36",52,0.264,0.2169,0.2424,0.7796
"1107",126580,"UNIVERSITY OF COLORADO AT COLORADO SPRINGS",1,0,1996,"2439","39.549367","180","295","375",227,148,63,"18",45,0.1982,0.1216,0.168,0.7867
"1108",126580,"UNIVERSITY OF COLORADO AT COLORADO SPRINGS",1,0,1997,"2681","45.028436","208","400","519",298,221,83,"27",56,0.1879,0.1222,0.1599,0.7707
"1109",126580,"UNIVERSITY OF COLORADO AT COLORADO SPRINGS",1,0,1998,"2681","52.523497","219","500","635",372,263,154,"53",101,0.2715,0.2015,0.2425,0.7874
"1110",126580,"UNIVERSITY OF COLORADO AT COLORADO SPRINGS",1,0,1999,"2234","123.679767","206","524","682",395,287,104,"35",69,0.1747,0.122,0.1525,0.7683
"1111",126580,"UNIVERSITY OF COLORADO AT COLORADO SPRINGS",1,0,2000,"2690","58.980889","214","551","718",457,261,162,"38",124,0.2713,0.1456,0.2256,0.7674
"1112",126580,"UNIVERSITY OF COLORADO AT COLORADO SPRINGS",1,0,2001,"2864","64.216824","222","596","785",453,332,171,"54",117,0.2583,0.1627,0.2178,0.7592
"1113",126580,"UNIVERSITY OF COLORADO AT COLORADO SPRINGS",1,0,2002,"3154","75.838655","259","658","834",501,333,211,"66",145,0.2894,0.1982,0.253,0.789
"1114",126580,"UNIVERSITY OF COLORADO AT COLORADO SPRINGS",1,0,2003,"3026","71.709142","251","694","892",552,340,193,"43",150,0.2717,0.1265,0.2164,0.778
"1115",126580,"UNIVERSITY OF COLORADO AT COLORADO SPRINGS",1,0,2004,"3296","76.250785","266","726","939",562,377,198,"54",144,0.2562,0.1432,0.2109,0.7732
"1116",126580,"University of Colorado at Colorado Springs",1,0,2005,"3966","82.159797","296","737","947",595,352,210,"50",160,0.2689,0.142,0.2218,0.7782
"1117",126580,"University of Colorado at Colorado Springs",1,0,2006,"4054","83.685026","247","693","914",531,383,216,"75",141,0.2655,0.1958,0.2363,0.7582
"1118",126580,"University of Colorado at Colorado Springs",1,0,2007,"4338","91.925186","263","676","933",511,422,247,"89",158,0.3092,0.2109,0.2647,0.7245
"1119",126580,"University of Colorado at Colorado Springs",1,0,2008,"4464","103.073555","305","815","1075",577,498,288,"110",178,0.3085,0.2209,0.2679,0.7581
"1120",126580,"University of Colorado at Colorado Springs",1,0,2009,"4680","109.777738","317","742","1035",543,492,247,"98",149,0.2744,0.1992,0.2386,0.7169
"1121",126580,"University of Colorado at Colorado Springs",1,0,2010,"5016","118.938522","317","798","1123",568,555,284,"112",172,0.3028,0.2018,0.2529,0.7106
"1122",126614,"UNIVERSITY OF COLORADO AT BOULDER",1,0,1991,"3066","376.268767","909","2666","3421",1631,1790,1268,"550",718,0.4402,0.3073,0.3707,0.7793
"1123",126614,"UNIVERSITY OF COLORADO AT BOULDER",1,0,1992,"2560","416.592808","1024","2818","3559",1700,1859,1198,"514",684,0.4024,0.2765,0.3366,0.7918
"1124",126614,"UNIVERSITY OF COLORADO AT BOULDER",1,0,1993,"2574","440.037533","1081","2656","3440",1693,1747,1215,"509",706,0.417,0.2914,0.3532,0.7721
"1125",126614,"UNIVERSITY OF COLORADO AT BOULDER",1,0,1995,"2770","473.232821","1093","3359","4170",2020,2150,1454,"602",852,0.4218,0.28,0.3487,0.8055
"1126",126614,"UNIVERSITY OF COLORADO AT BOULDER",1,0,1996,"2840","501.016024","1084","3224","3953",1983,1970,1529,"623",906,0.4569,0.3162,0.3868,0.8156
"1127",126614,"UNIVERSITY OF COLORADO AT BOULDER",1,0,1997,"2939","526.278582","1063","3456","4259",2157,2102,1565,"633",932,0.4321,0.3011,0.3675,0.8115
"1128",126614,"UNIVERSITY OF COLORADO AT BOULDER",1,0,1998,"3038","575.821964","1094","3483","4263",2037,2226,1545,"647",898,0.4408,0.2907,0.3624,0.817
"1129",126614,"UNIVERSITY OF COLORADO AT BOULDER",1,0,1999,"2444","576.711199","1076","3768","4545",2303,2242,1728,"700",1028,0.4464,0.3122,0.3802,0.829
"1130",126614,"UNIVERSITY OF COLORADO AT BOULDER",1,0,2000,"2514","639.080989","1076","4131","5047",2445,2602,1937,"829",1108,0.4532,0.3186,0.3838,0.8185
"1131",126614,"UNIVERSITY OF COLORADO AT BOULDER",1,0,2001,"2614","662.543832","1076","3899","4962",2396,2566,2013,"887",1126,0.4699,0.3457,0.4057,0.7858
"1132",126614,"UNIVERSITY OF COLORADO AT BOULDER",1,0,2002,"2776","671.695376","1127","4294","5377",2607,2770,2218,"1001",1217,0.4668,0.3614,0.4125,0.7986
"1133",126614,"UNIVERSITY OF COLORADO AT BOULDER",1,0,2003,"3192","692.178298","1105","4461","5515",2761,2754,2267,"966",1301,0.4712,0.3508,0.4111,0.8089
"1134",126614,"UNIVERSITY OF COLORADO AT BOULDER",1,0,2004,"3480","711.9636","1108","4025","5124",2484,2640,2093,"909",1184,0.4767,0.3443,0.4085,0.7855
"1135",126614,"University of Colorado at Boulder",1,0,2005,"4446","768.570245","1115","3977","5007",2364,2643,2007,"900",1107,0.4683,0.3405,0.4008,0.7943
"1136",126614,"University of Colorado at Boulder",1,0,2006,"4554","790.615607","1166","4416","5606",2688,2918,2336,"1016",1320,0.4911,0.3482,0.4167,0.7877
"1137",126614,"University of Colorado at Boulder",1,0,2007,"5418","836.65186","1223","4405","5540",2734,2806,2456,"1059",1397,0.511,0.3774,0.4433,0.7951
"1138",126614,"University of Colorado at Boulder",1,0,2008,"5922","875.935263","1368","4568","5811",2890,2921,2678,"1158",1520,0.526,0.3964,0.4609,0.7861
"1139",126614,"University of Colorado at Boulder",1,0,2009,"6446","941.566282","1395","4285","5515",2719,2796,2598,"1102",1496,0.5502,0.3941,0.4711,0.777
"1140",126614,"University of Colorado Boulder",1,0,2010,"7018","994.55599","1385","4000","5138",2403,2735,2438,"1094",1344,0.5593,0.4,0.4745,0.7785
"1141",126818,"COLORADO STATE UNIVERSITY",1,0,1991,"2362","311.329","935","1773","2155",1144,1011,516,"173",343,0.2998,0.1711,0.2394,0.8227
"1142",126818,"COLORADO STATE UNIVERSITY",1,0,1992,"2511","334.083","937","1872","2202",1150,1052,575,"205",370,0.3217,0.1949,0.2611,0.8501
"1143",126818,"COLORADO STATE UNIVERSITY",1,0,1993,"2558","338.402","926","1803","2168",1160,1008,611,"210",401,0.3457,0.2083,0.2818,0.8316
"1144",126818,"COLORADO STATE UNIVERSITY",1,0,1995,"2771","393.350031","935","2155","2546",1354,1192,805,"287",518,0.3826,0.2408,0.3162,0.8464
"1145",126818,"COLORADO STATE UNIVERSITY",1,0,1996,"2847","411.101","948","2299","2695",1511,1184,847,"307",540,0.3574,0.2593,0.3143,0.8531
"1146",126818,"COLORADO STATE UNIVERSITY",1,0,1997,"2925","418.434","939","2230","2615",1435,1180,861,"304",557,0.3882,0.2576,0.3293,0.8528
"1147",126818,"COLORADO STATE UNIVERSITY",1,0,1998,"2986","475.616","919","2590","3028",1772,1256,1028,"301",727,0.4103,0.2396,0.3395,0.8554
"1148",126818,"COLORADO STATE UNIVERSITY",1,0,1999,"2340","467.996","921","2642","3076",1702,1374,1054,"371",683,0.4013,0.27,0.3427,0.8589
"1149",126818,"COLORADO STATE UNIVERSITY",1,0,2000,"2408","503.418639","927.5","2710","3240",1862,1378,1119,"370",749,0.4023,0.2685,0.3454,0.8364
"1150",126818,"COLORADO STATE UNIVERSITY",1,0,2001,"2502","516.181845","934","3112","3683",2061,1622,1285,"420",865,0.4197,0.2589,0.3489,0.845
"1151",126818,"COLORADO STATE UNIVERSITY",1,0,2002,"2655","583.403","898","3159","3783",2121,1662,1340,"442",898,0.4234,0.2659,0.3542,0.8351
"1152",126818,"COLORADO STATE UNIVERSITY",1,0,2003,"2908","602.093883","1088","3142","3730",2012,1718,1319,"483",836,0.4155,0.2811,0.3536,0.8424
"1153",126818,"COLORADO STATE UNIVERSITY",1,0,2004,"2940","603.520584","1099","3412","4047",2216,1831,1484,"522",962,0.4341,0.2851,0.3667,0.8431
"1154",126818,"Colorado State University",1,0,2005,"3381","586.291923","1099","2994","3622",2036,1586,1278,"406",872,0.4283,0.256,0.3528,0.8266
"1155",126818,"Colorado State University",1,0,2006,"3466","622.828032","1122","3136","3825",2166,1659,1448,"441",1007,0.4649,0.2658,0.3786,0.8199
"1156",126818,"Colorado State University",1,0,2007,"4040","662.786257","1136","3659","4352",2387,1965,1609,"564",1045,0.4378,0.287,0.3697,0.8408
"1157",126818,"Colorado State University",1,0,2008,"4424","738.295377","1184","3479","4386",2435,1951,1693,"567",1126,0.4624,0.2906,0.386,0.7932
"1158",126818,"Colorado State University",1,0,2009,"4822","782.39672","1175","3303","4274",2360,1914,1732,"593",1139,0.4826,0.3098,0.4052,0.7728
"1159",126818,"Colorado State University-Fort Collins",1,0,2010,"5256","777.275616","1175","3339","4321",2414,1907,1820,"656",1164,0.4822,0.344,0.4212,0.7727
"1160",127060,"UNIVERSITY OF DENVER",0,1,1991,"12990","107.560545","375","396","504",265,239,280,"123",157,0.5925,0.5146,0.5556,0.7857
"1161",127060,"UNIVERSITY OF DENVER",0,1,1992,"13572","114.917148","374","425","555",284,271,303,"130",173,0.6092,0.4797,0.5459,0.7658
"1162",127060,"UNIVERSITY OF DENVER",0,1,1993,"14472","122.270185","378","438","576",306,270,332,"144",188,0.6144,0.5333,0.5764,0.7604
"1163",127060,"UNIVERSITY OF DENVER",0,1,1995,"16056","143.853468","389","506","654",330,324,376,"175",201,0.6091,0.5401,0.5749,0.7737
"1164",127060,"UNIVERSITY OF DENVER",0,1,1996,"16848","155.05437","402","515","717",372,345,389,"168",221,0.5941,0.487,0.5425,0.7183
"1165",127060,"UNIVERSITY OF DENVER",0,1,1997,"17640","149.838334","403","495","689",354,335,387,"173",214,0.6045,0.5164,0.5617,0.7184
"1166",127060,"UNIVERSITY OF DENVER",0,1,1998,"18468","149.591347","405","598","768",393,375,414,"185",229,0.5827,0.4933,0.5391,0.7786
"1167",127060,"UNIVERSITY OF DENVER",0,1,1999,"18936","157.042626","402","671","812",410,402,420,"181",239,0.5829,0.4502,0.5172,0.8264
"1168",127060,"UNIVERSITY OF DENVER",0,1,2000,"20052","181.51124","413.5","764","926",505,421,526,"214",312,0.6178,0.5083,0.568,0.8251
"1169",127060,"UNIVERSITY OF DENVER",0,1,2001,"21456","201.442211","425","749","933",486,447,561,"249",312,0.642,0.557,0.6013,0.8028
"1170",127060,"UNIVERSITY OF DENVER",0,1,2002,"22680","209.655586","439","803","988",527,461,571,"235",336,0.6376,0.5098,0.5779,0.8128
"1171",127060,"UNIVERSITY OF DENVER",0,1,2003,"24264","227.729095","440","850","1010",549,461,540,"216",324,0.5902,0.4685,0.5347,0.8416
"1172",127060,"UNIVERSITY OF DENVER",0,1,2004,"25956","245.2528","463","924","1124",588,536,633,"286",347,0.5901,0.5336,0.5632,0.8221
"1173",127060,"University of Denver",0,1,2005,"27756","261.203975","488","895","1089",608,481,655,"251",404,0.6645,0.5218,0.6015,0.8219
"1174",127060,"University of Denver",0,1,2006,"29628","279.972205","534","900","1135",615,520,692,"290",402,0.6537,0.5577,0.6097,0.793
"1175",127060,"University of Denver",0,1,2007,"31428","292.974326","574","727","1130",619,511,752,"321",431,0.6963,0.6282,0.6655,0.6434
"1176",127060,"University of Denver",0,1,2008,"32976","312.236408","586","796","1131",633,498,743,"317",426,0.673,0.6365,0.6569,0.7038
"1177",127060,"University of Denver",0,1,2009,"34596","325.561654","612","829","1196",684,512,797,"314",483,0.7061,0.6133,0.6664,0.6931
"1178",127060,"University of Denver",0,1,2010,"35604","327.27269","635","866","1215",663,552,806,"320",486,0.733,0.5797,0.6634,0.7128
"1179",127185,"FORT LEWIS COLLEGE",0,1,1991,"1550","26.082223","167","731","935",424,511,67,"30",37,0.0873,0.0587,0.0717,0.7818
"1180",127185,"FORT LEWIS COLLEGE",0,1,1992,"1701","28.016824","170","785","1004",439,565,118,"49",69,0.1572,0.0867,0.1175,0.7819
"1181",127185,"FORT LEWIS COLLEGE",0,1,1993,"1777","32.295443","165","851","1078",438,640,95,"39",56,0.1279,0.0609,0.0881,0.7894
"1182",127185,"FORT LEWIS COLLEGE",0,1,1995,"1904","35.840477","174","777","1010",434,576,96,"26",70,0.1613,0.0451,0.095,0.7693
"1183",127185,"FORT LEWIS COLLEGE",0,1,1996,"2050","37.479293","165","890","1124",493,631,122,"43",79,0.1602,0.0681,0.1085,0.7918
"1184",127185,"FORT LEWIS COLLEGE",0,1,1997,"2084","38.188565","175","797","1056",450,606,97,"39",58,0.1289,0.0644,0.0919,0.7547
"1185",127185,"FORT LEWIS COLLEGE",0,1,1998,"2110","41.777175","174","722","970",405,565,108,"46",62,0.1531,0.0814,0.1113,0.7443
"1186",127185,"FORT LEWIS COLLEGE",0,1,1999,"1676","46.310188","175","728","1019",429,590,102,"37",65,0.1515,0.0627,0.1001,0.7144
"1187",127185,"FORT LEWIS COLLEGE",1,0,2000,"1724","45.243125","178","674","938",428,510,120,"45",75,0.1752,0.0882,0.1279,0.7186
"1188",127185,"FORT LEWIS COLLEGE",1,0,2001,"1792","49.481107","181","702","1047",469,578,139,"50",89,0.1898,0.0865,0.1328,0.6705
"1189",127185,"FORT LEWIS COLLEGE",1,0,2002,"1902","48.033889","177","730","1035",467,568,147,"59",88,0.1884,0.1039,0.142,0.7053
"1190",127185,"FORT LEWIS COLLEGE",1,0,2003,"2020","51.202287","176","622","899",422,477,138,"51",87,0.2062,0.1069,0.1535,0.6919
"1191",127185,"FORT LEWIS COLLEGE",1,0,2004,"2270","47.97254","185","645","930",448,482,181,"67",114,0.2545,0.139,0.1946,0.6935
"1192",127185,"Fort Lewis College",1,0,2005,"4862","51.335475","190","580","860",386,474,161,"70",91,0.2358,0.1477,0.1872,0.6744
"1193",127185,"Fort Lewis College",1,0,2006,"5102","51.048468","174","518","821",367,454,161,"59",102,0.2779,0.13,0.1961,0.6309
"1194",127185,"Fort Lewis College",1,0,2007,"5138","54.294316","171","565","863",404,459,149,"50",99,0.245,0.1089,0.1727,0.6547
"1195",127185,"Fort Lewis College",1,0,2008,"2846","57.932171","175","475","758",355,403,136,"62",74,0.2085,0.1538,0.1794,0.6266
"1196",127185,"Fort Lewis College",1,0,2009,"3102","60.798808","183","515","766",344,422,138,"64",74,0.2151,0.1517,0.1802,0.6723
"1197",127185,"Fort Lewis College",1,0,2010,"3380","60.285036","167","552","830",393,437,203,"74",129,0.3282,0.1693,0.2446,0.6651
"1198",127565,"METROPOLITAN STATE COLLEGE OF DENVER",1,0,1991,"1483","62.91045","362","1004","1357",669,688,35,"12",23,0.0344,0.0174,0.0258,0.7399
"1199",127565,"METROPOLITAN STATE COLLEGE OF DENVER",1,0,1992,"1709","69.635175","372","905","1227",614,613,49,"17",32,0.0521,0.0277,0.0399,0.7376
"1200",127565,"METROPOLITAN STATE COLLEGE OF DENVER",1,0,1993,"1749","70.779798","370","968","1380",682,698,43,"22",21,0.0308,0.0315,0.0312,0.7014
"1201",127565,"METROPOLITAN STATE COLLEGE OF DENVER",1,0,1995,"1850","75.320438","385","801","1239",691,548,48,"19",29,0.042,0.0347,0.0387,0.6465
"1202",127565,"METROPOLITAN STATE COLLEGE OF DENVER",1,0,1996,"1942","80.986213","364","891","1324",677,647,51,"15",36,0.0532,0.0232,0.0385,0.673
"1203",127565,"METROPOLITAN STATE COLLEGE OF DENVER",1,0,1997,"1976","87.557281","376","1016","1478",787,691,69,"19",50,0.0635,0.0275,0.0467,0.6874
"1204",127565,"METROPOLITAN STATE COLLEGE OF DENVER",1,0,1998,"2033","92.386016","381","935","1382",759,623,81,"29",52,0.0685,0.0465,0.0586,0.6766
"1205",127565,"METROPOLITAN STATE COLLEGE OF DENVER",1,0,1999,"1718","98.380516","386","989","1440",764,676,86,"40",46,0.0602,0.0592,0.0597,0.6868
"1206",127565,"METROPOLITAN STATE COLLEGE OF DENVER",1,0,2000,"1768","98.110756","416","950","1435",778,657,79,"27",52,0.0668,0.0411,0.0551,0.662
"1207",127565,"METROPOLITAN STATE COLLEGE OF DENVER",1,0,2001,"1893","106.064514","446","1087","1596",816,780,97,"42",55,0.0674,0.0538,0.0608,0.6811
"1208",127565,"METROPOLITAN STATE COLLEGE OF DENVER",1,0,2002,"1925","102.255155","489","1143","1655",852,803,73,"25",48,0.0563,0.0311,0.0441,0.6906
"1209",127565,"METROPOLITAN STATE COLLEGE OF DENVER",1,0,2003,"2021","107.176515","392","1209","1809",931,878,82,"26",56,0.0602,0.0296,0.0453,0.6683
"1210",127565,"METROPOLITAN STATE COLLEGE OF DENVER",1,0,2004,"2044","103.893242","395","1242","1815",937,878,86,"34",52,0.0555,0.0387,0.0474,0.6843
"1211",127565,"Metropolitan State College of Denver",1,0,2005,"2191","107.255792","431","1201","1840",939,901,79,"32",47,0.0501,0.0355,0.0429,0.6527
"1212",127565,"Metropolitan State College of Denver",1,0,2006,"2246","107.91832","458","1014","1711",925,786,102,"33",69,0.0746,0.042,0.0596,0.5926
"1213",127565,"Metropolitan State College of Denver",1,0,2007,"2432","116.538553","500","1287","1910",1036,874,108,"38",70,0.0676,0.0435,0.0565,0.6738
"1214",127565,"Metropolitan State College of Denver",1,0,2008,"2615","124.675459","516","1218","1918",969,949,88,"33",55,0.0568,0.0348,0.0459,0.635
"1215",127565,"Metropolitan State College of Denver",1,0,2009,"2850","134.640006","509","1168","1959",985,974,115,"46",69,0.0701,0.0472,0.0587,0.5962
"1216",127565,"Metropolitan State College of Denver",1,0,2010,"3107","140.542231","517","1086","1876",916,960,112,"43",69,0.0753,0.0448,0.0597,0.5789
"1217",127741,"UNIVERSITY OF NORTHERN COLORADO",1,0,1991,"1926","89.940724","458","1365","1639",937,702,258,"78",180,0.1921,0.1111,0.1574,0.8328
"1218",127741,"UNIVERSITY OF NORTHERN COLORADO",1,0,1992,"2027","94.236719","447","1168","1464",921,543,232,"63",169,0.1835,0.116,0.1585,0.7978
"1219",127741,"UNIVERSITY OF NORTHERN COLORADO",1,0,1993,"2114","94.968098","467","1372","1704",1019,685,309,"81",228,0.2237,0.1182,0.1813,0.8052
"1220",127741,"UNIVERSITY OF NORTHERN COLORADO",1,0,1995,"2408","104.066212","463","1456","1763",1091,672,404,"90",314,0.2878,0.1339,0.2292,0.8259
"1221",127741,"UNIVERSITY OF NORTHERN COLORADO",1,0,1996,"2542","114.001645","445","1365","1642",1000,642,413,"120",293,0.293,0.1869,0.2515,0.8313
"1222",127741,"UNIVERSITY OF NORTHERN COLORADO",1,0,1997,"2578","112.227271","445","1543","1905",1147,758,490,"107",383,0.3339,0.1412,0.2572,0.81
"1223",127741,"UNIVERSITY OF NORTHERN COLORADO",1,0,1998,"2652","116.271996","452","1825","2165",1314,851,515,"123",392,0.2983,0.1445,0.2379,0.843
"1224",127741,"UNIVERSITY OF NORTHERN COLORADO",1,0,1999,"2014","123.679767","461","1892","2291",1401,890,589,"129",460,0.3283,0.1449,0.2571,0.8258
"1225",127741,"UNIVERSITY OF NORTHERN COLORADO",1,0,2000,"2072","128.89674","444","1748","2113",1240,873,605,"162",443,0.3573,0.1856,0.2863,0.8273
"1226",127741,"UNIVERSITY OF NORTHERN COLORADO",1,0,2001,"2155","132.826733","427","1740","2108",1309,799,623,"140",483,0.369,0.1752,0.2955,0.8254
"1227",127741,"UNIVERSITY OF NORTHERN COLORADO",1,0,2002,"2290","126.487537","452","1622","1938",1253,685,548,"116",432,0.3448,0.1693,0.2828,0.8369
"1228",127741,"UNIVERSITY OF NORTHERN COLORADO",1,0,2003,"2520","128.970239","410","1747","2118",1337,781,598,"169",429,0.3209,0.2164,0.2823,0.8248
"1229",127741,"UNIVERSITY OF NORTHERN COLORADO",1,0,2004,"2850","127.915555","412","1906","2412",1459,953,648,"190",458,0.3139,0.1994,0.2687,0.7902
"1230",127741,"University of Northern Colorado",1,0,2005,"3192","130.728738","400","1987","2483",1479,1004,620,"173",447,0.3022,0.1723,0.2497,0.8002
"1231",127741,"University of Northern Colorado",1,0,2006,"3276","146.158663","446","1950","2491",1442,1049,659,"204",455,0.3155,0.1945,0.2646,0.7828
"1232",127741,"University of Northern Colorado",1,0,2007,"3600","146.97813","438","1722","2199",1328,871,583,"149",434,0.3268,0.1711,0.2651,0.7831
"1233",127741,"University of Northern Colorado",1,0,2008,"3942","157.570463","458","1613","2071",1227,844,558,"156",402,0.3276,0.1848,0.2694,0.7789
"1234",127741,"University of Northern Colorado",1,0,2009,"4296","168.611766","488","1696","2275",1360,915,605,"165",440,0.3235,0.1803,0.2659,0.7455
"1235",127741,"University of Northern Colorado",1,0,2010,"4680","183.537278","498","1537","2221",1420,801,653,"183",470,0.331,0.2285,0.294,0.692
"1236",128106,"UNIVERSITY OF SOUTHERN COLORADO",1,0,1991,"1725","33.59886","171","386","579",287,292,59,"23",36,0.1254,0.0788,0.1019,0.6667
"1237",128106,"UNIVERSITY OF SOUTHERN COLORADO",1,0,1992,"1833","34.773687","164","433","656",342,314,58,"21",37,0.1082,0.0669,0.0884,0.6601
"1238",128106,"UNIVERSITY OF SOUTHERN COLORADO",1,0,1993,"1878","38.655854","170","466","678",321,357,78,"34",44,0.1371,0.0952,0.115,0.6873
"1239",128106,"UNIVERSITY OF SOUTHERN COLORADO",1,0,1995,"2080","44.043485","175","377","590",299,291,69,"31",38,0.1271,0.1065,0.1169,0.639
"1240",128106,"UNIVERSITY OF SOUTHERN COLORADO",1,0,1996,"2149","46.021248","168","381","574",305,269,68,"19",49,0.1607,0.0706,0.1185,0.6638
"1241",128106,"UNIVERSITY OF SOUTHERN COLORADO",1,0,1997,"2186","46.091093","171","369","580",299,281,49,"20",29,0.097,0.0712,0.0845,0.6362
"1242",128106,"UNIVERSITY OF SOUTHERN COLORADO",1,0,1998,"2219","48.251459","164","350","611",345,266,80,"30",50,0.1449,0.1128,0.1309,0.5728
"1243",128106,"UNIVERSITY OF SOUTHERN COLORADO",1,0,1999,"1808","71.658569","165","391","611",326,285,76,"27",49,0.1503,0.0947,0.1244,0.6399
"1244",128106,"UNIVERSITY OF SOUTHERN COLORADO",1,0,2000,"1860","50.109783","161.5","392","641",331,310,101,"41",60,0.1813,0.1323,0.1576,0.6115
"1245",128106,"UNIVERSITY OF SOUTHERN COLORADO",1,0,2001,"1940","51.574996","158","353","634",343,291,115,"47",68,0.1983,0.1615,0.1814,0.5568
"1246",128106,"UNIVERSITY OF SOUTHERN COLORADO",1,0,2002,"2060","50.763605","160","383","642",329,313,105,"39",66,0.2006,0.1246,0.1636,0.5966
"1247",128106,"COLORADO STATE UNIVERSITY-PUEBLO",1,0,2003,"1873","48.668116","161","422","686",372,314,93,"35",58,0.1559,0.1115,0.1356,0.6152
"1248",128106,"COLORADO STATE UNIVERSITY-PUEBLO",1,0,2004,"2524","48.243761","158","454","753",423,330,118,"34",84,0.1986,0.103,0.1567,0.6029
"1249",128106,"Colorado State University-Pueblo",1,0,2005,"2903","49.106477","160","382","665",361,304,125,"54",71,0.1967,0.1776,0.188,0.5744
"1250",128106,"Colorado State University-Pueblo",1,0,2006,"2975","51.260561","168","349","628",350,278,112,"42",70,0.2,0.1511,0.1783,0.5557
"1251",128106,"Colorado State University-Pueblo",1,0,2007,"3184","51.233298","155","314","602",308,294,109,"41",68,0.2208,0.1395,0.1811,0.5216
"1252",128106,"Colorado State University-Pueblo",1,0,2008,"3422","55.620998","177","517","1002",465,537,160,"65",95,0.2043,0.121,0.1597,0.516
"1253",128106,"Colorado State University-Pueblo",1,0,2009,"3732","66.771502","180","521","1013",513,500,178,"67",111,0.2164,0.134,0.1757,0.5143
"1254",128106,"Colorado State University-Pueblo",1,0,2010,"4068","66.414622","180","486","977",467,510,182,"80",102,0.2184,0.1569,0.1863,0.4974
"1255",128744,"UNIVERSITY OF BRIDGEPORT",1,0,1991,"12774","62.2698","152","81","208",110,98,12,"5",7,0.0636,0.051,0.0577,0.3894
"1256",128744,"UNIVERSITY OF BRIDGEPORT",1,0,1992,"12880","42.828","91","3","18",12,6,1,"0",1,0.0833,0,0.0556,0.1667
"1257",128744,"UNIVERSITY OF BRIDGEPORT",1,0,1993,"12905","33.997","90","37","137",66,71,58,"20",38,0.5758,0.2817,0.4234,0.2701
"1258",128744,"UNIVERSITY OF BRIDGEPORT",1,0,1995,"13124","41.791","83","37","123",73,50,38,"14",24,0.3288,0.28,0.3089,0.3008
"1259",128744,"UNIVERSITY OF BRIDGEPORT",1,0,1996,"13144","37.647488","83","25","116",58,58,35,"17",18,0.3103,0.2931,0.3017,0.2155
"1260",128744,"UNIVERSITY OF BRIDGEPORT",1,0,1997,"13644","31.709","88","49","187",93,94,58,"24",34,0.3656,0.2553,0.3102,0.262
"1261",128744,"UNIVERSITY OF BRIDGEPORT",1,0,1998,"14041","32.247","99","30","233",94,139,80,"48",32,0.3404,0.3453,0.3433,0.1288
"1262",128744,"UNIVERSITY OF BRIDGEPORT",1,0,1999,"13800","35.537","94","42","190",96,94,39,"15",24,0.25,0.1596,0.2053,0.2211
"1263",128744,"UNIVERSITY OF BRIDGEPORT",1,0,2000,"14150","35.805","89","45","161",80,81,53,"21",32,0.4,0.2593,0.3292,0.2795
"1264",128744,"UNIVERSITY OF BRIDGEPORT",1,0,2001,"14720","36.862","84","20","175",97,78,49,"17",32,0.3299,0.2179,0.28,0.1143
"1265",128744,"UNIVERSITY OF BRIDGEPORT",1,0,2002,"15604","37.399","86","48","234",144,90,66,"23",43,0.2986,0.2556,0.2821,0.2051
"1266",128744,"UNIVERSITY OF BRIDGEPORT",1,0,2003,"17008","44.823","87","67","286",158,128,61,"14",47,0.2975,0.1094,0.2133,0.2343
"1267",128744,"UNIVERSITY OF BRIDGEPORT",1,0,2004,"18300","38.55","88","62","241",134,107,47,"19",28,0.209,0.1776,0.195,0.2573
"1268",128744,"University of Bridgeport",1,0,2005,"19200","41.752","89","78","352",212,140,64,"20",44,0.2075,0.1429,0.1818,0.2216
"1269",128744,"University of Bridgeport",1,0,2006,"20250","47.985","102","72","303",176,127,70,"20",50,0.2841,0.1575,0.231,0.2376
"1270",128744,"University of Bridgeport",1,0,2007,"21150","54.289","114","70","331",209,122,62,"17",45,0.2153,0.1393,0.1873,0.2115
"1271",128744,"University of Bridgeport",1,0,2008,"22500","66.795","117","72","444",266,178,90,"30",60,0.2256,0.1685,0.2027,0.1622
"1272",128744,"University of Bridgeport",1,0,2009,"23400","73.673","125","75","429",260,169,108,"37",71,0.2731,0.2189,0.2517,0.1748
"1273",128744,"University of Bridgeport",1,0,2010,"24300","73.803","120","93","594",397,197,122,"41",81,0.204,0.2081,0.2054,0.1566
"1274",128771,"CENTRAL CONNECTICUT STATE UNIVERSITY",1,0,1991,"2414","62.489637","396","914","1088",627,461,115,"34",81,0.1292,0.0738,0.1057,0.8401
"1275",128771,"CENTRAL CONNECTICUT STATE UNIVERSITY",1,0,1992,"2804","65.585739","383","801","964",552,412,98,"31",67,0.1214,0.0752,0.1017,0.8309
"1276",128771,"CENTRAL CONNECTICUT STATE UNIVERSITY",1,0,1993,"2976","67.25079","390","714","902",483,419,80,"18",62,0.1284,0.043,0.0887,0.7916
"1277",128771,"CENTRAL CONNECTICUT STATE UNIVERSITY",1,0,1995,"3266","75.605881","387","843","1076",566,510,68,"28",40,0.0707,0.0549,0.0632,0.7835
"1278",128771,"CENTRAL CONNECTICUT STATE UNIVERSITY",1,0,1996,"3542","74.80828","367","886","1092",534,558,165,"65",100,0.1873,0.1165,0.1511,0.8114
"1279",128771,"CENTRAL CONNECTICUT STATE UNIVERSITY",1,0,1997,"3614","82.981808","354","948","1213",626,587,82,"36",46,0.0735,0.0613,0.0676,0.7815
"1280",128771,"CENTRAL CONNECTICUT STATE UNIVERSITY",1,0,1998,"3670","98.982177","377","1063","1317",675,642,163,"46",117,0.1733,0.0717,0.1238,0.8071
"1281",128771,"CENTRAL CONNECTICUT STATE UNIVERSITY",1,0,1999,"2062","106.164734","379","932","1280",559,721,143,"47",96,0.1717,0.0652,0.1117,0.7281
"1282",128771,"CENTRAL CONNECTICUT STATE UNIVERSITY",1,0,2000,"2142","120.849151","385","1001","1304",635,669,141,"42",99,0.1559,0.0628,0.1081,0.7676
"1283",128771,"CENTRAL CONNECTICUT STATE UNIVERSITY",1,0,2001,"2226","118.533213","391","975","1261",623,638,169,"74",95,0.1525,0.116,0.134,0.7732
"1284",128771,"CENTRAL CONNECTICUT STATE UNIVERSITY",1,0,2002,"2314","135.366475","400","1188","1473",735,738,192,"61",131,0.1782,0.0827,0.1303,0.8065
"1285",128771,"CENTRAL CONNECTICUT STATE UNIVERSITY",1,0,2003,"2648","150.414226","395","906","1176",571,605,166,"59",107,0.1874,0.0975,0.1412,0.7704
"1286",128771,"CENTRAL CONNECTICUT STATE UNIVERSITY",1,0,2004,"2862","164.912631","409","977","1278",596,682,213,"80",133,0.2232,0.1173,0.1667,0.7645
"1287",128771,"Central Connecticut State University",1,0,2005,"3034","209.640469","416","1050","1333",663,670,188,"82",106,0.1599,0.1224,0.141,0.7877
"1288",128771,"Central Connecticut State University",1,0,2006,"3187","176.126949","417","1008","1282",603,679,272,"117",155,0.257,0.1723,0.2122,0.7863
"1289",128771,"Central Connecticut State University",1,0,2007,"3346","186.188386","432","1154","1466",676,790,294,"133",161,0.2382,0.1684,0.2005,0.7872
"1290",128771,"Central Connecticut State University",1,0,2008,"3514","198.875571","434","992","1297",578,719,279,"133",146,0.2526,0.185,0.2151,0.7648
"1291",128771,"Central Connecticut State University",1,0,2009,"3742","210.116234","433","940","1277",621,656,321,"128",193,0.3108,0.1951,0.2514,0.7361
"1292",128771,"Central Connecticut State University",1,0,2010,"4023","198.411623","440","1031","1340",592,748,279,"125",154,0.2601,0.1671,0.2082,0.7694
"1293",129020,"UNIVERSITY OF CONNECTICUT",1,0,1991,"3402","324.761273","1093","2381","2904",1464,1440,977,"359",618,0.4221,0.2493,0.3364,0.8199
"1294",129020,"UNIVERSITY OF CONNECTICUT",1,0,1992,"3902","362.364299","1045","2197","2831",1454,1377,968,"354",614,0.4223,0.2571,0.3419,0.7761
"1295",129020,"UNIVERSITY OF CONNECTICUT",1,0,1993,"4290","360.891026","1044","1670","2052",1068,984,775,"297",478,0.4476,0.3018,0.3777,0.8138
"1296",129020,"UNIVERSITY OF CONNECTICUT",1,0,1995,"4810","454.445549","1068","1558","2010",1051,959,855,"341",514,0.4891,0.3556,0.4254,0.7751
"1297",129020,"UNIVERSITY OF CONNECTICUT",1,0,1996,"4974","447.579354","1025","1643","2142",1156,986,908,"311",597,0.5164,0.3154,0.4239,0.767
"1298",129020,"UNIVERSITY OF CONNECTICUT",1,0,1997,"5242","431.466304","962","1663","2172",1181,991,977,"340",637,0.5394,0.3431,0.4498,0.7657
"1299",129020,"UNIVERSITY OF CONNECTICUT",1,0,1998,"5330","444.855561","1014","1907","2536",1358,1178,1135,"431",704,0.5184,0.3659,0.4476,0.752
"1300",129020,"UNIVERSITY OF CONNECTICUT",1,0,1999,"4158","488.314951","1043","2256","2940",1596,1344,1454,"523",931,0.5833,0.3891,0.4946,0.7673
"1301",129020,"UNIVERSITY OF CONNECTICUT",1,0,2000,"4282","537.163218","1039.5","2112","2802",1549,1253,1484,"554",930,0.6004,0.4421,0.5296,0.7537
"1302",129020,"UNIVERSITY OF CONNECTICUT",1,0,2001,"4448","577.627672","1036","1979","3122",1648,1474,1671,"682",989,0.6001,0.4627,0.5352,0.6339
"1303",129020,"UNIVERSITY OF CONNECTICUT",1,0,2002,"4730","620.483377","1068","2382","3157",1722,1435,1766,"674",1092,0.6341,0.4697,0.5594,0.7545
"1304",129020,"UNIVERSITY OF CONNECTICUT",1,0,2003,"5260","676.241921","1017","2402","3182",1733,1449,1912,"757",1155,0.6665,0.5224,0.6009,0.7549
"1305",129020,"UNIVERSITY OF CONNECTICUT",1,0,2004,"5772","716.706319","1109","2402","3229",1789,1440,2104,"830",1274,0.7121,0.5764,0.6516,0.7439
"1306",129020,"University of Connecticut",1,0,2005,"6096","812.00528","1187","2212","3239",1789,1450,2176,"881",1295,0.7239,0.6076,0.6718,0.6829
"1307",129020,"University of Connecticut",1,0,2006,"6456","835.62865","1202","2074","3222",1631,1591,2148,"962",1186,0.7272,0.6047,0.6667,0.6437
"1308",129020,"University of Connecticut",1,0,2007,"6816","863.553752","1233","2012","3160",1682,1478,2136,"921",1215,0.7224,0.6231,0.6759,0.6367
"1309",129020,"University of Connecticut",1,0,2008,"7200","937.972827","1254","2208","3587",1780,1807,2382,"1098",1284,0.7213,0.6076,0.6641,0.6156
"1310",129020,"University of Connecticut",1,0,2009,"7632","1762.235439","1296","2125","3206",1652,1554,2216,"986",1230,0.7446,0.6345,0.6912,0.6628
"1311",129020,"University of Connecticut",1,0,2010,"8064","1764.68145","1312","2284","3317",1629,1688,2300,"1076",1224,0.7514,0.6374,0.6934,0.6886
"1312",129242,"FAIRFIELD UNIVERSITY",1,0,1991,"12920","60.842871","190","672","749",429,320,597,"255",342,0.7972,0.7969,0.7971,0.8972
"1313",129242,"FAIRFIELD UNIVERSITY",1,0,1992,"13720","65.459896","188","780","861",506,355,672,"277",395,0.7806,0.7803,0.7805,0.9059
"1314",129242,"FAIRFIELD UNIVERSITY",1,0,1993,"14560","71.812542","192","677","773",392,381,595,"283",312,0.7959,0.7428,0.7697,0.8758
"1315",129242,"FAIRFIELD UNIVERSITY",1,0,1995,"16340","79.863921","199","681","784",450,334,602,"248",354,0.7867,0.7425,0.7679,0.8686
"1316",129242,"FAIRFIELD UNIVERSITY",1,0,1996,"17360","84.50492","199","765","876",440,436,642,"299",343,0.7795,0.6858,0.7329,0.8733
"1317",129242,"FAIRFIELD UNIVERSITY",1,0,1997,"18310","73.515714","202","781","876",462,414,649,"286",363,0.7857,0.6908,0.7409,0.8916
"1318",129242,"FAIRFIELD UNIVERSITY",1,0,1998,"19210","76.214108","202","749","875",478,397,679,"299",380,0.795,0.7531,0.776,0.856
"1319",129242,"FAIRFIELD UNIVERSITY",1,0,1999,"20000","80.089765","206","756","837",446,391,662,"287",375,0.8408,0.734,0.7909,0.9032
"1320",129242,"FAIRFIELD UNIVERSITY",1,0,2000,"21000","85.765883","214","908","1008",610,398,797,"291",506,0.8295,0.7312,0.7907,0.9008
"1321",129242,"FAIRFIELD UNIVERSITY",1,0,2001,"22430","95.931345","222","697","831",463,368,646,"265",381,0.8229,0.7201,0.7774,0.8387
"1322",129242,"FAIRFIELD UNIVERSITY",1,0,2002,"24100","106.639003","219","708","813",461,352,609,"240",369,0.8004,0.6818,0.7491,0.8708
"1323",129242,"FAIRFIELD UNIVERSITY",1,0,2003,"26100","113.137","219","692","789",459,330,636,"260",376,0.8192,0.7879,0.8061,0.8771
"1324",129242,"FAIRFIELD UNIVERSITY",1,0,2004,"27930","119.058","221","784","856",475,381,679,"282",397,0.8358,0.7402,0.7932,0.9159
"1325",129242,"Fairfield University",1,0,2005,"29730","126.183","225","742","940",551,389,744,"297",447,0.8113,0.7635,0.7915,0.7894
"1326",129242,"Fairfield University",1,0,2006,"31450","130.838","238","614","896",534,362,696,"269",427,0.7996,0.7431,0.7768,0.6853
"1327",129242,"Fairfield University",1,0,2007,"33340","140.847","239","619","842",496,346,664,"268",396,0.7984,0.7746,0.7886,0.7352
"1328",129242,"Fairfield University",1,0,2008,"35510","156.314","252","536","898",537,361,688,"257",431,0.8026,0.7119,0.7661,0.5969
"1329",129242,"Fairfield University",1,0,2009,"36900","156.152","253","540","848",479,369,664,"270",394,0.8225,0.7317,0.783,0.6368
"1330",129242,"Fairfield University",1,0,2010,"38450","156.122","250","627","921",576,345,722,"250",472,0.8194,0.7246,0.7839,0.6808
"1331",129941,"UNIVERSITY OF NEW HAVEN",1,0,1991,"9600","30.5354","149","208","320",84,236,60,"42",18,0.2143,0.178,0.1875,0.65
"1332",129941,"UNIVERSITY OF NEW HAVEN",1,0,1992,"9870","32.519697","152","194","302",74,228,42,"30",12,0.1622,0.1316,0.1391,0.6424
"1333",129941,"UNIVERSITY OF NEW HAVEN",1,0,1993,"10180","34.442269","152","171","289",103,186,47,"27",20,0.1942,0.1452,0.1626,0.5917
"1334",129941,"UNIVERSITY OF NEW HAVEN",1,0,1995,"11450","31.845538","154","247","352",115,237,110,"74",36,0.313,0.3122,0.3125,0.7017
"1335",129941,"UNIVERSITY OF NEW HAVEN",1,0,1996,"12110","42.052795","157","229","329",109,220,68,"40",28,0.2569,0.1818,0.2067,0.696
"1336",129941,"UNIVERSITY OF NEW HAVEN",1,0,1997,"13100","42.908727","152","207","324",130,194,87,"46",41,0.3154,0.2371,0.2685,0.6389
"1337",129941,"UNIVERSITY OF NEW HAVEN",1,0,1998,"13800","45.333252","158","236","370",141,229,95,"51",44,0.3121,0.2227,0.2568,0.6378
"1338",129941,"UNIVERSITY OF NEW HAVEN",1,0,1999,"14250","40.659727","159","194","322",117,205,66,"32",34,0.2906,0.1561,0.205,0.6025
"1339",129941,"UNIVERSITY OF NEW HAVEN",1,0,2000,"15210","41.289997","165","242","457",195,262,101,"48",53,0.2718,0.1832,0.221,0.5295
"1340",129941,"UNIVERSITY OF NEW HAVEN",1,0,2001,"16200","44.055776","171","283","503",202,301,123,"54",69,0.3416,0.1794,0.2445,0.5626
"1341",129941,"UNIVERSITY OF NEW HAVEN",1,0,2002,"18800","46.950285","168","374","529",240,289,166,"67",99,0.4125,0.2318,0.3138,0.707
"1342",129941,"UNIVERSITY OF NEW HAVEN",1,0,2003,"20150","53.018749","178","467","618",301,317,223,"85",138,0.4585,0.2681,0.3608,0.7557
"1343",129941,"UNIVERSITY OF NEW HAVEN",1,0,2004,"21120","58.084867","169","437","571",264,307,197,"111",86,0.3258,0.3616,0.345,0.7653
"1344",129941,"University of New Haven",1,0,2005,"22380","61.808839","162","503","653",322,331,256,"117",139,0.4317,0.3535,0.392,0.7703
"1345",129941,"University of New Haven",1,0,2006,"24000","75.030993","169","513","690",325,365,305,"157",148,0.4554,0.4301,0.442,0.7435
"1346",129941,"University of New Haven",1,0,2007,"25380","81.408869","182","498","700",331,369,296,"138",158,0.4773,0.374,0.4229,0.7114
"1347",129941,"University of New Haven",1,0,2008,"27000","94.173239","183","686","1129",569,560,430,"175",255,0.4482,0.3125,0.3809,0.6076
"1348",129941,"University of New Haven",1,0,2009,"28250","107.799487","200","486","1252",639,613,553,"247",306,0.4789,0.4029,0.4417,0.3882
"1349",129941,"University of New Haven",1,0,2010,"29500","118.004788","207","189","1005",534,471,452,"198",254,0.4757,0.4204,0.4498,0.1881
"1350",130253,"SACRED HEART UNIVERSITY",1,0,1991,"8970","24.914975","103","356","485",196,289,93,"41",52,0.2653,0.1419,0.1918,0.734
"1351",130253,"SACRED HEART UNIVERSITY",1,0,1992,"9740","30.209619","108","375","491",240,251,114,"52",62,0.2583,0.2072,0.2322,0.7637
"1352",130253,"SACRED HEART UNIVERSITY",1,0,1993,"10550","35.578677","111","400","515",274,241,197,"72",125,0.4562,0.2988,0.3825,0.7767
"1353",130253,"SACRED HEART UNIVERSITY",1,0,1995,"12100","48.368655","128","550","639",357,282,269,"107",162,0.4538,0.3794,0.421,0.8607
"1354",130253,"SACRED HEART UNIVERSITY",1,0,1996,"12714","48.474822","127","534","602",361,241,281,"81",200,0.554,0.3361,0.4668,0.887
"1355",130253,"SACRED HEART UNIVERSITY",1,0,1997,"13435","48.681343","130","546","632",377,255,297,"113",184,0.4881,0.4431,0.4699,0.8639
"1356",130253,"SACRED HEART UNIVERSITY",1,0,1998,"13972","52.6266","137","618","702",409,293,308,"112",196,0.4792,0.3823,0.4387,0.8803
"1357",130253,"SACRED HEART UNIVERSITY",1,0,1999,"14670","56.802974","144","621","718",416,302,401,"141",260,0.625,0.4669,0.5585,0.8649
"1358",130253,"SACRED HEART UNIVERSITY",1,0,2000,"15404","63.95978","148.5","749","834",498,336,477,"168",309,0.6205,0.5,0.5719,0.8981
"1359",130253,"SACRED HEART UNIVERSITY",1,0,2001,"16328","69.308769","153","696","766",465,301,457,"172",285,0.6129,0.5714,0.5966,0.9086
"1360",130253,"SACRED HEART UNIVERSITY",1,0,2002,"19260","72.858312","160","752","797",457,340,445,"171",274,0.5996,0.5029,0.5583,0.9435
"1361",130253,"SACRED HEART UNIVERSITY",1,0,2003,"20220","79.117017","165","734","816",497,319,462,"144",318,0.6398,0.4514,0.5662,0.8995
"1362",130253,"SACRED HEART UNIVERSITY",1,0,2004,"21990","82.270772","181","786","876",521,355,528,"196",332,0.6372,0.5521,0.6027,0.8973
"1363",130253,"Sacred Heart University",1,0,2005,"23750","94.641473","182","821","886",542,344,544,"186",358,0.6605,0.5407,0.614,0.9266
"1364",130253,"Sacred Heart University",1,0,2006,"25300","103.230096","189","846","931",603,328,536,"172",364,0.6036,0.5244,0.5757,0.9087
"1365",130253,"Sacred Heart University",1,0,2007,"26950","106.507013","199","850","956",580,376,606,"220",386,0.6655,0.5851,0.6339,0.8891
"1366",130253,"Sacred Heart University",1,0,2008,"28790","114.390165","212","788","981",577,404,583,"201",382,0.662,0.4975,0.5943,0.8033
"1367",130253,"Sacred Heart University",1,0,2009,"30090","121.868961","201","681","907",542,365,526,"180",346,0.6384,0.4932,0.5799,0.7508
"1368",130253,"Sacred Heart University",1,0,2010,"31224","119.275122","217","690","974",610,364,529,"167",362,0.5934,0.4588,0.5431,0.7084
"1369",130314,"SAINT JOSEPH COLLEGE",1,0,1991,"10400","14.016188","70","79","104",104,0,54,"0",54,0.5192,NA,0.5192,0.7596
"1370",130314,"SAINT JOSEPH COLLEGE",1,0,1992,"11000","15.787772","71","89","105",105,0,42,"0",42,0.4,NA,0.4,0.8476
"1371",130314,"SAINT JOSEPH COLLEGE",1,0,1993,"11600","14.697211","66","78","93",93,0,47,"0",47,0.5054,NA,0.5054,0.8387
"1372",130314,"SAINT JOSEPH COLLEGE",1,0,1995,"13020","19.10017","74","134","153",152,1,82,"0",82,0.5395,0,0.5359,0.8758
"1373",130314,"SAINT JOSEPH COLLEGE",1,0,1996,"13800","21.042153","72","125","164",164,0,66,"0",66,0.4024,NA,0.4024,0.7622
"1374",130314,"SAINT JOSEPH COLLEGE",1,0,1997,"14490","18.654252","73","131","174",174,0,87,"0",87,0.5,NA,0.5,0.7529
"1375",130314,"SAINT JOSEPH COLLEGE",1,0,1998,"15070","20.098275","74","117","142",142,0,66,"0",66,0.4648,NA,0.4648,0.8239
"1376",130314,"SAINT JOSEPH COLLEGE",1,0,1999,"15900","21.562762","76","101","144",144,0,61,"0",61,0.4236,NA,0.4236,0.7014
"1377",130314,"SAINT JOSEPH COLLEGE",1,0,2000,"16930","23.021985","75","137","187",187,0,86,"0",86,0.4599,NA,0.4599,0.7326
"1378",130314,"SAINT JOSEPH COLLEGE",1,0,2001,"17869","25.321402","74","95","165",165,0,75,"0",75,0.4545,NA,0.4545,0.5758
"1379",130314,"SAINT JOSEPH COLLEGE",1,0,2002,"19110","28.03626","77","124","201",201,0,69,"0",69,0.3433,NA,0.3433,0.6169
"1380",130314,"SAINT JOSEPH COLLEGE",1,0,2003,"20350","30.474934","78","127","190",190,0,59,"0",59,0.3105,NA,0.3105,0.6684
"1381",130314,"SAINT JOSEPH COLLEGE",1,0,2004,"21370","32.473","75","116","189",189,0,56,"0",56,0.2963,NA,0.2963,0.6138
"1382",130314,"Saint Joseph College",1,0,2005,"22225","32.622","77","149","206",206,0,88,"0",88,0.4272,NA,0.4272,0.7233
"1383",130314,"Saint Joseph College",1,0,2006,"22890","33.048","78","96","133",133,0,50,"0",50,0.3759,NA,0.3759,0.7218
"1384",130314,"Saint Joseph College",1,0,2007,"24040","34.381","79","34","165",165,0,61,"0",61,0.3697,NA,0.3697,0.2061
"1385",130314,"Saint Joseph College",1,0,2008,"25240","36.013","76","134","225",225,0,92,"0",92,0.4089,NA,0.4089,0.5956
"1386",130314,"Saint Joseph College",1,0,2009,"26502","39.473","78","112","184",184,0,82,"0",82,0.4457,NA,0.4457,0.6087
"1387",130314,"Saint Joseph College",1,0,2010,"27580","41.35","96","141","229",229,0,137,"0",137,0.5983,NA,0.5983,0.6157
"1388",130493,"SOUTHERN CONNECTICUT STATE UNIVERSITY",1,0,1991,"2199","60.905016","404","806","1002",539,463,188,"49",139,0.2579,0.1058,0.1876,0.8044
"1389",130493,"SOUTHERN CONNECTICUT STATE UNIVERSITY",1,0,1992,"2646","62.755355","397","754","933",493,440,134,"35",99,0.2008,0.0795,0.1436,0.8081
"1390",130493,"SOUTHERN CONNECTICUT STATE UNIVERSITY",1,0,1993,"2838","67.394825","389","868","1044",572,472,139,"38",101,0.1766,0.0805,0.1331,0.8314
"1391",130493,"SOUTHERN CONNECTICUT STATE UNIVERSITY",1,0,1995,"3128","79.456218","382","665","917",526,391,121,"36",85,0.1616,0.0921,0.132,0.7252
"1392",130493,"SOUTHERN CONNECTICUT STATE UNIVERSITY",1,0,1996,"3474","70.715215","374","720","1009",587,422,137,"39",98,0.167,0.0924,0.1358,0.7136
"1393",130493,"SOUTHERN CONNECTICUT STATE UNIVERSITY",1,0,1997,"3568","79.630362","343","789","1089",624,465,146,"39",107,0.1715,0.0839,0.1341,0.7245
"1394",130493,"SOUTHERN CONNECTICUT STATE UNIVERSITY",1,0,1998,"3716","82.551804","381","808","1077",647,430,140,"24",116,0.1793,0.0558,0.13,0.7502
"1395",130493,"SOUTHERN CONNECTICUT STATE UNIVERSITY",1,0,1999,"2124","102.33545","388","877","1238",702,536,148,"50",98,0.1396,0.0933,0.1195,0.7084
"1396",130493,"SOUTHERN CONNECTICUT STATE UNIVERSITY",1,0,2000,"2142","114.252145","394.5","945","1350",775,575,142,"38",104,0.1342,0.0661,0.1052,0.7
"1397",130493,"SOUTHERN CONNECTICUT STATE UNIVERSITY",1,0,2001,"2226","120.718752","401","1015","1429",858,571,134,"37",97,0.1131,0.0648,0.0938,0.7103
"1398",130493,"SOUTHERN CONNECTICUT STATE UNIVERSITY",1,0,2002,"2314","130.652394","402","895","1276",719,557,144,"46",98,0.1363,0.0826,0.1129,0.7014
"1399",130493,"SOUTHERN CONNECTICUT STATE UNIVERSITY",1,0,2003,"2648","132.238169","396","944","1310",802,508,7,"2",5,0.0062,0.0039,0.0053,0.7206
"1400",130493,"SOUTHERN CONNECTICUT STATE UNIVERSITY",1,0,2004,"3010","131.897909","403","1035","1396",899,497,219,"46",173,0.1924,0.0926,0.1569,0.7414
"1401",130493,"Southern Connecticut State University",1,0,2005,"3034","161.025689","403","958","1313",866,447,192,"43",149,0.1721,0.0962,0.1462,0.7296
"1402",130493,"Southern Connecticut State University",1,0,2006,"3187","167.58286","409","1069","1516",987,529,262,"54",208,0.2107,0.1021,0.1728,0.7051
"1403",130493,"Southern Connecticut State University",1,0,2007,"3346","179.224713","438","951","1333",884,449,239,"56",183,0.207,0.1247,0.1793,0.7134
"1404",130493,"Southern Connecticut State University",1,0,2008,"3514","192.754315","449","928","1288",858,430,293,"77",216,0.2517,0.1791,0.2275,0.7205
"1405",130493,"Southern Connecticut State University",1,0,2009,"3742","203.083639","407","909","1237",792,445,280,"65",215,0.2715,0.1461,0.2264,0.7348
"1406",130493,"Southern Connecticut State University",1,0,2010,"4023","188.447417","424","862","1248",792,456,299,"58",241,0.3043,0.1272,0.2396,0.6907
"1407",130590,"TRINITY COLLEGE",1,0,1991,"16740","52.820515","145","401","481",226,255,387,"192",195,0.8628,0.7529,0.8046,0.8337
"1408",130590,"TRINITY COLLEGE",1,0,1992,"17620","56.832357","143","385","472",240,232,352,"161",191,0.7958,0.694,0.7458,0.8157
"1409",130590,"TRINITY COLLEGE",1,0,1993,"17950","60.838502","146","398","476",242,234,362,"173",189,0.781,0.7393,0.7605,0.8361
"1410",130590,"TRINITY COLLEGE",1,0,1995,"19690","65.298861","142","411","507",246,261,388,"174",214,0.8699,0.6667,0.7653,0.8107
"1411",130590,"TRINITY COLLEGE",1,0,1996,"21410","71.814962","151","405","504",238,266,387,"195",192,0.8067,0.7331,0.7679,0.8036
"1412",130590,"TRINITY COLLEGE",1,0,1997,"22470","71.590014","150","377","500",220,280,386,"205",181,0.8227,0.7321,0.772,0.754
"1413",130590,"TRINITY COLLEGE",1,0,1998,"23570","78.550715","151","362","509",263,246,390,"176",214,0.8137,0.7154,0.7662,0.7112
"1414",130590,"TRINITY COLLEGE",1,0,1999,"23730","85.981271","166","389","565",286,279,442,"206",236,0.8252,0.7384,0.7823,0.6885
"1415",130590,"TRINITY COLLEGE",1,0,2000,"24660","93.808451","181","349","489",253,236,389,"181",208,0.8221,0.7669,0.7955,0.7137
"1416",130590,"TRINITY COLLEGE",1,0,2001,"25880","97.721241","196","344","491",239,252,388,"184",204,0.8536,0.7302,0.7902,0.7006
"1417",130590,"TRINITY COLLEGE",1,0,2002,"27170","105.583341","201","349","548",286,262,445,"207",238,0.8322,0.7901,0.812,0.6369
"1418",130590,"TRINITY COLLEGE",1,0,2003,"28740","109.993188","191","335","548",257,291,421,"212",209,0.8132,0.7285,0.7682,0.6113
"1419",130590,"TRINITY COLLEGE",1,0,2004,"30380","113.101795","201","302","569",283,286,442,"213",229,0.8092,0.7448,0.7768,0.5308
"1420",130590,"Trinity College",1,0,2005,"32000","118.75715","189","358","573",289,284,469,"221",248,0.8581,0.7782,0.8185,0.6248
"1421",130590,"Trinity College",1,0,2006,"33440","114.666196","180","397","608",294,314,466,"229",237,0.8061,0.7293,0.7664,0.653
"1422",130590,"Trinity College",1,0,2007,"35110","120.698422","179","382","576",292,284,469,"224",245,0.839,0.7887,0.8142,0.6632
"1423",130590,"Trinity College",1,0,2008,"36864","129.384562","196","355","589",300,289,464,"214",250,0.8333,0.7405,0.7878,0.6027
"1424",130590,"Trinity College",1,0,2009,"38900","128.259577","206","398","573",272,301,464,"232",232,0.8529,0.7708,0.8098,0.6946
"1425",130590,"Trinity College",1,0,2010,"40410","129.970895","193","387","591",300,291,473,"223",250,0.8333,0.7663,0.8003,0.6548
"1426",130697,"WESLEYAN UNIVERSITY",1,0,1991,"16250","82.768","255","435","663",347,316,501,"223",278,0.8012,0.7057,0.7557,0.6561
"1427",130697,"WESLEYAN UNIVERSITY",1,0,1992,"17190","85.839","252","449","704",361,343,553,"263",290,0.8033,0.7668,0.7855,0.6378
"1428",130697,"WESLEYAN UNIVERSITY",1,0,1993,"18150","92.272","254","474","703",365,338,547,"257",290,0.7945,0.7604,0.7781,0.6743
"1429",130697,"WESLEYAN UNIVERSITY",1,0,1995,"20820","101.244","241","484","710",356,354,584,"288",296,0.8315,0.8136,0.8225,0.6817
"1430",130697,"WESLEYAN UNIVERSITY",1,0,1996,"21910","109.513","246","503","738",374,364,633,"311",322,0.861,0.8544,0.8577,0.6816
"1431",130697,"WESLEYAN UNIVERSITY",1,0,1997,"22980","106.258","252","463","700",371,329,583,"263",320,0.8625,0.7994,0.8329,0.6614
"1432",130697,"WESLEYAN UNIVERSITY",1,0,1998,"24050","112.777","259","463","716",382,334,593,"264",329,0.8613,0.7904,0.8282,0.6466
"1433",130697,"WESLEYAN UNIVERSITY",1,0,1999,"24330","116.573","263","499","732",375,357,609,"283",326,0.8693,0.7927,0.832,0.6817
"1434",130697,"WESLEYAN UNIVERSITY",1,0,2000,"25380","123.895","287","447","720",371,349,607,"281",326,0.8787,0.8052,0.8431,0.6208
"1435",130697,"WESLEYAN UNIVERSITY",1,0,2001,"26290","130.341","311","465","722",372,350,606,"280",326,0.8763,0.8,0.8393,0.644
"1436",130697,"WESLEYAN UNIVERSITY",1,0,2002,"27474","140.323","311","444","716",377,339,634,"288",346,0.9178,0.8496,0.8855,0.6201
"1437",130697,"WESLEYAN UNIVERSITY",1,0,2003,"29784","147.91","329","431","713",376,337,631,"291",340,0.9043,0.8635,0.885,0.6045
"1438",130697,"WESLEYAN UNIVERSITY",1,0,2004,"31436","159.757","322","428","728",385,343,649,"300",349,0.9065,0.8746,0.8915,0.5879
"1439",130697,"Wesleyan University",1,0,2005,"32976","161.525","325","422","705",360,345,614,"305",309,0.8583,0.8841,0.8709,0.5986
"1440",130697,"Wesleyan University",1,0,2006,"34630","166.772","333","448","716",352,364,624,"316",308,0.875,0.8681,0.8715,0.6257
"1441",130697,"Wesleyan University",1,0,2007,"36536","167.591","325","451","733",377,356,632,"305",327,0.8674,0.8567,0.8622,0.6153
"1442",130697,"Wesleyan University",1,0,2008,"38364","177.849","328","366","715",355,360,622,"300",322,0.907,0.8333,0.8699,0.5119
"1443",130697,"Wesleyan University",1,0,2009,"39822","187.436","330","380","744",389,355,681,"322",359,0.9229,0.907,0.9153,0.5108
"1444",130697,"Wesleyan University",1,0,2010,"41814","174.457","339","446","748",411,337,652,"292",360,0.8759,0.8665,0.8717,0.5963
"1445",130776,"WESTERN CONNECTICUT STATE UNIVERSITY",1,0,1991,"2361","30.092942","180","288","349",187,162,96,"32",64,0.3422,0.1975,0.2751,0.8252
"1446",130776,"WESTERN CONNECTICUT STATE UNIVERSITY",1,0,1992,"2910","29.632729","183","275","372",161,211,88,"47",41,0.2547,0.2227,0.2366,0.7392
"1447",130776,"WESTERN CONNECTICUT STATE UNIVERSITY",1,0,1993,"2900","32.390268","178","417","526",247,279,115,"50",65,0.2632,0.1792,0.2186,0.7928
"1448",130776,"WESTERN CONNECTICUT STATE UNIVERSITY",1,0,1995,"3168","38.574731","187","336","460",237,223,79,"35",44,0.1857,0.157,0.1717,0.7304
"1449",130776,"WESTERN CONNECTICUT STATE UNIVERSITY",1,0,1996,"3528","36.572844","181","383","496",242,254,60,"32",28,0.1157,0.126,0.121,0.7722
"1450",130776,"WESTERN CONNECTICUT STATE UNIVERSITY",1,0,1997,"3626","41.076663","174","495","668",303,365,90,"35",55,0.1815,0.0959,0.1347,0.741
"1451",130776,"WESTERN CONNECTICUT STATE UNIVERSITY",1,0,1998,"3626","43.955476","175","479","655",315,340,91,"33",58,0.1841,0.0971,0.1389,0.7313
"1452",130776,"WESTERN CONNECTICUT STATE UNIVERSITY",1,0,1999,"2062","49.620362","178","525","697",359,338,70,"22",48,0.1337,0.0651,0.1004,0.7532
"1453",130776,"WESTERN CONNECTICUT STATE UNIVERSITY",1,0,2000,"2142","59.529369","183.5","591","822",404,418,104,"42",62,0.1535,0.1005,0.1265,0.719
"1454",130776,"WESTERN CONNECTICUT STATE UNIVERSITY",1,0,2001,"2226","47.623472","189","617","841",439,402,111,"36",75,0.1708,0.0896,0.132,0.7337
"1455",130776,"WESTERN CONNECTICUT STATE UNIVERSITY",1,0,2002,"2314","74.784714","188","582","794",434,360,113,"32",81,0.1866,0.0889,0.1423,0.733
"1456",130776,"WESTERN CONNECTICUT STATE UNIVERSITY",1,0,2003,"2648","75.054286","186","630","808",444,364,105,"40",65,0.1464,0.1099,0.13,0.7797
"1457",130776,"WESTERN CONNECTICUT STATE UNIVERSITY",1,0,2004,"3010","76.83233","196","624","755",382,373,120,"53",67,0.1754,0.1421,0.1589,0.8265
"1458",130776,"Western Connecticut State University",1,0,2005,"3034","95.814121","197","617","773",396,377,124,"52",72,0.1818,0.1379,0.1604,0.7982
"1459",130776,"Western Connecticut State University",1,0,2006,"3187","120.915378","200","655","843",413,430,167,"64",103,0.2494,0.1488,0.1981,0.777
"1460",130776,"Western Connecticut State University",1,0,2007,"3346","106.657935","212","701","913",494,419,190,"77",113,0.2287,0.1838,0.2081,0.7678
"1461",130776,"Western Connecticut State University",1,0,2008,"3514","107.563677","221","700","928",462,466,180,"82",98,0.2121,0.176,0.194,0.7543
"1462",130776,"Western Connecticut State University",1,0,2009,"3742","110.766005","218","761","1008",549,459,255,"99",156,0.2842,0.2157,0.253,0.755
"1463",130776,"Western Connecticut State University",1,0,2010,"4023","110.530666","228","653","975",524,451,209,"85",124,0.2366,0.1885,0.2144,0.6697
"1464",130794,"YALE UNIVERSITY",1,0,1991,"16300","745.931568","773","800","1290",592,698,1127,"608",519,0.8767,0.8711,0.8736,0.6202
"1465",130794,"YALE UNIVERSITY",1,0,1992,"17500","799.262466","755","805","1326",640,686,1139,"561",578,0.9031,0.8178,0.859,0.6071
"1466",130794,"YALE UNIVERSITY",1,0,1993,"18630","837.577402","767","696","1317",627,690,1135,"582",553,0.882,0.8435,0.8618,0.5285
"1467",130794,"YALE UNIVERSITY",1,0,1995,"21000","934.937954","765","773","1360",692,668,1198,"575",623,0.9003,0.8608,0.8809,0.5684
"1468",130794,"YALE UNIVERSITY",1,0,1996,"22200","983.280245","772","767","1403",688,715,1235,"611",624,0.907,0.8545,0.8803,0.5467
"1469",130794,"YALE UNIVERSITY",1,0,1997,"23100","995.215","758","701","1307",662,645,1170,"552",618,0.9335,0.8558,0.8952,0.5363
"1470",130794,"YALE UNIVERSITY",1,0,1998,"23780","1066.49","777","656","1295",646,649,1146,"573",573,0.887,0.8829,0.8849,0.5066
"1471",130794,"YALE UNIVERSITY",1,0,1999,"24500","1136.545","814","736","1358",682,676,1219,"594",625,0.9164,0.8787,0.8976,0.542
"1472",130794,"YALE UNIVERSITY",1,0,2000,"25220","1283.533","845.5","693","1349",678,671,1189,"582",607,0.8953,0.8674,0.8814,0.5137
"1473",130794,"YALE UNIVERSITY",1,0,2001,"26100","1334.913","877","645","1293",648,645,1125,"538",587,0.9059,0.8341,0.8701,0.4988
"1474",130794,"YALE UNIVERSITY",1,0,2002,"27130","1426.989","893","661","1299",643,656,1164,"576",588,0.9145,0.878,0.8961,0.5089
"1475",130794,"YALE UNIVERSITY",1,0,2003,"28400","1543.176","1044","695","1350",680,670,1221,"582",639,0.9397,0.8687,0.9044,0.5148
"1476",130794,"YALE UNIVERSITY",1,0,2004,"29820","1675.908","1037","650","1306",632,674,1161,"589",572,0.9051,0.8739,0.889,0.4977
"1477",130794,"Yale University",1,0,2005,"31460","1786.94","1038","624","1320",651,669,1172,"574",598,0.9186,0.858,0.8879,0.4727
"1478",130794,"Yale University",1,0,2006,"33030","1963.572","1081","628","1313",654,659,1169,"578",591,0.9037,0.8771,0.8903,0.4783
"1479",130794,"Yale University",1,0,2007,"34530","2108.514","1079","697","1313",661,652,1177,"578",599,0.9062,0.8865,0.8964,0.5308
"1480",130794,"Yale University",1,0,2008,"35300","2314.45","1129","638","1316",664,652,1150,"543",607,0.9142,0.8328,0.8739,0.4848
"1481",130794,"Yale University",1,0,2009,"36500","2493.475","1164","667","1305",651,654,1145,"553",592,0.9094,0.8456,0.8774,0.5111
"1482",130794,"Yale University",1,0,2010,"38300","2572.137","1152","665","1343",696,647,1161,"547",614,0.8822,0.8454,0.8645,0.4952
"1483",130934,"DELAWARE STATE COLLEGE",1,0,1991,"1546","32.081375","158","103","585",330,255,53,"12",41,0.1242,0.0471,0.0906,0.1761
"1484",130934,"DELAWARE STATE COLLEGE",1,0,1992,"1788","36.031014","185","107","579",305,274,47,"22",25,0.082,0.0803,0.0812,0.1848
"1485",130934,"DELAWARE STATE UNIVERSITY",1,0,1993,"1966","37.691971","176","103","686",386,300,68,"11",57,0.1477,0.0367,0.0991,0.1501
"1486",130934,"DELAWARE STATE UNIVERSITY",1,0,1995,"2250","46.250521","168","53","563",333,230,76,"27",49,0.1471,0.1174,0.135,0.0941
"1487",130934,"DELAWARE STATE UNIVERSITY",1,0,1996,"2636","47.290445","173","63","544",305,239,87,"21",66,0.2164,0.0879,0.1599,0.1158
"1488",130934,"DELAWARE STATE UNIVERSITY",1,0,1997,"2810","49.98577","175","60","637",359,278,121,"35",86,0.2396,0.1259,0.19,0.0942
"1489",130934,"DELAWARE STATE UNIVERSITY",1,0,1998,"2974","53.432805","177","48","578",339,239,118,"39",79,0.233,0.1632,0.2042,0.083
"1490",130934,"DELAWARE STATE UNIVERSITY",1,0,1999,"3096","58.769636","184","67","632",375,257,132,"37",95,0.2533,0.144,0.2089,0.106
"1491",130934,"DELAWARE STATE UNIVERSITY",1,0,2000,"3290","63.480464","179","70","684",405,279,155,"36",119,0.2938,0.129,0.2266,0.1023
"1492",130934,"DELAWARE STATE UNIVERSITY",1,0,2001,"3422","64.829804","174","55","686",385,301,107,"30",77,0.2,0.0997,0.156,0.0802
"1493",130934,"DELAWARE STATE UNIVERSITY",1,0,2002,"3956","60.612916","182","64","761",439,322,1,"0",1,0.0023,0,0.0013,0.0841
"1494",130934,"DELAWARE STATE UNIVERSITY",1,0,2003,"3996","63.521403","194","53","597",355,242,89,"13",76,0.2141,0.0537,0.1491,0.0888
"1495",130934,"DELAWARE STATE UNIVERSITY",1,0,2004,"4646","67.950029","179","62","687",400,287,133,"23",110,0.275,0.0801,0.1936,0.0902
"1496",130934,"Delaware State University",1,0,2005,"5480","74.162341","177","53","885",514,371,164,"40",124,0.2412,0.1078,0.1853,0.0599
"1497",130934,"Delaware State University",1,0,2006,"5366","80.082297","166","66","818",463,355,126,"37",89,0.1922,0.1042,0.154,0.0807
"1498",130934,"Delaware State University",1,0,2007,"5366","92.997394","184","58","799",495,304,145,"37",108,0.2182,0.1217,0.1815,0.0726
"1499",130934,"Delaware State University",1,0,2008,"5701","102.995991","193","44","721",455,266,154,"36",118,0.2593,0.1353,0.2136,0.061
"1500",130934,"Delaware State University",1,0,2009,"5701","107.647559","190","57","739",463,276,165,"42",123,0.2657,0.1522,0.2233,0.0771
"1501",130934,"Delaware State University",1,0,2010,"5901","99.109336","198","57","887",556,331,220,"58",162,0.2914,0.1752,0.248,0.0643
"1502",130943,"UNIVERSITY OF DELAWARE",1,0,1991,"3520","316.913314","972","2948","3170",1871,1299,1592,"524",1068,0.5708,0.4034,0.5022,0.93
"1503",130943,"UNIVERSITY OF DELAWARE",1,0,1992,"3722","333.674797","960","2695","2944",1729,1215,1593,"590",1003,0.5801,0.4856,0.5411,0.9154
"1504",130943,"UNIVERSITY OF DELAWARE",1,0,1993,"3948","346.072111","901","2892","3181",1847,1334,1623,"573",1050,0.5685,0.4295,0.5102,0.9091
"1505",130943,"UNIVERSITY OF DELAWARE",1,0,1995,"4286","388.758975","915","2784","3155",1883,1272,1719,"621",1098,0.5831,0.4882,0.5448,0.8824
"1506",130943,"UNIVERSITY OF DELAWARE",1,0,1996,"4430","403.319051","920","2881","3290",1980,1310,1823,"623",1200,0.6061,0.4756,0.5541,0.8757
"1507",130943,"UNIVERSITY OF DELAWARE",1,0,1997,"4574","408.309118","935","2781","3179",1881,1298,1823,"622",1201,0.6385,0.4792,0.5735,0.8748
"1508",130943,"UNIVERSITY OF DELAWARE",1,0,1998,"4716","433.526077","930","3145","3545",2149,1396,2078,"696",1382,0.6431,0.4986,0.5862,0.8872
"1509",130943,"UNIVERSITY OF DELAWARE",1,0,1999,"4380","467.776004","933","3123","3513",2146,1367,2193,"764",1429,0.6659,0.5589,0.6243,0.889
"1510",130943,"UNIVERSITY OF DELAWARE",1,0,2000,"4510","479.046543","989","2722","3128",1926,1202,1884,"620",1264,0.6563,0.5158,0.6023,0.8702
"1511",130943,"UNIVERSITY OF DELAWARE",1,0,2001,"4770","473.703","1045","2939","3362",1944,1418,2147,"767",1380,0.7099,0.5409,0.6386,0.8742
"1512",130943,"UNIVERSITY OF DELAWARE",1,0,2002,"5070","509.917","1124","3256","3712",2222,1490,2282,"777",1505,0.6773,0.5215,0.6148,0.8772
"1513",130943,"UNIVERSITY OF DELAWARE",1,0,2003,"5890","514.103629","1116","3154","3794",2157,1637,2016,"761",1255,0.5818,0.4649,0.5314,0.8313
"1514",130943,"UNIVERSITY OF DELAWARE",1,0,2004,"6304","540.045285","1121","3170","3769",2173,1596,2131,"776",1355,0.6236,0.4862,0.5654,0.8411
"1515",130943,"University of Delaware",1,0,2005,"6614","578.911928","1077","3183","3830",2252,1578,2250,"803",1447,0.6425,0.5089,0.5875,0.8311
"1516",130943,"University of Delaware",1,0,2006,"6980","603.64744","1117","2907","3563",2127,1436,2175,"777",1398,0.6573,0.5411,0.6104,0.8159
"1517",130943,"University of Delaware",1,0,2007,"7340","639.637603","1117","3046","3912",2305,1607,2445,"879",1566,0.6794,0.547,0.625,0.7786
"1518",130943,"University of Delaware",1,0,2008,"7780","674.991354","1117","3028","3834",2211,1623,2378,"891",1487,0.6725,0.549,0.6202,0.7898
"1519",130943,"University of Delaware",1,0,2009,"8540","702.104681","1112","3261","4211",2424,1787,2486,"929",1557,0.6423,0.5199,0.5904,0.7744
"1520",130943,"University of Delaware",1,0,2010,"9040","738.021556","1126","2863","3719",2116,1603,2399,"913",1486,0.7023,0.5696,0.6451,0.7698
"1521",131159,"AMERICAN UNIVERSITY",1,0,1991,"13716","159.183","468","794","1027",633,394,622,"223",399,0.6303,0.566,0.6056,0.7731
"1522",131159,"AMERICAN UNIVERSITY",1,0,1992,"14594","169.135","452","786","1025",629,396,629,"235",394,0.6264,0.5934,0.6137,0.7668
"1523",131159,"AMERICAN UNIVERSITY",1,0,1993,"15386","176.246","446","805","1039",660,379,641,"219",422,0.6394,0.5778,0.6169,0.7748
"1524",131159,"AMERICAN UNIVERSITY",1,0,1995,"17115","190.096","441","964","1221",794,427,789,"288",501,0.631,0.6745,0.6462,0.7895
"1525",131159,"AMERICAN UNIVERSITY",1,0,1996,"17744","180.8096","452","799","1107",703,404,643,"224",419,0.596,0.5545,0.5808,0.7218
"1526",131159,"AMERICAN UNIVERSITY",1,0,1997,"18555","173.445","456","781","1056",665,391,678,"239",439,0.6602,0.6113,0.642,0.7396
"1527",131159,"AMERICAN UNIVERSITY",1,0,1998,"19433","186.721","457","919","1232",774,458,802,"262",540,0.6977,0.5721,0.651,0.7459
"1528",131159,"AMERICAN UNIVERSITY",1,0,1999,"20118","203.919","463","706","1146",744,402,723,"231",492,0.6613,0.5746,0.6309,0.6161
"1529",131159,"AMERICAN UNIVERSITY",1,0,2000,"21144","204.735","475","813","1272",821,451,818,"260",558,0.6797,0.5765,0.6431,0.6392
"1530",131159,"AMERICAN UNIVERSITY",1,0,2001,"22116","219.535","487","925","1387",875,512,924,"330",594,0.6789,0.6445,0.6662,0.6669
"1531",131159,"AMERICAN UNIVERSITY",1,0,2002,"23068","243.192","476","910","1303",811,492,917,"329",588,0.725,0.6687,0.7038,0.6984
"1532",131159,"AMERICAN UNIVERSITY",1,0,2003,"24452","262.941","492","835","1238",832,406,882,"286",596,0.7163,0.7044,0.7124,0.6745
"1533",131159,"AMERICAN UNIVERSITY",1,0,2004,"25920","275.704","490","811","1210",776,434,902,"306",596,0.768,0.7051,0.7455,0.6702
"1534",131159,"American University",1,0,2005,"27552","292.926","543","820","1216",778,438,898,"319",579,0.7442,0.7283,0.7385,0.6743
"1535",131159,"American University",1,0,2006,"29206","306.724","547","966","1385",923,462,1007,"321",686,0.7432,0.6948,0.7271,0.6975
"1536",131159,"American University",1,0,2007,"30958","323.304","568","850","1288",840,448,975,"334",641,0.7631,0.7455,0.757,0.6599
"1537",131159,"American University",1,0,2008,"32816","357.045","588","917","1570",967,603,1199,"442",757,0.7828,0.733,0.7637,0.5841
"1538",131159,"American University",1,0,2009,"34456","369.268","637","914","1527",917,610,1164,"449",715,0.7797,0.7361,0.7623,0.5986
"1539",131159,"American University",1,0,2010,"36180","406.717","681","935","1498",911,587,1145,"438",707,0.7761,0.7462,0.7644,0.6242
"1540",131283,"CATHOLIC UNIVERSITY OF AMERICA",1,0,1991,"11936","95.508327","386","428","532",308,224,309,"124",185,0.6006,0.5536,0.5808,0.8045
"1541",131283,"CATHOLIC UNIVERSITY OF AMERICA",1,0,1992,"12986","101.395719","389","380","471",252,219,272,"121",151,0.5992,0.5525,0.5775,0.8068
"1542",131283,"CATHOLIC UNIVERSITY OF AMERICA",1,0,1993,"13614","100.512002","380","418","505",276,229,306,"130",176,0.6377,0.5677,0.6059,0.8277
"1543",131283,"CATHOLIC UNIVERSITY OF AMERICA",1,0,1995,"15062","111.225676","357","408","514",265,249,290,"125",165,0.6226,0.502,0.5642,0.7938
"1544",131283,"CATHOLIC UNIVERSITY OF AMERICA",1,0,1996,"16152","115.749063","355","362","452",264,188,261,"100",161,0.6098,0.5319,0.5774,0.8009
"1545",131283,"CATHOLIC UNIVERSITY OF AMERICA",1,0,1997,"17110","104.300142","347","472","567",313,254,337,"148",189,0.6038,0.5827,0.5944,0.8325
"1546",131283,"CATHOLIC UNIVERSITY OF AMERICA",1,0,1998,"18066","108.415656","350","489","597",338,259,378,"149",229,0.6775,0.5753,0.6332,0.8191
"1547",131283,"CATHOLIC UNIVERSITY OF AMERICA",1,0,1999,"18200","118.18978","349","641","762",381,381,457,"204",253,0.664,0.5354,0.5997,0.8412
"1548",131283,"CATHOLIC UNIVERSITY OF AMERICA",1,0,2000,"19100","90.61575","354.5","406","530",298,232,315,"126",189,0.6342,0.5431,0.5943,0.766
"1549",131283,"CATHOLIC UNIVERSITY OF AMERICA",1,0,2001,"20050","125.972533","360","513","613",342,271,407,"170",237,0.693,0.6273,0.6639,0.8369
"1550",131283,"CATHOLIC UNIVERSITY OF AMERICA",1,0,2002,"21050","134.824305","359","550","700",406,294,438,"170",268,0.6601,0.5782,0.6257,0.7857
"1551",131283,"CATHOLIC UNIVERSITY OF AMERICA",1,0,2003,"22200","141.813545","336","506","646",362,284,423,"167",256,0.7072,0.588,0.6548,0.7833
"1552",131283,"CATHOLIC UNIVERSITY OF AMERICA",1,0,2004,"23600","154.839","354","545","719",387,332,429,"182",247,0.6382,0.5482,0.5967,0.758
"1553",131283,"Catholic University of America",1,0,2005,"24800","160.025","344","569","786",455,331,482,"187",295,0.6484,0.565,0.6132,0.7239
"1554",131283,"Catholic University of America",1,0,2006,"26200","165.236","344","608","856",459,397,527,"219",308,0.671,0.5516,0.6157,0.7103
"1555",131283,"Catholic University of America",1,0,2007,"27700","177.691","347","653","864",451,413,535,"233",302,0.6696,0.5642,0.6192,0.7558
"1556",131283,"Catholic University of America",1,0,2008,"30520","191.431","352","605","901",475,426,537,"234",303,0.6379,0.5493,0.596,0.6715
"1557",131283,"Catholic University of America",1,0,2009,"31740","194.316","368","542","813",456,357,501,"184",317,0.6952,0.5154,0.6162,0.6667
"1558",131283,"Catholic University of America",1,0,2010,"33580","202.389","385","666","991",576,415,613,"240",373,0.6476,0.5783,0.6186,0.672
"1559",131450,"GALLAUDET UNIVERSITY",1,0,1991,"3854","73.488546","266","149","227",129,98,15,"2",13,0.1008,0.0204,0.0661,0.6564
"1560",131450,"GALLAUDET UNIVERSITY",1,0,1992,"4194","75.441221","264","210","339",177,162,15,"6",9,0.0508,0.037,0.0442,0.6195
"1561",131450,"GALLAUDET UNIVERSITY",1,0,1993,"4570","79.054144","261","190","306",164,142,18,"6",12,0.0732,0.0423,0.0588,0.6209
"1562",131450,"GALLAUDET UNIVERSITY",1,0,1995,"6140","86.111985","244","137","225",120,105,10,"2",8,0.0667,0.019,0.0444,0.6089
"1563",131450,"GALLAUDET UNIVERSITY",1,0,1996,"6650","87.688446","225","113","186",105,81,13,"6",7,0.0667,0.0741,0.0699,0.6075
"1564",131450,"GALLAUDET UNIVERSITY",1,0,1997,"7043","84.508447","225","134","211",116,95,10,"3",7,0.0603,0.0316,0.0474,0.6351
"1565",131450,"GALLAUDET UNIVERSITY",1,0,1998,"7464","86.84098","221","125","230",112,118,17,"7",10,0.0893,0.0593,0.0739,0.5435
"1566",131450,"GALLAUDET UNIVERSITY",1,0,1999,"6870","90.235296","227","168","254",135,119,14,"6",8,0.0593,0.0504,0.0551,0.6614
"1567",131450,"GALLAUDET UNIVERSITY",1,0,2000,"7350","94.310997","225","142","241",123,118,16,"3",13,0.1057,0.0254,0.0664,0.5892
"1568",131450,"GALLAUDET UNIVERSITY",1,0,2001,"7870","96.727512","223","126","213",113,100,10,"3",7,0.0619,0.03,0.0469,0.5915
"1569",131450,"GALLAUDET UNIVERSITY",1,0,2002,"8420","106.925012","229","143","235",122,113,12,"6",6,0.0492,0.0531,0.0511,0.6085
"1570",131450,"GALLAUDET UNIVERSITY",1,0,2003,"9000","105.853054","230","144","236",124,112,25,"8",17,0.1371,0.0714,0.1059,0.6102
"1571",131450,"GALLAUDET UNIVERSITY",1,0,2004,"9630","107.836458","230","128","227",121,106,18,"8",10,0.0826,0.0755,0.0793,0.5639
"1572",131450,"Gallaudet University",1,0,2005,"9920","115.852149","235","176","280",151,129,28,"7",21,0.1391,0.0543,0.1,0.6286
"1573",131450,"Gallaudet University",1,0,2006,"10220","119.653942","227","146","209",96,113,15,"5",10,0.1042,0.0442,0.0718,0.6986
"1574",131450,"Gallaudet University",1,0,2007,"10220","123.553504","211","123","174",97,77,27,"9",18,0.1856,0.1169,0.1552,0.7069
"1575",131450,"Gallaudet University",1,0,2008,"10850","129.00714","200","111","179",97,82,29,"9",20,0.2062,0.1098,0.162,0.6201
"1576",131450,"Gallaudet University",1,0,2009,"10850","134.85567","201","141","211",112,99,51,"13",38,0.3393,0.1313,0.2417,0.6682
"1577",131450,"Gallaudet University",1,0,2010,"10850","135.636281","191","120","198",107,91,39,"10",29,0.271,0.1099,0.197,0.6061
"1578",131469,"GEORGE WASHINGTON UNIVERSITY",1,0,1991,"14902","522.1887","633","802","1151",622,529,686,"282",404,0.6495,0.5331,0.596,0.6968
"1579",131469,"GEORGE WASHINGTON UNIVERSITY",1,0,1992,"16080","578.24166","643","765","1193",642,551,695,"291",404,0.6293,0.5281,0.5826,0.6412
"1580",131469,"GEORGE WASHINGTON UNIVERSITY",1,0,1993,"16988","671.295592","637","983","1492",801,691,887,"373",514,0.6417,0.5398,0.5945,0.6588
"1581",131469,"GEORGE WASHINGTON UNIVERSITY",1,0,1995,"19032","778.990692","633","917","1367",803,564,905,"346",559,0.6961,0.6135,0.662,0.6708
"1582",131469,"GEORGE WASHINGTON UNIVERSITY",1,0,1996,"19980","767.369564","649","1081","1643",973,670,1082,"427",655,0.6732,0.6373,0.6586,0.6579
"1583",131469,"GEORGE WASHINGTON UNIVERSITY",1,0,1997,"21360","724.9783","670","1102","1716",972,744,1185,"485",700,0.7202,0.6519,0.6906,0.6422
"1584",131469,"GEORGE WASHINGTON UNIVERSITY",1,0,1998,"22625","669.005063","692","1182","1773",1057,716,1285,"471",814,0.7701,0.6578,0.7248,0.6667
"1585",131469,"GEORGE WASHINGTON UNIVERSITY",1,0,1999,"22925","697.857863","717","1427","2109",1282,827,1515,"556",959,0.748,0.6723,0.7183,0.6766
"1586",131469,"GEORGE WASHINGTON UNIVERSITY",1,0,2000,"24005","651.967","742","1426","2093",1241,852,1504,"574",930,0.7494,0.6737,0.7186,0.6813
"1587",131469,"GEORGE WASHINGTON UNIVERSITY",1,0,2001,"24880","554.647","767","1696","2566",1433,1133,1864,"761",1103,0.7697,0.6717,0.7264,0.661
"1588",131469,"GEORGE WASHINGTON UNIVERSITY",1,0,2002,"27790","608.002","890","1518","2283",1359,924,1735,"660",1075,0.791,0.7143,0.76,0.6649
"1589",131469,"GEORGE WASHINGTON UNIVERSITY",1,0,2003,"29320","639.937","862","1550","2260",1333,927,1726,"683",1043,0.7824,0.7368,0.7637,0.6858
"1590",131469,"GEORGE WASHINGTON UNIVERSITY",1,0,2004,"34000","671.814","859","1763","2623",1441,1182,1957,"830",1127,0.7821,0.7022,0.7461,0.6721
"1591",131469,"George Washington University",1,0,2005,"33992","718.34","841","1562","2408",1375,1033,1823,"732",1091,0.7935,0.7086,0.7571,0.6487
"1592",131469,"George Washington University",1,0,2006,"35604","776.728","854","1544","2440",1348,1092,1804,"756",1048,0.7774,0.6923,0.7393,0.6328
"1593",131469,"George Washington University",1,0,2007,"37000","821.815644","904","1275","2123",1198,925,1604,"668",936,0.7813,0.7222,0.7555,0.6006
"1594",131469,"George Washington University",1,0,2008,"38630","903.268295","910","1224","2449",1408,1041,1755,"687",1068,0.7585,0.6599,0.7166,0.4998
"1595",131469,"George Washington University",1,0,2009,"39962","953.345881","939","1437","2582",1435,1147,1940,"825",1115,0.777,0.7193,0.7514,0.5565
"1596",131469,"George Washington University",1,0,2010,"41182","986.274","983","1535","2376",1316,1060,1805,"761",1044,0.7933,0.7179,0.7597,0.646
"1597",131496,"GEORGETOWN UNIVERSITY",1,0,1991,"15652","645.2","499","964","1369",710,659,1133,"547",586,0.8254,0.83,0.8276,0.7042
"1598",131496,"GEORGETOWN UNIVERSITY",1,0,1992,"16589","717.625","514","945","1383",733,650,1179,"550",629,0.8581,0.8462,0.8525,0.6833
"1599",131496,"GEORGETOWN UNIVERSITY",1,0,1993,"17586","745.768","528","940","1377",720,657,1155,"551",604,0.8389,0.8387,0.8388,0.6826
"1600",131496,"GEORGETOWN UNIVERSITY",1,0,1995,"19402","822.65","553","973","1403",742,661,1207,"568",639,0.8612,0.8593,0.8603,0.6935
"1601",131496,"GEORGETOWN UNIVERSITY",1,0,1996,"20388","863.097","576","1020","1408",760,648,1256,"569",687,0.9039,0.8781,0.892,0.7244
"1602",131496,"GEORGETOWN UNIVERSITY",1,0,1997,"21405","837.388","616","978","1394",757,637,1247,"561",686,0.9062,0.8807,0.8945,0.7016
"1603",131496,"GEORGETOWN UNIVERSITY",1,0,1998,"22446","854.905","617","1036","1470",810,660,1302,"581",721,0.8901,0.8803,0.8857,0.7048
"1604",131496,"GEORGETOWN UNIVERSITY",1,0,1999,"23088","889.587","622","1028","1474",802,672,1299,"587",712,0.8878,0.8735,0.8813,0.6974
"1605",131496,"GEORGETOWN UNIVERSITY",1,0,2000,"23952","545.138","634","1064","1469",789,680,1327,"603",724,0.9176,0.8868,0.9033,0.7243
"1606",131496,"GEORGETOWN UNIVERSITY",1,0,2001,"25152","540.712","646","1066","1482",757,725,1339,"648",691,0.9128,0.8938,0.9035,0.7193
"1607",131496,"GEORGETOWN UNIVERSITY",1,0,2002,"26544","584.273361","746","1042","1477",795,682,1324,"608",716,0.9006,0.8915,0.8964,0.7055
"1608",131496,"GEORGETOWN UNIVERSITY",1,0,2003,"27864","639.27","780","970","1504",827,677,1321,"575",746,0.9021,0.8493,0.8783,0.6449
"1609",131496,"GEORGETOWN UNIVERSITY",1,0,2004,"29808","680.496","821","1055","1523",855,668,1358,"574",784,0.917,0.8593,0.8917,0.6927
"1610",131496,"Georgetown University",1,0,2005,"31656","711.847","836","1007","1530",774,756,1378,"669",709,0.916,0.8849,0.9007,0.6582
"1611",131496,"Georgetown University",1,0,2006,"33552","744.101","875","1047","1588",877,711,1419,"630",789,0.8997,0.8861,0.8936,0.6593
"1612",131496,"Georgetown University",1,0,2007,"35568","818.381","915","1083","1577",864,713,1387,"616",771,0.8924,0.864,0.8795,0.6867
"1613",131496,"Georgetown University",1,0,2008,"37536","890.08","943","1099","1571",822,749,1430,"665",765,0.9307,0.8879,0.9102,0.6996
"1614",131496,"Georgetown University",1,0,2009,"38616","937.521","980","1027","1550",861,689,1389,"601",788,0.9152,0.8723,0.8961,0.6626
"1615",131496,"Georgetown University",1,0,2010,"39768","974.494","966","1016","1569",859,710,1414,"623",791,0.9208,0.8775,0.9012,0.6475
"1616",131520,"HOWARD UNIVERSITY",1,0,1991,"6438","458.204544","820","3","1089",687,402,261,"64",197,0.2868,0.1592,0.2397,0.0028
"1617",131520,"HOWARD UNIVERSITY",1,0,1992,"6981","461.85769","825","3","1264",797,467,264,"70",194,0.2434,0.1499,0.2089,0.0024
"1618",131520,"HOWARD UNIVERSITY",1,0,1993,"7535","563.779917","891","0","1492",951,541,352,"88",264,0.2776,0.1627,0.2359,0
"1619",131520,"HOWARD UNIVERSITY",1,0,1995,"8105","605.034512","723","1","834",540,294,438,"117",321,0.5944,0.398,0.5252,0.0012
"1620",131520,"HOWARD UNIVERSITY",1,0,1996,"8725","551.302333","809","1","1002",648,354,463,"126",337,0.5201,0.3559,0.4621,0.001
"1621",131520,"HOWARD UNIVERSITY",1,0,1997,"8985","509.244147","873","3","1098",715,383,402,"98",304,0.4252,0.2559,0.3661,0.0027
"1622",131520,"HOWARD UNIVERSITY",1,0,1998,"9155","535.250342","849","0","1244",831,413,469,"103",366,0.4404,0.2494,0.377,0
"1623",131520,"HOWARD UNIVERSITY",1,0,1999,"8925","599.148295","865","2","937",632,305,405,"99",306,0.4842,0.3246,0.4322,0.0021
"1624",131520,"HOWARD UNIVERSITY",1,0,2000,"9190","635.548","922","6","1355",909,446,624,"145",479,0.527,0.3251,0.4605,0.0044
"1625",131520,"HOWARD UNIVERSITY",1,0,2001,"9515","642.609","979","0","1344",900,444,680,"185",495,0.55,0.4167,0.506,0
"1626",131520,"HOWARD UNIVERSITY",1,0,2002,"9515","657.273","810","2","1366",931,435,621,"125",496,0.5328,0.2874,0.4546,0.0015
"1627",131520,"HOWARD UNIVERSITY",1,0,2003,"10130","676.498","836","1","1446",992,454,679,"155",524,0.5282,0.3414,0.4696,7e-04
"1628",131520,"HOWARD UNIVERSITY",1,0,2004,"10840","716.631","842","2","1445",987,458,691,"151",540,0.5471,0.3297,0.4782,0.0014
"1629",131520,"Howard University",1,0,2005,"11490","726.605","859","3","1410",944,466,635,"166",469,0.4968,0.3562,0.4504,0.0021
"1630",131520,"Howard University",1,0,2006,"12180","737.797","1177","0","1512",1022,490,629,"155",474,0.4638,0.3163,0.416,0
"1631",131520,"Howard University",1,0,2007,"13215","793.362","1034","0","1451",1028,423,574,"129",445,0.4329,0.305,0.3956,0
"1632",131520,"Howard University",1,0,2008,"14205","834.328","807","0","1477",1004,473,629,"133",496,0.494,0.2812,0.4259,0
"1633",131520,"Howard University",1,0,2009,"15270","1051.876","955","0","1600",1097,503,633,"144",489,0.4458,0.2863,0.3956,0
"1634",131520,"Howard University",1,0,2010,"17100","903.5","676","0","1464",1034,430,571,"122",449,0.4342,0.2837,0.39,0
"1635",132471,"BARRY UNIVERSITY",1,0,1991,"9793","39.444381","188","122","301",179,122,85,"34",51,0.2849,0.2787,0.2824,0.4053
"1636",132471,"BARRY UNIVERSITY",1,0,1992,"10180","44.689633","195","129","265",146,119,80,"28",52,0.3562,0.2353,0.3019,0.4868
"1637",132471,"BARRY UNIVERSITY",1,0,1993,"11030","57.433438","215","111","232",143,89,77,"19",58,0.4056,0.2135,0.3319,0.4784
"1638",132471,"BARRY UNIVERSITY",1,0,1995,"12110","61.105119","245","71","177",103,74,46,"10",36,0.3495,0.1351,0.2599,0.4011
"1639",132471,"BARRY UNIVERSITY",1,0,1996,"12790","66.640852","238","70","177",101,76,40,"16",24,0.2376,0.2105,0.226,0.3955
"1640",132471,"BARRY UNIVERSITY",1,0,1997,"13460","55.773125","248","64","176",112,64,58,"18",40,0.3571,0.2812,0.3295,0.3636
"1641",132471,"BARRY UNIVERSITY",1,0,1998,"14790","65.228266","254","133","393",249,144,82,"20",62,0.249,0.1389,0.2087,0.3384
"1642",132471,"BARRY UNIVERSITY",1,0,1999,"15530","71.855426","267","123","398",251,147,9,"1",8,0.0319,0.0068,0.0226,0.309
"1643",132471,"BARRY UNIVERSITY",1,0,2000,"15530","85.930472","296.5","120","401",258,143,70,"18",52,0.2016,0.1259,0.1746,0.2993
"1644",132471,"BARRY UNIVERSITY",1,0,2001,"17500","94.248373","326","148","431",264,167,101,"32",69,0.2614,0.1916,0.2343,0.3434
"1645",132471,"BARRY UNIVERSITY",1,0,2002,"18900","108.609981","334","162","446",273,173,110,"34",76,0.2784,0.1965,0.2466,0.3632
"1646",132471,"BARRY UNIVERSITY",1,0,2003,"20320","116.246649","342","190","517",336,181,91,"33",58,0.1726,0.1823,0.176,0.3675
"1647",132471,"BARRY UNIVERSITY",1,0,2004,"21350","118.228736","353","160","553",349,204,101,"29",72,0.2063,0.1422,0.1826,0.2893
"1648",132471,"Barry University",1,0,2005,"22430","125.508712","357","209","563",356,207,117,"35",82,0.2303,0.1691,0.2078,0.3712
"1649",132471,"Barry University",1,0,2006,"24000","132.102308","340","96","387",255,132,82,"24",58,0.2275,0.1818,0.2119,0.2481
"1650",132471,"Barry University",1,0,2007,"24500","137.808492","315","117","472",316,156,102,"28",74,0.2342,0.1795,0.2161,0.2479
"1651",132471,"Barry University",1,0,2008,"25500","134.588154","325","111","584",400,184,120,"34",86,0.215,0.1848,0.2055,0.1901
"1652",132471,"Barry University",1,0,2009,"26400","139.035915","341","88","648",433,215,102,"25",77,0.1778,0.1163,0.1574,0.1358
"1653",132471,"Barry University",1,0,2010,"27200","146.715626","422","73","625",403,222,98,"32",66,0.1638,0.1441,0.1568,0.1168
"1654",132602,"BETHUNE COOKMAN COLLEGE",1,0,1991,"4835","27.451481","122","4","619",348,271,134,"25",109,0.3132,0.0923,0.2165,0.0065
"1655",132602,"BETHUNE COOKMAN COLLEGE",1,0,1992,"4965","30.730046","123","4","597",326,271,99,"29",70,0.2147,0.107,0.1658,0.0067
"1656",132602,"BETHUNE COOKMAN COLLEGE",1,0,1993,"5165","31.321708","125","4","543",291,252,100,"28",72,0.2474,0.1111,0.1842,0.0074
"1657",132602,"BETHUNE COOKMAN COLLEGE",1,0,1995,"6458","31.275504","126","1","729",393,336,106,"31",75,0.1908,0.0923,0.1454,0.0014
"1658",132602,"BETHUNE COOKMAN COLLEGE",1,0,1996,"6780","36.702346","128","0","575",322,253,93,"20",73,0.2267,0.0791,0.1617,0
"1659",132602,"BETHUNE COOKMAN COLLEGE",1,0,1997,"7280","28.062388","130","1","749",388,361,77,"25",52,0.134,0.0693,0.1028,0.0013
"1660",132602,"BETHUNE COOKMAN COLLEGE",1,0,1998,"8047","35.05529","133","10","623",316,307,97,"24",73,0.231,0.0782,0.1557,0.0161
"1661",132602,"BETHUNE COOKMAN COLLEGE",1,0,1999,"8560","36.077863","132","5","677",360,317,134,"36",98,0.2722,0.1136,0.1979,0.0074
"1662",132602,"BETHUNE COOKMAN COLLEGE",1,0,2000,"8988","37.868112","135","7","833",478,355,105,"26",79,0.1653,0.0732,0.1261,0.0084
"1663",132602,"BETHUNE COOKMAN COLLEGE",1,0,2001,"9617","42.452761","138","13","720",386,334,91,"31",60,0.1554,0.0928,0.1264,0.0181
"1664",132602,"BETHUNE COOKMAN COLLEGE",1,0,2002,"9810","43.459963","136","10","607",351,256,161,"59",102,0.2906,0.2305,0.2652,0.0165
"1665",132602,"BETHUNE COOKMAN COLLEGE",1,0,2003,"10106","45.020787","141","7","827",492,335,112,"24",88,0.1789,0.0716,0.1354,0.0085
"1666",132602,"BETHUNE COOKMAN COLLEGE",1,0,2004,"10610","48.25973","150","5","818",503,315,118,"29",89,0.1769,0.0921,0.1443,0.0061
"1667",132602,"Bethune Cookman College",1,0,2005,"11140","49.287771","147","9","913",525,388,140,"52",88,0.1676,0.134,0.1533,0.0099
"1668",132602,"Bethune Cookman College",1,0,2006,"11792","50.060341","161","12","901",497,404,142,"64",78,0.1569,0.1584,0.1576,0.0133
"1669",132602,"Bethune-Cookman University",1,0,2007,"12382","54.839892","162","5","821",511,310,136,"44",92,0.18,0.1419,0.1657,0.0061
"1670",132602,"Bethune-Cookman University",1,0,2008,"12876","57.628416","204","6","719",478,241,198,"38",160,0.3347,0.1577,0.2754,0.0083
"1671",132602,"Bethune-Cookman University",1,0,2009,"12936","63.393489","202","6","917",551,366,233,"76",157,0.2849,0.2077,0.2541,0.0065
"1672",132602,"Bethune-Cookman University",1,0,2010,"13452","60.938667","197","9","924",579,345,132,"32",100,0.1727,0.0928,0.1429,0.0097
"1673",132903,"UNIVERSITY OF CENTRAL FLORIDA",1,0,1991,"1523","148.62821","597","1026","1577",813,764,332,"89",243,0.2989,0.1165,0.2105,0.6506
"1674",132903,"UNIVERSITY OF CENTRAL FLORIDA",1,0,1992,"1713","151.508648","585","995","1405",745,660,330,"92",238,0.3195,0.1394,0.2349,0.7082
"1675",132903,"UNIVERSITY OF CENTRAL FLORIDA",1,0,1993,"1756","158.277754","593","1365","1882",955,927,432,"144",288,0.3016,0.1553,0.2295,0.7253
"1676",132903,"UNIVERSITY OF CENTRAL FLORIDA",1,0,1995,"1840","187.902863","566","1900","2411",1295,1116,661,"217",444,0.3429,0.1944,0.2742,0.7881
"1677",132903,"UNIVERSITY OF CENTRAL FLORIDA",1,0,1996,"1924","202.769647","685","1966","2579",1316,1263,672,"219",453,0.3442,0.1734,0.2606,0.7623
"1678",132903,"UNIVERSITY OF CENTRAL FLORIDA",1,0,1997,"2024","219.510899","662","2171","2839",1510,1329,785,"265",520,0.3444,0.1994,0.2765,0.7647
"1679",132903,"UNIVERSITY OF CENTRAL FLORIDA",1,0,1998,"2121","255.098347","777","2959","3792",1932,1860,1097,"387",710,0.3675,0.2081,0.2893,0.7803
"1680",132903,"UNIVERSITY OF CENTRAL FLORIDA",1,0,1999,"2296","286.61689","874","3177","4267",2256,2011,1298,"425",873,0.387,0.2113,0.3042,0.7446
"1681",132903,"UNIVERSITY OF CENTRAL FLORIDA",1,0,2000,"1554","310.136223","903","3329","4558",2436,2122,1384,"436",948,0.3892,0.2055,0.3036,0.7304
"1682",132903,"UNIVERSITY OF CENTRAL FLORIDA",1,0,2001,"1670","364.083698","932","3537","4913",2621,2292,1529,"529",1000,0.3815,0.2308,0.3112,0.7199
"1683",132903,"UNIVERSITY OF CENTRAL FLORIDA",1,0,2002,"1753","359.140562","1004","3824","5330",2851,2479,1736,"578",1158,0.4062,0.2332,0.3257,0.7174
"1684",132903,"UNIVERSITY OF CENTRAL FLORIDA",1,0,2003,"1902","434.622144","1068","3910","5653",2956,2697,1923,"673",1250,0.4229,0.2495,0.3402,0.6917
"1685",132903,"UNIVERSITY OF CENTRAL FLORIDA",1,0,2004,"2045","482.210908","1120","4020","5710",3041,2669,1986,"723",1263,0.4153,0.2709,0.3478,0.704
"1686",132903,"University of Central Florida",1,0,2005,"2147","529.373343","1134","4096","6041",3216,2825,2025,"720",1305,0.4058,0.2549,0.3352,0.678
"1687",132903,"University of Central Florida",1,0,2006,"2211","574.74022","1168","4542","6389",3389,3000,2257,"754",1503,0.4435,0.2513,0.3533,0.7109
"1688",132903,"University of Central Florida",1,0,2007,"2211","624.994652","1158","4398","6350",3310,3040,2277,"827",1450,0.4381,0.272,0.3586,0.6926
"1689",132903,"University of Central Florida",1,0,2008,"2531","661.810938","1139","4150","6139",3283,2856,2464,"867",1597,0.4864,0.3036,0.4014,0.676
"1690",132903,"University of Central Florida",1,0,2009,"2910","695.121732","1097","4258","6251",3342,2909,2529,"868",1661,0.497,0.2984,0.4046,0.6812
"1691",132903,"University of Central Florida",1,0,2010,"3347","711.086355","1122","3805","6028",3179,2849,2407,"859",1548,0.4869,0.3015,0.3993,0.6312
"1692",133492,"ECKERD COLLEGE",1,0,1991,"12900","29.2314","84","278","336",187,149,186,"80",106,0.5668,0.5369,0.5536,0.8274
"1693",133492,"ECKERD COLLEGE",1,0,1992,"13725","32.1892","86","279","348",182,166,187,"92",95,0.522,0.5542,0.5374,0.8017
"1694",133492,"ECKERD COLLEGE",1,0,1993,"14770","36.5442","87","303","364",185,179,201,"103",98,0.5297,0.5754,0.5522,0.8324
"1695",133492,"ECKERD COLLEGE",1,0,1995,"15975","38.6276","92","278","334",184,150,199,"83",116,0.6304,0.5533,0.5958,0.8323
"1696",133492,"ECKERD COLLEGE",1,0,1996,"16625","39.4907","92","341","429",260,169,242,"84",158,0.6077,0.497,0.5641,0.7949
"1697",133492,"ECKERD COLLEGE",1,0,1997,"17130","34.5735","96","310","386",230,156,230,"88",142,0.6174,0.5641,0.5959,0.8031
"1698",133492,"ECKERD COLLEGE",1,0,1998,"17685","38.2242","91","330","407",227,180,234,"99",135,0.5947,0.55,0.5749,0.8108
"1699",133492,"ECKERD COLLEGE",1,0,1999,"18025","40.1158","96","326","403",210,193,232,"101",131,0.6238,0.5233,0.5757,0.8089
"1700",133492,"ECKERD COLLEGE",1,0,2000,"18565","44.2505","96.5","315","408",223,185,215,"95",120,0.5381,0.5135,0.527,0.7721
"1701",133492,"ECKERD COLLEGE",1,0,2001,"19870","45.060183","97","345","424",241,183,225,"83",142,0.5892,0.4536,0.5307,0.8137
"1702",133492,"ECKERD COLLEGE",1,0,2002,"21262","45.427818","94","332","442",239,203,261,"117",144,0.6025,0.5764,0.5905,0.7511
"1703",133492,"ECKERD COLLEGE",1,0,2003,"22538","46.754664","103","338","434",248,186,250,"101",149,0.6008,0.543,0.576,0.7788
"1704",133492,"ECKERD COLLEGE",1,0,2004,"24116","49.623376","106","372","471",272,199,297,"119",178,0.6544,0.598,0.6306,0.7898
"1705",133492,"Eckerd College",1,0,2005,"25804","55.41758","112","408","501",297,204,275,"102",173,0.5825,0.5,0.5489,0.8144
"1706",133492,"Eckerd College",1,0,2006,"27352","58.152811","114","447","544",315,229,308,"113",195,0.619,0.4934,0.5662,0.8217
"1707",133492,"Eckerd College",1,0,2007,"28860","62.188144","113","432","535",319,216,315,"127",188,0.5893,0.588,0.5888,0.8075
"1708",133492,"Eckerd College",1,0,2008,"30304","64.533369","112","385","487",285,202,283,"116",167,0.586,0.5743,0.5811,0.7906
"1709",133492,"Eckerd College",1,0,2009,"31818","63.633304","115","413","504",300,204,301,"122",179,0.5967,0.598,0.5972,0.8194
"1710",133492,"Eckerd College",1,0,2010,"32932","63.524219","114","384","496",300,196,304,"117",187,0.6233,0.5969,0.6129,0.7742
"1711",133553,"EMBRY-RIDDLE AERONAUTICAL UNIVERSITY",1,0,1991,"6310","86.648269","312","730","875",134,741,190,"158",32,0.2388,0.2132,0.2171,0.8343
"1712",133553,"EMBRY-RIDDLE AERONAUTICAL UNIVERSITY",1,0,1992,"6810","93.150731","311","691","801",132,669,190,"149",41,0.3106,0.2227,0.2372,0.8627
"1713",133553,"EMBRY-RIDDLE AERONAUTICAL UNIVERSITY",1,0,1993,"7370","95.802626","299","688","799",128,671,154,"122",32,0.25,0.1818,0.1927,0.8611
"1714",133553,"EMBRY-RIDDLE AERONAUTICAL UNIVERSITY",1,0,1995,"8280","98.554063","274","498","665",100,565,128,"105",23,0.23,0.1858,0.1925,0.7489
"1715",133553,"EMBRY-RIDDLE AERONAUTICAL UNIVERSITY",1,0,1996,"8740","104.659523","252","476","711",95,616,132,"119",13,0.1368,0.1932,0.1857,0.6695
"1716",133553,"EMBRY-RIDDLE AERONAUTICAL UNIVERSITY",1,0,1997,"9230","104.159","248","689","1020",136,884,213,"184",29,0.2132,0.2081,0.2088,0.6755
"1717",133553,"EMBRY-RIDDLE AERONAUTICAL UNIVERSITY",1,0,1998,"9920","113.799","247","644","934",128,806,279,"230",49,0.3828,0.2854,0.2987,0.6895
"1718",133553,"EMBRY RIDDLE AERONAUTICAL UNIVERSITY",1,0,1999,"10100","122.652","247","685","939",151,788,305,"245",60,0.3974,0.3109,0.3248,0.7295
"1719",133553,"EMBRY RIDDLE AERONAUTICAL UNIVERSITY",1,0,2000,"14500","136.639","208.5","603","797",124,673,280,"225",55,0.4435,0.3343,0.3513,0.7566
"1720",133553,"EMBRY RIDDLE AERONAUTICAL UNIVERSITY-DAYTONA BEACH",1,0,2001,"15370","154.991","170","753","1013",159,854,338,"277",61,0.3836,0.3244,0.3337,0.7433
"1721",133553,"EMBRY RIDDLE AERONAUTICAL UNIVERSITY-DAYTONA BEACH",1,0,2002,"17850","170.053","183","633","872",148,724,315,"244",71,0.4797,0.337,0.3612,0.7259
"1722",133553,"EMBRY RIDDLE AERONAUTICAL UNIVERSITY-DAYTONA BEACH",1,0,2003,"20700","188.076","183","687","1012",164,848,292,"238",54,0.3293,0.2807,0.2885,0.6789
"1723",133553,"EMBRY RIDDLE AERONAUTICAL UNIVERSITY-DAYTONA BEACH",1,0,2004,"21530","206.417","187","646","933",139,794,282,"231",51,0.3669,0.2909,0.3023,0.6924
"1724",133553,"Embry Riddle Aeronautical University-Daytona Beach",1,0,2005,"22820","217.057","191","656","975",152,823,307,"246",61,0.4013,0.2989,0.3149,0.6728
"1725",133553,"Embry Riddle Aeronautical University-Daytona Beach",1,0,2006,"24420","234.425","198","713","1101",161,940,363,"290",73,0.4534,0.3085,0.3297,0.6476
"1726",133553,"Embry Riddle Aeronautical University-Daytona Beach",1,0,2007,"25400","240.198","210","650","1014",158,856,341,"277",64,0.4051,0.3236,0.3363,0.641
"1727",133553,"Embry Riddle Aeronautical University-Daytona Beach",1,0,2008,"26420","250.665","214","667","1058",158,900,325,"263",62,0.3924,0.2922,0.3072,0.6304
"1728",133553,"Embry Riddle Aeronautical University-Daytona Beach",1,0,2009,"27480","265.454","211","476","853",134,719,265,"203",62,0.4627,0.2823,0.3107,0.558
"1729",133553,"Embry Riddle Aeronautical University-Daytona Beach",1,0,2010,"28560","260.447","222","574","949",120,829,283,"239",44,0.3667,0.2883,0.2982,0.6048
"1730",133650,"FLORIDA AGRICULTURAL AND MECHANICAL UNIVERSITY",1,0,1991,"1545","94.541167","400","8","1608",945,663,188,"36",152,0.1608,0.0543,0.1169,0.005
"1731",133650,"FLORIDA AGRICULTURAL AND MECHANICAL UNIVERSITY",1,0,1992,"1749","102.597023","355","18","1383",815,568,206,"60",146,0.1791,0.1056,0.149,0.013
"1732",133650,"FLORIDA AGRICULTURAL AND MECHANICAL UNIVERSITY",1,0,1993,"1829","110.952098","364","15","1507",908,599,210,"46",164,0.1806,0.0768,0.1393,0.01
"1733",133650,"FLORIDA AGRICULTURAL AND MECHANICAL UNIVERSITY",1,0,1995,"1848","135.948437","443","9","1574",952,622,245,"63",182,0.1912,0.1013,0.1557,0.0057
"1734",133650,"FLORIDA AGRICULTURAL AND MECHANICAL UNIVERSITY",1,0,1996,"1863","150.395571","446","16","1717",1017,700,281,"83",198,0.1947,0.1186,0.1637,0.0093
"1735",133650,"FLORIDA AGRICULTURAL AND MECHANICAL UNIVERSITY",1,0,1997,"1970","189.715364","482","15","1947",1148,799,328,"84",244,0.2125,0.1051,0.1685,0.0077
"1736",133650,"FLORIDA AGRICULTURAL AND MECHANICAL UNIVERSITY",1,0,1998,"2133","169.815703","435","7","2213",1294,919,385,"120",265,0.2048,0.1306,0.174,0.0032
"1737",133650,"FLORIDA AGRICULTURAL AND MECHANICAL UNIVERSITY",1,0,1999,"2325","191.754963","442","13","2205",1277,928,360,"86",274,0.2146,0.0927,0.1633,0.0059
"1738",133650,"FLORIDA AGRICULTURAL AND MECHANICAL UNIVERSITY",1,0,2000,"1554","199.9037","465","17","2145",1263,882,415,"99",316,0.2502,0.1122,0.1935,0.0079
"1739",133650,"FLORIDA AGRICULTURAL AND MECHANICAL UNIVERSITY",1,0,2001,"1670","215.531405","488","15","2243",1300,943,368,"88",280,0.2154,0.0933,0.1641,0.0067
"1740",133650,"FLORIDA AGRICULTURAL AND MECHANICAL UNIVERSITY",1,0,2002,"1754","206.904316","490","14","2097",1249,848,280,"77",203,0.1625,0.0908,0.1335,0.0067
"1741",133650,"FLORIDA AGRICULTURAL AND MECHANICAL UNIVERSITY",1,0,2003,"1902","230.739","518","20","2403",1391,1012,289,"79",210,0.151,0.0781,0.1203,0.0083
"1742",133650,"FLORIDA AGRICULTURAL AND MECHANICAL UNIVERSITY",1,0,2004,"2045","263.98403","548","49","2105",1242,863,268,"73",195,0.157,0.0846,0.1273,0.0233
"1743",133650,"Florida Agricultural and Mechanical University",1,0,2005,"2148","270.573399","673","19","1636",925,711,183,"61",122,0.1319,0.0858,0.1119,0.0116
"1744",133650,"Florida Agricultural and Mechanical University",1,0,2006,"2211","270.401329","658","27","1614",925,689,156,"36",120,0.1297,0.0522,0.0967,0.0167
"1745",133650,"Florida Agricultural and Mechanical University",1,0,2007,"2211","267.848349","617","21","1853",1071,782,217,"74",143,0.1335,0.0946,0.1171,0.0113
"1746",133650,"Florida Agricultural and Mechanical University",1,0,2008,"2461","272.76917","637","31","2090",1196,894,254,"79",175,0.1463,0.0884,0.1215,0.0148
"1747",133650,"Florida Agricultural and Mechanical University",1,0,2009,"2658","281.217819","623","23","2348",1421,927,267,"88",179,0.126,0.0949,0.1137,0.0098
"1748",133650,"Florida Agricultural and Mechanical University",1,0,2010,"2870","284.306213","614","45","2701",1636,1065,331,"94",237,0.1449,0.0883,0.1225,0.0167
"1749",133669,"FLORIDA ATLANTIC UNIVERSITY",1,0,1991,"1350","112.311883","464","483","651",358,293,93,"29",64,0.1788,0.099,0.1429,0.7419
"1750",133669,"FLORIDA ATLANTIC UNIVERSITY",1,0,1992,"1733","116.033074","530","607","795",417,378,115,"43",72,0.1727,0.1138,0.1447,0.7635
"1751",133669,"FLORIDA ATLANTIC UNIVERSITY",1,0,1993,"1791","124.391519","528","530","743",412,331,104,"34",70,0.1699,0.1027,0.14,0.7133
"1752",133669,"FLORIDA ATLANTIC UNIVERSITY",1,0,1995,"1446","136.502085","535","581","901",504,397,162,"51",111,0.2202,0.1285,0.1798,0.6448
"1753",133669,"FLORIDA ATLANTIC UNIVERSITY",1,0,1996,"1512","163.542156","538","693","1001",551,450,155,"57",98,0.1779,0.1267,0.1548,0.6923
"1754",133669,"FLORIDA ATLANTIC UNIVERSITY-BOCA RATON",1,0,1997,"1618","186.772567","575","777","1174",669,505,161,"54",107,0.1599,0.1069,0.1371,0.6618
"1755",133669,"FLORIDA ATLANTIC UNIVERSITY-BOCA RATON",1,0,1998,"1695","208.496801","618","847","1309",773,536,196,"56",140,0.1811,0.1045,0.1497,0.6471
"1756",133669,"FLORIDA ATLANTIC UNIVERSITY-BOCA RATON",1,0,1999,"2253","237.761107","657","928","1423",860,563,201,"56",145,0.1686,0.0995,0.1413,0.6521
"1757",133669,"FLORIDA ATLANTIC UNIVERSITY-BOCA RATON",1,0,2000,"1554","246.1541","669","1179","1818",988,830,254,"89",165,0.167,0.1072,0.1397,0.6485
"1758",133669,"FLORIDA ATLANTIC UNIVERSITY-BOCA RATON",1,0,2001,"1670","270.488842","681","1211","1937",1120,817,292,"85",207,0.1848,0.104,0.1507,0.6252
"1759",133669,"FLORIDA ATLANTIC UNIVERSITY-BOCA RATON",1,0,2002,"1402","291.23382","689","1229","1994",1102,892,323,"115",208,0.1887,0.1289,0.162,0.6163
"1760",133669,"FLORIDA ATLANTIC UNIVERSITY-BOCA RATON",1,0,2003,"1522","320.757203","731","1268","2038",1143,895,335,"109",226,0.1977,0.1218,0.1644,0.6222
"1761",133669,"FLORIDA ATLANTIC UNIVERSITY-BOCA RATON",1,0,2004,"1636","343.691979","740","1397","2278",1231,1047,364,"122",242,0.1966,0.1165,0.1598,0.6133
"1762",133669,"Florida Atlantic University",1,0,2005,"1717","399.393389","767","1324","2080",1111,969,363,"126",237,0.2133,0.13,0.1745,0.6365
"1763",133669,"Florida Atlantic University",1,0,2006,"1769","358.391623","777","1328","2193",1208,985,339,"115",224,0.1854,0.1168,0.1546,0.6056
"1764",133669,"Florida Atlantic University",1,0,2007,"1769","364.266868","797","1482","2563",1326,1237,388,"150",238,0.1795,0.1213,0.1514,0.5782
"1765",133669,"Florida Atlantic University",1,0,2008,"1968","394.77435","788","1533","2677",1407,1270,457,"149",308,0.2189,0.1173,0.1707,0.5727
"1766",133669,"Florida Atlantic University",1,0,2009,"2126","402.663152","779","1418","2447",1314,1133,487,"156",331,0.2519,0.1377,0.199,0.5795
"1767",133669,"Florida Atlantic University",1,0,2010,"2296","416.626339","774","1425","2616",1359,1257,501,"169",332,0.2443,0.1344,0.1915,0.5447
"1768",133711,"FLAGLER COLLEGE",1,0,1991,"4550","9.924229","59","273","290",169,121,133,"50",83,0.4911,0.4132,0.4586,0.9414
"1769",133711,"FLAGLER COLLEGE",1,0,1992,"4710","10.485905","74","273","299",169,130,125,"43",82,0.4852,0.3308,0.4181,0.913
"1770",133711,"FLAGLER COLLEGE",1,0,1993,"4920","9.491341","44","309","338",193,145,147,"59",88,0.456,0.4069,0.4349,0.9142
"1771",133711,"FLAGLER COLLEGE",1,0,1995,"5375","12.412258","51","334","355",217,138,143,"45",98,0.4516,0.3261,0.4028,0.9408
"1772",133711,"FLAGLER COLLEGE",1,0,1996,"5530","12.795854","52","334","355",217,138,143,"45",98,0.4516,0.3261,0.4028,0.9408
"1773",133711,"FLAGLER COLLEGE",1,0,1997,"5760","14.513937","53","403","424",272,152,176,"55",121,0.4449,0.3618,0.4151,0.9505
"1774",133711,"FLAGLER COLLEGE",1,0,1998,"5950","14.863592","59","391","418",285,133,182,"58",124,0.4351,0.4361,0.4354,0.9354
"1775",133711,"FLAGLER COLLEGE",1,0,1999,"6130","16.140968","60","394","419",267,152,186,"61",125,0.4682,0.4013,0.4439,0.9403
"1776",133711,"FLAGLER COLLEGE",1,0,2000,"6320","18.287966","62","453","496",315,181,206,"72",134,0.4254,0.3978,0.4153,0.9133
"1777",133711,"FLAGLER COLLEGE",1,0,2001,"6550","21.236217","64","377","407",253,154,185,"59",126,0.498,0.3831,0.4545,0.9263
"1778",133711,"FLAGLER COLLEGE",1,0,2002,"6870","23.42346","73","441","481",308,173,231,"70",161,0.5227,0.4046,0.4802,0.9168
"1779",133711,"FLAGLER COLLEGE",1,0,2003,"7410","25.017525","79","495","556",318,238,220,"84",136,0.4277,0.3529,0.3957,0.8903
"1780",133711,"FLAGLER COLLEGE",1,0,2004,"8000","27.103093","69","454","500",296,204,250,"98",152,0.5135,0.4804,0.5,0.908
"1781",133711,"Flagler College",1,0,2005,"8600","26.667664","73","426","459",283,176,216,"77",139,0.4912,0.4375,0.4706,0.9281
"1782",133711,"Flagler College",1,0,2006,"9450","30.507675","76","208","463",284,179,235,"77",158,0.5563,0.4302,0.5076,0.4492
"1783",133711,"Flagler College",1,0,2007,"11810","34.366384","87","290","531",333,198,246,"85",161,0.4835,0.4293,0.4633,0.5461
"1784",133711,"Flagler College",1,0,2008,"12520","41.942325","91","550","645",365,280,312,"116",196,0.537,0.4143,0.4837,0.8527
"1785",133711,"Flagler College",1,0,2009,"13300","45.954558","94","480","564",337,227,281,"94",187,0.5549,0.4141,0.4982,0.8511
"1786",133711,"Flagler College-St Augustine",1,0,2010,"13860","48.494465","96","490","612",347,265,281,"98",183,0.5274,0.3698,0.4592,0.8007
"1787",133881,"FLORIDA INSTITUTE OF TECHNOLOGY",0,1,1991,"10752","49.743997","232","256","350",78,272,98,"67",31,0.3974,0.2463,0.28,0.7314
"1788",133881,"FLORIDA INSTITUTE OF TECHNOLOGY",0,1,1992,"11817","52.821214","224","321","457",121,336,147,"99",48,0.3967,0.2946,0.3217,0.7024
"1789",133881,"FLORIDA INSTITUTE OF TECHNOLOGY",1,0,1993,"13035","57.751728","232","247","358",109,249,93,"65",28,0.2569,0.261,0.2598,0.6899
"1790",133881,"FLORIDA INSTITUTE OF TECHNOLOGY",1,0,1995,"14111","60.248108","171","237","370",111,259,113,"70",43,0.3874,0.2703,0.3054,0.6405
"1791",133881,"FLORIDA INSTITUTE OF TECHNOLOGY",1,0,1996,"15060","62.405159","177","314","491",149,342,171,"101",70,0.4698,0.2953,0.3483,0.6395
"1792",133881,"FLORIDA INSTITUTE OF TECHNOLOGY-MELBOURNE",1,0,1997,"15510","59.386221","168","216","367",112,255,128,"84",44,0.3929,0.3294,0.3488,0.5886
"1793",133881,"FLORIDA INSTITUTE OF TECHNOLOGY-MELBOURNE",1,0,1998,"16500","53.660441","170","307","461",145,316,173,"108",65,0.4483,0.3418,0.3753,0.6659
"1794",133881,"FLORIDA INSTITUTE OF TECHNOLOGY-MELBOURNE",1,0,1999,"17300","54.416983","171","259","402",116,286,139,"95",44,0.3793,0.3322,0.3458,0.6443
"1795",133881,"FLORIDA INSTITUTE OF TECHNOLOGY-MELBOURNE",1,0,2000,"18450","58.889125","179.5","355","531",156,375,214,"145",69,0.4423,0.3867,0.403,0.6685
"1796",133881,"FLORIDA INSTITUTE OF TECHNOLOGY-MELBOURNE",1,0,2001,"19700","81.020339","188","332","544",153,391,203,"128",75,0.4902,0.3274,0.3732,0.6103
"1797",133881,"FLORIDA INSTITUTE OF TECHNOLOGY-MELBOURNE",1,0,2002,"20900","88.049971","202","306","518",139,379,218,"142",76,0.5468,0.3747,0.4208,0.5907
"1798",133881,"FLORIDA INSTITUTE OF TECHNOLOGY-MELBOURNE",1,0,2003,"22600","93.358965","218","326","549",174,375,219,"136",83,0.477,0.3627,0.3989,0.5938
"1799",133881,"FLORIDA INSTITUTE OF TECHNOLOGY-MELBOURNE",1,0,2004,"23730","93.698474","216","337","551",181,370,218,"132",86,0.4751,0.3568,0.3956,0.6116
"1800",133881,"Florida Institute of Technology-Melbourne",1,0,2005,"25150","105.17125","210","394","603",154,449,242,"172",70,0.4545,0.3831,0.4013,0.6534
"1801",133881,"Florida Institute of Technology",1,0,2006,"27540","90.184336","213","280","597",160,437,222,"144",78,0.4875,0.3295,0.3719,0.469
"1802",133881,"Florida Institute of Technology",1,0,2007,"28920","94.085294","226","305","675",186,489,261,"170",91,0.4892,0.3476,0.3867,0.4519
"1803",133881,"Florida Institute of Technology",1,0,2008,"29940","102.877319","232","384","635",194,441,247,"152",95,0.4897,0.3447,0.389,0.6047
"1804",133881,"Florida Institute of Technology",1,0,2009,"31020","115.339646","240","304","538",145,393,222,"144",78,0.5379,0.3664,0.4126,0.5651
"1805",133881,"Florida Institute of Technology",1,0,2010,"31734","125.400988","238","298","489",138,351,220,"142",78,0.5652,0.4046,0.4499,0.6094
"1806",133951,"FLORIDA INTERNATIONAL UNIVERSITY",1,0,1991,"1478","141.265096","782","242","1021",600,421,198,"62",136,0.2267,0.1473,0.1939,0.237
"1807",133951,"FLORIDA INTERNATIONAL UNIVERSITY",1,0,1992,"1701","146.086956","758","266","1124",625,499,197,"64",133,0.2128,0.1283,0.1753,0.2367
"1808",133951,"FLORIDA INTERNATIONAL UNIVERSITY",1,0,1993,"1757","163.429754","767","223","1306",751,555,216,"65",151,0.2011,0.1171,0.1654,0.1708
"1809",133951,"FLORIDA INTERNATIONAL UNIVERSITY",1,0,1995,"1791","194.301454","806","324","1752",1003,749,270,"74",196,0.1954,0.0988,0.1541,0.1849
"1810",133951,"FLORIDA INTERNATIONAL UNIVERSITY",1,0,1996,"1875","214.890568","813","298","1846",1067,779,314,"87",227,0.2127,0.1117,0.1701,0.1614
"1811",133951,"FLORIDA INTERNATIONAL UNIVERSITY",1,0,1997,"2035","238.101745","831","371","1987",1144,843,352,"91",261,0.2281,0.1079,0.1772,0.1867
"1812",133951,"FLORIDA INTERNATIONAL UNIVERSITY",1,0,1998,"2154","266.211766","864","423","2227",1298,929,430,"117",313,0.2411,0.1259,0.1931,0.1899
"1813",133951,"FLORIDA INTERNATIONAL UNIVERSITY",1,0,1999,"2272","290.073995","863","451","2482",1460,1022,525,"141",384,0.263,0.138,0.2115,0.1817
"1814",133951,"FLORIDA INTERNATIONAL UNIVERSITY",1,0,2000,"1554","311.314151","827.5","523","2582",1511,1071,507,"148",359,0.2376,0.1382,0.1964,0.2026
"1815",133951,"FLORIDA INTERNATIONAL UNIVERSITY",1,0,2001,"1670","354.523168","792","490","2457",1364,1093,527,"145",382,0.2801,0.1327,0.2145,0.1994
"1816",133951,"FLORIDA INTERNATIONAL UNIVERSITY",1,0,2002,"1754","385.7671","714","535","2801",1617,1184,566,"176",390,0.2412,0.1486,0.2021,0.191
"1817",133951,"FLORIDA INTERNATIONAL UNIVERSITY",1,0,2003,"1902","411.724271","745","570","3038",1756,1282,597,"185",412,0.2346,0.1443,0.1965,0.1876
"1818",133951,"FLORIDA INTERNATIONAL UNIVERSITY",1,0,2004,"2045","443.419642","769","551","3370",1906,1464,647,"198",449,0.2356,0.1352,0.192,0.1635
"1819",133951,"Florida International University",1,0,2005,"2147","465.435","757","641","3967",2261,1706,634,"188",446,0.1973,0.1102,0.1598,0.1616
"1820",133951,"Florida International University",1,0,2006,"2211","506.644879","759","626","3889",2099,1790,736,"243",493,0.2349,0.1358,0.1893,0.161
"1821",133951,"Florida International University",1,0,2007,"2211","532.179535","852","512","3230",1707,1523,661,"209",452,0.2648,0.1372,0.2046,0.1585
"1822",133951,"Florida International University",1,0,2008,"2565","571.39945","854","459","3106",1642,1464,732,"234",498,0.3033,0.1598,0.2357,0.1478
"1823",133951,"Florida International University",1,0,2009,"2864","599.354536","871","403","2946",1615,1331,828,"278",550,0.3406,0.2089,0.2811,0.1368
"1824",133951,"Florida International University",1,0,2010,"3200","631.006253","857","424","3752",2079,1673,931,"280",651,0.3131,0.1674,0.2481,0.113
"1825",134079,"FLORIDA SOUTHERN COLLEGE",1,0,1991,"6080","24.49916","99","346","378",210,168,147,"53",94,0.4476,0.3155,0.3889,0.9153
"1826",134079,"FLORIDA SOUTHERN COLLEGE",1,0,1992,"7080","25.559905","96","311","343",200,143,147,"45",102,0.51,0.3147,0.4286,0.9067
"1827",134079,"FLORIDA SOUTHERN COLLEGE",1,0,1993,"7660","25.320721","96","330","375",207,168,138,"58",80,0.3865,0.3452,0.368,0.88
"1828",134079,"FLORIDA SOUTHERN COLLEGE",1,0,1995,"8630","28.523792","90","438","527",302,225,230,"76",154,0.5099,0.3378,0.4364,0.8311
"1829",134079,"FLORIDA SOUTHERN COLLEGE",1,0,1996,"9970","32.866152","92","384","458",287,171,224,"67",157,0.547,0.3918,0.4891,0.8384
"1830",134079,"FLORIDA SOUTHERN COLLEGE",1,0,1997,"10604","29.331773","94","364","428",270,158,196,"67",129,0.4778,0.4241,0.4579,0.8505
"1831",134079,"FLORIDA SOUTHERN COLLEGE",1,0,1998,"11274","30.356835","98","380","440",286,154,199,"55",144,0.5035,0.3571,0.4523,0.8636
"1832",134079,"FLORIDA SOUTHERN COLLEGE",1,0,1999,"11650","32.689457","101","383","425",267,158,173,"55",118,0.4419,0.3481,0.4071,0.9012
"1833",134079,"FLORIDA SOUTHERN COLLEGE",1,0,2000,"12750","36.015103","104","419","506",306,200,209,"62",147,0.4804,0.31,0.413,0.8281
"1834",134079,"FLORIDA SOUTHERN COLLEGE",1,0,2001,"13700","38.654787","107","434","515",323,192,205,"66",139,0.4303,0.3438,0.3981,0.8427
"1835",134079,"FLORIDA SOUTHERN COLLEGE",1,0,2002,"15778","39.899215","107","414","491",322,169,184,"41",143,0.4441,0.2426,0.3747,0.8432
"1836",134079,"FLORIDA SOUTHERN COLLEGE",1,0,2003,"17192","40.782876","109","354","436",250,186,163,"51",112,0.448,0.2742,0.3739,0.8119
"1837",134079,"FLORIDA SOUTHERN COLLEGE",1,0,2004,"17860","41.93105","114","468","553",342,211,227,"70",157,0.4591,0.3318,0.4105,0.8463
"1838",134079,"Florida Southern College",1,0,2005,"18765","44.926193","112","386","462",274,188,190,"60",130,0.4745,0.3191,0.4113,0.8355
"1839",134079,"Florida Southern College",1,0,2006,"19700","43.665351","110","342","420",267,153,198,"59",139,0.5206,0.3856,0.4714,0.8143
"1840",134079,"Florida Southern College",1,0,2007,"20690","46.830703","106","333","423",259,164,199,"77",122,0.471,0.4695,0.4704,0.7872
"1841",134079,"Florida Southern College",1,0,2008,"21620","46.879481","107","414","497",304,193,277,"102",175,0.5757,0.5285,0.5573,0.833
"1842",134079,"Florida Southern College",1,0,2009,"22270","51.165303","100","430","557",319,238,257,"91",166,0.5204,0.3824,0.4614,0.772
"1843",134079,"Florida Southern College",1,0,2010,"23578","52.434809","102","452","602",357,245,314,"119",195,0.5462,0.4857,0.5216,0.7508
"1844",134097,"FLORIDA STATE UNIVERSITY",1,0,1991,"1492","322.394422","1065","2346","2899",1702,1197,1131,"410",721,0.4236,0.3425,0.3901,0.8092
"1845",134097,"FLORIDA STATE UNIVERSITY",1,0,1992,"1679","327.816428","1047","2730","3313",1949,1364,1259,"378",881,0.452,0.2771,0.38,0.824
"1846",134097,"FLORIDA STATE UNIVERSITY",1,0,1993,"1780","345.014235","1038","2914","3603",2132,1471,1424,"480",944,0.4428,0.3263,0.3952,0.8088
"1847",134097,"FLORIDA STATE UNIVERSITY",1,0,1995,"1798","398.115442","1011","2983","3826",2210,1616,1534,"530",1004,0.4543,0.328,0.4009,0.7797
"1848",134097,"FLORIDA STATE UNIVERSITY",1,0,1996,"1882","411.486095","982","3023","3999",2329,1670,1583,"536",1047,0.4495,0.321,0.3958,0.7559
"1849",134097,"FLORIDA STATE UNIVERSITY",1,0,1997,"1988","429.783221","971","3408","4491",2525,1966,1822,"606",1216,0.4816,0.3082,0.4057,0.7589
"1850",134097,"FLORIDA STATE UNIVERSITY",1,0,1998,"2084","446.582774","981","3862","5066",2932,2134,2143,"705",1438,0.4905,0.3304,0.423,0.7623
"1851",134097,"FLORIDA STATE UNIVERSITY",1,0,1999,"2195","493.5209","1007","3892","5078",2934,2144,2244,"793",1451,0.4945,0.3699,0.4419,0.7664
"1852",134097,"FLORIDA STATE UNIVERSITY",1,0,2000,"1554","520.718227","1045.5","4188","5557",3294,2263,2481,"811",1670,0.507,0.3584,0.4465,0.7536
"1853",134097,"FLORIDA STATE UNIVERSITY",1,0,2001,"1670","586.596702","1084","4014","5681",3318,2363,2702,"928",1774,0.5347,0.3927,0.4756,0.7066
"1854",134097,"FLORIDA STATE UNIVERSITY",1,0,2002,"1754","571.405731","1124","4531","6258",3742,2516,2927,"959",1968,0.5259,0.3812,0.4677,0.724
"1855",134097,"FLORIDA STATE UNIVERSITY",1,0,2003,"1902","620.863","1116","4543","6059",3522,2537,2847,"987",1860,0.5281,0.389,0.4699,0.7498
"1856",134097,"FLORIDA STATE UNIVERSITY",1,0,2004,"2045","682.88384","1124","4545","6198",3727,2471,3112,"1029",2083,0.5589,0.4164,0.5021,0.7333
"1857",134097,"Florida State University",1,0,2005,"2147","742.366156","1283","4419","6052",3554,2498,2995,"1066",1929,0.5428,0.4267,0.4949,0.7302
"1858",134097,"Florida State University",1,0,2006,"2211","780.044957","1330","4564","6191",3597,2594,3310,"1201",2109,0.5863,0.463,0.5346,0.7372
"1859",134097,"Florida State University",1,0,2007,"2211","848.859388","1367","4426","6104",3436,2668,3458,"1266",2192,0.638,0.4745,0.5665,0.7251
"1860",134097,"Florida State University",1,0,2008,"2461","882.403405","1314","3523","4993",2928,2065,3066,"1093",1973,0.6738,0.5293,0.6141,0.7056
"1861",134097,"Florida State University",1,0,2009,"2658","908.011174","1312","4079","5925",3476,2449,3650,"1245",2405,0.6919,0.5084,0.616,0.6884
"1862",134097,"Florida State University",1,0,2010,"2870","911.787861","1257","4073","5957",3515,2442,3620,"1249",2371,0.6745,0.5115,0.6077,0.6837
"1863",134130,"UNIVERSITY OF FLORIDA",1,0,1991,"1420","777.328149","3083","3388","4364",2116,2248,1284,"490",794,0.3752,0.218,0.2942,0.7764
"1864",134130,"UNIVERSITY OF FLORIDA",1,0,1992,"1650","790.970391","2271","3308","4471",2097,2374,1377,"568",809,0.3858,0.2393,0.308,0.7399
"1865",134130,"UNIVERSITY OF FLORIDA",1,0,1993,"1770","822.790749","2261","3823","5074",2520,2554,1728,"701",1027,0.4075,0.2745,0.3406,0.7534
"1866",134130,"UNIVERSITY OF FLORIDA",1,0,1995,"1705","889.57149","2225","4121","5655",3023,2632,2443,"903",1540,0.5094,0.3431,0.432,0.7287
"1867",134130,"UNIVERSITY OF FLORIDA",1,0,1996,"1793","934.329132","2229","3823","5171",2899,2272,2599,"929",1670,0.5761,0.4089,0.5026,0.7393
"1868",134130,"UNIVERSITY OF FLORIDA",1,0,1997,"1926","974.607575","1575","4397","5959",3307,2652,2950,"1073",1877,0.5676,0.4046,0.495,0.7379
"1869",134130,"UNIVERSITY OF FLORIDA",1,0,1998,"2052","1030.298","1447","4123","5629",3171,2458,2886,"1037",1849,0.5831,0.4219,0.5127,0.7325
"1870",134130,"UNIVERSITY OF FLORIDA",1,0,1999,"2141","1102.119966","1536","4292","6065",3388,2677,3191,"1111",2080,0.6139,0.415,0.5261,0.7077
"1871",134130,"UNIVERSITY OF FLORIDA",1,0,2000,"1554","1164.348","1568.5","4553","6864",3874,2990,3692,"1285",2407,0.6213,0.4298,0.5379,0.6633
"1872",134130,"UNIVERSITY OF FLORIDA",1,0,2001,"1670","1252.251","1601","4518","6178",3348,2830,3304,"1208",2096,0.626,0.4269,0.5348,0.7313
"1873",134130,"UNIVERSITY OF FLORIDA",1,0,2002,"1754","1280.576","1686","4405","6406",3674,2732,3586,"1215",2371,0.6453,0.4447,0.5598,0.6876
"1874",134130,"UNIVERSITY OF FLORIDA",1,0,2003,"1902","1390.376","1679","4452","6499",3790,2709,3779,"1253",2526,0.6665,0.4625,0.5815,0.685
"1875",134130,"UNIVERSITY OF FLORIDA",1,0,2004,"2045","1479.158","1622","4481","6621",3706,2915,3933,"1418",2515,0.6786,0.4864,0.594,0.6768
"1876",134130,"University of Florida",1,0,2005,"2147","1655.523","1663","4673","7217",4080,3137,4230,"1533",2697,0.661,0.4887,0.5861,0.6475
"1877",134130,"University of Florida",1,0,2006,"2211","1745.853","2007","3961","6674",3783,2891,4294,"1572",2722,0.7195,0.5438,0.6434,0.5935
"1878",134130,"University of Florida",1,0,2007,"2211","1826.855","2009","3758","6440",3792,2648,4197,"1467",2730,0.7199,0.554,0.6517,0.5835
"1879",134130,"University of Florida",1,0,2008,"2670","1860.279","2314","3837","6382",3787,2595,4289,"1442",2847,0.7518,0.5557,0.672,0.6012
"1880",134130,"University of Florida",1,0,2009,"3070","2157.318","2249","3575","6253",3728,2525,4149,"1367",2782,0.7462,0.5414,0.6635,0.5717
"1881",134130,"University of Florida",1,0,2010,"3530","2226.809","2180","3693","6345",3661,2684,4275,"1469",2806,0.7665,0.5473,0.6738,0.582
"1882",134945,"JACKSONVILLE UNIVERSITY",1,0,1991,"8450","25.971557","105","307","388",147,241,102,"56",46,0.3129,0.2324,0.2629,0.7912
"1883",134945,"JACKSONVILLE UNIVERSITY",1,0,1992,"9320","27.590311","111","227","304",128,176,81,"33",48,0.375,0.1875,0.2664,0.7467
"1884",134945,"JACKSONVILLE UNIVERSITY",1,0,1993,"10080","28.392044","107","249","310",139,171,92,"47",45,0.3237,0.2749,0.2968,0.8032
"1885",134945,"JACKSONVILLE UNIVERSITY",1,0,1995,"10580","31.109817","109","267","356",197,159,129,"51",78,0.3959,0.3208,0.3624,0.75
"1886",134945,"JACKSONVILLE UNIVERSITY",1,0,1996,"12510","33.546845","114","273","365",197,168,113,"44",69,0.3503,0.2619,0.3096,0.7479
"1887",134945,"JACKSONVILLE UNIVERSITY",1,0,1997,"13900","36.875629","118","197","290",125,165,65,"19",46,0.368,0.1152,0.2241,0.6793
"1888",134945,"JACKSONVILLE UNIVERSITY",1,0,1998,"14420","34.841859","119","192","307",112,195,75,"40",35,0.3125,0.2051,0.2443,0.6254
"1889",134945,"JACKSONVILLE UNIVERSITY",1,0,1999,"14390","36.267084","110","180","309",122,187,98,"49",49,0.4016,0.262,0.3172,0.5825
"1890",134945,"JACKSONVILLE UNIVERSITY",1,0,2000,"15270","36.946318","111","277","406",163,243,155,"80",75,0.4601,0.3292,0.3818,0.6823
"1891",134945,"JACKSONVILLE UNIVERSITY",1,0,2001,"15990","35.110199","112","289","428",186,242,219,"140",79,0.4247,0.5785,0.5117,0.6752
"1892",134945,"JACKSONVILLE UNIVERSITY",1,0,2002,"16540","39.019676","121","274","389",165,224,105,"52",53,0.3212,0.2321,0.2699,0.7044
"1893",134945,"JACKSONVILLE UNIVERSITY",1,0,2003,"17700","43.390576","125","299","430",192,238,137,"57",80,0.4167,0.2395,0.3186,0.6953
"1894",134945,"JACKSONVILLE UNIVERSITY",1,0,2004,"18590","44.39894","121","283","462",197,265,118,"59",59,0.2995,0.2226,0.2554,0.6126
"1895",134945,"Jacksonville University",1,0,2005,"19970","46.979918","130","272","544",252,292,127,"59",68,0.2698,0.2021,0.2335,0.5
"1896",134945,"Jacksonville University",1,0,2006,"21200","44.65256","138","275","493",213,280,134,"62",72,0.338,0.2214,0.2718,0.5578
"1897",134945,"Jacksonville University",1,0,2007,"22500","47.986662","137","326","581",274,307,141,"60",81,0.2956,0.1954,0.2427,0.5611
"1898",134945,"Jacksonville University",1,0,2008,"23900","66.193702","160","321","539",249,290,151,"67",84,0.3373,0.231,0.2801,0.5955
"1899",134945,"Jacksonville University",1,0,2009,"25300","72.744904","161","445","665",337,328,187,"78",109,0.3234,0.2378,0.2812,0.6692
"1900",134945,"Jacksonville University",1,0,2010,"26600","64.536962","172","324","624",313,311,197,"87",110,0.3514,0.2797,0.3157,0.5192
"1901",135726,"UNIVERSITY OF MIAMI",1,0,1991,"14080","612.877697","748","1074","1832",826,1006,775,"383",392,0.4746,0.3807,0.423,0.5862
"1902",135726,"UNIVERSITY OF MIAMI",1,0,1992,"15050","673.533346","752","1007","1770",841,929,798,"395",403,0.4792,0.4252,0.4508,0.5689
"1903",135726,"UNIVERSITY OF MIAMI",1,0,1993,"15880","729.416459","769","836","1612",791,821,741,"338",403,0.5095,0.4117,0.4597,0.5186
"1904",135726,"UNIVERSITY OF MIAMI",1,0,1995,"17699","799.261343","748","871","1684",913,771,832,"348",484,0.5301,0.4514,0.4941,0.5172
"1905",135726,"UNIVERSITY OF MIAMI",1,0,1996,"18582","849.400617","770","798","1678",893,785,887,"381",506,0.5666,0.4854,0.5286,0.4756
"1906",135726,"UNIVERSITY OF MIAMI",1,0,1997,"19512","790.705012","735","921","1814",960,854,962,"421",541,0.5635,0.493,0.5303,0.5077
"1907",135726,"UNIVERSITY OF MIAMI",1,0,1998,"20424","800.098828","731","940","1831",980,851,975,"389",586,0.598,0.4571,0.5325,0.5134
"1908",135726,"UNIVERSITY OF MIAMI",1,0,1999,"20960","829.860449","752","982","1845",998,847,1031,"439",592,0.5932,0.5183,0.5588,0.5322
"1909",135726,"UNIVERSITY OF MIAMI",1,0,2000,"22124","873.46946","809.5","1091","1964",1081,883,1140,"469",671,0.6207,0.5311,0.5804,0.5555
"1910",135726,"UNIVERSITY OF MIAMI",1,0,2001,"23228","951.23888","867","1215","2152",1277,875,1349,"503",846,0.6625,0.5749,0.6269,0.5646
"1911",135726,"UNIVERSITY OF MIAMI",1,0,2002,"24378","1048.155261","865","1177","2046",1197,849,1311,"497",814,0.68,0.5854,0.6408,0.5753
"1912",135726,"UNIVERSITY OF MIAMI",1,0,2003,"25838","1148.999705","897","1192","2066",1142,924,1374,"582",792,0.6935,0.6299,0.6651,0.577
"1913",135726,"UNIVERSITY OF MIAMI",1,0,2004,"27384","1259.3757","910","1163","2025",1157,868,1381,"551",830,0.7174,0.6348,0.682,0.5743
"1914",135726,"University of Miami",1,0,2005,"29020","1289.254237","908","1249","2258",1168,1090,1480,"670",810,0.6935,0.6147,0.6554,0.5531
"1915",135726,"University of Miami",1,0,2006,"30732","1360.000435","955","1087","2046",1055,991,1421,"644",777,0.7365,0.6498,0.6945,0.5313
"1916",135726,"University of Miami",1,0,2007,"32422","1552.580264","970","968","1977",1049,928,1400,"606",794,0.7569,0.653,0.7081,0.4896
"1917",135726,"University of Miami",1,0,2008,"34206","1846.231509","1003","932","1983",987,996,1358,"647",711,0.7204,0.6496,0.6848,0.47
"1918",135726,"University of Miami",1,0,2009,"35540","2141.466289","998","948","1903",924,979,1297,"599",698,0.7554,0.6118,0.6816,0.4982
"1919",135726,"University of Miami",1,0,2010,"36962","2203.927038","1018","1104","2105",1072,1033,1465,"646",819,0.764,0.6254,0.696,0.5245
"1920",136172,"UNIVERSITY OF NORTH FLORIDA",1,0,1991,"1413","48.059897","243","315","406",240,166,71,"24",47,0.1958,0.1446,0.1749,0.7759
"1921",136172,"UNIVERSITY OF NORTH FLORIDA",1,0,1992,"1534","48.572049","225","366","487",277,210,68,"27",41,0.148,0.1286,0.1396,0.7515
"1922",136172,"UNIVERSITY OF NORTH FLORIDA",1,0,1993,"1732","53.973128","230","432","545",289,256,94,"25",69,0.2388,0.0977,0.1725,0.7927
"1923",136172,"UNIVERSITY OF NORTH FLORIDA",1,0,1995,"1747","63.733139","334","592","762",463,299,145,"26",119,0.257,0.087,0.1903,0.7769
"1924",136172,"UNIVERSITY OF NORTH FLORIDA",1,0,1996,"1884","69.545238","278","766","987",583,404,213,"62",151,0.259,0.1535,0.2158,0.7761
"1925",136172,"UNIVERSITY OF NORTH FLORIDA",1,0,1997,"2006","75.651469","294","861","1105",646,459,269,"77",192,0.2972,0.1678,0.2434,0.7792
"1926",136172,"UNIVERSITY OF NORTH FLORIDA",1,0,1998,"2157","85.570526","342","1127","1371",842,529,353,"105",248,0.2945,0.1985,0.2575,0.822
"1927",136172,"UNIVERSITY OF NORTH FLORIDA",1,0,1999,"2274","99.515589","359","1228","1501",886,615,375,"97",278,0.3138,0.1577,0.2498,0.8181
"1928",136172,"UNIVERSITY OF NORTH FLORIDA",1,0,2000,"1554","105.860922","360.5","1321","1664",963,701,335,"100",235,0.244,0.1427,0.2013,0.7939
"1929",136172,"UNIVERSITY OF NORTH FLORIDA",1,0,2001,"1670","119.986416","362","1303","1672",979,693,392,"126",266,0.2717,0.1818,0.2344,0.7793
"1930",136172,"UNIVERSITY OF NORTH FLORIDA",1,0,2002,"1754","128.294835","375","1508","1865",1067,798,395,"129",266,0.2493,0.1617,0.2118,0.8086
"1931",136172,"UNIVERSITY OF NORTH FLORIDA",1,0,2003,"1902","132.981941","409","1566","1919",1115,804,444,"120",324,0.2906,0.1493,0.2314,0.8161
"1932",136172,"UNIVERSITY OF NORTH FLORIDA",1,0,2004,"2045","137.883501","427","1714","2199",1252,947,447,"116",331,0.2644,0.1225,0.2033,0.7794
"1933",136172,"University of North Florida",1,0,2005,"2147","148.431714","449","1742","2288",1296,992,518,"179",339,0.2616,0.1804,0.2264,0.7614
"1934",136172,"University of North Florida",1,0,2006,"2211","162.981837","482","1756","2304",1301,1003,462,"131",331,0.2544,0.1306,0.2005,0.7622
"1935",136172,"University of North Florida",1,0,2007,"2211","181.038225","512","1539","2048",1185,863,435,"151",284,0.2397,0.175,0.2124,0.7515
"1936",136172,"University of North Florida",1,0,2008,"2461","192.276737","481","1273","1694",1013,681,444,"115",329,0.3248,0.1689,0.2621,0.7515
"1937",136172,"University of North Florida",1,0,2009,"2547","205.948371","487","1506","2025",1129,896,536,"155",381,0.3375,0.173,0.2647,0.7437
"1938",136172,"University of North Florida",1,0,2010,"2930","215.871416","491","1480","1926",1078,848,504,"137",367,0.3404,0.1616,0.2617,0.7684
"1939",136950,"ROLLINS COLLEGE",1,0,1991,"13900","38.718947","149","328","401",227,174,233,"92",141,0.6211,0.5287,0.581,0.818
"1940",136950,"ROLLINS COLLEGE",1,0,1992,"14974","41.84673","156","327","394",215,179,194,"71",123,0.5721,0.3966,0.4924,0.8299
"1941",136950,"ROLLINS COLLEGE",1,0,1993,"15950","47.514514","154","315","377",210,167,195,"82",113,0.5381,0.491,0.5172,0.8355
"1942",136950,"ROLLINS COLLEGE",1,0,1995,"17995","48.103039","146","331","412",248,164,250,"88",162,0.6532,0.5366,0.6068,0.8034
"1943",136950,"ROLLINS COLLEGE",1,0,1996,"19075","52.618867","147","292","418",240,178,194,"69",125,0.5208,0.3876,0.4641,0.6986
"1944",136950,"ROLLINS COLLEGE",1,0,1997,"20010","45.315549","149","287","415",253,162,192,"65",127,0.502,0.4012,0.4627,0.6916
"1945",136950,"ROLLINS COLLEGE",1,0,1998,"20915","47.547643","148","364","458",278,180,232,"80",152,0.5468,0.4444,0.5066,0.7948
"1946",136950,"ROLLINS COLLEGE",1,0,1999,"21250","50.697939","143","338","448",267,181,220,"87",133,0.4981,0.4807,0.4911,0.7545
"1947",136950,"ROLLINS COLLEGE",1,0,2000,"22206","57.084528","147.5","300","425",256,169,252,"87",165,0.6445,0.5148,0.5929,0.7059
"1948",136950,"ROLLINS COLLEGE",1,0,2001,"23205","61.441137","152","360","473",300,173,278,"90",188,0.6267,0.5202,0.5877,0.7611
"1949",136950,"ROLLINS COLLEGE",1,0,2002,"24250","63.529","177","369","466",280,186,278,"97",181,0.6464,0.5215,0.5966,0.7918
"1950",136950,"ROLLINS COLLEGE",1,0,2003,"25500","67.753","179","368","496",298,198,291,"102",189,0.6342,0.5152,0.5867,0.7419
"1951",136950,"ROLLINS COLLEGE",1,0,2004,"26910","71.032","179","341","486",284,202,285,"116",169,0.5951,0.5743,0.5864,0.7016
"1952",136950,"Rollins College",1,0,2005,"28390","75.006","185","346","463",275,188,284,"105",179,0.6509,0.5585,0.6134,0.7473
"1953",136950,"Rollins College",1,0,2006,"30420","79.54","188","367","501",287,214,312,"119",193,0.6725,0.5561,0.6228,0.7325
"1954",136950,"Rollins College",1,0,2007,"32640","84.726","193","407","525",305,220,319,"124",195,0.6393,0.5636,0.6076,0.7752
"1955",136950,"Rollins College",1,0,2008,"34520","92.37","194","332","464",262,202,293,"118",175,0.6679,0.5842,0.6315,0.7155
"1956",136950,"Rollins College",1,0,2009,"36220","97.082","196","328","464",287,177,299,"103",196,0.6829,0.5819,0.6444,0.7069
"1957",136950,"Rollins College",1,0,2010,"37640","99.941","200","308","465",286,179,298,"100",198,0.6923,0.5587,0.6409,0.6624
"1958",137546,"STETSON UNIVERSITY",1,0,1991,"10020","44.552126","174","410","460",256,204,237,"89",148,0.5781,0.4363,0.5152,0.8913
"1959",137546,"STETSON UNIVERSITY",1,0,1992,"11110","47.789559","176","419","501",282,219,232,"87",145,0.5142,0.3973,0.4631,0.8363
"1960",137546,"STETSON UNIVERSITY",1,0,1993,"11995","61.826839","185","403","481",292,189,238,"87",151,0.5171,0.4603,0.4948,0.8378
"1961",137546,"STETSON UNIVERSITY",1,0,1995,"13700","61.023","183","397","464",253,211,228,"89",139,0.5494,0.4218,0.4914,0.8556
"1962",137546,"STETSON UNIVERSITY",1,0,1996,"14735","61.038","193","351","416",229,187,211,"83",128,0.559,0.4439,0.5072,0.8438
"1963",137546,"STETSON UNIVERSITY",1,0,1997,"15765","51.242","192","442","504",289,215,283,"104",179,0.6194,0.4837,0.5615,0.877
"1964",137546,"STETSON UNIVERSITY",1,0,1998,"16650","55.192","203","461","539",311,228,279,"113",166,0.5338,0.4956,0.5176,0.8553
"1965",137546,"STETSON UNIVERSITY",1,0,1999,"16640","60.362","220","461","548",325,223,312,"119",193,0.5938,0.5336,0.5693,0.8412
"1966",137546,"STETSON UNIVERSITY",1,0,2000,"17475","67.854362","227.5","424","502",262,240,265,"108",157,0.5992,0.45,0.5279,0.8446
"1967",137546,"STETSON UNIVERSITY",1,0,2001,"18350","74.27275","235","421","527",298,229,289,"117",172,0.5772,0.5109,0.5484,0.7989
"1968",137546,"STETSON UNIVERSITY",1,0,2002,"19450","79.486104","239","448","542",325,217,299,"104",195,0.6,0.4793,0.5517,0.8266
"1969",137546,"STETSON UNIVERSITY",1,0,2003,"20425","79.142945","236","456","523",284,239,260,"109",151,0.5317,0.4561,0.4971,0.8719
"1970",137546,"STETSON UNIVERSITY",1,0,2004,"22350","83.051374","231","474","598",354,244,303,"100",203,0.5734,0.4098,0.5067,0.7926
"1971",137546,"Stetson University",1,0,2005,"23750","89.043219","243","396","547",312,235,308,"135",173,0.5545,0.5745,0.5631,0.7239
"1972",137546,"Stetson University",1,0,2006,"25350","94.453934","237","402","565",338,227,317,"113",204,0.6036,0.4978,0.5611,0.7115
"1973",137546,"Stetson University",1,0,2007,"27100","97.790949","235","430","557",322,235,314,"121",193,0.5994,0.5149,0.5637,0.772
"1974",137546,"Stetson University",1,0,2008,"28456","101.143354","231","440","617",360,257,344,"133",211,0.5861,0.5175,0.5575,0.7131
"1975",137546,"Stetson University",1,0,2009,"29880","107.849442","229","350","502",273,229,287,"124",163,0.5971,0.5415,0.5717,0.6972
"1976",137546,"Stetson University",1,0,2010,"31374","109.371966","227","375","545",331,214,305,"109",196,0.5921,0.5093,0.5596,0.6881
"1977",138354,"THE UNIVERSITY OF WEST FLORIDA",1,0,1991,"1463","61.996751","241","315","380",215,165,40,"16",24,0.1116,0.097,0.1053,0.8289
"1978",138354,"THE UNIVERSITY OF WEST FLORIDA",1,0,1992,"1654","64.444173","230","335","396",208,188,70,"28",42,0.2019,0.1489,0.1768,0.846
"1979",138354,"THE UNIVERSITY OF WEST FLORIDA",1,0,1993,"1702","66.454197","221","347","438",252,186,68,"17",51,0.2024,0.0914,0.1553,0.7922
"1980",138354,"THE UNIVERSITY OF WEST FLORIDA",1,0,1995,"1723","75.041697","212","393","509",279,230,101,"30",71,0.2545,0.1304,0.1984,0.7721
"1981",138354,"THE UNIVERSITY OF WEST FLORIDA",1,0,1996,"1819","77.883096","210","369","459",261,198,107,"39",68,0.2605,0.197,0.2331,0.8039
"1982",138354,"THE UNIVERSITY OF WEST FLORIDA",1,0,1997,"1985","77.445263","206","500","620",372,248,101,"28",73,0.1962,0.1129,0.1629,0.8065
"1983",138354,"THE UNIVERSITY OF WEST FLORIDA",1,0,1998,"2143","83.192724","210","515","647",365,282,136,"40",96,0.263,0.1418,0.2102,0.796
"1984",138354,"THE UNIVERSITY OF WEST FLORIDA",1,0,1999,"2293","89.245116","225","515","637",335,302,132,"54",78,0.2328,0.1788,0.2072,0.8085
"1985",138354,"THE UNIVERSITY OF WEST FLORIDA",1,0,2000,"1554","97.118466","236.5","513","629",355,274,117,"30",87,0.2451,0.1095,0.186,0.8156
"1986",138354,"THE UNIVERSITY OF WEST FLORIDA",1,0,2001,"1670","105.880837","248","543","695",406,289,167,"59",108,0.266,0.2042,0.2403,0.7813
"1987",138354,"THE UNIVERSITY OF WEST FLORIDA",1,0,2002,"1754","110.965256","245","614","760",443,317,172,"52",120,0.2709,0.164,0.2263,0.8079
"1988",138354,"THE UNIVERSITY OF WEST FLORIDA",1,0,2003,"1902","122.163282","247","652","816",469,347,169,"48",121,0.258,0.1383,0.2071,0.799
"1989",138354,"THE UNIVERSITY OF WEST FLORIDA",1,0,2004,"2045","131.004565","257","690","859",475,384,168,"57",111,0.2337,0.1484,0.1956,0.8033
"1990",138354,"The University of West Florida",1,0,2005,"2147","135.306506","332","676","830",490,340,194,"65",129,0.2633,0.1912,0.2337,0.8145
"1991",138354,"The University of West Florida",1,0,2006,"2211","145.499252","343","648","861",495,366,209,"65",144,0.2909,0.1776,0.2427,0.7526
"1992",138354,"The University of West Florida",1,0,2007,"2211","144.440146","332","699","912",511,401,184,"57",127,0.2485,0.1421,0.2018,0.7664
"1993",138354,"The University of West Florida",1,0,2008,"2460","146.900467","324","764","1030",605,425,277,"94",183,0.3025,0.2212,0.2689,0.7417
"1994",138354,"The University of West Florida",1,0,2009,"2743","143.373373","312","852","1154",643,511,313,"91",222,0.3453,0.1781,0.2712,0.7383
"1995",138354,"The University of West Florida",1,0,2010,"3062","159.71406","303","878","1211",661,550,325,"118",207,0.3132,0.2145,0.2684,0.725
"1996",138716,"ALBANY STATE COLLEGE",0,1,1991,"1794","22.396126","138","8","541",292,249,39,"7",32,0.1096,0.0281,0.0721,0.0148
"1997",138716,"ALBANY STATE COLLEGE",0,1,1992,"1731","23.681949","142","11","645",364,281,50,"14",36,0.0989,0.0498,0.0775,0.0171
"1998",138716,"ALBANY STATE COLLEGE",0,1,1993,"1771","27.103232","138","7","649",367,282,47,"8",39,0.1063,0.0284,0.0724,0.0108
"1999",138716,"ALBANY STATE COLLEGE",0,1,1995,"2034","36.194748","136","7","530",291,239,37,"10",27,0.0928,0.0418,0.0698,0.0132
"2000",138716,"ALBANY STATE UNIVERSITY",0,1,1996,"2139","34.755175","147","4","503",281,222,34,"10",24,0.0854,0.045,0.0676,0.008
"2001",138716,"ALBANY STATE UNIVERSITY",0,1,1997,"2244","36.632235","149","4","575",359,216,35,"9",26,0.0724,0.0417,0.0609,0.007
"2002",138716,"ALBANY STATE UNIVERSITY",1,0,1998,"2176","40.867235","127","4","493",313,180,30,"10",20,0.0639,0.0556,0.0609,0.0081
"2003",138716,"ALBANY STATE UNIVERSITY",1,0,1999,"1808","46.497783","138","9","648",424,224,92,"23",69,0.1627,0.1027,0.142,0.0139
"2004",138716,"ALBANY STATE UNIVERSITY",1,0,2000,"1876","44.668319","142","1","643",431,212,79,"14",65,0.1508,0.066,0.1229,0.0016
"2005",138716,"ALBANY STATE UNIVERSITY",1,0,2001,"1932","50.256305","146","9","420",266,154,79,"17",62,0.2331,0.1104,0.1881,0.0214
"2006",138716,"ALBANY STATE UNIVERSITY",1,0,2002,"2010","52.659817","164","9","470",300,170,88,"22",66,0.22,0.1294,0.1872,0.0191
"2007",138716,"ALBANY STATE UNIVERSITY",1,0,2003,"2212","65.821834","148","9","537",322,215,78,"21",57,0.177,0.0977,0.1453,0.0168
"2008",138716,"ALBANY STATE UNIVERSITY",1,0,2004,"2322","54.753769","142","4","602",399,203,98,"22",76,0.1905,0.1084,0.1628,0.0066
"2009",138716,"Albany State University",1,0,2005,"2438","60.354502","145","3","596",388,208,93,"16",77,0.1985,0.0769,0.156,0.005
"2010",138716,"Albany State University",1,0,2006,"2548","54.585767","142","5","702",467,235,74,"14",60,0.1285,0.0596,0.1054,0.0071
"2011",138716,"Albany State University",1,0,2007,"2706","57.633061","148","9","626",401,225,100,"17",83,0.207,0.0756,0.1597,0.0144
"2012",138716,"Albany State University",1,0,2008,"2838","65.268718","142","7","626",392,234,65,"9",56,0.1429,0.0385,0.1038,0.0112
"2013",138716,"Albany State University",1,0,2009,"3100","64.347246","141","6","745",468,277,66,"15",51,0.109,0.0542,0.0886,0.0081
"2014",138716,"Albany State University",1,0,2010,"3132","66.186892","145","6","883",542,341,47,"13",34,0.0627,0.0381,0.0532,0.0068
"2015",138789,"ARMSTRONG STATE COLLEGE",0,1,1991,"1467","20.168402","161","450","567",340,227,50,"14",36,0.1059,0.0617,0.0882,0.7937
"2016",138789,"ARMSTRONG STATE COLLEGE",0,1,1992,"1521","21.569178","187","381","496",292,204,25,"10",15,0.0514,0.049,0.0504,0.7681
"2017",138789,"ARMSTRONG STATE COLLEGE",0,1,1993,"1568","26.000218","202","448","577",353,224,39,"7",32,0.0907,0.0312,0.0676,0.7764
"2018",138789,"ARMSTRONG STATE COLLEGE",0,1,1995,"1719","33.564123","210","582","773",497,276,50,"13",37,0.0744,0.0471,0.0647,0.7529
"2019",138789,"ARMSTRONG ATLANTIC STATE UNIVERSITY",0,1,1996,"1836","37.221025","209","575","805",519,286,60,"14",46,0.0886,0.049,0.0745,0.7143
"2020",138789,"ARMSTRONG ATLANTIC STATE UNIVERSITY",0,1,1997,"1962","39.16519","211","517","690",470,220,50,"7",43,0.0915,0.0318,0.0725,0.7493
"2021",138789,"ARMSTRONG ATLANTIC STATE UNIVERSITY",1,0,1998,"2020","42.933241","212","389","550",378,172,26,"8",18,0.0476,0.0465,0.0473,0.7073
"2022",138789,"ARMSTRONG ATLANTIC STATE UNIVERSITY",1,0,1999,"1808","48.799135","213","449","602",386,216,35,"10",25,0.0648,0.0463,0.0581,0.7458
"2023",138789,"ARMSTRONG ATLANTIC STATE UNIVERSITY",1,0,2000,"1876","51.639592","210.5","440","568",327,241,27,"9",18,0.055,0.0373,0.0475,0.7746
"2024",138789,"ARMSTRONG ATLANTIC STATE UNIVERSITY",1,0,2001,"1932","52.61317","208","424","551",328,223,39,"7",32,0.0976,0.0314,0.0708,0.7695
"2025",138789,"ARMSTRONG ATLANTIC STATE UNIVERSITY",1,0,2002,"2010","50.082239","241","422","581",350,231,48,"13",35,0.1,0.0563,0.0826,0.7263
"2026",138789,"ARMSTRONG ATLANTIC STATE UNIVERSITY",1,0,2003,"2212","58.011492","217","556","719",433,286,47,"8",39,0.0901,0.028,0.0654,0.7733
"2027",138789,"ARMSTRONG ATLANTIC STATE UNIVERSITY",1,0,2004,"2212","54.725815","223","577","776",449,327,70,"21",49,0.1091,0.0642,0.0902,0.7436
"2028",138789,"Armstrong Atlantic State University",1,0,2005,"2438","58.433277","234","465","700",453,247,70,"14",56,0.1236,0.0567,0.1,0.6643
"2029",138789,"Armstrong Atlantic State University",1,0,2006,"2548","67.419112","240","490","757",472,285,63,"14",49,0.1038,0.0491,0.0832,0.6473
"2030",138789,"Armstrong Atlantic State University",1,0,2007,"2706","74.764829","245","501","793",477,316,77,"16",61,0.1279,0.0506,0.0971,0.6318
"2031",138789,"Armstrong Atlantic State University",1,0,2008,"2838","75.241825","237","543","864",511,353,87,"23",64,0.1252,0.0652,0.1007,0.6285
"2032",138789,"Armstrong Atlantic State University",1,0,2009,"3120","80.151201","239","699","1063",611,452,110,"20",90,0.1473,0.0442,0.1035,0.6576
"2033",138789,"Armstrong Atlantic State University",1,0,2010,"3432","82.326049","254","678","1161",685,476,141,"41",100,0.146,0.0861,0.1214,0.584
"2034",139144,"BERRY COLLEGE",1,0,1991,"6990","29.317585","95","409","429",253,176,220,"85",135,0.5336,0.483,0.5128,0.9534
"2035",139144,"BERRY COLLEGE",1,0,1992,"7500","29.500969","95","402","425",286,139,191,"64",127,0.4441,0.4604,0.4494,0.9459
"2036",139144,"BERRY COLLEGE",1,0,1993,"8050","31.282567","92","453","484",306,178,183,"57",126,0.4118,0.3202,0.3781,0.936
"2037",139144,"BERRY COLLEGE",1,0,1995,"9216","35.548723","97","479","522",316,206,184,"68",116,0.3671,0.3301,0.3525,0.9176
"2038",139144,"BERRY COLLEGE",1,0,1996,"9678","38.981842","103","510","539",339,200,252,"79",173,0.5103,0.395,0.4675,0.9462
"2039",139144,"BERRY COLLEGE",1,0,1997,"10210","41.20335","111","472","504",332,172,295,"99",196,0.5904,0.5756,0.5853,0.9365
"2040",139144,"BERRY COLLEGE",1,0,1998,"10900","44.330089","124","492","525",336,189,297,"106",191,0.5685,0.5608,0.5657,0.9371
"2041",139144,"BERRY COLLEGE",1,0,1999,"11550","47.626032","136","385","401",243,158,197,"69",128,0.5267,0.4367,0.4913,0.9601
"2042",139144,"BERRY COLLEGE",1,0,2000,"12500","51.019465","142","457","486",321,165,258,"84",174,0.5421,0.5091,0.5309,0.9403
"2043",139144,"BERRY COLLEGE",1,0,2001,"13450","54.757633","148","497","536",357,179,262,"74",188,0.5266,0.4134,0.4888,0.9272
"2044",139144,"BERRY COLLEGE",1,0,2002,"14260","60.146659","149","516","565",353,212,276,"94",182,0.5156,0.4434,0.4885,0.9133
"2045",139144,"BERRY COLLEGE",1,0,2003,"15220","65.235324","148","455","504",321,183,240,"76",164,0.5109,0.4153,0.4762,0.9028
"2046",139144,"BERRY COLLEGE",1,0,2004,"16240","65.908938","146","462","514",349,165,261,"76",185,0.5301,0.4606,0.5078,0.8988
"2047",139144,"Berry College",1,0,2005,"17570","68.105352","137","456","513",316,197,226,"65",161,0.5095,0.3299,0.4405,0.8889
"2048",139144,"Berry College",1,0,2006,"18950","57.296797","139","385","427",302,125,221,"56",165,0.5464,0.448,0.5176,0.9016
"2049",139144,"Berry College",1,0,2007,"20570","58.811252","143","469","537",373,164,269,"75",194,0.5201,0.4573,0.5009,0.8734
"2050",139144,"Berry College",1,0,2008,"22170","61.085372","141","371","448",311,137,243,"70",173,0.5563,0.5109,0.5424,0.8281
"2051",139144,"Berry College",1,0,2009,"23160","68.051672","144","455","569",402,167,315,"85",230,0.5721,0.509,0.5536,0.7996
"2052",139144,"Berry College",1,0,2010,"24420","73.576941","146","562","653",431,222,386,"126",260,0.6032,0.5676,0.5911,0.8606
"2053",139366,"COLUMBUS COLLEGE",0,1,1991,"1482","25.129821","180","352","509",312,197,30,"9",21,0.0673,0.0457,0.0589,0.6916
"2054",139366,"COLUMBUS COLLEGE",0,1,1992,"1545","25.841395","198","407","589",365,224,42,"14",28,0.0767,0.0625,0.0713,0.691
"2055",139366,"COLUMBUS COLLEGE",0,1,1993,"1600","28.7072","178","416","650",401,249,59,"20",39,0.0973,0.0803,0.0908,0.64
"2056",139366,"COLUMBUS STATE UNIVERSITY",0,1,1995,"1740","38.154466","190","435","633",390,243,54,"17",37,0.0949,0.07,0.0853,0.6872
"2057",139366,"COLUMBUS STATE UNIVERSITY",0,1,1996,"1845","43.162612","201","386","616",383,233,43,"10",33,0.0862,0.0429,0.0698,0.6266
"2058",139366,"COLUMBUS STATE UNIVERSITY",0,1,1997,"1941","47.752637","218","420","612",354,258,53,"14",39,0.1102,0.0543,0.0866,0.6863
"2059",139366,"COLUMBUS STATE UNIVERSITY",1,0,1998,"2020","60.516912","215","493","723",450,273,63,"17",46,0.1022,0.0623,0.0871,0.6819
"2060",139366,"COLUMBUS STATE UNIVERSITY",1,0,1999,"1808","48.285626","216","495","672",412,260,54,"13",41,0.0995,0.05,0.0804,0.7366
"2061",139366,"COLUMBUS STATE UNIVERSITY",1,0,2000,"1876","63.476812","211","492","759",468,291,87,"24",63,0.1346,0.0825,0.1146,0.6482
"2062",139366,"COLUMBUS STATE UNIVERSITY",1,0,2001,"1932","52.274134","206","518","761",468,293,84,"20",64,0.1368,0.0683,0.1104,0.6807
"2063",139366,"COLUMBUS STATE UNIVERSITY",1,0,2002,"2010","52.96242","207","611","943",548,395,91,"18",73,0.1332,0.0456,0.0965,0.6479
"2064",139366,"COLUMBUS STATE UNIVERSITY",1,0,2003,"2212","53.690479","198","631","1037",619,418,114,"32",82,0.1325,0.0766,0.1099,0.6085
"2065",139366,"COLUMBUS STATE UNIVERSITY",1,0,2004,"2322","55.216877","201","606","972",584,388,116,"31",85,0.1455,0.0799,0.1193,0.6235
"2066",139366,"Columbus State University",1,0,2005,"2438","62.803548","217","657","1067",641,426,129,"33",96,0.1498,0.0775,0.1209,0.6157
"2067",139366,"Columbus State University",1,0,2006,"2548","69.444986","245","611","1054",640,414,139,"37",102,0.1594,0.0894,0.1319,0.5797
"2068",139366,"Columbus State University",1,0,2007,"2706","78.534936","246","599","996",568,428,117,"29",88,0.1549,0.0678,0.1175,0.6014
"2069",139366,"Columbus State University",1,0,2008,"2838","83.345525","252","627","1114",642,472,131,"38",93,0.1449,0.0805,0.1176,0.5628
"2070",139366,"Columbus State University",1,0,2009,"3100","83.115895","261","653","1231",734,497,138,"43",95,0.1294,0.0865,0.1121,0.5305
"2071",139366,"Columbus State University",1,0,2010,"3281","93.359287","267","606","1154",718,436,130,"43",87,0.1212,0.0986,0.1127,0.5251
"2072",139393,"COVENANT COLLEGE",1,0,1991,"7900","8.195649","37","133","136",73,63,56,"21",35,0.4795,0.3333,0.4118,0.9779
"2073",139393,"COVENANT COLLEGE",1,0,1992,"8550","9.87474","37","147","155",98,57,56,"18",38,0.3878,0.3158,0.3613,0.9484
"2074",139393,"COVENANT COLLEGE",1,0,1993,"9200","11.191437","39","159","168",93,75,75,"31",44,0.4731,0.4133,0.4464,0.9464
"2075",139393,"COVENANT COLLEGE",1,0,1995,"10920","12.588074","39","142","155",90,65,75,"33",42,0.4667,0.5077,0.4839,0.9161
"2076",139393,"COVENANT COLLEGE",1,0,1996,"11780","12.966311","37","192","206",119,87,109,"43",66,0.5546,0.4943,0.5291,0.932
"2077",139393,"COVENANT COLLEGE",1,0,1997,"12900","13.603456","46","183","197",112,85,89,"31",58,0.5179,0.3647,0.4518,0.9289
"2078",139393,"COVENANT COLLEGE",1,0,1998,"13750","14.376184","43","196","211",134,77,112,"36",76,0.5672,0.4675,0.5308,0.9289
"2079",139393,"COVENANT COLLEGE",1,0,1999,"14400","16.493311","44","208","228",144,84,124,"45",79,0.5486,0.5357,0.5439,0.9123
"2080",139393,"COVENANT COLLEGE",1,0,2000,"15600","18.575071","45","191","206",117,89,107,"47",60,0.5128,0.5281,0.5194,0.9272
"2081",139393,"COVENANT COLLEGE",1,0,2001,"16590","19.871537","46","216","238",151,87,120,"41",79,0.5232,0.4713,0.5042,0.9076
"2082",139393,"COVENANT COLLEGE",1,0,2002,"17750","21.063842","58","209","231",141,90,129,"44",85,0.6028,0.4889,0.5584,0.9048
"2083",139393,"COVENANT COLLEGE",1,0,2003,"17750","21.114885","56","214","236",146,90,108,"32",76,0.5205,0.3556,0.4576,0.9068
"2084",139393,"COVENANT COLLEGE",1,0,2004,"18750","22.14934","59","243","260",156,104,123,"41",82,0.5256,0.3942,0.4731,0.9346
"2085",139393,"Covenant College",1,0,2005,"20100","23.143585","61","241","270",138,132,122,"48",74,0.5362,0.3636,0.4519,0.8926
"2086",139393,"Covenant College",1,0,2006,"21100","23.636324","65","265","297",166,131,163,"62",101,0.6084,0.4733,0.5488,0.8923
"2087",139393,"Covenant College",1,0,2007,"22160","25.727421","70","258","291",163,128,139,"51",88,0.5399,0.3984,0.4777,0.8866
"2088",139393,"Covenant College",1,0,2008,"23600","27.829832","66","240","267",149,118,129,"51",78,0.5235,0.4322,0.4831,0.8989
"2089",139393,"Covenant College",1,0,2009,"24520","31.508612","60","252","277",158,119,139,"48",91,0.5759,0.4034,0.5018,0.9097
"2090",139393,"Covenant College",1,0,2010,"25476","29.777903","63","233","269",131,138,160,"66",94,0.7176,0.4783,0.5948,0.8662
"2091",139658,"EMORY UNIVERSITY",1,0,1991,"14580","747.481775","492","1110","1415",772,643,950,"430",520,0.6736,0.6687,0.6714,0.7845
"2092",139658,"EMORY UNIVERSITY",1,0,1992,"15600","801.383663","507","1078","1478",872,606,1010,"406",604,0.6927,0.67,0.6834,0.7294
"2093",139658,"EMORY UNIVERSITY",1,0,1993,"16820","885.669317","549","1037","1406",762,644,999,"458",541,0.71,0.7112,0.7105,0.7376
"2094",139658,"EMORY UNIVERSITY",1,0,1995,"19000","1061.150602","569","1146","1587",896,691,1093,"441",652,0.7277,0.6382,0.6887,0.7221
"2095",139658,"EMORY UNIVERSITY",1,0,1996,"19870","1106.292747","592","1058","1508",867,641,1076,"438",638,0.7359,0.6833,0.7135,0.7016
"2096",139658,"EMORY UNIVERSITY",1,0,1997,"21110","1154.808485","581","1011","1477",762,715,1120,"525",595,0.7808,0.7343,0.7583,0.6845
"2097",139658,"EMORY UNIVERSITY",1,0,1998,"21870","1427.635967","587","1152","1692",908,784,1227,"548",679,0.7478,0.699,0.7252,0.6809
"2098",139658,"EMORY UNIVERSITY",1,0,1999,"22870","1581.26798","579","1018","1515",870,645,1148,"486",662,0.7609,0.7535,0.7578,0.6719
"2099",139658,"EMORY UNIVERSITY",1,0,2000,"24240","1664.259022","589.5","1021","1532",831,701,936,"420",516,0.6209,0.5991,0.611,0.6664
"2100",139658,"EMORY UNIVERSITY",1,0,2001,"25240","1772.315101","600","979","1547",817,730,1013,"486",527,0.645,0.6658,0.6548,0.6328
"2101",139658,"EMORY UNIVERSITY",1,0,2002,"26600","1854.805411","613","995","1558",903,655,1061,"444",617,0.6833,0.6779,0.681,0.6386
"2102",139658,"EMORY UNIVERSITY",1,0,2003,"27600","2043.568872","645","950","1595",895,700,1060,"453",607,0.6782,0.6471,0.6646,0.5956
"2103",139658,"EMORY UNIVERSITY",1,0,2004,"28940","2214.257","666","959","1587",911,676,1044,"436",608,0.6674,0.645,0.6578,0.6043
"2104",139658,"Emory University",1,0,2005,"30400","2350.209","685","931","1631",933,698,1032,"450",582,0.6238,0.6447,0.6327,0.5708
"2105",139658,"Emory University",1,0,2006,"32100","2550.026","697","882","1648",938,710,1108,"477",631,0.6727,0.6718,0.6723,0.5352
"2106",139658,"Emory University",1,0,2007,"33900","2672.681","992","791","1597",863,734,1027,"477",550,0.6373,0.6499,0.6431,0.4953
"2107",139658,"Emory University",1,0,2008,"35800","2832.473","1003","785","1661",893,768,1064,"501",563,0.6305,0.6523,0.6406,0.4726
"2108",139658,"Emory University",1,0,2009,"37500","3022.079","995","537","1287",712,575,1067,"448",619,0.8694,0.7791,0.8291,0.4172
"2109",139658,"Emory University",1,0,2010,"38600","3133.354","1003","593","1321",748,573,1125,"462",663,0.8864,0.8063,0.8516,0.4489
"2110",139719,"FORT VALLEY STATE COLLEGE",0,1,1991,"1650","26.016798","148","7","464",276,188,48,"22",26,0.0942,0.117,0.1034,0.0151
"2111",139719,"FORT VALLEY STATE COLLEGE",0,1,1992,"1650","27.190422","147","1","497",264,233,52,"18",34,0.1288,0.0773,0.1046,0.002
"2112",139719,"FORT VALLEY STATE COLLEGE",0,1,1993,"1775","30.696842","142","7","539",290,249,27,"3",24,0.0828,0.012,0.0501,0.013
"2113",139719,"FORT VALLEY STATE UNIVERSITY",0,1,1995,"1920","36.694496","143","5","522",261,261,38,"8",30,0.1149,0.0307,0.0728,0.0096
"2114",139719,"FORT VALLEY STATE UNIVERSITY",0,1,1996,"2040","38.800271","149","4","573",307,266,48,"6",42,0.1368,0.0226,0.0838,0.007
"2115",139719,"FORT VALLEY STATE UNIVERSITY",0,1,1997,"2157","43.013789","139","5","502",270,232,75,"19",56,0.2074,0.0819,0.1494,0.01
"2116",139719,"FORT VALLEY STATE UNIVERSITY",1,0,1998,"2216","45.125017","152","4","432",240,192,40,"11",29,0.1208,0.0573,0.0926,0.0093
"2117",139719,"FORT VALLEY STATE UNIVERSITY",1,0,1999,"1808","47.048933","146","2","406",206,200,36,"9",27,0.1311,0.045,0.0887,0.0049
"2118",139719,"FORT VALLEY STATE UNIVERSITY",1,0,2000,"1876","49.036556","143.5","7","360",195,165,48,"14",34,0.1744,0.0848,0.1333,0.0194
"2119",139719,"FORT VALLEY STATE UNIVERSITY",1,0,2001,"1932","51.175405","141","3","425",225,200,60,"16",44,0.1956,0.08,0.1412,0.0071
"2120",139719,"FORT VALLEY STATE UNIVERSITY",1,0,2002,"2580","113.477563","135","3","386",192,194,59,"12",47,0.2448,0.0619,0.1528,0.0078
"2121",139719,"FORT VALLEY STATE UNIVERSITY",1,0,2003,"2212","59.477177","107","2","496",260,236,64,"17",47,0.1808,0.072,0.129,0.004
"2122",139719,"FORT VALLEY STATE UNIVERSITY",1,0,2004,"2322","50.296193","126","7","456",227,229,66,"18",48,0.2115,0.0786,0.1447,0.0154
"2123",139719,"Fort Valley State University",1,0,2005,"2438","47.618504","101","2","317",169,148,48,"11",37,0.2189,0.0743,0.1514,0.0063
"2124",139719,"Fort Valley State University",1,0,2006,"2548","50.190816","107","2","486",253,233,51,"9",42,0.166,0.0386,0.1049,0.0041
"2125",139719,"Fort Valley State University",1,0,2007,"2706","54.320413","110","2","716",386,330,56,"12",44,0.114,0.0364,0.0782,0.0028
"2126",139719,"Fort Valley State University",1,0,2008,"2868","62.806433","117","9","1074",568,506,117,"32",85,0.1496,0.0632,0.1089,0.0084
"2127",139719,"Fort Valley State University",1,0,2009,"3874","67.348281","103","7","984",550,434,118,"26",92,0.1673,0.0599,0.1199,0.0071
"2128",139719,"Fort Valley State University",1,0,2010,"4274","76.558683","144","6","840",487,353,69,"26",43,0.0883,0.0737,0.0821,0.0071
"2129",139755,"GEORGIA INSTITUTE OF TECHNOLOGY MAIN CAMPUS",0,1,1991,"2118","311.743882","608","1383","1750",415,1335,484,"335",149,0.359,0.2509,0.2766,0.7903
"2130",139755,"GEORGIA INSTITUTE OF TECHNOLOGY MAIN CAMPUS",0,1,1992,"2205","326.970397","587","1363","1691",467,1224,472,"298",174,0.3726,0.2435,0.2791,0.806
"2131",139755,"GEORGIA INSTITUTE OF TECHNOLOGY MAIN CAMPUS",0,1,1993,"2277","343.587415","626","1529","1963",484,1479,398,"252",146,0.3017,0.1704,0.2028,0.7789
"2132",139755,"GEORGIA INSTITUTE OF TECHNOLOGY MAIN CAMPUS",0,1,1995,"2457","404.504924","640","1612","2120",600,1520,451,"271",180,0.3,0.1783,0.2127,0.7604
"2133",139755,"GEORGIA INSTITUTE OF TECHNOLOGY MAIN CAMPUS",0,1,1996,"2685","448.229336","670","1667","2120",596,1524,484,"288",196,0.3289,0.189,0.2283,0.7863
"2134",139755,"GEORGIA INSTITUTE OF TECHNOLOGY-MAIN CAMPUS",0,1,1997,"2901","487.300638","688","1600","2069",565,1504,487,"305",182,0.3221,0.2028,0.2354,0.7733
"2135",139755,"GEORGIA INSTITUTE OF TECHNOLOGY-MAIN CAMPUS",0,1,1998,"2991","525.655933","686","1799","2487",721,1766,644,"371",273,0.3786,0.2101,0.2589,0.7234
"2136",139755,"GEORGIA INSTITUTE OF TECHNOLOGY-MAIN CAMPUS",1,0,1999,"2414","573.238846","721","1683","2293",654,1639,657,"431",226,0.3456,0.263,0.2865,0.734
"2137",139755,"GEORGIA INSTITUTE OF TECHNOLOGY-MAIN CAMPUS",1,0,2000,"2506","625.803014","737.5","1633","2242",640,1602,760,"470",290,0.4531,0.2934,0.339,0.7284
"2138",139755,"GEORGIA INSTITUTE OF TECHNOLOGY-MAIN CAMPUS",1,0,2001,"2632","653.738318","754","1625","2223",634,1589,736,"441",295,0.4653,0.2775,0.3311,0.731
"2139",139755,"GEORGIA INSTITUTE OF TECHNOLOGY-MAIN CAMPUS",1,0,2002,"2790","658.557586","879","1662","2275",636,1639,711,"445",266,0.4182,0.2715,0.3125,0.7305
"2140",139755,"GEORGIA INSTITUTE OF TECHNOLOGY-MAIN CAMPUS",1,0,2003,"3208","758.455038","852","1579","2224",607,1617,683,"427",256,0.4217,0.2641,0.3071,0.71
"2141",139755,"GEORGIA INSTITUTE OF TECHNOLOGY-MAIN CAMPUS",1,0,2004,"3368","792.229885","834","1812","2572",766,1806,845,"514",331,0.4321,0.2846,0.3285,0.7045
"2142",139755,"Georgia Institute of Technology-Main Campus",1,0,2005,"3638","819.2405","879","1716","2415",714,1701,756,"431",325,0.4552,0.2534,0.313,0.7106
"2143",139755,"Georgia Institute of Technology-Main Campus",1,0,2006,"3892","859.740592","907","1912","2838",890,1948,953,"548",405,0.4551,0.2813,0.3358,0.6737
"2144",139755,"Georgia Institute of Technology-Main Campus",1,0,2007,"4159","936.375463","909","1702","2622",854,1768,1072,"645",427,0.5,0.3648,0.4088,0.6491
"2145",139755,"Georgia Institute of Technology-Main Campus",1,0,2008,"4395","1006.807755","964","1674","2633",838,1795,974,"604",370,0.4415,0.3365,0.3699,0.6358
"2146",139755,"Georgia Institute of Technology-Main Campus",1,0,2009,"4829","1051.641194","978","1558","2654",887,1767,1064,"638",426,0.4803,0.3611,0.4009,0.587
"2147",139755,"Georgia Institute of Technology-Main Campus",1,0,2010,"5873","1093.918233","990","1625","2706",976,1730,1111,"648",463,0.4744,0.3746,0.4106,0.6005
"2148",139764,"GEORGIA SOUTHWESTERN COLLEGE",0,1,1991,"1578","16.136682","111","241","322",190,132,70,"35",35,0.1842,0.2652,0.2174,0.7484
"2149",139764,"GEORGIA SOUTHWESTERN COLLEGE",0,1,1992,"1650","16.820867","114","283","375",243,132,75,"28",47,0.1934,0.2121,0.2,0.7547
"2150",139764,"GEORGIA SOUTHWESTERN COLLEGE",0,1,1993,"1680","19.471783","113","271","349",226,123,38,"6",32,0.1416,0.0488,0.1089,0.7765
"2151",139764,"GEORGIA SOUTHWESTERN STATE UNIVERSITY",0,1,1995,"1898","22.299201","104","200","328",211,117,26,"3",23,0.109,0.0256,0.0793,0.6098
"2152",139764,"GEORGIA SOUTHWESTERN STATE UNIVERSITY",0,1,1996,"2067","23.428673","110","206","315",199,116,43,"10",33,0.1658,0.0862,0.1365,0.654
"2153",139764,"GEORGIA SOUTHWESTERN STATE UNIVERSITY",0,1,1997,"2145","25.316984","107","306","449",283,166,85,"29",56,0.1979,0.1747,0.1893,0.6815
"2154",139764,"GEORGIA SOUTHWESTERN STATE UNIVERSITY",1,0,1998,"2199","27.739775","95","242","335",215,120,41,"5",36,0.1674,0.0417,0.1224,0.7224
"2155",139764,"GEORGIA SOUTHWESTERN STATE UNIVERSITY",1,0,1999,"1808","28.866142","98","175","259",161,98,42,"14",28,0.1739,0.1429,0.1622,0.6757
"2156",139764,"GEORGIA SOUTHWESTERN STATE UNIVERSITY",1,0,2000,"1876","29.773788","99.5","228","308",202,106,44,"15",29,0.1436,0.1415,0.1429,0.7403
"2157",139764,"GEORGIA SOUTHWESTERN STATE UNIVERSITY",1,0,2001,"1932","32.716383","101","193","266",173,93,31,"8",23,0.1329,0.086,0.1165,0.7256
"2158",139764,"GEORGIA SOUTHWESTERN STATE UNIVERSITY",1,0,2002,"2010","31.873243","107","215","331",216,115,46,"15",31,0.1435,0.1304,0.139,0.6495
"2159",139764,"GEORGIA SOUTHWESTERN STATE UNIVERSITY",1,0,2003,"2212","30.435301","100","166","326",222,104,48,"13",35,0.1577,0.125,0.1472,0.5092
"2160",139764,"GEORGIA SOUTHWESTERN STATE UNIVERSITY",1,0,2004,"2322","29.86269","90","210","359",247,112,40,"6",34,0.1377,0.0536,0.1114,0.585
"2161",139764,"Georgia Southwestern State University",1,0,2005,"2438","30.520716","83","213","358",200,158,36,"9",27,0.135,0.057,0.1006,0.595
"2162",139764,"Georgia Southwestern State University",1,0,2006,"2548","31.475186","90","222","399",236,163,52,"11",41,0.1737,0.0675,0.1303,0.5564
"2163",139764,"Georgia Southwestern State University",1,0,2007,"2706","33.735259","92","244","388",252,136,59,"16",43,0.1706,0.1176,0.1521,0.6289
"2164",139764,"Georgia Southwestern State University",1,0,2008,"2838","34.306119","99","237","418",240,178,42,"16",26,0.1083,0.0899,0.1005,0.567
"2165",139764,"Georgia Southwestern State University",1,0,2009,"2907","37.371929","96","257","435",251,184,49,"16",33,0.1315,0.087,0.1126,0.5908
"2166",139764,"Georgia Southwestern State University",1,0,2010,"3133","41.238333","102","298","473",284,189,64,"13",51,0.1796,0.0688,0.1353,0.63
"2167",139861,"GEORGIA COLLEGE",0,1,1991,"1563","26.678054","155","605","770",476,294,126,"35",91,0.1912,0.119,0.1636,0.7857
"2168",139861,"GEORGIA COLLEGE",0,1,1992,"1632","28.551448","172","582","754",451,303,112,"23",89,0.1973,0.0759,0.1485,0.7719
"2169",139861,"GEORGIA COLLEGE",0,1,1993,"1693","32.008913","177","589","809",520,289,122,"18",104,0.2,0.0623,0.1508,0.7281
"2170",139861,"GEORGIA COLLEGE",0,1,1995,"1820","39.107837","189","624","754",467,287,123,"28",95,0.2034,0.0976,0.1631,0.8276
"2171",139861,"GEORGIA COLLEGE AND STATE UNIVERSITY",0,1,1996,"1923","49.798584","196","603","715",483,232,119,"23",96,0.1988,0.0991,0.1664,0.8434
"2172",139861,"GEORGIA COLLEGE AND STATE UNIVERSITY",0,1,1997,"2064","53.084508","186","702","818",528,290,130,"31",99,0.1875,0.1069,0.1589,0.8582
"2173",139861,"GEORGIA COLLEGE AND STATE UNIVERSITY",1,0,1998,"2136","49.636677","198","654","750",470,280,127,"22",105,0.2234,0.0786,0.1693,0.872
"2174",139861,"GEORGIA COLLEGE AND STATE UNIVERSITY",1,0,1999,"1808","50.166046","200","709","786",486,300,164,"36",128,0.2634,0.12,0.2087,0.902
"2175",139861,"GEORGIA COLLEGE AND STATE UNIVERSITY",1,0,2000,"1876","52.990558","224.5","707","820",506,314,189,"41",148,0.2925,0.1306,0.2305,0.8622
"2176",139861,"GEORGIA COLLEGE AND STATE UNIVERSITY",1,0,2001,"2532","55.246775","249","791","879",556,323,203,"52",151,0.2716,0.161,0.2309,0.8999
"2177",139861,"GEORGIA COLLEGE AND STATE UNIVERSITY",1,0,2002,"2610","64.727452","276","903","984",612,372,199,"45",154,0.2516,0.121,0.2022,0.9177
"2178",139861,"GEORGIA COLLEGE AND STATE UNIVERSITY",1,0,2003,"3002","72.408162","276","944","1027",611,416,254,"69",185,0.3028,0.1659,0.2473,0.9192
"2179",139861,"GEORGIA COLLEGE AND STATE UNIVERSITY",1,0,2004,"3152","74.506053","280","841","918",582,336,322,"90",232,0.3986,0.2679,0.3508,0.9161
"2180",139861,"Georgia College and State University",1,0,2005,"3404","69.619601","268","941","1032",631,401,342,"101",241,0.3819,0.2519,0.3314,0.9118
"2181",139861,"Georgia College & State University",1,0,2006,"3608","77.099606","276","1009","1137",707,430,403,"101",302,0.4272,0.2349,0.3544,0.8874
"2182",139861,"Georgia College & State University",1,0,2007,"3892","81.982305","262","1077","1197",778,419,464,"124",340,0.437,0.2959,0.3876,0.8997
"2183",139861,"Georgia College & State University",1,0,2008,"4113","102.222813","280","1015","1177",751,426,470,"136",334,0.4447,0.3192,0.3993,0.8624
"2184",139861,"Georgia College & State University",1,0,2009,"4520","99.542327","301","1047","1206",741,465,476,"138",338,0.4561,0.2968,0.3947,0.8682
"2185",139861,"Georgia College & State University",1,0,2010,"5013","98.450927","316","1001","1202",767,435,505,"138",367,0.4785,0.3172,0.4201,0.8328
"2186",139931,"GEORGIA SOUTHERN UNIVERSITY",0,1,1991,"1620","77.854395","555","2145","2737",1457,1280,508,"172",336,0.2306,0.1344,0.1856,0.7837
"2187",139931,"GEORGIA SOUTHERN UNIVERSITY",0,1,1992,"1638","84.559324","575","2046","2828",1530,1298,506,"174",332,0.217,0.1341,0.1789,0.7235
"2188",139931,"GEORGIA SOUTHERN UNIVERSITY",0,1,1993,"1807","100.591366","621","2032","2955",1602,1353,540,"158",382,0.2385,0.1168,0.1827,0.6876
"2189",139931,"GEORGIA SOUTHERN UNIVERSITY",0,1,1995,"1965","118.565567","627","2175","3193",1825,1368,407,"112",295,0.1616,0.0819,0.1275,0.6812
"2190",139931,"GEORGIA SOUTHERN UNIVERSITY",0,1,1996,"2055","125.892346","632","2196","3159",1699,1460,385,"115",270,0.1589,0.0788,0.1219,0.6952
"2191",139931,"GEORGIA SOUTHERN UNIVERSITY",0,1,1997,"2256","134.306359","639","1883","2596",1387,1209,306,"81",225,0.1622,0.067,0.1179,0.7253
"2192",139931,"GEORGIA SOUTHERN UNIVERSITY",1,0,1998,"2349","144.42565","641","1973","2897",1549,1348,335,"87",248,0.1601,0.0645,0.1156,0.681
"2193",139931,"GEORGIA SOUTHERN UNIVERSITY",1,0,1999,"1808","153.40787","651","2218","3266",1729,1537,384,"98",286,0.1654,0.0638,0.1176,0.6791
"2194",139931,"GEORGIA SOUTHERN UNIVERSITY",1,0,2000,"1876","159.551681","638","2004","2859",1481,1378,379,"105",274,0.185,0.0762,0.1326,0.7009
"2195",139931,"GEORGIA SOUTHERN UNIVERSITY",1,0,2001,"1932","164.75407","625","1939","2632",1278,1354,435,"110",325,0.2543,0.0812,0.1653,0.7367
"2196",139931,"GEORGIA SOUTHERN UNIVERSITY",1,0,2002,"2010","153.340933","604","1976","2597",1232,1365,434,"138",296,0.2403,0.1011,0.1671,0.7609
"2197",139931,"GEORGIA SOUTHERN UNIVERSITY",1,0,2003,"2212","158.350497","640","2090","2735",1305,1430,466,"145",321,0.246,0.1014,0.1704,0.7642
"2198",139931,"GEORGIA SOUTHERN UNIVERSITY",1,0,2004,"2322","160.96016","664","2248","2982",1393,1589,546,"158",388,0.2785,0.0994,0.1831,0.7539
"2199",139931,"Georgia Southern University",1,0,2005,"2438","168.879312","645","2303","3123",1472,1651,623,"195",428,0.2908,0.1181,0.1995,0.7374
"2200",139931,"Georgia Southern University",1,0,2006,"2548","185.086091","673","2084","2731",1294,1437,617,"214",403,0.3114,0.1489,0.2259,0.7631
"2201",139931,"Georgia Southern University",1,0,2007,"2744","203.9072","714","1317","3028",1402,1626,773,"287",486,0.3466,0.1765,0.2553,0.4349
"2202",139931,"Georgia Southern University",1,0,2008,"2898","220.942431","741","2175","3106",1453,1653,828,"300",528,0.3634,0.1815,0.2666,0.7003
"2203",139931,"Georgia Southern University",1,0,2009,"3178","241.160856","751","2416","3490",1683,1807,854,"292",562,0.3339,0.1616,0.2447,0.6923
"2204",139931,"Georgia Southern University",1,0,2010,"3283","257.714225","761","2339","3597",1785,1812,950,"305",645,0.3613,0.1683,0.2641,0.6503
"2205",139940,"GEORGIA STATE UNIVERSITY",0,1,1991,"1884","148.132609","759","652","1007",598,409,103,"34",69,0.1154,0.0831,0.1023,0.6475
"2206",139940,"GEORGIA STATE UNIVERSITY",0,1,1992,"1952","152.277623","769","639","998",574,424,96,"36",60,0.1045,0.0849,0.0962,0.6403
"2207",139940,"GEORGIA STATE UNIVERSITY",0,1,1993,"2019","168.410574","793","622","1072",613,459,119,"33",86,0.1403,0.0719,0.111,0.5802
"2208",139940,"GEORGIA STATE UNIVERSITY",0,1,1995,"2249","206.749347","800","626","1276",750,526,127,"51",76,0.1013,0.097,0.0995,0.4906
"2209",139940,"GEORGIA STATE UNIVERSITY",0,1,1996,"2385","220.962918","814","779","1551",985,566,211,"58",153,0.1553,0.1025,0.136,0.5023
"2210",139940,"GEORGIA STATE UNIVERSITY",0,1,1997,"2673","259.304925","845","979","1906",1172,734,211,"60",151,0.1288,0.0817,0.1107,0.5136
"2211",139940,"GEORGIA STATE UNIVERSITY",1,0,1998,"2778","292.831154","864","831","1491",924,567,208,"63",145,0.1569,0.1111,0.1395,0.5573
"2212",139940,"GEORGIA STATE UNIVERSITY",1,0,1999,"2414","316.171116","943","1002","1772",1082,690,242,"69",173,0.1599,0.1,0.1366,0.5655
"2213",139940,"GEORGIA STATE UNIVERSITY",1,0,2000,"2506","319.378301","940.5","1048","2061",1233,828,303,"85",218,0.1768,0.1027,0.147,0.5085
"2214",139940,"GEORGIA STATE UNIVERSITY",1,0,2001,"2632","357.34066","938","1006","2136",1305,831,357,"99",258,0.1977,0.1191,0.1671,0.471
"2215",139940,"GEORGIA STATE UNIVERSITY",1,0,2002,"2790","378.826376","1000","1208","2469",1419,1050,423,"107",316,0.2227,0.1019,0.1713,0.4893
"2216",139940,"GEORGIA STATE UNIVERSITY",1,0,2003,"3208","389.396091","944","956","1920",1159,761,349,"114",235,0.2028,0.1498,0.1818,0.4979
"2217",139940,"GEORGIA STATE UNIVERSITY",1,0,2004,"3368","400.738734","981","1111","2272",1338,934,389,"132",257,0.1921,0.1413,0.1712,0.489
"2218",139940,"Georgia State University",1,0,2005,"3638","402.610596","998","1018","2325",1322,1003,408,"164",244,0.1846,0.1635,0.1755,0.4378
"2219",139940,"Georgia State University",1,0,2006,"3856","432.928448","994","940","2174",1313,861,439,"135",304,0.2315,0.1568,0.2019,0.4324
"2220",139940,"Georgia State University",1,0,2007,"4159","428.173736","1046","1005","2521",1486,1035,540,"154",386,0.2598,0.1488,0.2142,0.3987
"2221",139940,"Georgia State University",1,0,2008,"4856","513.552094","1064","732","2743",1609,1134,614,"206",408,0.2536,0.1817,0.2238,0.2669
"2222",139940,"Georgia State University",1,0,2009,"6070","522.91678","1052","1095","2937",1745,1192,702,"233",469,0.2688,0.1955,0.239,0.3728
"2223",139940,"Georgia State University",1,0,2010,"7070","531.620006","1067","998","2853",1540,1313,669,"240",429,0.2786,0.1828,0.2345,0.3498
"2224",139959,"UNIVERSITY OF GEORGIA",0,1,1991,"2076","497.490574","1728","2931","3408",1927,1481,1191,"429",762,0.3954,0.2897,0.3495,0.86
"2225",139959,"UNIVERSITY OF GEORGIA",0,1,1992,"2175","491.605846","1668","2697","3147",1823,1324,1456,"521",935,0.5129,0.3935,0.4627,0.857
"2226",139959,"UNIVERSITY OF GEORGIA",0,1,1993,"2250","532.743588","1658","3324","3808",2115,1693,1617,"630",987,0.4667,0.3721,0.4246,0.8729
"2227",139959,"UNIVERSITY OF GEORGIA",0,1,1995,"2542","644.748056","1689","3379","3996",2376,1620,1702,"570",1132,0.4764,0.3519,0.4259,0.8456
"2228",139959,"UNIVERSITY OF GEORGIA",0,1,1996,"2694","689.914153","1708","3239","3671",2184,1487,1546,"494",1052,0.4817,0.3322,0.4211,0.8823
"2229",139959,"UNIVERSITY OF GEORGIA",0,1,1997,"2838","735.012941","1700","3856","4348",2544,1804,1729,"569",1160,0.456,0.3154,0.3977,0.8868
"2230",139959,"UNIVERSITY OF GEORGIA",1,0,1998,"2930","769.256438","1705","3855","4384",2588,1796,1771,"535",1236,0.4776,0.2979,0.404,0.8793
"2231",139959,"UNIVERSITY OF GEORGIA",1,0,1999,"2414","793.657179","1719","3842","4375",2586,1789,1860,"592",1268,0.4903,0.3309,0.4251,0.8782
"2232",139959,"UNIVERSITY OF GEORGIA",1,0,2000,"2506","883.661895","1723","3669","4207",2556,1651,1911,"584",1327,0.5192,0.3537,0.4542,0.8721
"2233",139959,"UNIVERSITY OF GEORGIA",1,0,2001,"2632","926.951047","1727","3950","4459",2646,1813,2137,"677",1460,0.5518,0.3734,0.4793,0.8858
"2234",139959,"UNIVERSITY OF GEORGIA",1,0,2002,"2790","854.93174","1705","3752","4282",2570,1712,2155,"713",1442,0.5611,0.4165,0.5033,0.8762
"2235",139959,"UNIVERSITY OF GEORGIA",1,0,2003,"3208","934.305212","1690","4469","5157",3146,2011,2535,"807",1728,0.5493,0.4013,0.4916,0.8666
"2236",139959,"UNIVERSITY OF GEORGIA",1,0,2004,"3368","942.532849","1661","3918","4500",2724,1776,2335,"774",1561,0.5731,0.4358,0.5189,0.8707
"2237",139959,"University of Georgia",1,0,2005,"3638","931.59988","1691","3697","4654",2812,1842,2505,"845",1660,0.5903,0.4587,0.5382,0.7944
"2238",139959,"University of Georgia",1,0,2006,"3856","1017.933224","1735","4018","5059",3161,1898,2732,"900",1832,0.5796,0.4742,0.54,0.7942
"2239",139959,"University of Georgia",1,0,2007,"4159","1055.795456","1733","3741","4675",2942,1733,2655,"853",1802,0.6125,0.4922,0.5679,0.8002
"2240",139959,"University of Georgia",1,0,2008,"4395","1123.218995","1761","3759","4778",3013,1765,2853,"924",1929,0.6402,0.5235,0.5971,0.7867
"2241",139959,"University of Georgia",1,0,2009,"4828","1138.522399","1775","3610","4675",2862,1813,2881,"951",1930,0.6744,0.5245,0.6163,0.7722
"2242",139959,"University of Georgia",1,0,2010,"5873","1123.921055","1749","3345","4667",2886,1781,2903,"961",1942,0.6729,0.5396,0.622,0.7167
"2243",140447,"MERCER UNIVERSITY",0,1,1991,"9450","81.443751","234","544","670",347,323,230,"100",130,0.3746,0.3096,0.3433,0.8119
"2244",140447,"MERCER UNIVERSITY",0,1,1992,"10287","83.419406","238","428","579",349,230,158,"45",113,0.3238,0.1957,0.2729,0.7392
"2245",140447,"MERCER UNIVERSITY",0,1,1993,"11160","88.389029","246","480","639",378,261,243,"85",158,0.418,0.3257,0.3803,0.7512
"2246",140447,"MERCER UNIVERSITY",0,1,1995,"12987","107.790755","255","439","630",381,249,199,"65",134,0.3517,0.261,0.3159,0.6968
"2247",140447,"MERCER UNIVERSITY",0,1,1996,"13896","113.803823","253","487","681",432,249,228,"63",165,0.3819,0.253,0.3348,0.7151
"2248",140447,"MERCER UNIVERSITY",0,1,1997,"14656","109.961904","313","456","679",428,251,215,"70",145,0.3388,0.2789,0.3166,0.6716
"2249",140447,"MERCER UNIVERSITY",1,0,1998,"15465","118.759028","307","490","706",428,278,221,"74",147,0.3435,0.2662,0.313,0.6941
"2250",140447,"MERCER UNIVERSITY",1,0,1999,"16290","124.711601","314","457","730",449,281,254,"79",175,0.3898,0.2811,0.3479,0.626
"2251",140447,"MERCER UNIVERSITY",1,0,2000,"17028","135.802884","316","444","733",438,295,223,"71",152,0.347,0.2407,0.3042,0.6057
"2252",140447,"MERCER UNIVERSITY",1,0,2001,"18290","142.032357","318","567","767",472,295,257,"73",184,0.3898,0.2475,0.3351,0.7392
"2253",140447,"MERCER UNIVERSITY",1,0,2002,"19728","159.750978","320","500","687",387,300,275,"93",182,0.4703,0.31,0.4003,0.7278
"2254",140447,"MERCER UNIVERSITY",1,0,2003,"20796","160.636557","320","478","663",381,282,292,"88",204,0.5354,0.3121,0.4404,0.721
"2255",140447,"MERCER UNIVERSITY",1,0,2004,"22050","166.443525","318","447","632",373,259,270,"90",180,0.4826,0.3475,0.4272,0.7073
"2256",140447,"Mercer University",1,0,2005,"23460","171.569345","343","461","666",408,258,267,"86",181,0.4436,0.3333,0.4009,0.6922
"2257",140447,"Mercer University",1,0,2006,"25056","186.883217","349","391","582",300,282,253,"98",155,0.5167,0.3475,0.4347,0.6718
"2258",140447,"Mercer University",1,0,2007,"26760","175.376311","349","352","602",337,265,265,"87",178,0.5282,0.3283,0.4402,0.5847
"2259",140447,"Mercer University",1,0,2008,"28500","182.648217","348","387","615",365,250,298,"94",204,0.5589,0.376,0.4846,0.6293
"2260",140447,"Mercer University",1,0,2009,"29340","195.632274","359","374","628",349,279,294,"108",186,0.533,0.3871,0.4682,0.5955
"2261",140447,"Mercer University",1,0,2010,"30360","205.642103","380","368","596",301,295,293,"116",177,0.588,0.3932,0.4916,0.6174
"2262",140960,"SAVANNAH STATE COLLEGE",0,1,1991,"1635","22.276385","121","7","737",394,343,75,"28",47,0.1193,0.0816,0.1018,0.0095
"2263",140960,"SAVANNAH STATE COLLEGE",0,1,1992,"1686","23.92359","130","10","636",346,290,50,"15",35,0.1012,0.0517,0.0786,0.0157
"2264",140960,"SAVANNAH STATE COLLEGE",0,1,1993,"1741","26.909869","145","9","760",391,369,48,"15",33,0.0844,0.0407,0.0632,0.0118
"2265",140960,"SAVANNAH STATE UNIVERSITY",0,1,1995,"1965","31.865901","137","13","676",358,318,25,"2",23,0.0642,0.0063,0.037,0.0192
"2266",140960,"SAVANNAH STATE UNIVERSITY",0,1,1996,"2130","32.827942","146","6","483",268,215,13,"3",10,0.0373,0.014,0.0269,0.0124
"2267",140960,"SAVANNAH STATE UNIVERSITY",0,1,1997,"2226","43.86031","147","8","455",240,215,19,"4",15,0.0625,0.0186,0.0418,0.0176
"2268",140960,"SAVANNAH STATE UNIVERSITY",1,0,1998,"2278","47.443791","143","6","321",179,142,23,"5",18,0.1006,0.0352,0.0717,0.0187
"2269",140960,"SAVANNAH STATE UNIVERSITY",1,0,1999,"1808","48.674112","142","10","281",150,131,18,"4",14,0.0933,0.0305,0.0641,0.0356
"2270",140960,"SAVANNAH STATE UNIVERSITY",1,0,2000,"1826","49.420892","130","16","370",195,175,35,"7",28,0.1436,0.04,0.0946,0.0432
"2271",140960,"SAVANNAH STATE UNIVERSITY",1,0,2001,"1932","54.951306","118","10","440",238,202,58,"13",45,0.1891,0.0644,0.1318,0.0227
"2272",140960,"SAVANNAH STATE UNIVERSITY",1,0,2002,"2010","39.821557","122","3","496",269,227,52,"7",45,0.1673,0.0308,0.1048,0.006
"2273",140960,"SAVANNAH STATE UNIVERSITY",1,0,2003,"2212","40.94207","114","7","607",354,253,76,"12",64,0.1808,0.0474,0.1252,0.0115
"2274",140960,"SAVANNAH STATE UNIVERSITY",1,0,2004,"2322","42.839104","123","12","568",316,252,73,"22",51,0.1614,0.0873,0.1285,0.0211
"2275",140960,"Savannah State University",1,0,2005,"2438","44.370963","123","14","806",427,379,73,"16",57,0.1335,0.0422,0.0906,0.0174
"2276",140960,"Savannah State University",1,0,2006,"2548","45.560682","114","9","697",377,320,60,"12",48,0.1273,0.0375,0.0861,0.0129
"2277",140960,"Savannah State University",1,0,2007,"2706","47.275338","116","8","612",343,269,51,"10",41,0.1195,0.0372,0.0833,0.0131
"2278",140960,"Savannah State University",1,0,2008,"3098","52.342957","149","8","905",490,415,71,"22",49,0.1,0.053,0.0785,0.0088
"2279",140960,"Savannah State University",1,0,2009,"3100","63.56044","151","16","866",448,418,68,"18",50,0.1116,0.0431,0.0785,0.0185
"2280",140960,"Savannah State University",1,0,2010,"4274","69.837897","157","35","953",504,449,81,"19",62,0.123,0.0423,0.085,0.0367
"2281",140988,"SHORTER COLLEGE",1,0,1991,"5810","8.543026","61","130","139",96,43,59,"18",41,0.4271,0.4186,0.4245,0.9353
"2282",140988,"SHORTER COLLEGE",1,0,1992,"6220","9.427774","58","157","175",118,57,65,"20",45,0.3814,0.3509,0.3714,0.8971
"2283",140988,"SHORTER COLLEGE",1,0,1993,"6670","10.207097","55","156","165",112,53,60,"15",45,0.4018,0.283,0.3636,0.9455
"2284",140988,"SHORTER COLLEGE",1,0,1995,"7610","12.403241","63","150","167",118,49,76,"24",52,0.4407,0.4898,0.4551,0.8982
"2285",140988,"SHORTER COLLEGE",1,0,1996,"7860","13.590423","62","181","204",134,70,75,"22",53,0.3955,0.3143,0.3676,0.8873
"2286",140988,"SHORTER COLLEGE",1,0,1997,"8260","13.520945","60","222","242",162,80,90,"26",64,0.3951,0.325,0.3719,0.9174
"2287",140988,"SHORTER COLLEGE",1,0,1998,"8770","12.495862","57","221","247",167,80,86,"22",64,0.3832,0.275,0.3482,0.8947
"2288",140988,"SHORTER COLLEGE",1,0,1999,"9050","13.870712","61","227","259",171,88,103,"32",71,0.4152,0.3636,0.3977,0.8764
"2289",140988,"SHORTER COLLEGE",1,0,2000,"9350","14.859364","62.5","268","299",205,94,105,"23",82,0.4,0.2447,0.3512,0.8963
"2290",140988,"SHORTER COLLEGE",1,0,2001,"9800","16.024006","64","228","258",186,72,92,"20",72,0.3871,0.2778,0.3566,0.8837
"2291",140988,"SHORTER COLLEGE",1,0,2002,"10400","17.891243","64","191","218",144,74,80,"23",57,0.3958,0.3108,0.367,0.8761
"2292",140988,"SHORTER COLLEGE",1,0,2003,"11440","18.020294","65","155","184",96,88,80,"33",47,0.4896,0.375,0.4348,0.8424
"2293",140988,"SHORTER COLLEGE",1,0,2004,"12500","18.158053","67","194","226",128,98,95,"31",64,0.5,0.3163,0.4204,0.8584
"2294",140988,"Shorter College",1,0,2005,"13200","19.93552","72","222","291",133,158,101,"40",61,0.4586,0.2532,0.3471,0.7629
"2295",140988,"Shorter College",1,0,2006,"14000","17.663892","67","237","311",138,173,104,"42",62,0.4493,0.2428,0.3344,0.7621
"2296",140988,"Shorter College",1,0,2007,"14850","19.117167","69","215","276",131,145,91,"35",56,0.4275,0.2414,0.3297,0.779
"2297",140988,"Shorter College",1,0,2008,"15440","21.098852","77","247","330",163,167,117,"46",71,0.4356,0.2754,0.3545,0.7485
"2298",140988,"Shorter College",1,0,2009,"15950","23.00122","83","253","333",175,158,105,"32",73,0.4171,0.2025,0.3153,0.7598
"2299",140988,"Shorter University",1,0,2010,"16700","26.107102","85","311","446",216,230,121,"48",73,0.338,0.2087,0.2713,0.6973
"2300",141185,"TOCCOA FALLS COLLEGE",1,0,1991,"5208","7.396549","41","201","218",113,105,51,"25",26,0.2301,0.2381,0.2339,0.922
"2301",141185,"TOCCOA FALLS COLLEGE",1,0,1992,"5486","8.10709","39","186","201",114,87,53,"19",34,0.2982,0.2184,0.2637,0.9254
"2302",141185,"TOCCOA FALLS COLLEGE",1,0,1993,"6104","8.782683","40","161","165",105,60,47,"15",32,0.3048,0.25,0.2848,0.9758
"2303",141185,"TOCCOA FALLS COLLEGE",1,0,1995,"6628","10.535165","45","188","210",124,86,8,"2",6,0.0484,0.0233,0.0381,0.8952
"2304",141185,"TOCCOA FALLS COLLEGE",1,0,1996,"7005","11.594617","45","171","187",120,67,66,"22",44,0.3667,0.3284,0.3529,0.9144
"2305",141185,"TOCCOA FALLS COLLEGE",1,0,1997,"7395","12.469112","47","244","263",157,106,79,"29",50,0.3185,0.2736,0.3004,0.9278
"2306",141185,"TOCCOA FALLS COLLEGE",1,0,1998,"7763","13.914466","50","204","229",141,88,76,"24",52,0.3688,0.2727,0.3319,0.8908
"2307",141185,"TOCCOA FALLS COLLEGE",1,0,1999,"8384","13.589641","47","201","216",135,81,65,"19",46,0.3407,0.2346,0.3009,0.9306
"2308",141185,"TOCCOA FALLS COLLEGE",1,0,2000,"8888","15.125682","50","173","192",105,87,51,"13",38,0.3619,0.1494,0.2656,0.901
"2309",141185,"TOCCOA FALLS COLLEGE",1,0,2001,"9600","15.005635","53","171","198",124,74,71,"25",46,0.371,0.3378,0.3586,0.8636
"2310",141185,"TOCCOA FALLS COLLEGE",1,0,2002,"9900","15.414944","47","157","175",106,69,88,"37",51,0.4811,0.5362,0.5029,0.8971
"2311",141185,"TOCCOA FALLS COLLEGE",1,0,2003,"10850","14.608669","45","149","165",107,58,83,"22",61,0.5701,0.3793,0.503,0.903
"2312",141185,"TOCCOA FALLS COLLEGE",1,0,2004,"11450","15.111937","42","140","161",98,63,67,"20",47,0.4796,0.3175,0.4161,0.8696
"2313",141185,"Toccoa Falls College",1,0,2005,"12050","15.062195","43","199","223",135,88,84,"27",57,0.4222,0.3068,0.3767,0.8924
"2314",141185,"Toccoa Falls College",1,0,2006,"12900","16.970901","48","165","190",104,86,62,"18",44,0.4231,0.2093,0.3263,0.8684
"2315",141185,"Toccoa Falls College",1,0,2007,"13700","17.405521","49","190","218",128,90,75,"28",47,0.3672,0.3111,0.344,0.8716
"2316",141185,"Toccoa Falls College",1,0,2008,"14500","19.001936","50","135","155",93,62,63,"20",43,0.4624,0.3226,0.4065,0.871
"2317",141185,"Toccoa Falls College",1,0,2009,"15450","19.331027","50","140","168",109,59,59,"21",38,0.3486,0.3559,0.3512,0.8333
"2318",141185,"Toccoa Falls College",1,0,2010,"15760","18.351699","43","124","153",78,75,54,"16",38,0.4872,0.2133,0.3529,0.8105
"2319",141264,"VALDOSTA STATE COLLEGE",0,1,1991,"1638","42.782269","286","804","994",614,380,225,"78",147,0.2394,0.2053,0.2264,0.8089
"2320",141264,"VALDOSTA STATE COLLEGE",0,1,1992,"1689","44.824172","280","778","1057",608,449,146,"43",103,0.1694,0.0958,0.1381,0.736
"2321",141264,"VALDOSTA STATE UNIVERSITY",0,1,1993,"1729","53.086757","311","986","1357",807,550,211,"50",161,0.1995,0.0909,0.1555,0.7266
"2322",141264,"VALDOSTA STATE UNIVERSITY",0,1,1995,"1887","69.940716","375","1154","1665",985,680,247,"71",176,0.1787,0.1044,0.1483,0.6931
"2323",141264,"VALDOSTA STATE UNIVERSITY",0,1,1996,"2043","82.108039","392","1281","1838",1030,808,227,"65",162,0.1573,0.0804,0.1235,0.697
"2324",141264,"VALDOSTA STATE UNIVERSITY",0,1,1997,"2139","87.243174","409","1118","1594",947,647,179,"50",129,0.1362,0.0773,0.1123,0.7014
"2325",141264,"VALDOSTA STATE UNIVERSITY",1,0,1998,"2202","94.835256","431","973","1301",755,546,158,"44",114,0.151,0.0806,0.1214,0.7479
"2326",141264,"VALDOSTA STATE UNIVERSITY",1,0,1999,"1808","99.93351","461","876","1177",735,442,211,"52",159,0.2163,0.1176,0.1793,0.7443
"2327",141264,"VALDOSTA STATE UNIVERSITY",1,0,2000,"1876","98.534106","436","568","788",512,276,141,"49",92,0.1797,0.1775,0.1789,0.7208
"2328",141264,"VALDOSTA STATE UNIVERSITY",1,0,2001,"1932","102.304707","411","1123","1534",937,597,266,"67",199,0.2124,0.1122,0.1734,0.7321
"2329",141264,"VALDOSTA STATE UNIVERSITY",1,0,2002,"2010","89.419998","438","1183","1584",973,611,239,"54",185,0.1901,0.0884,0.1509,0.7468
"2330",141264,"VALDOSTA STATE UNIVERSITY",1,0,2003,"2212","100.796516","423","1334","1756",1007,749,262,"73",189,0.1877,0.0975,0.1492,0.7597
"2331",141264,"VALDOSTA STATE UNIVERSITY",1,0,2004,"2322","101.507171","420","1281","1690",969,721,279,"78",201,0.2074,0.1082,0.1651,0.758
"2332",141264,"Valdosta State University",1,0,2005,"2438","105.308416","435","1227","1775",1072,703,299,"69",230,0.2146,0.0982,0.1685,0.6913
"2333",141264,"Valdosta State University",1,0,2006,"2548","112.487349","438","1327","2015",1195,820,300,"78",222,0.1858,0.0951,0.1489,0.6586
"2334",141264,"Valdosta State University",1,0,2007,"2744","123.941775","441","1286","2029",1233,796,316,"86",230,0.1865,0.108,0.1557,0.6338
"2335",141264,"Valdosta State University",1,0,2008,"2898","133.896934","469","1245","2106",1223,883,344,"93",251,0.2052,0.1053,0.1633,0.5912
"2336",141264,"Valdosta State University",1,0,2009,"2978","148.485247","472","1271","2416",1421,995,365,"85",280,0.197,0.0854,0.1511,0.5261
"2337",141264,"Valdosta State University",1,0,2010,"3283","157.477266","499","1278","2528",1554,974,401,"100",301,0.1937,0.1027,0.1586,0.5055
"2338",141334,"WEST GEORGIA COLLEGE",0,1,1991,"1653","38.168033","246","901","1178",664,514,157,"43",114,0.1717,0.0837,0.1333,0.7649
"2339",141334,"WEST GEORGIA COLLEGE",0,1,1992,"2067","39.992769","255","896","1182",657,525,141,"39",102,0.1553,0.0743,0.1193,0.758
"2340",141334,"WEST GEORGIA COLLEGE",0,1,1993,"1766","45.204785","272","904","1263",738,525,97,"19",78,0.1057,0.0362,0.0768,0.7158
"2341",141334,"STATE UNIVERSITY OF WEST GEORGIA",0,1,1995,"2274","53.814116","283","1102","1430",841,589,128,"32",96,0.1141,0.0543,0.0895,0.7706
"2342",141334,"STATE UNIVERSITY OF WEST GEORGIA",0,1,1996,"2364","60.47179","289","1034","1296",801,495,141,"28",113,0.1411,0.0566,0.1088,0.7978
"2343",141334,"STATE UNIVERSITY OF WEST GEORGIA",0,1,1997,"2088","65.138221","286","924","1208",718,490,135,"29",106,0.1476,0.0592,0.1118,0.7649
"2344",141334,"STATE UNIVERSITY OF WEST GEORGIA",1,0,1998,"2158","71.176193","271","1168","1670",1042,628,166,"34",132,0.1267,0.0541,0.0994,0.6994
"2345",141334,"STATE UNIVERSITY OF WEST GEORGIA",1,0,1999,"1808","76.048797","318","1151","1604",1005,599,144,"34",110,0.1095,0.0568,0.0898,0.7176
"2346",141334,"STATE UNIVERSITY OF WEST GEORGIA",1,0,2000,"1876","81.072377","331.5","1220","1661",987,674,187,"34",153,0.155,0.0504,0.1126,0.7345
"2347",141334,"STATE UNIVERSITY OF WEST GEORGIA",1,0,2001,"2468","88.222709","345","1177","1551",931,620,194,"34",160,0.1719,0.0548,0.1251,0.7589
"2348",141334,"STATE UNIVERSITY OF WEST GEORGIA",1,0,2002,"2010","92.611703","356","1190","1617",921,696,181,"41",140,0.152,0.0589,0.1119,0.7359
"2349",141334,"STATE UNIVERSITY OF WEST GEORGIA",1,0,2003,"2212","99.979087","308","1249","1738",1020,718,215,"47",168,0.1647,0.0655,0.1237,0.7186
"2350",141334,"STATE UNIVERSITY OF WEST GEORGIA",1,0,2004,"2322","109.311261","383","1198","1702",976,726,202,"67",135,0.1383,0.0923,0.1187,0.7039
"2351",141334,"University of West Georgia",1,0,2005,"2438","89.042683","383","1124","1640",966,674,212,"47",165,0.1708,0.0697,0.1293,0.6854
"2352",141334,"University of West Georgia",1,0,2006,"2548","101.38694","390","1096","1694",1002,692,254,"67",187,0.1866,0.0968,0.1499,0.647
"2353",141334,"University of West Georgia",1,0,2007,"2744","109.542911","396","1121","1803",1051,752,311,"93",218,0.2074,0.1237,0.1725,0.6217
"2354",141334,"University of West Georgia",1,0,2008,"2898","118.242391","412","1284","2008",1216,792,321,"88",233,0.1916,0.1111,0.1599,0.6394
"2355",141334,"University of West Georgia",1,0,2009,"3996","124.758173","430","885","1911",1095,816,298,"81",217,0.1982,0.0993,0.1559,0.4631
"2356",141334,"University of West Georgia",1,0,2010,"3696","135.502006","448","747","1844",1124,720,309,"79",230,0.2046,0.1097,0.1676,0.4051
"2357",141486,"CHAMINADE UNIVERSITY OF HONOLULU",1,0,1991,"6800","13.502894","56","31","122",73,49,23,"9",14,0.1918,0.1837,0.1885,0.2541
"2358",141486,"CHAMINADE UNIVERSITY OF HONOLULU",1,0,1992,"7600","13.7375","56","37","127",73,54,23,"8",15,0.2055,0.1481,0.1811,0.2913
"2359",141486,"CHAMINADE UNIVERSITY OF HONOLULU",1,0,1993,"9990","13.231195","59","25","84",50,34,17,"5",12,0.24,0.1471,0.2024,0.2976
"2360",141486,"CHAMINADE UNIVERSITY OF HONOLULU",1,0,1995,"10600","15.261173","57","41","123",72,51,31,"12",19,0.2639,0.2353,0.252,0.3333
"2361",141486,"CHAMINADE UNIVERSITY OF HONOLULU",1,0,1996,"10600","17.38635","45","45","152",100,52,31,"10",21,0.21,0.1923,0.2039,0.2961
"2362",141486,"CHAMINADE UNIVERSITY OF HONOLULU",1,0,1997,"10800","15.278924","50","47","146",105,41,30,"9",21,0.2,0.2195,0.2055,0.3219
"2363",141486,"CHAMINADE UNIVERSITY OF HONOLULU",1,0,1998,"11180","15.837203","50","51","186",122,64,40,"12",28,0.2295,0.1875,0.2151,0.2742
"2364",141486,"CHAMINADE UNIVERSITY OF HONOLULU",1,0,1999,"11600","17.040571","54","54","231",159,72,49,"12",37,0.2327,0.1667,0.2121,0.2338
"2365",141486,"CHAMINADE UNIVERSITY OF HONOLULU",1,0,2000,"12040","18.973611","56","59","237",163,74,45,"13",32,0.1963,0.1757,0.1899,0.2489
"2366",141486,"CHAMINADE UNIVERSITY OF HONOLULU",1,0,2001,"12500","19.083322","58","53","223",160,63,39,"11",28,0.175,0.1746,0.1749,0.2377
"2367",141486,"CHAMINADE UNIVERSITY OF HONOLULU",1,0,2002,"12950","21.344619","57","48","212",154,58,23,"8",15,0.0974,0.1379,0.1085,0.2264
"2368",141486,"CHAMINADE UNIVERSITY OF HONOLULU",1,0,2003,"13380","23.614722","63","72","254",174,80,54,"18",36,0.2069,0.225,0.2126,0.2835
"2369",141486,"CHAMINADE UNIVERSITY OF HONOLULU",1,0,2004,"13850","25.527738","67","64","247",167,80,62,"21",41,0.2455,0.2625,0.251,0.2591
"2370",141486,"Chaminade University of Honolulu",1,0,2005,"14330","26.863055","69","64","260",182,78,57,"12",45,0.2473,0.1538,0.2192,0.2462
"2371",141486,"Chaminade University of Honolulu",1,0,2006,"14820","29.235735","74","53","264",185,79,54,"17",37,0.2,0.2152,0.2045,0.2008
"2372",141486,"Chaminade University of Honolulu",1,0,2007,"15330","30.765853","74","61","242",156,86,65,"18",47,0.3013,0.2093,0.2686,0.2521
"2373",141486,"Chaminade University of Honolulu",1,0,2008,"16000","32.990589","61","29","236",161,75,69,"18",51,0.3168,0.24,0.2924,0.1229
"2374",141486,"Chaminade University of Honolulu",1,0,2009,"16900","34.584509","62","50","262",164,98,73,"25",48,0.2927,0.2551,0.2786,0.1908
"2375",141486,"Chaminade University of Honolulu",1,0,2010,"17600","35.082443","71","43","287",203,84,101,"29",72,0.3547,0.3452,0.3519,0.1498
"2376",141565,"UNIVERSITY OF HAWAII AT HILO",1,0,1991,"1240","36.20684","129","44","198",100,98,10,"2",8,0.08,0.0204,0.0505,0.2222
"2377",141565,"UNIVERSITY OF HAWAII AT HILO",1,0,1992,"1280","30.211413","142","51","286",173,113,23,"10",13,0.0751,0.0885,0.0804,0.1783
"2378",141565,"UNIVERSITY OF HAWAII AT HILO",1,0,1993,"1320","34.308954","141","71","310",190,120,20,"4",16,0.0842,0.0333,0.0645,0.229
"2379",141565,"UNIVERSITY OF HAWAII AT HILO",1,0,1995,"1426","38.492387","132","73","359",216,143,32,"5",27,0.125,0.035,0.0891,0.2033
"2380",141565,"UNIVERSITY OF HAWAII AT HILO",1,0,1996,"1826","35.360182","132","62","333",207,126,35,"11",24,0.1159,0.0873,0.1051,0.1862
"2381",141565,"UNIVERSITY OF HAWAII AT HILO",1,0,1997,"2186","38.34824","142","74","335",202,133,36,"11",25,0.1238,0.0827,0.1075,0.2209
"2382",141565,"UNIVERSITY OF HAWAII AT HILO",1,0,1998,"2258","37.925322","150","86","351",194,157,24,"11",13,0.067,0.0701,0.0684,0.245
"2383",141565,"UNIVERSITY OF HAWAII AT HILO",1,0,1999,"2280","41.846386","152","98","366",207,159,39,"11",28,0.1353,0.0692,0.1066,0.2678
"2384",141565,"UNIVERSITY OF HAWAII AT HILO",1,0,2000,"2280","41.507169","157","117","362",223,139,39,"13",26,0.1166,0.0935,0.1077,0.3232
"2385",141565,"UNIVERSITY OF HAWAII AT HILO",1,0,2001,"2304","46.304247","162","170","400",231,169,53,"17",36,0.1558,0.1006,0.1325,0.425
"2386",141565,"UNIVERSITY OF HAWAII AT HILO",1,0,2002,"2328","50.086349","161","144","404",238,166,57,"17",40,0.1681,0.1024,0.1411,0.3564
"2387",141565,"UNIVERSITY OF HAWAII AT HILO",1,0,2003,"2376","52.43117","167","197","423",274,149,54,"17",37,0.135,0.1141,0.1277,0.4657
"2388",141565,"UNIVERSITY OF HAWAII AT HILO",1,0,2004,"2424","55.266232","169","146","412",225,187,50,"18",32,0.1422,0.0963,0.1214,0.3544
"2389",141565,"University of Hawaii at Hilo",1,0,2005,"2472","61.164939","185","133","409",215,194,50,"15",35,0.1628,0.0773,0.1222,0.3252
"2390",141565,"University of Hawaii at Hilo",1,0,2006,"3000","70.972216","194","123","448",267,181,48,"9",39,0.1461,0.0497,0.1071,0.2746
"2391",141565,"University of Hawaii at Hilo",1,0,2007,"3528","76.379077","205","122","497",299,198,41,"11",30,0.1003,0.0556,0.0825,0.2455
"2392",141565,"University of Hawaii at Hilo",1,0,2008,"4056","90.602042","216","125","536",326,210,61,"16",45,0.138,0.0762,0.1138,0.2332
"2393",141565,"University of Hawaii at Hilo",1,0,2009,"4584","99.739715","217","93","460",269,191,54,"17",37,0.1375,0.089,0.1174,0.2022
"2394",141565,"University of Hawaii at Hilo",1,0,2010,"5112","100.821134","226","71","392",230,162,43,"13",30,0.1304,0.0802,0.1097,0.1811
"2395",141574,"UNIVERSITY OF HAWAII AT MANOA",1,0,1991,"1387","376.849761","1080","182","1462",794,668,117,"35",82,0.1033,0.0524,0.08,0.1245
"2396",141574,"UNIVERSITY OF HAWAII AT MANOA",1,0,1992,"1437","413.830325","1104","147","1485",823,662,158,"46",112,0.1361,0.0695,0.1064,0.099
"2397",141574,"UNIVERSITY OF HAWAII AT MANOA",1,0,1993,"1497","428.136401","1099","196","1551",899,652,141,"44",97,0.1079,0.0675,0.0909,0.1264
"2398",141574,"UNIVERSITY OF HAWAII AT MANOA",1,0,1995,"1631","466.611193","1039","164","1671",967,704,184,"57",127,0.1313,0.081,0.1101,0.0981
"2399",141574,"UNIVERSITY OF HAWAII AT MANOA",1,0,1996,"2421","449.161192","1090","168","1357",769,588,154,"45",109,0.1417,0.0765,0.1135,0.1238
"2400",141574,"UNIVERSITY OF HAWAII AT MANOA",1,0,1997,"2949","445.502639","1088","169","1439",807,632,174,"50",124,0.1537,0.0791,0.1209,0.1174
"2401",141574,"UNIVERSITY OF HAWAII AT MANOA",1,0,1998,"3046","483.988676","1054","149","1388",795,593,162,"55",107,0.1346,0.0927,0.1167,0.1073
"2402",141574,"UNIVERSITY OF HAWAII AT MANOA",1,0,1999,"3024","481.339849","1044","217","1421",793,628,164,"56",108,0.1362,0.0892,0.1154,0.1527
"2403",141574,"UNIVERSITY OF HAWAII AT MANOA",1,0,2000,"3024","478.764372","1016.5","294","1499",846,653,168,"48",120,0.1418,0.0735,0.1121,0.1961
"2404",141574,"UNIVERSITY OF HAWAII AT MANOA",1,0,2001,"3120","484.149346","989","330","1521",883,638,224,"61",163,0.1846,0.0956,0.1473,0.217
"2405",141574,"UNIVERSITY OF HAWAII AT MANOA",1,0,2002,"3216","599.3001","1039","435","1726",970,756,251,"74",177,0.1825,0.0979,0.1454,0.252
"2406",141574,"UNIVERSITY OF HAWAII AT MANOA",1,0,2003,"3312","606.846378","1069","545","1878",1035,843,307,"92",215,0.2077,0.1091,0.1635,0.2902
"2407",141574,"UNIVERSITY OF HAWAII AT MANOA",1,0,2004,"3408","639.514404","1078","578","1892",1039,853,325,"109",216,0.2079,0.1278,0.1718,0.3055
"2408",141574,"University of Hawaii at Manoa",1,0,2005,"3504","669.00639","1083","413","1923",1060,863,354,"128",226,0.2132,0.1483,0.1841,0.2148
"2409",141574,"University of Hawaii at Manoa",1,0,2006,"4320","728.327568","1119","402","1679",922,757,293,"107",186,0.2017,0.1413,0.1745,0.2394
"2410",141574,"University of Hawaii at Manoa",1,0,2007,"5136","774.959102","1136","401","1727",946,781,322,"111",211,0.223,0.1421,0.1865,0.2322
"2411",141574,"University of Hawaii at Manoa",1,0,2008,"5952","838.226522","1163","413","1808",1027,781,358,"114",244,0.2376,0.146,0.198,0.2284
"2412",141574,"University of Hawaii at Manoa",1,0,2009,"6768","908.664404","1138","406","1847",984,863,392,"155",237,0.2409,0.1796,0.2122,0.2198
"2413",141574,"University of Hawaii at Manoa",1,0,2010,"7584","826.217","1084","349","1776",984,792,439,"164",275,0.2795,0.2071,0.2472,0.1965
"2414",142276,"IDAHO STATE UNIVERSITY",1,0,1991,"1230","76.951782","421","972","1091",569,522,47,"14",33,0.058,0.0268,0.0431,0.8909
"2415",142276,"IDAHO STATE UNIVERSITY",1,0,1992,"1454","86.37766","439","982","1091",556,535,66,"22",44,0.0791,0.0411,0.0605,0.9001
"2416",142276,"IDAHO STATE UNIVERSITY",1,0,1993,"1602","93.994182","460","1043","1165",626,539,44,"12",32,0.0511,0.0223,0.0378,0.8953
"2417",142276,"IDAHO STATE UNIVERSITY",1,0,1995,"1570","106.85874","481","1256","1363",783,580,37,"6",31,0.0396,0.0103,0.0271,0.9215
"2418",142276,"IDAHO STATE UNIVERSITY",1,0,1996,"2125","119.239115","484","1274","1378",789,589,49,"15",34,0.0431,0.0255,0.0356,0.9245
"2419",142276,"IDAHO STATE UNIVERSITY",1,0,1997,"2424","122.853638","496","1281","1400",793,607,44,"11",33,0.0416,0.0181,0.0314,0.915
"2420",142276,"IDAHO STATE UNIVERSITY",1,0,1998,"2590","130.287279","509","1282","1442",787,655,52,"15",37,0.047,0.0229,0.0361,0.889
"2421",142276,"IDAHO STATE UNIVERSITY",1,0,1999,"0","143.395715","536","1205","1345",740,605,45,"10",35,0.0473,0.0165,0.0335,0.8959
"2422",142276,"IDAHO STATE UNIVERSITY",1,0,2000,"0","146.104691","564","1183","1345",781,564,51,"9",42,0.0538,0.016,0.0379,0.8796
"2423",142276,"IDAHO STATE UNIVERSITY",1,0,2001,"0","154.665596","592","1313","1485",783,702,53,"9",44,0.0562,0.0128,0.0357,0.8842
"2424",142276,"IDAHO STATE UNIVERSITY",1,0,2002,"0","157.03908","555","615","704",474,230,59,"5",54,0.1139,0.0217,0.0838,0.8736
"2425",142276,"IDAHO STATE UNIVERSITY",1,0,2003,"0","158.180499","547","692","787",499,288,53,"10",43,0.0862,0.0347,0.0673,0.8793
"2426",142276,"IDAHO STATE UNIVERSITY",1,0,2004,"0","171.185489","599","820","983",522,461,63,"18",45,0.0862,0.039,0.0641,0.8342
"2427",142276,"Idaho State University",1,0,2005,"0","188.019028","644","762","909",519,390,74,"22",52,0.1002,0.0564,0.0814,0.8383
"2428",142276,"Idaho State University",1,0,2006,"2689","195.727594","615","804","994",525,469,85,"23",62,0.1181,0.049,0.0855,0.8089
"2429",142276,"Idaho State University",1,0,2007,"2882","200.689245","617","803","998",526,472,88,"26",62,0.1179,0.0551,0.0882,0.8046
"2430",142276,"Idaho State University",1,0,2008,"3114","216.629911","618","827","1031",525,506,94,"35",59,0.1124,0.0692,0.0912,0.8021
"2431",142276,"Idaho State University",1,0,2009,"3318","214.709047","581","976","1189",599,590,122,"47",75,0.1252,0.0797,0.1026,0.8209
"2432",142276,"Idaho State University",1,0,2010,"3800","211.393246","593","650","1432",749,683,121,"34",87,0.1162,0.0498,0.0845,0.4539
"2433",142285,"UNIVERSITY OF IDAHO",1,0,1991,"1236","151.495672","527","1154","1273",524,749,140,"72",68,0.1298,0.0961,0.11,0.9065
"2434",142285,"UNIVERSITY OF IDAHO",1,0,1992,"1296","165.752216","520","1164","1290",574,716,173,"77",96,0.1672,0.1075,0.1341,0.9023
"2435",142285,"UNIVERSITY OF IDAHO",1,0,1993,"1426","173.035943","546","1167","1323",613,710,214,"71",143,0.2333,0.1,0.1618,0.8821
"2436",142285,"UNIVERSITY OF IDAHO",1,0,1995,"1620","195.428084","555","1113","1242",602,640,225,"78",147,0.2442,0.1219,0.1812,0.8961
"2437",142285,"UNIVERSITY OF IDAHO",1,0,1996,"1768","198.75906","637","1093","1201",574,627,222,"85",137,0.2387,0.1356,0.1848,0.9101
"2438",142285,"UNIVERSITY OF IDAHO",1,0,1997,"1942","204.26562","638","1220","1360",687,673,240,"82",158,0.23,0.1218,0.1765,0.8971
"2439",142285,"UNIVERSITY OF IDAHO",1,0,1998,"2136","209.491418","611","1319","1481",732,749,297,"112",185,0.2527,0.1495,0.2005,0.8906
"2440",142285,"UNIVERSITY OF IDAHO",1,0,1999,"0","220.869718","585","1295","1457",736,721,318,"123",195,0.2649,0.1706,0.2183,0.8888
"2441",142285,"UNIVERSITY OF IDAHO",1,0,2000,"0","235.342254","595","1346","1560",722,838,311,"127",184,0.2548,0.1516,0.1994,0.8628
"2442",142285,"UNIVERSITY OF IDAHO",1,0,2001,"0","265.261846","605","1455","1642",791,851,340,"122",218,0.2756,0.1434,0.2071,0.8861
"2443",142285,"UNIVERSITY OF IDAHO",1,0,2002,"0","287.864433","560","1384","1619",784,835,371,"153",218,0.2781,0.1832,0.2292,0.8548
"2444",142285,"UNIVERSITY OF IDAHO",1,0,2003,"0","276.08144","544","1370","1590",748,842,393,"163",230,0.3075,0.1936,0.2472,0.8616
"2445",142285,"UNIVERSITY OF IDAHO",1,0,2004,"0","277.676742","516","1346","1602",755,847,383,"147",236,0.3126,0.1736,0.2391,0.8402
"2446",142285,"University of Idaho",1,0,2005,"0","302.110577","525","1416","1673",823,850,386,"156",230,0.2795,0.1835,0.2307,0.8464
"2447",142285,"University of Idaho",1,0,2006,"0","308.345442","550","1339","1582",749,833,369,"150",219,0.2924,0.1801,0.2332,0.8464
"2448",142285,"University of Idaho",1,0,2007,"0","317.588762","564","1356","1615",764,851,402,"173",229,0.2997,0.2033,0.2489,0.8396
"2449",142285,"University of Idaho",1,0,2008,"0","334.568883","591","1401","1663",777,886,460,"202",258,0.332,0.228,0.2766,0.8425
"2450",142285,"University of Idaho",1,0,2009,"0","346.579566","572","1417","1754",841,913,512,"180",332,0.3948,0.1972,0.2919,0.8079
"2451",142285,"University of Idaho",1,0,2010,"0","349.067948","538","1430","1709",799,910,511,"226",285,0.3567,0.2484,0.299,0.8367
"2452",142461,"NORTHWEST NAZARENE COLLEGE",0,1,1991,"6966","12.149618","67","220","237",129,108,51,"17",34,0.2636,0.1574,0.2152,0.9283
"2453",142461,"NORTHWEST NAZARENE COLLEGE",0,1,1992,"8160","13.587047","65","253","284",162,122,82,"31",51,0.3148,0.2541,0.2887,0.8908
"2454",142461,"NORTHWEST NAZARENE COLLEGE",0,1,1993,"8766","15.356008","71","269","319",180,139,110,"42",68,0.3778,0.3022,0.3448,0.8433
"2455",142461,"NORTHWEST NAZARENE COLLEGE",0,1,1995,"11145","17.25169","85","37","320",183,137,86,"27",59,0.3224,0.1971,0.2688,0.1156
"2456",142461,"NORTHWEST NAZARENE COLLEGE",0,1,1996,"11685","17.199652","84","248","264",156,108,18,"4",14,0.0897,0.037,0.0682,0.9394
"2457",142461,"NORTHWEST NAZARENE COLLEGE",0,1,1997,"11823","16.395924","81","263","277",148,129,91,"37",54,0.3649,0.2868,0.3285,0.9495
"2458",142461,"NORTHWEST NAZARENE COLLEGE",0,1,1998,"12456","16.985467","81","299","310",193,117,101,"27",74,0.3834,0.2308,0.3258,0.9645
"2459",142461,"NORTHWEST NAZARENE UNIVERSITY",0,1,1999,"12510","18.741365","83","275","295",165,130,88,"31",57,0.3455,0.2385,0.2983,0.9322
"2460",142461,"NORTHWEST NAZARENE UNIVERSITY",1,0,2000,"12990","19.643109","85.5","228","240",137,103,74,"24",50,0.365,0.233,0.3083,0.95
"2461",142461,"NORTHWEST NAZARENE UNIVERSITY",1,0,2001,"13700","22.011776","88","236","265",150,115,83,"31",52,0.3467,0.2696,0.3132,0.8906
"2462",142461,"NORTHWEST NAZARENE UNIVERSITY",1,0,2002,"14520","23.367983","90","227","276",169,107,87,"38",49,0.2899,0.3551,0.3152,0.8225
"2463",142461,"NORTHWEST NAZARENE UNIVERSITY",1,0,2003,"15330","25.945527","89","206","241",153,88,89,"22",67,0.4379,0.25,0.3693,0.8548
"2464",142461,"NORTHWEST NAZARENE UNIVERSITY",1,0,2004,"15980","26.49978","95","205","247",159,88,99,"28",71,0.4465,0.3182,0.4008,0.83
"2465",142461,"Northwest Nazarene University",1,0,2005,"17280","27.144323","98","208","249",168,81,88,"24",64,0.381,0.2963,0.3534,0.8353
"2466",142461,"Northwest Nazarene University",1,0,2006,"18430","28.266434","89","199","247",128,119,86,"37",49,0.3828,0.3109,0.3482,0.8057
"2467",142461,"Northwest Nazarene University",1,0,2007,"19700","29.732802","98","166","220",139,81,70,"22",48,0.3453,0.2716,0.3182,0.7545
"2468",142461,"Northwest Nazarene University",1,0,2008,"20900","33.062421","101","236","301",169,132,96,"34",62,0.3669,0.2576,0.3189,0.7841
"2469",142461,"Northwest Nazarene University",1,0,2009,"21930","35.728363","102","204","263",151,112,95,"33",62,0.4106,0.2946,0.3612,0.7757
"2470",142461,"Northwest Nazarene University",1,0,2010,"22810","35.986947","108","166","253",151,102,78,"30",48,0.3179,0.2941,0.3083,0.6561
"2471",143084,"AUGUSTANA COLLEGE",0,1,1991,"11175","33.118552","141","455","526",296,230,337,"145",192,0.6486,0.6304,0.6407,0.865
"2472",143084,"AUGUSTANA COLLEGE",0,1,1992,"12009","34.016851","137","496","538",309,229,318,"119",199,0.644,0.5197,0.5911,0.9219
"2473",143084,"AUGUSTANA COLLEGE",0,1,1993,"12942","35.534631","137","446","498",290,208,309,"121",188,0.6483,0.5817,0.6205,0.8956
"2474",143084,"AUGUSTANA COLLEGE",0,1,1995,"14064","40.756228","131","549","605",352,253,394,"151",243,0.6903,0.5968,0.6512,0.9074
"2475",143084,"AUGUSTANA COLLEGE",0,1,1996,"14700","43.662838","135","521","574",345,229,397,"153",244,0.7072,0.6681,0.6916,0.9077
"2476",143084,"AUGUSTANA COLLEGE",0,1,1997,"15300","38.515836","145","507","564",328,236,400,"146",254,0.7744,0.6186,0.7092,0.8989
"2477",143084,"AUGUSTANA COLLEGE",0,1,1998,"16323","39.999652","147","527","567",321,246,389,"148",241,0.7508,0.6016,0.6861,0.9295
"2478",143084,"AUGUSTANA COLLEGE",0,1,1999,"16866","43.336878","139","517","565",338,227,402,"161",241,0.713,0.7093,0.7115,0.915
"2479",143084,"AUGUSTANA COLLEGE",0,1,2000,"17541","44.115997","140.5","564","610",359,251,443,"172",271,0.7549,0.6853,0.7262,0.9246
"2480",143084,"AUGUSTANA COLLEGE",0,1,2001,"18330","45.902267","142","511","550",310,240,392,"167",225,0.7258,0.6958,0.7127,0.9291
"2481",143084,"AUGUSTANA COLLEGE",0,1,2002,"19200","47.774239","142","565","601",349,252,417,"158",259,0.7421,0.627,0.6938,0.9401
"2482",143084,"AUGUSTANA COLLEGE",0,1,2003,"20397","50.382449","145","558","614",369,245,443,"153",290,0.7859,0.6245,0.7215,0.9088
"2483",143084,"AUGUSTANA COLLEGE",0,1,2004,"21672","51.93733","144","547","599",321,278,426,"178",248,0.7726,0.6403,0.7112,0.9132
"2484",143084,"Augustana College",0,1,2005,"22971","54.32142","149","614","679",383,296,474,"193",281,0.7337,0.652,0.6981,0.9043
"2485",143084,"Augustana College",0,1,2006,"24408","58.561121","164","625","692",392,300,505,"216",289,0.7372,0.72,0.7298,0.9032
"2486",143084,"Augustana College",0,1,2007,"25935","61.74849","173","576","713",418,295,525,"199",326,0.7799,0.6746,0.7363,0.8079
"2487",143084,"Augustana College",0,1,2008,"30150","66.426258","180","468","640",369,271,454,"179",275,0.7453,0.6605,0.7094,0.7312
"2488",143084,"Augustana College",0,1,2009,"31326","75.359417","174","512","616",342,274,434,"168",266,0.7778,0.6131,0.7045,0.8312
"2489",143084,"Augustana College",0,1,2010,"32235","66.418619","184","616","753",432,321,532,"206",326,0.7546,0.6417,0.7065,0.8181
"2490",143288,"BLACKBURN COLLEGE",1,0,1991,"7750","6.084678","35","91","116",44,72,23,"6",17,0.3864,0.0833,0.1983,0.7845
"2491",143288,"BLACKBURN COLLEGE",1,0,1992,"7750","5.817705","32","122","148",74,74,52,"17",35,0.473,0.2297,0.3514,0.8243
"2492",143288,"BLACKBURN COLLEGE",1,0,1993,"7820","5.299439","25","132","156",76,80,42,"15",27,0.3553,0.1875,0.2692,0.8462
"2493",143288,"BLACKBURN COLLEGE",1,0,1995,"6500","5.699062","27","142","157",66,91,37,"17",20,0.303,0.1868,0.2357,0.9045
"2494",143288,"BLACKBURN COLLEGE",1,0,1996,"6850","6.406186","28","120","142",72,70,35,"13",22,0.3056,0.1857,0.2465,0.8451
"2495",143288,"BLACKBURN COLLEGE",1,0,1997,"7425","52.110738","29","135","155",81,74,39,"11",28,0.3457,0.1486,0.2516,0.871
"2496",143288,"BLACKBURN COLLEGE",1,0,1998,"7880","5.451649","27","123","144",66,78,37,"16",21,0.3182,0.2051,0.2569,0.8542
"2497",143288,"BLACKBURN COLLEGE",1,0,1999,"7950","4.247773","31","130","145",76,69,44,"21",23,0.3026,0.3043,0.3034,0.8966
"2498",143288,"BLACKBURN COLLEGE",1,0,2000,"8190","7.075803","32","158","191",107,84,56,"18",38,0.3551,0.2143,0.2932,0.8272
"2499",143288,"BLACKBURN COLLEGE",1,0,2001,"8600","9.449292","33","120","162",95,67,60,"18",42,0.4421,0.2687,0.3704,0.7407
"2500",143288,"BLACKBURN COLLEGE",1,0,2002,"9200","9.613474","35","115","147",75,72,44,"16",28,0.3733,0.2222,0.2993,0.7823
"2501",143288,"BLACKBURN COLLEGE",1,0,2003,"9890","9.326467","35","140","176",82,94,49,"19",30,0.3659,0.2021,0.2784,0.7955
"2502",143288,"BLACKBURN COLLEGE",1,0,2004,"14600","8.99158","35","146","176",87,89,55,"23",32,0.3678,0.2584,0.3125,0.8295
"2503",143288,"Blackburn College",1,0,2005,"15040","10.342611","34","164","183",92,91,66,"30",36,0.3913,0.3297,0.3607,0.8962
"2504",143288,"Blackburn College",1,0,2006,"15700","11.021087","35","148","177",111,66,63,"17",46,0.4144,0.2576,0.3559,0.8362
"2505",143288,"Blackburn College",1,0,2007,"15770","11.56445","33","148","175",93,82,59,"23",36,0.3871,0.2805,0.3371,0.8457
"2506",143288,"Blackburn College",1,0,2008,"13500","11.398929","32","149","171",94,77,52,"18",34,0.3617,0.2338,0.3041,0.8713
"2507",143288,"Blackburn College",1,0,2009,"14176","11.870047","36","128","146",93,53,46,"18",28,0.3011,0.3396,0.3151,0.8767
"2508",143288,"Blackburn College",1,0,2010,"14176","11.392574","36","119","150",105,45,46,"9",37,0.3524,0.2,0.3067,0.7933
"2509",144005,"CHICAGO STATE UNIVERSITY",1,0,1991,"1784","47.923981","293","6","614",414,200,7,"3",4,0.0097,0.015,0.0114,0.0098
"2510",144005,"CHICAGO STATE UNIVERSITY",1,0,1992,"1868","49.315067","308","7","576",351,225,3,"2",1,0.0028,0.0089,0.0052,0.0122
"2511",144005,"CHICAGO STATE UNIVERSITY",1,0,1993,"2198","54.696528","351","8","641",432,209,7,"1",6,0.0139,0.0048,0.0109,0.0125
"2512",144005,"CHICAGO STATE UNIVERSITY",1,0,1995,"2336","62.264492","339","12","613",410,203,35,"3",32,0.078,0.0148,0.0571,0.0196
"2513",144005,"CHICAGO STATE UNIVERSITY",1,0,1996,"2420","71.093677","356","7","563",409,154,17,"4",13,0.0318,0.026,0.0302,0.0124
"2514",144005,"CHICAGO STATE UNIVERSITY",1,0,1997,"2496","75.284971","362","5","487",332,155,6,"1",5,0.0151,0.0065,0.0123,0.0103
"2515",144005,"CHICAGO STATE UNIVERSITY",1,0,1998,"2868","83.282217","355","9","601",399,202,10,"3",7,0.0175,0.0149,0.0166,0.015
"2516",144005,"CHICAGO STATE UNIVERSITY",1,0,1999,"2290","86.601364","329","8","461",329,132,9,"3",6,0.0182,0.0227,0.0195,0.0174
"2517",144005,"CHICAGO STATE UNIVERSITY",1,0,2000,"2364","95.939812","329","12","345",232,113,10,"5",5,0.0216,0.0442,0.029,0.0348
"2518",144005,"CHICAGO STATE UNIVERSITY",1,0,2001,"2484","99.000079","329","9","395",280,115,16,"3",13,0.0464,0.0261,0.0405,0.0228
"2519",144005,"CHICAGO STATE UNIVERSITY",1,0,2002,"2732","99.674052","322","12","438",302,136,11,"2",9,0.0298,0.0147,0.0251,0.0274
"2520",144005,"CHICAGO STATE UNIVERSITY",1,0,2003,"3168","94.563271","309","13","476",336,140,12,"4",8,0.0238,0.0286,0.0252,0.0273
"2521",144005,"CHICAGO STATE UNIVERSITY",1,0,2004,"4575","122.583667","305","12","563",367,196,17,"13",4,0.0109,0.0663,0.0302,0.0213
"2522",144005,"Chicago State University",1,0,2005,"4890","101.817917","306","8","405",268,137,15,"4",11,0.041,0.0292,0.037,0.0198
"2523",144005,"Chicago State University",1,0,2006,"5090","107.611929","301","9","359",254,105,16,"2",14,0.0551,0.019,0.0446,0.0251
"2524",144005,"Chicago State University",1,0,2007,"5440","117.131377","310","9","372",255,117,15,"4",11,0.0431,0.0342,0.0403,0.0242
"2525",144005,"Chicago State University",1,0,2008,"5914","128.952212","303","6","402",279,123,10,"4",6,0.0215,0.0325,0.0249,0.0149
"2526",144005,"Chicago State University",1,0,2009,"5976","131.26849","310","12","589",428,161,13,"6",7,0.0164,0.0373,0.0221,0.0204
"2527",144005,"Chicago State University",1,0,2010,"6145","134.610114","289","9","523",354,169,14,"2",12,0.0339,0.0118,0.0268,0.0172
"2528",144281,"COLUMBIA COLLEGE",1,0,1991,"6296","46.142008","157","384","846",439,407,21,"8",13,0.0296,0.0197,0.0248,0.4539
"2529",144281,"COLUMBIA COLLEGE",1,0,1992,"6664","51.051466","165","378","760",373,387,90,"42",48,0.1287,0.1085,0.1184,0.4974
"2530",144281,"COLUMBIA COLLEGE",1,0,1993,"6928","54.11192","171","409","817",398,419,95,"34",61,0.1533,0.0811,0.1163,0.5006
"2531",144281,"COLUMBIA COLLEGE",1,0,1995,"7670","64.408935","191","489","939",464,475,131,"67",64,0.1379,0.1411,0.1395,0.5208
"2532",144281,"COLUMBIA COLLEGE",1,0,1996,"8030","69.976234","196","484","868",411,457,130,"52",78,0.1898,0.1138,0.1498,0.5576
"2533",144281,"COLUMBIA COLLEGE CHICAGO",1,0,1997,"8498","59.4924","187","552","1078",519,559,147,"61",86,0.1657,0.1091,0.1364,0.5121
"2534",144281,"COLUMBIA COLLEGE CHICAGO",1,0,1998,"9544","67.200738","209","649","1210",588,622,229,"108",121,0.2058,0.1736,0.1893,0.5364
"2535",144281,"COLUMBIA COLLEGE CHICAGO",1,0,1999,"10690","74.006789","246","572","1134",560,574,225,"103",122,0.2179,0.1794,0.1984,0.5044
"2536",144281,"COLUMBIA COLLEGE CHICAGO",1,0,2000,"11600","86.101992","263.5","675","1265",640,625,330,"139",191,0.2984,0.2224,0.2609,0.5336
"2537",144281,"COLUMBIA COLLEGE CHICAGO",1,0,2001,"12524","97.441949","281","811","1448",767,681,353,"157",196,0.2555,0.2305,0.2438,0.5601
"2538",144281,"COLUMBIA COLLEGE CHICAGO",1,0,2002,"13714","107.88914","288","944","1589",854,735,401,"164",237,0.2775,0.2231,0.2524,0.5941
"2539",144281,"COLUMBIA COLLEGE CHICAGO",1,0,2003,"14880","123.671558","293","860","1446",777,669,389,"166",223,0.287,0.2481,0.269,0.5947
"2540",144281,"COLUMBIA COLLEGE CHICAGO",1,0,2004,"14880","129.410899","299","1030","1744",873,871,449,"217",232,0.2658,0.2491,0.2575,0.5906
"2541",144281,"Columbia College Chicago",1,0,2005,"15588","150.364266","302","1148","1795",933,862,504,"219",285,0.3055,0.2541,0.2808,0.6396
"2542",144281,"Columbia College Chicago",1,0,2006,"16328","168.53313","316","1229","1972",1025,947,547,"247",300,0.2927,0.2608,0.2774,0.6232
"2543",144281,"Columbia College Chicago",1,0,2007,"17104","185.619756","323","1344","2166",1148,1018,692,"313",379,0.3301,0.3075,0.3195,0.6205
"2544",144281,"Columbia College Chicago",1,0,2008,"17950","208.99151","342","1376","2329",1289,1040,690,"277",413,0.3204,0.2663,0.2963,0.5908
"2545",144281,"Columbia College Chicago",1,0,2009,"18490","222.875929","354","1173","2089",1170,919,616,"241",375,0.3205,0.2622,0.2949,0.5615
"2546",144281,"Columbia College-Chicago",1,0,2010,"19140","228.147668","364","1278","2209",1252,957,665,"258",407,0.3251,0.2696,0.301,0.5785
"2547",144740,"DEPAUL UNIVERSITY",0,1,1991,"9342","128.804544","470","748","1047",593,454,388,"147",241,0.4064,0.3238,0.3706,0.7144
"2548",144740,"DEPAUL UNIVERSITY",0,1,1992,"10014","142.220989","494","671","927",520,407,350,"119",231,0.4442,0.2924,0.3776,0.7238
"2549",144740,"DEPAUL UNIVERSITY",0,1,1993,"10590","151.393145","500","832","1182",701,481,416,"159",257,0.3666,0.3306,0.3519,0.7039
"2550",144740,"DEPAUL UNIVERSITY",0,1,1995,"11856","169.629224","500","861","1225",700,525,447,"177",270,0.3857,0.3371,0.3649,0.7029
"2551",144740,"DEPAUL UNIVERSITY",0,1,1996,"12780","192.116596","515","752","1122",668,454,483,"184",299,0.4476,0.4053,0.4305,0.6702
"2552",144740,"DEPAUL UNIVERSITY",0,1,1997,"13490","187.929","519","777","1211",713,498,566,"212",354,0.4965,0.4257,0.4674,0.6416
"2553",144740,"DEPAUL UNIVERSITY",0,1,1998,"14100","201.463","532","903","1448",852,596,591,"216",375,0.4401,0.3624,0.4081,0.6236
"2554",144740,"DEPAUL UNIVERSITY",0,1,1999,"14670","218.058","581","1037","1700",997,703,771,"299",472,0.4734,0.4253,0.4535,0.61
"2555",144740,"DEPAUL UNIVERSITY",0,1,2000,"15390","242.485","647.5","1232","1897",1140,757,852,"308",544,0.4772,0.4069,0.4491,0.6494
"2556",144740,"DEPAUL UNIVERSITY",0,1,2001,"16500","272.705138","714","1242","2042",1180,862,866,"325",541,0.4585,0.377,0.4241,0.6082
"2557",144740,"DEPAUL UNIVERSITY",0,1,2002,"17820","315.686","775","1271","2231",1323,908,985,"346",639,0.483,0.3811,0.4415,0.5697
"2558",144740,"DEPAUL UNIVERSITY",0,1,2003,"20555","338.177","832","1381","2249",1351,898,966,"341",625,0.4626,0.3797,0.4295,0.6141
"2559",144740,"DEPAUL UNIVERSITY",0,1,2004,"21669","354.129","839","1425","2304",1367,937,1097,"377",720,0.5267,0.4023,0.4761,0.6185
"2560",144740,"DePaul University",0,1,2005,"22789","343.253","834","1566","2392",1411,981,1168,"450",718,0.5089,0.4587,0.4883,0.6547
"2561",144740,"DePaul University",0,1,2006,"22365","352.61","850","1652","2531",1428,1103,1280,"482",798,0.5588,0.437,0.5057,0.6527
"2562",144740,"DePaul University",0,1,2007,"23820","367.955","870","1580","2513",1458,1055,1363,"522",841,0.5768,0.4948,0.5424,0.6287
"2563",144740,"DePaul University",0,1,2008,"25770","401.324","899","1574","2553",1502,1051,1430,"537",893,0.5945,0.5109,0.5601,0.6165
"2564",144740,"DePaul University",0,1,2009,"26765","434.34","919","1412","2523",1494,1029,1425,"538",887,0.5937,0.5228,0.5648,0.5597
"2565",144740,"DePaul University",0,1,2010,"28240","462.184","938","1337","2235",1307,928,1313,"501",812,0.6213,0.5399,0.5875,0.5982
"2566",144892,"EASTERN ILLINOIS UNIVERSITY",1,0,1991,"2358","99.245217","555","1342","1493",911,582,577,"185",392,0.4303,0.3179,0.3865,0.8989
"2567",144892,"EASTERN ILLINOIS UNIVERSITY",1,0,1992,"2533","98.153506","564","1309","1463",893,570,464,"132",332,0.3718,0.2316,0.3172,0.8947
"2568",144892,"EASTERN ILLINOIS UNIVERSITY",1,0,1993,"2600","99.217939","562","1457","1612",969,643,471,"112",359,0.3705,0.1742,0.2922,0.9038
"2569",144892,"EASTERN ILLINOIS UNIVERSITY",1,0,1995,"2777","110.409371","578","1349","1538",973,565,468,"117",351,0.3607,0.2071,0.3043,0.8771
"2570",144892,"EASTERN ILLINOIS UNIVERSITY",1,0,1996,"2905","113.795696","572","1451","1640",1000,640,505,"126",379,0.379,0.1969,0.3079,0.8848
"2571",144892,"EASTERN ILLINOIS UNIVERSITY",1,0,1997,"3078","121.7891","579","1373","1552",950,602,479,"121",358,0.3768,0.201,0.3086,0.8847
"2572",144892,"EASTERN ILLINOIS UNIVERSITY",1,0,1998,"3232","128.816683","568","1418","1604",984,620,547,"148",399,0.4055,0.2387,0.341,0.884
"2573",144892,"EASTERN ILLINOIS UNIVERSITY",1,0,1999,"2254","136.363384","558","1277","1478",929,549,482,"131",351,0.3778,0.2386,0.3261,0.864
"2574",144892,"EASTERN ILLINOIS UNIVERSITY",1,0,2000,"2910","144.944336","531.5","1294","1495",870,625,471,"151",320,0.3678,0.2416,0.3151,0.8656
"2575",144892,"EASTERN ILLINOIS UNIVERSITY",1,0,2001,"2993","153.746216","505","1216","1431",836,595,445,"135",310,0.3708,0.2269,0.311,0.8498
"2576",144892,"EASTERN ILLINOIS UNIVERSITY",1,0,2002,"3254","153.91178","554","1714","1984",1143,841,582,"183",399,0.3491,0.2176,0.2933,0.8639
"2577",144892,"EASTERN ILLINOIS UNIVERSITY",1,0,2003,"3563","154.469375","565","1682","1892",1098,794,563,"185",378,0.3443,0.233,0.2976,0.889
"2578",144892,"EASTERN ILLINOIS UNIVERSITY",1,0,2004,"3830","202.18929","599","1524","1725",1032,693,594,"177",417,0.4041,0.2554,0.3443,0.8835
"2579",144892,"Eastern Illinois University",1,0,2005,"4629","178.398588","605","1286","1645",967,678,521,"168",353,0.365,0.2478,0.3167,0.7818
"2580",144892,"Eastern Illinois University",1,0,2006,"5207","183.290867","609","1399","1760",1062,698,583,"164",419,0.3945,0.235,0.3312,0.7949
"2581",144892,"Eastern Illinois University",1,0,2007,"5832","196.036538","622","1259","1641",988,653,551,"171",380,0.3846,0.2619,0.3358,0.7672
"2582",144892,"Eastern Illinois University",1,0,2008,"6540","207.289294","643","1333","1764",1029,735,582,"196",386,0.3751,0.2667,0.3299,0.7557
"2583",144892,"Eastern Illinois University",1,0,2009,"7170","220.640117","630","1181","1637",997,640,520,"178",342,0.343,0.2781,0.3177,0.7214
"2584",144892,"Eastern Illinois University",1,0,2010,"6835","236.288982","617","1039","1446",892,554,492,"157",335,0.3756,0.2834,0.3402,0.7185
"2585",144962,"ELMHURST COLLEGE",1,0,1991,"8460","24.304199","97","199","247",130,117,99,"38",61,0.4692,0.3248,0.4008,0.8057
"2586",144962,"ELMHURST COLLEGE",1,0,1992,"9050","25.121077","99","175","229",128,101,92,"29",63,0.4922,0.2871,0.4017,0.7642
"2587",144962,"ELMHURST COLLEGE",1,0,1993,"9676","25.453884","97","191","252",140,112,99,"41",58,0.4143,0.3661,0.3929,0.7579
"2588",144962,"ELMHURST COLLEGE",1,0,1995,"10264","29.577816","96","195","253",147,106,128,"41",87,0.5918,0.3868,0.5059,0.7708
"2589",144962,"ELMHURST COLLEGE",1,0,1996,"10976","32.23892","99","181","222",137,85,130,"49",81,0.5912,0.5765,0.5856,0.8153
"2590",144962,"ELMHURST COLLEGE",1,0,1997,"11900","28.528453","101","230","289",155,134,2,"1",1,0.0065,0.0075,0.0069,0.7958
"2591",144962,"ELMHURST COLLEGE",1,0,1998,"12870","31.448109","106","211","266",152,114,154,"51",103,0.6776,0.4474,0.5789,0.7932
"2592",144962,"ELMHURST COLLEGE",1,0,1999,"13900","32.472522","109","220","269",156,113,158,"58",100,0.641,0.5133,0.5874,0.8178
"2593",144962,"ELMHURST COLLEGE",1,0,2000,"15000","36.098921","110.5","237","301",185,116,183,"50",133,0.7189,0.431,0.608,0.7874
"2594",144962,"ELMHURST COLLEGE",1,0,2001,"16200","37.034014","112","222","302",169,133,153,"47",106,0.6272,0.3534,0.5066,0.7351
"2595",144962,"ELMHURST COLLEGE",1,0,2002,"17500","38.308211","113","243","295",185,110,157,"41",116,0.627,0.3727,0.5322,0.8237
"2596",144962,"ELMHURST COLLEGE",1,0,2003,"18600","39.466168","110","279","366",230,136,194,"54",140,0.6087,0.3971,0.5301,0.7623
"2597",144962,"ELMHURST COLLEGE",1,0,2004,"20090","40.536688","108","300","386",225,161,215,"66",149,0.6622,0.4099,0.557,0.7772
"2598",144962,"Elmhurst College",1,0,2005,"21600","43.700544","121","364","466",282,184,252,"84",168,0.5957,0.4565,0.5408,0.7811
"2599",144962,"Elmhurst College",1,0,2006,"23100","49.87365","124","380","484",296,188,275,"100",175,0.5912,0.5319,0.5682,0.7851
"2600",144962,"Elmhurst College",1,0,2007,"24600","53.530904","129","394","508",304,204,300,"99",201,0.6612,0.4853,0.5906,0.7756
"2601",144962,"Elmhurst College",1,0,2008,"26000","57.249076","141","453","576",348,228,350,"113",237,0.681,0.4956,0.6076,0.7865
"2602",144962,"Elmhurst College",1,0,2009,"27270","65.78402","144","435","584",341,243,317,"106",211,0.6188,0.4362,0.5428,0.7449
"2603",144962,"Elmhurst College",1,0,2010,"28600","66.456399","145","436","537",330,207,301,"99",202,0.6121,0.4783,0.5605,0.8119
"2604",144971,"EUREKA COLLEGE",1,0,1991,"9425","7.971528","39","112","129",70,59,54,"21",33,0.4714,0.3559,0.4186,0.8682
"2605",144971,"EUREKA COLLEGE",1,0,1992,"10325","9.372937","37","110","119",60,59,53,"22",31,0.5167,0.3729,0.4454,0.9244
"2606",144971,"EUREKA COLLEGE",1,0,1993,"11105","9.77588","37","96","109",45,64,50,"26",24,0.5333,0.4062,0.4587,0.8807
"2607",144971,"EUREKA COLLEGE",1,0,1995,"12505","9.858249","36","129","139",58,81,68,"35",33,0.569,0.4321,0.4892,0.9281
"2608",144971,"EUREKA COLLEGE",1,0,1996,"13216","9.945163","37","118","128",67,61,55,"19",36,0.5373,0.3115,0.4297,0.9219
"2609",144971,"EUREKA COLLEGE",1,0,1997,"13950","8.363892","40","135","141",50,91,54,"25",29,0.58,0.2747,0.383,0.9574
"2610",144971,"EUREKA COLLEGE",1,0,1998,"14790","9.055544","44","105","114",57,57,65,"31",34,0.5965,0.5439,0.5702,0.9211
"2611",144971,"EUREKA COLLEGE",1,0,1999,"15200","9.342022","43","119","130",76,54,60,"19",41,0.5395,0.3519,0.4615,0.9154
"2612",144971,"EUREKA COLLEGE",1,0,2000,"15850","9.946518","45","102","121",72,49,49,"17",32,0.4444,0.3469,0.405,0.843
"2613",144971,"EUREKA COLLEGE",1,0,2001,"16600","10.443157","47","125","146",75,71,60,"26",34,0.4533,0.3662,0.411,0.8562
"2614",144971,"EUREKA COLLEGE",1,0,2002,"17430","10.609122","42","106","136",70,66,50,"16",34,0.4857,0.2424,0.3676,0.7794
"2615",144971,"EUREKA COLLEGE",1,0,2003,"18700","10.468631","43","79","92",44,48,15,"5",10,0.2273,0.1042,0.163,0.8587
"2616",144971,"EUREKA COLLEGE",1,0,2004,"13000","10.051049","44","97","116",57,59,35,"15",20,0.3509,0.2542,0.3017,0.8362
"2617",144971,"Eureka College",1,0,2005,"13000","10.678181","42","120","138",74,64,66,"29",37,0.5,0.4531,0.4783,0.8696
"2618",144971,"Eureka College",1,0,2006,"13760","11.757462","43","120","137",74,63,54,"26",28,0.3784,0.4127,0.3942,0.8759
"2619",144971,"Eureka College",1,0,2007,"14800","11.4401","36","112","122",73,49,53,"15",38,0.5205,0.3061,0.4344,0.918
"2620",144971,"Eureka College",1,0,2008,"15675","12.287276","44","125","153",75,78,53,"18",35,0.4667,0.2308,0.3464,0.817
"2621",144971,"Eureka College",1,0,2009,"16650","14.08954","42","125","143",75,68,55,"23",32,0.4267,0.3382,0.3846,0.8741
"2622",144971,"Eureka College",1,0,2010,"17275","14.059757","43","148","174",92,82,70,"30",40,0.4348,0.3659,0.4023,0.8506
"2623",145600,"UNIVERSITY OF ILLINOIS AT CHICAGO",1,0,1991,"3077","698.517911","1126","960","2356",1233,1123,197,"83",114,0.0925,0.0739,0.0836,0.4075
"2624",145600,"UNIVERSITY OF ILLINOIS AT CHICAGO",1,0,1992,"3371","732.529072","1144","995","2475",1273,1202,240,"95",145,0.1139,0.079,0.097,0.402
"2625",145600,"UNIVERSITY OF ILLINOIS AT CHICAGO",1,0,1993,"3439","817.999541","1135","1022","2589",1360,1229,229,"85",144,0.1059,0.0692,0.0885,0.3947
"2626",145600,"UNIVERSITY OF ILLINOIS AT CHICAGO",1,0,1995,"3974","931.100466","1152","1024","2469",1401,1068,309,"110",199,0.142,0.103,0.1252,0.4147
"2627",145600,"UNIVERSITY OF ILLINOIS AT CHICAGO",1,0,1996,"4188","955.364563","1163","1176","2720",1505,1215,454,"179",275,0.1827,0.1473,0.1669,0.4324
"2628",145600,"UNIVERSITY OF ILLINOIS AT CHICAGO",1,0,1997,"4358","983.575916","1087","1107","2820",1560,1260,460,"165",295,0.1891,0.131,0.1631,0.3926
"2629",145600,"UNIVERSITY OF ILLINOIS AT CHICAGO",1,0,1998,"4498","1011.811671","1088","1143","2880",1629,1251,465,"166",299,0.1835,0.1327,0.1615,0.3969
"2630",145600,"UNIVERSITY OF ILLINOIS AT CHICAGO",1,0,1999,"3138","1064.093134","1043","1039","2552",1381,1171,506,"215",291,0.2107,0.1836,0.1983,0.4071
"2631",145600,"UNIVERSITY OF ILLINOIS AT CHICAGO",1,0,2000,"3232","1153.833824","1169","1069","2762",1557,1205,588,"203",385,0.2473,0.1685,0.2129,0.387
"2632",145600,"UNIVERSITY OF ILLINOIS AT CHICAGO",1,0,2001,"3830","1232.57335","1295","1084","2637",1470,1167,590,"210",380,0.2585,0.1799,0.2237,0.4111
"2633",145600,"UNIVERSITY OF ILLINOIS AT CHICAGO",1,0,2002,"4664","1430.240136","1271","1179","2952",1674,1278,607,"248",359,0.2145,0.1941,0.2056,0.3994
"2634",145600,"UNIVERSITY OF ILLINOIS AT CHICAGO",1,0,2003,"4898","1530.504423","1237","1095","2880",1573,1307,702,"275",427,0.2715,0.2104,0.2438,0.3802
"2635",145600,"UNIVERSITY OF ILLINOIS AT CHICAGO",1,0,2004,"5682","1818.701659","1236","983","2671",1488,1183,681,"278",403,0.2708,0.235,0.255,0.368
"2636",145600,"University of Illinois at Chicago",1,0,2005,"6194","1682.972269","1182","1009","2759",1534,1225,742,"294",448,0.292,0.24,0.2689,0.3657
"2637",145600,"University of Illinois at Chicago",1,0,2006,"6780","1744.271713","1202","1153","2830",1554,1276,878,"380",498,0.3205,0.2978,0.3102,0.4074
"2638",145600,"University of Illinois at Chicago",1,0,2007,"7424","1827.433746","1212","1335","3272",1813,1459,978,"390",588,0.3243,0.2673,0.2989,0.408
"2639",145600,"University of Illinois at Chicago",1,0,2008,"8130","1981.447266","1239","1178","2944",1659,1285,981,"392",589,0.355,0.3051,0.3332,0.4001
"2640",145600,"University of Illinois at Chicago",1,0,2009,"8342","2072.104886","1199","1209","3126",1680,1446,1056,"411",645,0.3839,0.2842,0.3378,0.3868
"2641",145600,"University of Illinois at Chicago",1,0,2010,"9133","2111.921111","1185","1191","3185",1731,1454,984,"387",597,0.3449,0.2662,0.3089,0.3739
"2642",145619,"ILLINOIS BENEDICTINE COLLEGE",1,0,1991,"8980","19.355513","88","165","246",117,129,87,"37",50,0.4274,0.2868,0.3537,0.6707
"2643",145619,"ILLINOIS BENEDICTINE COLLEGE",1,0,1992,"9300","22.415411","88","159","230",110,120,102,"43",59,0.5364,0.3583,0.4435,0.6913
"2644",145619,"ILLINOIS BENEDICTINE COLLEGE",1,0,1993,"9950","24.974753","91","205","270",125,145,104,"43",61,0.488,0.2966,0.3852,0.7593
"2645",145619,"BENEDICTINE UNIVERSITY",1,0,1995,"11030","28.398152","85","160","245",123,122,95,"38",57,0.4634,0.3115,0.3878,0.6531
"2646",145619,"BENEDICTINE UNIVERSITY",1,0,1996,"11790","29.822977","87","141","231",112,119,82,"30",52,0.4643,0.2521,0.355,0.6104
"2647",145619,"BENEDICTINE UNIVERSITY",1,0,1997,"11990","23.625476","85","191","300",129,171,117,"56",61,0.4729,0.3275,0.39,0.6367
"2648",145619,"BENEDICTINE UNIVERSITY",1,0,1998,"12600","27.435386","84","173","299",160,139,93,"35",58,0.3625,0.2518,0.311,0.5786
"2649",145619,"BENEDICTINE UNIVERSITY",1,0,1999,"13700","31.691384","84","145","259",127,132,74,"30",44,0.3465,0.2273,0.2857,0.5598
"2650",145619,"BENEDICTINE UNIVERSITY",1,0,2000,"14500","29.149461","90","103","278",156,122,114,"45",69,0.4423,0.3689,0.4101,0.3705
"2651",145619,"BENEDICTINE UNIVERSITY",1,0,2001,"15200","32.798742","96","125","262",159,103,120,"41",79,0.4969,0.3981,0.458,0.4771
"2652",145619,"BENEDICTINE UNIVERSITY",1,0,2002,"16250","34.707189","96","161","303",165,138,150,"56",94,0.5697,0.4058,0.495,0.5314
"2653",145619,"BENEDICTINE UNIVERSITY",1,0,2003,"16960","35.327263","96","137","302",169,133,116,"49",67,0.3964,0.3684,0.3841,0.4536
"2654",145619,"BENEDICTINE UNIVERSITY",1,0,2004,"17800","37.914346","91","125","301",151,150,121,"53",68,0.4503,0.3533,0.402,0.4153
"2655",145619,"Benedictine University",1,0,2005,"18700","40.171769","88","98","308",163,145,97,"42",55,0.3374,0.2897,0.3149,0.3182
"2656",145619,"Benedictine University",1,0,2006,"19800","43.390665","89","167","379",189,190,139,"57",82,0.4339,0.3,0.3668,0.4406
"2657",145619,"Benedictine University",1,0,2007,"20800","47.170224","93","159","385",185,200,146,"68",78,0.4216,0.34,0.3792,0.413
"2658",145619,"Benedictine University",1,0,2008,"21600","51.72381","101","142","434",227,207,141,"57",84,0.37,0.2754,0.3249,0.3272
"2659",145619,"Benedictine University",1,0,2009,"21600","58.239464","104","169","451",215,236,156,"68",88,0.4093,0.2881,0.3459,0.3747
"2660",145619,"Benedictine University",1,0,2010,"22500","63.950332","108","190","548",311,237,197,"63",134,0.4309,0.2658,0.3595,0.3467
"2661",145637,"UNIVERSITY OF ILLINOIS URBANA CAMPUS",1,0,1991,"3184","768.487322","1937","4125","5649",2615,3034,2770,"1300",1470,0.5621,0.4285,0.4904,0.7302
"2662",145637,"UNIVERSITY OF ILLINOIS URBANA CAMPUS",1,0,1992,"3458","771.805427","1905","3918","5491",2566,2925,2656,"1267",1389,0.5413,0.4332,0.4837,0.7135
"2663",145637,"UNIVERSITY OF ILLINOIS AT URBANA",1,0,1993,"3506","805.182519","1868","4068","5705",2588,3117,2665,"1307",1358,0.5247,0.4193,0.4671,0.7131
"2664",145637,"UNIVERSITY OF ILLINOIS AT URBANA",1,0,1995,"3958","863.141803","1831","4379","6101",2944,3157,3312,"1492",1820,0.6182,0.4726,0.5429,0.7178
"2665",145637,"UNIVERSITY OF ILLINOIS AT URBANA",1,0,1996,"4153","872.884862","1855","4184","5938",2865,3073,3321,"1507",1814,0.6332,0.4904,0.5593,0.7046
"2666",145637,"UNIVERSITY OF ILLINOIS AT URBANA",1,0,1997,"4340","919.154765","1765","4051","5789",2865,2924,3331,"1523",1808,0.6311,0.5209,0.5754,0.6998
"2667",145637,"UNIVERSITY OF ILLINOIS AT URBANA",1,0,1998,"4554","967.05257","1730","4500","6453",3174,3279,3729,"1680",2049,0.6456,0.5124,0.5779,0.6974
"2668",145637,"UNIVERSITY OF ILLINOIS AT URBANA",1,0,1999,"3546","1011.771729","1759","4521","6458",3131,3327,3849,"1733",2116,0.6758,0.5209,0.596,0.7001
"2669",145637,"UNIVERSITY OF ILLINOIS AT URBANA-CHAMPAIGN",1,0,2000,"3724","1063.13113","2019.5","4241","6167",2990,3177,3737,"1692",2045,0.6839,0.5326,0.606,0.6877
"2670",145637,"UNIVERSITY OF ILLINOIS AT URBANA-CHAMPAIGN",1,0,2001,"4410","1121.713552","2280","4149","6234",3008,3226,3886,"1789",2097,0.6971,0.5546,0.6234,0.6655
"2671",145637,"UNIVERSITY OF ILLINOIS AT URBANA-CHAMPAIGN",1,0,2002,"5302","1342.798333","2259","4322","6354",3120,3234,4027,"1814",2213,0.7093,0.5609,0.6338,0.6802
"2672",145637,"UNIVERSITY OF ILLINOIS AT URBANA-CHAMPAIGN",1,0,2003,"5568","1470.22041","2229","4543","6807",3268,3539,4390,"2070",2320,0.7099,0.5849,0.6449,0.6674
"2673",145637,"UNIVERSITY OF ILLINOIS AT URBANA-CHAMPAIGN",1,0,2004,"6460","1809.047742","2205","4897","7225",3555,3670,4848,"2215",2633,0.7406,0.6035,0.671,0.6778
"2674",145637,"University of Illinois at Urbana-Champaign",1,0,2005,"7042","1654.324359","2124","5099","7565",3511,4054,4966,"2375",2591,0.738,0.5858,0.6564,0.674
"2675",145637,"University of Illinois at Urbana-Champaign",1,0,2006,"7708","1719.621509","2184","4656","7152",3518,3634,4881,"2256",2625,0.7462,0.6208,0.6825,0.651
"2676",145637,"University of Illinois at Urbana-Champaign",1,0,2007,"8440","1775.062977","2193","4412","6930",3295,3635,4722,"2281",2441,0.7408,0.6275,0.6814,0.6367
"2677",145637,"University of Illinois at Urbana-Champaign",1,0,2008,"9242","1894.50227","2203","4416","7277",3386,3891,5015,"2439",2576,0.7608,0.6268,0.6892,0.6068
"2678",145637,"University of Illinois at Urbana-Champaign",1,0,2009,"9484","1966.956879","2204","4310","6974",3332,3642,4938,"2317",2621,0.7866,0.6362,0.7081,0.618
"2679",145637,"University of Illinois at Urbana-Champaign",1,0,2010,"11003","2047.223003","2112","3940","6921",3054,3867,4823,"2414",2409,0.7888,0.6243,0.6969,0.5693
"2680",145691,"ILLINOIS COLLEGE",1,0,1991,"6600","13.116937","47","232","241",117,124,85,"39",46,0.3932,0.3145,0.3527,0.9627
"2681",145691,"ILLINOIS COLLEGE",1,0,1992,"7050","13.509299","48","255","260",136,124,114,"35",79,0.5809,0.2823,0.4385,0.9808
"2682",145691,"ILLINOIS COLLEGE",1,0,1993,"7550","13.908128","51","253","261",150,111,113,"34",79,0.5267,0.3063,0.433,0.9693
"2683",145691,"ILLINOIS COLLEGE",1,0,1995,"8600","16.989597","52","216","223",139,84,98,"30",68,0.4892,0.3571,0.4395,0.9686
"2684",145691,"ILLINOIS COLLEGE",1,0,1996,"9150","18.045915","53","191","200",123,77,87,"22",65,0.5285,0.2857,0.435,0.955
"2685",145691,"ILLINOIS COLLEGE",1,0,1997,"9500","15.020037","54","230","242",148,94,102,"30",72,0.4865,0.3191,0.4215,0.9504
"2686",145691,"ILLINOIS COLLEGE",1,0,1998,"9850","13.048461","55","224","238",133,105,107,"37",70,0.5263,0.3524,0.4496,0.9412
"2687",145691,"ILLINOIS COLLEGE",1,0,1999,"10200","13.862874","55","224","241",131,110,97,"34",63,0.4809,0.3091,0.4025,0.9295
"2688",145691,"ILLINOIS COLLEGE",1,0,2000,"10735","14.693151","55.5","216","239",128,111,102,"32",70,0.5469,0.2883,0.4268,0.9038
"2689",145691,"ILLINOIS COLLEGE",1,0,2001,"11272","15.852164","56","190","205",113,92,94,"37",57,0.5044,0.4022,0.4585,0.9268
"2690",145691,"ILLINOIS COLLEGE",1,0,2002,"11850","17.38358","57","287","306",170,136,156,"60",96,0.5647,0.4412,0.5098,0.9379
"2691",145691,"ILLINOIS COLLEGE",1,0,2003,"13300","19.059815","61","285","318",180,138,157,"59",98,0.5444,0.4275,0.4937,0.8962
"2692",145691,"ILLINOIS COLLEGE",1,0,2004,"14600","22.155992","74","237","258",136,122,135,"49",86,0.6324,0.4016,0.5233,0.9186
"2693",145691,"Illinois College",1,0,2005,"15500","21.922063","71","232","256",117,139,124,"60",64,0.547,0.4317,0.4844,0.9062
"2694",145691,"Illinois College",1,0,2006,"16610","23.768814","74","260","293",154,139,148,"49",99,0.6429,0.3525,0.5051,0.8874
"2695",145691,"Illinois College",1,0,2007,"17600","23.119038","72","228","258",125,133,144,"58",86,0.688,0.4361,0.5581,0.8837
"2696",145691,"Illinois College",1,0,2008,"18500","24.819013","75","136","166",84,82,110,"51",59,0.7024,0.622,0.6627,0.8193
"2697",145691,"Illinois College",1,0,2009,"20900","27.300199","75","191","224",99,125,139,"71",68,0.6869,0.568,0.6205,0.8527
"2698",145691,"Illinois College",1,0,2010,"22350","25.920254","75","169","225",113,112,134,"58",76,0.6726,0.5179,0.5956,0.7511
"2699",145813,"ILLINOIS STATE UNIVERSITY",1,0,1991,"2430","176.783274","738","2588","3055",1757,1298,849,"286",563,0.3204,0.2203,0.2779,0.8471
"2700",145813,"ILLINOIS STATE UNIVERSITY",1,0,1992,"2871","175.864879","715","2457","2898",1706,1192,772,"229",543,0.3183,0.1921,0.2664,0.8478
"2701",145813,"ILLINOIS STATE UNIVERSITY",1,0,1993,"3253","185.095563","720","1915","2387",1440,947,648,"183",465,0.3229,0.1932,0.2715,0.8023
"2702",145813,"ILLINOIS STATE UNIVERSITY",1,0,1995,"3544","185.783514","772","2460","2950",1798,1152,823,"240",583,0.3242,0.2083,0.279,0.8339
"2703",145813,"ILLINOIS STATE UNIVERSITY",1,0,1996,"3720","215.43066","773","2416","2888",1793,1095,877,"245",632,0.3525,0.2237,0.3037,0.8366
"2704",145813,"ILLINOIS STATE UNIVERSITY",1,0,1997,"3969","227.553572","784","2723","3253",1981,1272,1016,"297",719,0.3629,0.2335,0.3123,0.8371
"2705",145813,"ILLINOIS STATE UNIVERSITY",1,0,1998,"4085","246.22524","807","2281","2740",1728,1012,915,"268",647,0.3744,0.2648,0.3339,0.8325
"2706",145813,"ILLINOIS STATE UNIVERSITY",1,0,1999,"3127","266.933319","839","2690","3067",1907,1160,1072,"301",771,0.4043,0.2595,0.3495,0.8771
"2707",145813,"ILLINOIS STATE UNIVERSITY",1,0,2000,"3219","272.855575","852","2891","3254",1996,1258,1204,"347",857,0.4294,0.2758,0.37,0.8884
"2708",145813,"ILLINOIS STATE UNIVERSITY",1,0,2001,"3332","294.92123","865","2943","3331",2080,1251,1316,"364",952,0.4577,0.291,0.3951,0.8835
"2709",145813,"ILLINOIS STATE UNIVERSITY",1,0,2002,"3640","310.419011","799","2763","3097",1933,1164,1279,"366",913,0.4723,0.3144,0.413,0.8922
"2710",145813,"ILLINOIS STATE UNIVERSITY",1,0,2003,"3640","307.078429","833","2639","3088",1934,1154,1294,"411",883,0.4566,0.3562,0.419,0.8546
"2711",145813,"ILLINOIS STATE UNIVERSITY",1,0,2004,"4800","370.931598","821","2290","2824",1739,1085,1280,"392",888,0.5106,0.3613,0.4533,0.8109
"2712",145813,"Illinois State University",1,0,2005,"5400","316.259877","820","2541","3167",1970,1197,1388,"419",969,0.4919,0.35,0.4383,0.8023
"2713",145813,"Illinois State University",1,0,2006,"6150","332.585619","833","2681","3188",1915,1273,1496,"471",1025,0.5352,0.37,0.4693,0.841
"2714",145813,"Illinois State University",1,0,2007,"6999","350.200037","815","2650","3140",1887,1253,1457,"455",1002,0.531,0.3631,0.464,0.8439
"2715",145813,"Illinois State University",1,0,2008,"7680","375.579344","834","2838","3387",2088,1299,1545,"503",1042,0.499,0.3872,0.4562,0.8379
"2716",145813,"Illinois State University",1,0,2009,"8280","399.698341","864","2413","3060",1816,1244,1462,"500",962,0.5297,0.4019,0.4778,0.7886
"2717",145813,"Illinois State University",1,0,2010,"8051","442.190509","852","2591","3179",1914,1265,1512,"499",1013,0.5293,0.3945,0.4756,0.815
"2718",146481,"LAKE FOREST COLLEGE",1,0,1991,"13895","22.187242","85","201","234",124,110,123,"53",70,0.5645,0.4818,0.5256,0.859
"2719",146481,"LAKE FOREST COLLEGE",1,0,1992,"15085","23.652563","82","183","235",123,112,145,"66",79,0.6423,0.5893,0.617,0.7787
"2720",146481,"LAKE FOREST COLLEGE",1,0,1993,"16175","24.262824","81","224","271",140,131,148,"65",83,0.5929,0.4962,0.5461,0.8266
"2721",146481,"LAKE FOREST COLLEGE",1,0,1995,"18116","27.678797","76","218","266",155,111,156,"58",98,0.6323,0.5225,0.5865,0.8195
"2722",146481,"LAKE FOREST COLLEGE",1,0,1996,"19000","29.479323","76","254","324",152,172,188,"90",98,0.6447,0.5233,0.5802,0.784
"2723",146481,"LAKE FOREST COLLEGE",1,0,1997,"19560","24.30596","81","264","337",191,146,205,"77",128,0.6702,0.5274,0.6083,0.7834
"2724",146481,"LAKE FOREST COLLEGE",1,0,1998,"20080","25.845507","83","246","302",177,125,167,"63",104,0.5876,0.504,0.553,0.8146
"2725",146481,"LAKE FOREST COLLEGE",1,0,1999,"20240","27.70797","76","270","341",208,133,216,"80",136,0.6538,0.6015,0.6334,0.7918
"2726",146481,"LAKE FOREST COLLEGE",1,0,2000,"20900","29.747204","80","282","335",187,148,194,"78",116,0.6203,0.527,0.5791,0.8418
"2727",146481,"LAKE FOREST COLLEGE",1,0,2001,"21896","31.782892","84","256","336",188,148,214,"83",131,0.6968,0.5608,0.6369,0.7619
"2728",146481,"LAKE FOREST COLLEGE",1,0,2002,"22976","32.66929","84","270","358",219,139,213,"71",142,0.6484,0.5108,0.595,0.7542
"2729",146481,"LAKE FOREST COLLEGE",1,0,2003,"24096","34.690359","84","260","347",194,153,203,"86",117,0.6031,0.5621,0.585,0.7493
"2730",146481,"LAKE FOREST COLLEGE",1,0,2004,"25518","35.853135","86","322","405",247,158,257,"83",174,0.7045,0.5253,0.6346,0.7951
"2731",146481,"Lake Forest College",1,0,2005,"27000","38.338137","92","276","358",202,156,213,"78",135,0.6683,0.5,0.595,0.7709
"2732",146481,"Lake Forest College",1,0,2006,"28700","39.883635","89","303","386",224,162,241,"96",145,0.6473,0.5926,0.6244,0.785
"2733",146481,"Lake Forest College",1,0,2007,"30600","42.225195","90","273","356",214,142,208,"75",133,0.6215,0.5282,0.5843,0.7669
"2734",146481,"Lake Forest College",1,0,2008,"32130","43.74872","91","261","378",218,160,242,"85",157,0.7202,0.5312,0.6402,0.6905
"2735",146481,"Lake Forest College",1,0,2009,"33576","43.849212","92","248","354",213,141,232,"81",151,0.7089,0.5745,0.6554,0.7006
"2736",146481,"Lake Forest College",1,0,2010,"34885","44.0861","96","232","402",238,164,258,"98",160,0.6723,0.5976,0.6418,0.5771
"2737",146612,"LEWIS UNIVERSITY",1,0,1991,"8502","26.975181","122","302","387",166,221,122,"59",63,0.3795,0.267,0.3152,0.7804
"2738",146612,"LEWIS UNIVERSITY",1,0,1992,"9536","29.938384","132","278","345",161,184,84,"34",50,0.3106,0.1848,0.2435,0.8058
"2739",146612,"LEWIS UNIVERSITY",1,0,1993,"10112","32.652154","136","252","344",155,189,109,"49",60,0.3871,0.2593,0.3169,0.7326
"2740",146612,"LEWIS UNIVERSITY",1,0,1995,"11008","39.922159","121","219","331",158,173,104,"49",55,0.3481,0.2832,0.3142,0.6616
"2741",146612,"LEWIS UNIVERSITY",1,0,1996,"11552","41.318055","127","219","312",137,175,120,"57",63,0.4599,0.3257,0.3846,0.7019
"2742",146612,"LEWIS UNIVERSITY",1,0,1997,"12416","46.746393","143","252","386",176,210,145,"70",75,0.4261,0.3333,0.3756,0.6528
"2743",146612,"LEWIS UNIVERSITY",1,0,1998,"13024","37.985575","148","254","391",193,198,151,"64",87,0.4508,0.3232,0.3862,0.6496
"2744",146612,"LEWIS UNIVERSITY",1,0,1999,"13664","54.313671","143","290","425",194,231,171,"82",89,0.4588,0.355,0.4024,0.6824
"2745",146612,"LEWIS UNIVERSITY",1,0,2000,"14208","59.837513","142","293","427",183,244,127,"69",58,0.3169,0.2828,0.2974,0.6862
"2746",146612,"LEWIS UNIVERSITY",1,0,2001,"14976","63.437417","141","272","384",191,193,126,"52",74,0.3874,0.2694,0.3281,0.7083
"2747",146612,"LEWIS UNIVERSITY",1,0,2002,"15250","66.701423","142","272","366",161,205,132,"66",66,0.4099,0.322,0.3607,0.7432
"2748",146612,"LEWIS UNIVERSITY",1,0,2003,"15950","68.407304","144","321","458",224,234,179,"86",93,0.4152,0.3675,0.3908,0.7009
"2749",146612,"LEWIS UNIVERSITY",1,0,2004,"16906","71.452097","150","369","509",275,234,186,"81",105,0.3818,0.3462,0.3654,0.725
"2750",146612,"Lewis University",1,0,2005,"17990","77.710417","163","404","557",321,236,232,"92",140,0.4361,0.3898,0.4165,0.7253
"2751",146612,"Lewis University",1,0,2006,"19200","87.326225","169","405","568",323,245,223,"94",129,0.3994,0.3837,0.3926,0.713
"2752",146612,"Lewis University",1,0,2007,"20450","95.962694","179","435","634",365,269,283,"131",152,0.4164,0.487,0.4464,0.6861
"2753",146612,"Lewis University",1,0,2008,"21990","76.049186","183","435","650",345,305,272,"127",145,0.4203,0.4164,0.4185,0.6692
"2754",146612,"Lewis University",1,0,2009,"22990","80.42657","189","433","653",360,293,288,"114",174,0.4833,0.3891,0.441,0.6631
"2755",146612,"Lewis University",1,0,2010,"23780","98.679868","201","387","632",319,313,257,"126",131,0.4107,0.4026,0.4066,0.6123
"2756",146719,"LOYOLA UNIVERSITY OF CHICAGO",1,0,1991,"9270","561.76308","601","579","922",593,329,347,"119",228,0.3845,0.3617,0.3764,0.628
"2757",146719,"LOYOLA UNIVERSITY OF CHICAGO",1,0,1992,"9840","635.436091","606","707","985",587,398,377,"143",234,0.3986,0.3593,0.3827,0.7178
"2758",146719,"LOYOLA UNIVERSITY OF CHICAGO",1,0,1993,"10470","662.272481","563","562","856",511,345,366,"141",225,0.4403,0.4087,0.4276,0.6565
"2759",146719,"LOYOLA UNIVERSITY OF CHICAGO",1,0,1995,"13000","641.228839","536","793","1182",733,449,544,"167",377,0.5143,0.3719,0.4602,0.6709
"2760",146719,"LOYOLA UNIVERSITY OF CHICAGO",1,0,1996,"14400","387.764641","532","677","1063",690,373,562,"175",387,0.5609,0.4692,0.5287,0.6369
"2761",146719,"LOYOLA UNIVERSITY OF CHICAGO",1,0,1997,"15654","361.520895","530","739","1189",758,431,558,"189",369,0.4868,0.4385,0.4693,0.6215
"2762",146719,"LOYOLA UNIVERSITY OF CHICAGO",1,0,1998,"16600","297.603342","535","819","1340",868,472,641,"208",433,0.4988,0.4407,0.4784,0.6112
"2763",146719,"LOYOLA UNIVERSITY CHICAGO",1,0,1999,"17750","326.684018","522","638","1067",717,350,541,"169",372,0.5188,0.4829,0.507,0.5979
"2764",146719,"LOYOLA UNIVERSITY CHICAGO",1,0,2000,"18266","315.669381","494","566","889",585,304,542,"164",378,0.6462,0.5395,0.6097,0.6367
"2765",146719,"LOYOLA UNIVERSITY CHICAGO",1,0,2001,"18814","317.901622","466","875","1424",960,464,674,"202",472,0.4917,0.4353,0.4733,0.6145
"2766",146719,"LOYOLA UNIVERSITY CHICAGO",1,0,2002,"19472","316.555773","442","1005","1623",1069,554,821,"261",560,0.5239,0.4711,0.5059,0.6192
"2767",146719,"LOYOLA UNIVERSITY CHICAGO",1,0,2003,"20544","309.298747","524","1172","1915",1292,623,924,"296",628,0.4861,0.4751,0.4825,0.612
"2768",146719,"LOYOLA UNIVERSITY CHICAGO",1,0,2004,"21780","310.40654","502","1101","1787",1176,611,856,"296",560,0.4762,0.4845,0.479,0.6161
"2769",146719,"Loyola University Chicago",1,0,2005,"23500","327.797622","523","1316","2080",1365,715,1053,"346",707,0.5179,0.4839,0.5062,0.6327
"2770",146719,"Loyola University Chicago",1,0,2006,"24580","354.411527","550","1381","2134",1426,708,1104,"357",747,0.5238,0.5042,0.5173,0.6471
"2771",146719,"Loyola University Chicago",1,0,2007,"27200","375.331354","582","1349","2035",1377,658,1215,"371",844,0.6129,0.5638,0.5971,0.6629
"2772",146719,"Loyola University Chicago",1,0,2008,"28700","410.357419","597","1541","2176",1460,716,1419,"448",971,0.6651,0.6257,0.6521,0.7082
"2773",146719,"Loyola University Chicago",1,0,2009,"29850","421.527019","629","1410","2076",1358,718,1323,"434",889,0.6546,0.6045,0.6373,0.6792
"2774",146719,"Loyola University-Chicago",1,0,2010,"31040","402.689139","658","1400","2063",1315,748,1342,"444",898,0.6829,0.5936,0.6505,0.6786
"2775",146825,"MACMURRAY COLLEGE",1,0,1991,"8150","12.407437","66","160","185",89,96,83,"28",55,0.618,0.2917,0.4486,0.8649
"2776",146825,"MACMURRAY COLLEGE",1,0,1992,"8620","13.505439","69","155","171",84,87,67,"23",44,0.5238,0.2644,0.3918,0.9064
"2777",146825,"MACMURRAY COLLEGE",1,0,1993,"9160","14.163477","69","130","151",72,79,64,"21",43,0.5972,0.2658,0.4238,0.8609
"2778",146825,"MACMURRAY COLLEGE",1,0,1995,"10190","15.804065","66","156","175",75,100,50,"12",38,0.5067,0.12,0.2857,0.8914
"2779",146825,"MACMURRAY COLLEGE",1,0,1996,"10940","14.668524","64","134","156",90,66,54,"15",39,0.4333,0.2273,0.3462,0.859
"2780",146825,"MACMURRAY COLLEGE",1,0,1997,"11400","13.776536","66","109","127",49,78,47,"24",23,0.4694,0.3077,0.3701,0.8583
"2781",146825,"MACMURRAY COLLEGE",1,0,1998,"11820","14.104256","72","142","163",79,84,59,"22",37,0.4684,0.2619,0.362,0.8712
"2782",146825,"MACMURRAY COLLEGE",1,0,1999,"12300","13.777262","56","138","187",80,107,55,"25",30,0.375,0.2336,0.2941,0.738
"2783",146825,"MACMURRAY COLLEGE",1,0,2000,"13140","13.896518","53.5","158","199",97,102,55,"20",35,0.3608,0.1961,0.2764,0.794
"2784",146825,"MACMURRAY COLLEGE",1,0,2001,"14000","15.022325","51","107","144",65,79,37,"14",23,0.3538,0.1772,0.2569,0.7431
"2785",146825,"MACMURRAY COLLEGE",1,0,2002,"14500","13.356183","45","103","127",72,55,46,"14",32,0.4444,0.2545,0.3622,0.811
"2786",146825,"MACMURRAY COLLEGE",1,0,2003,"14500","12.518368","40","113","162",79,83,48,"17",31,0.3924,0.2048,0.2963,0.6975
"2787",146825,"MACMURRAY COLLEGE",1,0,2004,"14500","13.264619","39","115","152",74,78,37,"17",20,0.2703,0.2179,0.2434,0.7566
"2788",146825,"MacMurray College",1,0,2005,"15000","13.546312","41","110","159",77,82,35,"10",25,0.3247,0.122,0.2201,0.6918
"2789",146825,"MacMurray College",1,0,2006,"15500","13.954413","38","114","166",86,80,41,"14",27,0.314,0.175,0.247,0.6867
"2790",146825,"MacMurray College",1,0,2007,"16400","11.767836","35","89","125",73,52,35,"3",32,0.4384,0.0577,0.28,0.712
"2791",146825,"MacMurray College",1,0,2008,"17000","10.396702","31","59","90",36,54,21,"8",13,0.3611,0.1481,0.2333,0.6556
"2792",146825,"MacMurray College",1,0,2009,"17940","10.003159","33","61","96",34,62,19,"6",13,0.3824,0.0968,0.1979,0.6354
"2793",146825,"MacMurray College",1,0,2010,"18838","8.595246","33","52","90",39,51,10,"4",6,0.1538,0.0784,0.1111,0.5778
"2794",147013,"MCKENDREE COLLEGE",1,0,1991,"6746","11.195621","41","114","132",79,53,46,"15",31,0.3924,0.283,0.3485,0.8636
"2795",147013,"MCKENDREE COLLEGE",1,0,1992,"7066","12.343461","46","118","134",82,52,53,"19",34,0.4146,0.3654,0.3955,0.8806
"2796",147013,"MCKENDREE COLLEGE",1,0,1993,"7450","13.208569","47","99","119",72,47,34,"12",22,0.3056,0.2553,0.2857,0.8319
"2797",147013,"MCKENDREE COLLEGE",1,0,1995,"8640","13.913492","48","175","188",109,79,54,"16",38,0.3486,0.2025,0.2872,0.9309
"2798",147013,"MCKENDREE COLLEGE",1,0,1996,"9600","15.905391","51","282","309",142,167,106,"46",60,0.4225,0.2754,0.343,0.9126
"2799",147013,"MCKENDREE COLLEGE",1,0,1997,"10400","14.266206","57","220","242",131,111,98,"35",63,0.4809,0.3153,0.405,0.9091
"2800",147013,"MCKENDREE COLLEGE",1,0,1998,"11200","15.810881","57","213","247",139,108,91,"24",67,0.482,0.2222,0.3684,0.8623
"2801",147013,"MCKENDREE COLLEGE",1,0,1999,"12000","17.281567","60","211","246",164,82,101,"27",74,0.4512,0.3293,0.4106,0.8577
"2802",147013,"MCKENDREE COLLEGE",1,0,2000,"12300","19.849333","61.5","239","265",154,111,97,"35",62,0.4026,0.3153,0.366,0.9019
"2803",147013,"MCKENDREE COLLEGE",1,0,2001,"13350","21.668405","63","244","284",168,116,128,"35",93,0.5536,0.3017,0.4507,0.8592
"2804",147013,"MCKENDREE COLLEGE",1,0,2002,"14200","22.466566","65","229","258",135,123,127,"48",79,0.5852,0.3902,0.4922,0.8876
"2805",147013,"MCKENDREE COLLEGE",1,0,2003,"15200","21.861367","71","224","287",124,163,113,"55",58,0.4677,0.3374,0.3937,0.7805
"2806",147013,"MCKENDREE COLLEGE",1,0,2004,"16400","23.838502","70","269","337",134,203,122,"55",67,0.5,0.2709,0.362,0.7982
"2807",147013,"McKendree College",1,0,2005,"17500","25.831042","76","209","273",126,147,94,"39",55,0.4365,0.2653,0.3443,0.7656
"2808",147013,"McKendree College",1,0,2006,"18300","26.663345","82","265","343",162,181,114,"40",74,0.4568,0.221,0.3324,0.7726
"2809",147013,"McKendree University",1,0,2007,"19500","29.9414","87","238","298",131,167,94,"42",52,0.3969,0.2515,0.3154,0.7987
"2810",147013,"McKendree University",1,0,2008,"20570","30.126195","94","228","308",145,163,110,"40",70,0.4828,0.2454,0.3571,0.7403
"2811",147013,"McKendree University",1,0,2009,"21370","31.093461","91","231","305",148,157,102,"44",58,0.3919,0.2803,0.3344,0.7574
"2812",147013,"McKendree University",1,0,2010,"22330","31.593971","97","239","335",154,181,121,"54",67,0.4351,0.2983,0.3612,0.7134
"2813",147244,"MILLIKIN UNIVERSITY",1,0,1991,"9990","29.311958","116","390","422",242,180,245,"94",151,0.624,0.5222,0.5806,0.9242
"2814",147244,"MILLIKIN UNIVERSITY",1,0,1992,"10590","30.969184","118","479","516",302,214,289,"102",187,0.6192,0.4766,0.5601,0.9283
"2815",147244,"MILLIKIN UNIVERSITY",1,0,1993,"11240","34.825176","124","415","452",235,217,256,"111",145,0.617,0.5115,0.5664,0.9181
"2816",147244,"MILLIKIN UNIVERSITY",1,0,1995,"12596","35.938683","128","409","494",272,222,248,"98",150,0.5515,0.4414,0.502,0.8279
"2817",147244,"MILLIKIN UNIVERSITY",1,0,1996,"13290","38.526984","130","422","497",284,213,253,"80",173,0.6092,0.3756,0.5091,0.8491
"2818",147244,"MILLIKIN UNIVERSITY",1,0,1997,"14138","28.285297","222","473","569",302,267,286,"112",174,0.5762,0.4195,0.5026,0.8313
"2819",147244,"MILLIKIN UNIVERSITY",1,0,1998,"14758","31.052635","136","495","594",331,263,291,"91",200,0.6042,0.346,0.4899,0.8333
"2820",147244,"MILLIKIN UNIVERSITY",1,0,1999,"15348","35.415925","137","521","595",324,271,323,"130",193,0.5957,0.4797,0.5429,0.8756
"2821",147244,"MILLIKIN UNIVERSITY",1,0,2000,"16192","38.179957","148","487","574",316,258,320,"120",200,0.6329,0.4651,0.5575,0.8484
"2822",147244,"MILLIKIN UNIVERSITY",1,0,2001,"17084","41.36781","159","547","646",356,290,349,"139",210,0.5899,0.4793,0.5402,0.8467
"2823",147244,"MILLIKIN UNIVERSITY",1,0,2002,"18109","48.115103","159","551","634",351,283,335,"117",218,0.6211,0.4134,0.5284,0.8691
"2824",147244,"MILLIKIN UNIVERSITY",1,0,2003,"18834","41.451315","143","491","595",299,296,317,"132",185,0.6187,0.4459,0.5328,0.8252
"2825",147244,"MILLIKIN UNIVERSITY",1,0,2004,"19900","40.011384","138","429","530",302,228,268,"99",169,0.5596,0.4342,0.5057,0.8094
"2826",147244,"Millikin University",1,0,2005,"20696","41.353776","142","470","572",313,259,311,"119",192,0.6134,0.4595,0.5437,0.8217
"2827",147244,"Millikin University",1,0,2006,"21524","42.68309","145","386","475",261,214,214,"89",125,0.4789,0.4159,0.4505,0.8126
"2828",147244,"Millikin University",1,0,2007,"23250","46.33716","155","384","475",268,207,228,"91",137,0.5112,0.4396,0.48,0.8084
"2829",147244,"Millikin University",1,0,2008,"24600","48.126975","158","388","484",298,186,247,"83",164,0.5503,0.4462,0.5103,0.8017
"2830",147244,"Millikin University",1,0,2009,"25750","50.083813","154","421","541",317,224,259,"97",162,0.511,0.433,0.4787,0.7782
"2831",147244,"Millikin University",1,0,2010,"26780","48.219455","151","372","498",258,240,244,"101",143,0.5543,0.4208,0.49,0.747
"2832",147341,"MONMOUTH COLLEGE",1,0,1991,"12450","14.889175","53","222","252",117,135,113,"48",65,0.5556,0.3556,0.4484,0.881
"2833",147341,"MONMOUTH COLLEGE",1,0,1992,"12800","15.40303","53","112","125",67,58,61,"23",38,0.5672,0.3966,0.488,0.896
"2834",147341,"MONMOUTH COLLEGE",1,0,1993,"12900","14.726836","44","185","204",93,111,77,"31",46,0.4946,0.2793,0.3775,0.9069
"2835",147341,"MONMOUTH COLLEGE",1,0,1995,"13460","18.521916","49","284","308",187,121,156,"54",102,0.5455,0.4463,0.5065,0.9221
"2836",147341,"MONMOUTH COLLEGE",1,0,1996,"13965","20.288695","52","254","282",167,115,139,"52",87,0.521,0.4522,0.4929,0.9007
"2837",147341,"MONMOUTH COLLEGE",1,0,1997,"14420","12.459627","51","234","272",176,96,150,"48",102,0.5795,0.5,0.5515,0.8603
"2838",147341,"MONMOUTH COLLEGE",1,0,1998,"15120","13.647436","49","271","320",146,174,170,"84",86,0.589,0.4828,0.5312,0.8469
"2839",147341,"MONMOUTH COLLEGE",1,0,1999,"15720","14.400049","57","233","259",155,104,132,"44",88,0.5677,0.4231,0.5097,0.8996
"2840",147341,"MONMOUTH COLLEGE",1,0,2000,"16370","15.781718","57.5","214","235",136,99,143,"51",92,0.6765,0.5152,0.6085,0.9106
"2841",147341,"MONMOUTH COLLEGE",1,0,2001,"17000","17.466465","58","236","258",122,136,128,"67",61,0.5,0.4926,0.4961,0.9147
"2842",147341,"MONMOUTH COLLEGE",1,0,2002,"17760","19.013151","61","261","282",147,135,150,"61",89,0.6054,0.4519,0.5319,0.9255
"2843",147341,"MONMOUTH COLLEGE",1,0,2003,"18600","19.735348","66","324","355",175,180,215,"97",118,0.6743,0.5389,0.6056,0.9127
"2844",147341,"MONMOUTH COLLEGE",1,0,2004,"19350","21.38215","69","349","389",227,162,169,"59",110,0.4846,0.3642,0.4344,0.8972
"2845",147341,"Monmouth College",1,0,2005,"20200","23.747388","73","325","367",180,187,140,"50",90,0.5,0.2674,0.3815,0.8856
"2846",147341,"Monmouth College",1,0,2006,"21100","25.846358","79","310","392",215,177,172,"64",108,0.5023,0.3616,0.4388,0.7908
"2847",147341,"Monmouth College",1,0,2007,"22000","27.106146","74","344","393",213,180,223,"90",133,0.6244,0.5,0.5674,0.8753
"2848",147341,"Monmouth College",1,0,2008,"24000","27.595858","81","319","383",179,204,182,"84",98,0.5475,0.4118,0.4752,0.8329
"2849",147341,"Monmouth College",1,0,2009,"24950","28.56748","80","296","378",187,191,183,"79",104,0.5561,0.4136,0.4841,0.7831
"2850",147341,"Monmouth College",1,0,2010,"26900","29.77298","78","249","355",187,168,168,"73",95,0.508,0.4345,0.4732,0.7014
"2851",147703,"NORTHERN ILLINOIS UNIVERSITY",1,0,1991,"2641","206.163415","1003","2368","3161",1646,1515,651,"251",400,0.243,0.1657,0.2059,0.7491
"2852",147703,"NORTHERN ILLINOIS UNIVERSITY",1,0,1992,"3084","210.086263","963","1954","2742",1537,1205,607,"211",396,0.2576,0.1751,0.2214,0.7126
"2853",147703,"NORTHERN ILLINOIS UNIVERSITY",1,0,1993,"3339","219.435834","944","1633","2380",1320,1060,491,"163",328,0.2485,0.1538,0.2063,0.6861
"2854",147703,"NORTHERN ILLINOIS UNIVERSITY",1,0,1995,"3746","238.351511","941","1620","2429",1368,1061,582,"200",382,0.2792,0.1885,0.2396,0.6669
"2855",147703,"NORTHERN ILLINOIS UNIVERSITY",1,0,1996,"3948","261.553585","929","1605","2434",1339,1095,613,"246",367,0.2741,0.2247,0.2518,0.6594
"2856",147703,"NORTHERN ILLINOIS UNIVERSITY",1,0,1997,"4122","269.945729","891","1855","2673",1444,1229,691,"252",439,0.304,0.205,0.2585,0.694
"2857",147703,"NORTHERN ILLINOIS UNIVERSITY",1,0,1998,"4210","281.39409","856","1839","2818",1513,1305,682,"244",438,0.2895,0.187,0.242,0.6526
"2858",147703,"NORTHERN ILLINOIS UNIVERSITY",1,0,1999,"3060","296.478468","847","1918","2924",1587,1337,742,"285",457,0.288,0.2132,0.2538,0.656
"2859",147703,"NORTHERN ILLINOIS UNIVERSITY",1,0,2000,"3150","319.964372","867","1748","2765",1341,1424,634,"273",361,0.2692,0.1917,0.2293,0.6322
"2860",147703,"NORTHERN ILLINOIS UNIVERSITY",1,0,2001,"3293","348.924555","887","1810","2792",1459,1333,725,"281",444,0.3043,0.2108,0.2597,0.6483
"2861",147703,"NORTHERN ILLINOIS UNIVERSITY",1,0,2002,"3581","372.366019","908","1993","3015",1585,1430,698,"283",415,0.2618,0.1979,0.2315,0.661
"2862",147703,"NORTHERN ILLINOIS UNIVERSITY",1,0,2003,"3956","369.945819","898","2097","3229",1635,1594,737,"300",437,0.2673,0.1882,0.2282,0.6494
"2863",147703,"NORTHERN ILLINOIS UNIVERSITY",1,0,2004,"4612","457.665746","874","2014","2933",1585,1348,807,"334",473,0.2984,0.2478,0.2751,0.6867
"2864",147703,"Northern Illinois University",1,0,2005,"5061","405.282105","891","2095","3171",1637,1534,826,"360",466,0.2847,0.2347,0.2605,0.6607
"2865",147703,"Northern Illinois University",1,0,2006,"5550","420.798489","904","2140","3260",1641,1619,903,"427",476,0.2901,0.2637,0.277,0.6564
"2866",147703,"Northern Illinois University",1,0,2007,"6150","433.016409","908","1637","2997",1584,1413,793,"353",440,0.2778,0.2498,0.2646,0.5462
"2867",147703,"Northern Illinois University",1,0,2008,"6720","463.14356","926","1633","2844",1469,1375,718,"315",403,0.2743,0.2291,0.2525,0.5742
"2868",147703,"Northern Illinois University",1,0,2009,"7260","484.375128","921","1711","2988",1573,1415,754,"310",444,0.2823,0.2191,0.2523,0.5726
"2869",147703,"Northern Illinois University",1,0,2010,"7020","502.113951","896","1396","2663",1338,1325,625,"278",347,0.2593,0.2098,0.2347,0.5242
"2870",147767,"NORTHWESTERN UNIVERSITY",0,1,1991,"14370","589.244","875","1405","1945",955,990,1601,"782",819,0.8576,0.7899,0.8231,0.7224
"2871",147767,"NORTHWESTERN UNIVERSITY",0,1,1992,"15075","663.591","886","1364","1889",948,941,1533,"719",814,0.8586,0.7641,0.8115,0.7221
"2872",147767,"NORTHWESTERN UNIVERSITY",0,1,1993,"15804","694.555","872","1356","1903",950,953,1566,"749",817,0.86,0.7859,0.8229,0.7126
"2873",147767,"NORTHWESTERN UNIVERSITY",0,1,1995,"17184","786.636","878","1235","1948",1066,882,1595,"672",923,0.8659,0.7619,0.8188,0.634
"2874",147767,"NORTHWESTERN UNIVERSITY",0,1,1996,"18108","848.516","892","1305","1947",1035,912,1639,"719",920,0.8889,0.7884,0.8418,0.6703
"2875",147767,"NORTHWESTERN UNIVERSITY",0,1,1997,"19152","660.765","879","1206","1889",959,930,1578,"743",835,0.8707,0.7989,0.8354,0.6384
"2876",147767,"NORTHWESTERN UNIVERSITY",0,1,1998,"22392","672.467","916","1223","1912",1023,889,1601,"706",895,0.8749,0.7942,0.8373,0.6396
"2877",147767,"NORTHWESTERN UNIVERSITY",0,1,1999,"23476","758.327","896","1202","1951",1039,912,1657,"746",911,0.8768,0.818,0.8493,0.6161
"2878",147767,"NORTHWESTERN UNIVERSITY",0,1,2000,"24648","819.646","901.5","1148","1876",983,893,1612,"731",881,0.8962,0.8186,0.8593,0.6119
"2879",147767,"NORTHWESTERN UNIVERSITY",0,1,2001,"25839","871.935","907","1143","1947",1026,921,1682,"769",913,0.8899,0.835,0.8639,0.5871
"2880",147767,"NORTHWESTERN UNIVERSITY",0,1,2002,"27108","921.225","915","1199","2000",1075,925,1725,"759",966,0.8986,0.8205,0.8625,0.5995
"2881",147767,"NORTHWESTERN UNIVERSITY",0,1,2003,"28404","958.882","900","1206","1941",1035,906,1694,"753",941,0.9092,0.8311,0.8727,0.6213
"2882",147767,"NORTHWESTERN UNIVERSITY",0,1,2004,"29940","1063.589","933","1178","1914",1030,884,1652,"728",924,0.8971,0.8235,0.8631,0.6155
"2883",147767,"Northwestern University",0,1,2005,"31644","1169.656","1170","1172","1952",1018,934,1669,"756",913,0.8969,0.8094,0.855,0.6004
"2884",147767,"Northwestern University",0,1,2006,"33408","1245.029","1223","1221","2060",1089,971,1768,"799",969,0.8898,0.8229,0.8583,0.5927
"2885",147767,"Northwestern University",0,1,2007,"35064","1356.559","1266","1112","1979",1057,922,1705,"770",935,0.8846,0.8351,0.8615,0.5619
"2886",147767,"Northwestern University",0,1,2008,"36756","1563.035","1294","1167","2077",1075,1002,1773,"822",951,0.8847,0.8204,0.8536,0.5619
"2887",147767,"Northwestern University",0,1,2009,"38463","1588.143","1310","1186","2128",1076,1052,1754,"826",928,0.8625,0.7852,0.8242,0.5573
"2888",147767,"Northwestern University",0,1,2010,"39840","1671.197","1352","1190","2126",1125,1001,1785,"790",995,0.8844,0.7892,0.8396,0.5597
"2889",147776,"NORTHEASTERN ILLINOIS UNIVERSITY",0,1,1991,"2092","57.339573","345","314","724",447,277,17,"5",12,0.0268,0.0181,0.0235,0.4337
"2890",147776,"NORTHEASTERN ILLINOIS UNIVERSITY",1,0,1992,"1834","59.80775","340","292","688",408,280,21,"6",15,0.0368,0.0214,0.0305,0.4244
"2891",147776,"NORTHEASTERN ILLINOIS UNIVERSITY",1,0,1993,"2062","60.647722","331","227","641",374,267,14,"3",11,0.0294,0.0112,0.0218,0.3541
"2892",147776,"NORTHEASTERN ILLINOIS UNIVERSITY",1,0,1995,"2244","66.953186","319","316","812",488,324,20,"7",13,0.0266,0.0216,0.0246,0.3892
"2893",147776,"NORTHEASTERN ILLINOIS UNIVERSITY",1,0,1996,"2352","74.268532","322","271","799",474,325,12,"6",6,0.0127,0.0185,0.015,0.3392
"2894",147776,"NORTHEASTERN ILLINOIS UNIVERSITY",1,0,1997,"2469","77.075785","327","364","1007",630,377,25,"9",16,0.0254,0.0239,0.0248,0.3615
"2895",147776,"NORTHEASTERN ILLINOIS UNIVERSITY",1,0,1998,"2507","76.579898","329","324","961",594,367,15,"3",12,0.0202,0.0082,0.0156,0.3371
"2896",147776,"NORTHEASTERN ILLINOIS UNIVERSITY",1,0,1999,"2262","83.441627","312","304","943",573,370,22,"7",15,0.0262,0.0189,0.0233,0.3224
"2897",147776,"NORTHEASTERN ILLINOIS UNIVERSITY",1,0,2000,"2340","91.01603","332","323","948",570,378,27,"7",20,0.0351,0.0185,0.0285,0.3407
"2898",147776,"NORTHEASTERN ILLINOIS UNIVERSITY",1,0,2001,"2424","99.656845","352","337","964",622,342,21,"7",14,0.0225,0.0205,0.0218,0.3496
"2899",147776,"NORTHEASTERN ILLINOIS UNIVERSITY",1,0,2002,"2508","104.717831","370","331","977",589,388,27,"9",18,0.0306,0.0232,0.0276,0.3388
"2900",147776,"NORTHEASTERN ILLINOIS UNIVERSITY",1,0,2003,"2640","105.35715","398","361","1046",657,389,36,"12",24,0.0365,0.0308,0.0344,0.3451
"2901",147776,"NORTHEASTERN ILLINOIS UNIVERSITY",1,0,2004,"2976","136.830924","415","337","972",580,392,37,"7",30,0.0517,0.0179,0.0381,0.3467
"2902",147776,"Northeastern Illinois University",1,0,2005,"3840","120.069108","415","320","960",570,390,51,"16",35,0.0614,0.041,0.0531,0.3333
"2903",147776,"Northeastern Illinois University",1,0,2006,"4200","123.134565","411","300","1022",600,422,40,"18",22,0.0367,0.0427,0.0391,0.2935
"2904",147776,"Northeastern Illinois University",1,0,2007,"4680","134.579369","411","298","870",506,364,36,"9",27,0.0534,0.0247,0.0414,0.3425
"2905",147776,"Northeastern Illinois University",1,0,2008,"5280","136.970706","421","269","952",519,433,48,"18",30,0.0578,0.0416,0.0504,0.2826
"2906",147776,"Northeastern Illinois University",1,0,2009,"5880","137.53064","404","273","996",545,451,50,"20",30,0.055,0.0443,0.0502,0.2741
"2907",147776,"Northeastern Illinois University",1,0,2010,"5520","150.14281","416","274","976",551,425,37,"11",26,0.0472,0.0259,0.0379,0.2807
"2908",147828,"OLIVET NAZARENE UNIVERSITY",1,0,1991,"6476","17.407594","74","338","376",209,167,140,"42",98,0.4689,0.2515,0.3723,0.8989
"2909",147828,"OLIVET NAZARENE UNIVERSITY",1,0,1992,"7050","19.207675","80","350","388",202,186,129,"48",81,0.401,0.2581,0.3325,0.9021
"2910",147828,"OLIVET NAZARENE UNIVERSITY",1,0,1993,"7836","21.471059","96","386","421",234,187,169,"61",108,0.4615,0.3262,0.4014,0.9169
"2911",147828,"OLIVET NAZARENE UNIVERSITY",1,0,1995,"9440","25.395606","82","371","389",217,172,150,"60",90,0.4147,0.3488,0.3856,0.9537
"2912",147828,"OLIVET NAZARENE UNIVERSITY",1,0,1996,"10166","27.224987","81","374","400",231,169,141,"55",86,0.3723,0.3254,0.3525,0.935
"2913",147828,"OLIVET NAZARENE UNIVERSITY",1,0,1997,"10840","25.195975","85","385","426",229,197,170,"53",117,0.5109,0.269,0.3991,0.9038
"2914",147828,"OLIVET NAZARENE UNIVERSITY",1,0,1998,"11728","25.815979","84","382","428",227,201,159,"59",100,0.4405,0.2935,0.3715,0.8925
"2915",147828,"OLIVET NAZARENE UNIVERSITY",1,0,1999,"11528","27.855504","83","365","410",224,186,169,"61",108,0.4821,0.328,0.4122,0.8902
"2916",147828,"OLIVET NAZARENE UNIVERSITY",1,0,2000,"11928","29.685213","82","421","468",278,190,187,"61",126,0.4532,0.3211,0.3996,0.8996
"2917",147828,"OLIVET NAZARENE UNIVERSITY",1,0,2001,"12644","32.196935","81","480","541",297,244,240,"90",150,0.5051,0.3689,0.4436,0.8872
"2918",147828,"OLIVET NAZARENE UNIVERSITY",1,0,2002,"13400","36.097868","86","490","553",328,225,274,"95",179,0.5457,0.4222,0.4955,0.8861
"2919",147828,"OLIVET NAZARENE UNIVERSITY",1,0,2003,"14160","39.643737","92","506","578",339,239,252,"93",159,0.469,0.3891,0.436,0.8754
"2920",147828,"OLIVET NAZARENE UNIVERSITY",1,0,2004,"14900","42.750192","96","613","699",427,272,338,"97",241,0.5644,0.3566,0.4835,0.877
"2921",147828,"Olivet Nazarene University",1,0,2005,"15650","47.280191","106","560","669",404,265,294,"94",200,0.495,0.3547,0.4395,0.8371
"2922",147828,"Olivet Nazarene University",1,0,2006,"16750","51.381074","107","654","751",414,337,332,"126",206,0.4976,0.3739,0.4421,0.8708
"2923",147828,"Olivet Nazarene University",1,0,2007,"18750","56.605889","119","609","704",384,320,343,"135",208,0.5417,0.4219,0.4872,0.8651
"2924",147828,"Olivet Nazarene University",1,0,2008,"20750","58.563818","118","505","590",357,233,260,"76",184,0.5154,0.3262,0.4407,0.8559
"2925",147828,"Olivet Nazarene University",1,0,2009,"22750","62.328965","122","677","771",447,324,395,"134",261,0.5839,0.4136,0.5123,0.8781
"2926",147828,"Olivet Nazarene University",1,0,2010,"24750","66.36542","122","628","740",417,323,344,"128",216,0.518,0.3963,0.4649,0.8486
"2927",148131,"QUINCY COLLEGE",1,0,1991,"8604","14.793589","61","278","296",153,143,105,"44",61,0.3987,0.3077,0.3547,0.9392
"2928",148131,"QUINCY COLLEGE",1,0,1992,"9160","15.224122","58","285","313",148,165,80,"24",56,0.3784,0.1455,0.2556,0.9105
"2929",148131,"QUINCY UNIVERSITY",1,0,1993,"9532","15.533624","55","262","297",134,163,71,"33",38,0.2836,0.2025,0.2391,0.8822
"2930",148131,"QUINCY UNIVERSITY",1,0,1995,"10910","16.52044","54","230","259",126,133,89,"30",59,0.4683,0.2256,0.3436,0.888
"2931",148131,"QUINCY UNIVERSITY",1,0,1996,"11510","17.207924","51","243","283",135,148,112,"50",62,0.4593,0.3378,0.3958,0.8587
"2932",148131,"QUINCY UNIVERSITY",1,0,1997,"12410","13.085654","52","199","224",116,108,77,"26",51,0.4397,0.2407,0.3438,0.8884
"2933",148131,"QUINCY UNIVERSITY",1,0,1998,"13370","14.21253","58","204","232",122,110,109,"43",66,0.541,0.3909,0.4698,0.8793
"2934",148131,"QUINCY UNIVERSITY",1,0,1999,"13450","14.988678","60","223","273",148,125,98,"36",62,0.4189,0.288,0.359,0.8168
"2935",148131,"QUINCY UNIVERSITY",1,0,2000,"14300","16.037846","60.5","201","235",137,98,81,"25",56,0.4088,0.2551,0.3447,0.8553
"2936",148131,"QUINCY UNIVERSITY",1,0,2001,"15010","16.454871","61","190","231",119,112,83,"32",51,0.4286,0.2857,0.3593,0.8225
"2937",148131,"QUINCY UNIVERSITY",1,0,2002,"15910","17.65855","58","197","229",112,117,88,"33",55,0.4911,0.2821,0.3843,0.8603
"2938",148131,"QUINCY UNIVERSITY",1,0,2003,"16400","16.197364","48","179","222",108,114,68,"32",36,0.3333,0.2807,0.3063,0.8063
"2939",148131,"QUINCY UNIVERSITY",1,0,2004,"17140","16.654476","45","167","228",124,104,75,"27",48,0.3871,0.2596,0.3289,0.7325
"2940",148131,"Quincy University",1,0,2005,"17800","17.177988","52","150","202",99,103,69,"28",41,0.4141,0.2718,0.3416,0.7426
"2941",148131,"Quincy University",1,0,2006,"18450","18.172853","53","131","161",88,73,67,"27",40,0.4545,0.3699,0.4161,0.8137
"2942",148131,"Quincy University",1,0,2007,"18950","18.503913","48","170","234",104,130,92,"42",50,0.4808,0.3231,0.3932,0.7265
"2943",148131,"Quincy University",1,0,2008,"20100","20.009588","49","176","245",108,137,81,"31",50,0.463,0.2263,0.3306,0.7184
"2944",148131,"Quincy University",1,0,2009,"21300","21.790766","53","180","248",127,121,81,"31",50,0.3937,0.2562,0.3266,0.7258
"2945",148131,"Quincy University",1,0,2010,"22240","23.931922","58","152","272",136,136,94,"44",50,0.3676,0.3235,0.3456,0.5588
"2946",148496,"ROSARY COLLEGE",1,0,1991,"9226","15.795578","71","113","152",124,28,58,"11",47,0.379,0.3929,0.3816,0.7434
"2947",148496,"ROSARY COLLEGE",1,0,1992,"9940","16.170774","74","109","142",117,25,67,"9",58,0.4957,0.36,0.4718,0.7676
"2948",148496,"ROSARY COLLEGE",1,0,1993,"10500","16.69972","72","104","140",101,39,66,"17",49,0.4851,0.4359,0.4714,0.7429
"2949",148496,"ROSARY COLLEGE",1,0,1995,"11550","19.294097","69","98","124",95,29,67,"13",54,0.5684,0.4483,0.5403,0.7903
"2950",148496,"ROSARY COLLEGE",1,0,1996,"12230","19.635942","71","108","153",106,47,80,"27",53,0.5,0.5745,0.5229,0.7059
"2951",148496,"DOMINICAN UNIVERSITY",1,0,1997,"13050","16.719394","73","154","199",140,59,99,"28",71,0.5071,0.4746,0.4975,0.7739
"2952",148496,"DOMINICAN UNIVERSITY",1,0,1998,"13700","19.363808","76","150","207",137,70,102,"36",66,0.4818,0.5143,0.4928,0.7246
"2953",148496,"DOMINICAN UNIVERSITY",1,0,1999,"14160","21.458391","79","135","195",144,51,112,"28",84,0.5833,0.549,0.5744,0.6923
"2954",148496,"DOMINICAN UNIVERSITY",1,0,2000,"14720","22.902023","84.5","114","165",108,57,94,"30",64,0.5926,0.5263,0.5697,0.6909
"2955",148496,"DOMINICAN UNIVERSITY",1,0,2001,"15600","25.698823","90","159","222",139,83,111,"34",77,0.554,0.4096,0.5,0.7162
"2956",148496,"DOMINICAN UNIVERSITY",1,0,2002,"16620","28.303747","97","137","192",123,69,111,"29",82,0.6667,0.4203,0.5781,0.7135
"2957",148496,"DOMINICAN UNIVERSITY",1,0,2003,"17850","32.201296","96","175","240",176,64,146,"40",106,0.6023,0.625,0.6083,0.7292
"2958",148496,"DOMINICAN UNIVERSITY",1,0,2004,"18900","34.095451","100","177","271",181,90,156,"41",115,0.6354,0.4556,0.5756,0.6531
"2959",148496,"Dominican University",1,0,2005,"19950","37.624364","109","161","266",178,88,147,"46",101,0.5674,0.5227,0.5526,0.6053
"2960",148496,"Dominican University",1,0,2006,"21150","40.458776","112","205","362",256,106,203,"52",151,0.5898,0.4906,0.5608,0.5663
"2961",148496,"Dominican University",1,0,2007,"22350","42.795956","122","199","366",265,101,184,"43",141,0.5321,0.4257,0.5027,0.5437
"2962",148496,"Dominican University",1,0,2008,"23700","45.825066","125","234","416",291,125,198,"59",139,0.4777,0.472,0.476,0.5625
"2963",148496,"Dominican University",1,0,2009,"24600","49.612977","140","231","405",279,126,193,"51",142,0.509,0.4048,0.4765,0.5704
"2964",148496,"Dominican University",1,0,2010,"25560","52.896566","156","207","427",287,140,212,"60",152,0.5296,0.4286,0.4965,0.4848
"2965",148584,"COLLEGE OF SAINT FRANCIS",1,0,1991,"7982","15.184974","50","144","171",81,90,58,"22",36,0.4444,0.2444,0.3392,0.8421
"2966",148584,"COLLEGE OF SAINT FRANCIS",1,0,1992,"8600","16.621232","51","133","144",67,77,52,"23",29,0.4328,0.2987,0.3611,0.9236
"2967",148584,"COLLEGE OF SAINT FRANCIS",1,0,1993,"9100","17.653597","50","140","149",79,70,61,"25",36,0.4557,0.3571,0.4094,0.9396
"2968",148584,"COLLEGE OF ST FRANCIS",1,0,1995,"10790","19.741556","53","149","165",82,83,67,"30",37,0.4512,0.3614,0.4061,0.903
"2969",148584,"COLLEGE OF ST FRANCIS",1,0,1996,"11490","23.222377","53","102","151",91,60,53,"15",38,0.4176,0.25,0.351,0.6755
"2970",148584,"UNIVERSITY OF ST FRANCIS",1,0,1997,"11950","25.30946","69","91","134",82,52,48,"13",35,0.4268,0.25,0.3582,0.6791
"2971",148584,"UNIVERSITY OF ST FRANCIS",1,0,1998,"12480","28.247039","70","118","176",88,88,64,"21",43,0.4886,0.2386,0.3636,0.6705
"2972",148584,"UNIVERSITY OF ST FRANCIS",1,0,1999,"12800","30.820787","69","145","170",101,69,54,"14",40,0.396,0.2029,0.3176,0.8529
"2973",148584,"UNIVERSITY OF ST FRANCIS",1,0,2000,"13990","24.946512","72.5","148","190",109,81,73,"25",48,0.4404,0.3086,0.3842,0.7789
"2974",148584,"UNIVERSITY OF ST FRANCIS",1,0,2001,"14680","28.031246","76","153","177",112,65,72,"21",51,0.4554,0.3231,0.4068,0.8644
"2975",148584,"UNIVERSITY OF ST FRANCIS",1,0,2002,"15710","28.883544","75","101","149",86,63,49,"17",32,0.3721,0.2698,0.3289,0.6779
"2976",148584,"UNIVERSITY OF ST FRANCIS",1,0,2003,"16480","31.386503","79","144","190",110,80,62,"27",35,0.3182,0.3375,0.3263,0.7579
"2977",148584,"UNIVERSITY OF ST FRANCIS",1,0,2004,"17310","40.619312","81","120","157",94,63,64,"21",43,0.4574,0.3333,0.4076,0.7643
"2978",148584,"University of St Francis",1,0,2005,"18170","34.417453","84","137","190",116,74,85,"27",58,0.5,0.3649,0.4474,0.7211
"2979",148584,"University of St Francis",1,0,2006,"19150","34.362515","87","128","181",104,77,62,"21",41,0.3942,0.2727,0.3425,0.7072
"2980",148584,"University of St Francis",1,0,2007,"20440","35.105451","84","149","198",124,74,63,"18",45,0.3629,0.2432,0.3182,0.7525
"2981",148584,"University of St Francis",1,0,2008,"21450","37.69614","93","160","203",125,78,77,"27",50,0.4,0.3462,0.3793,0.7882
"2982",148584,"University of St Francis",1,0,2009,"22288","39.41618","96","170","223",144,79,92,"26",66,0.4583,0.3291,0.4126,0.7623
"2983",148584,"University of St Francis",1,0,2010,"24292","39.001615","95","144","210",131,79,93,"29",64,0.4885,0.3671,0.4429,0.6857
"2984",148627,"SAINT XAVIER COLLEGE",1,0,1991,"8840","25.859128","133","118","160",109,51,50,"11",39,0.3578,0.2157,0.3125,0.7375
"2985",148627,"SAINT XAVIER UNIVERSITY",1,0,1992,"9650","28.873992","145","129","192",134,58,55,"11",44,0.3284,0.1897,0.2865,0.6719
"2986",148627,"SAINT XAVIER UNIVERSITY",1,0,1993,"10340","29.544951","153","196","272",163,109,75,"20",55,0.3374,0.1835,0.2757,0.7206
"2987",148627,"SAINT XAVIER UNIVERSITY",1,0,1995,"11600","35.187747","137","153","226",139,87,67,"19",48,0.3453,0.2184,0.2965,0.677
"2988",148627,"SAINT XAVIER UNIVERSITY",1,0,1996,"12080","36.979468","141","133","203",116,87,56,"14",42,0.3621,0.1609,0.2759,0.6552
"2989",148627,"SAINT XAVIER UNIVERSITY",1,0,1997,"12560","29.93047","140","164","270",180,90,82,"21",61,0.3389,0.2333,0.3037,0.6074
"2990",148627,"SAINT XAVIER UNIVERSITY",1,0,1998,"13160","31.476164","142","167","271",180,91,87,"21",66,0.3667,0.2308,0.321,0.6162
"2991",148627,"SAINT XAVIER UNIVERSITY",1,0,1999,"13650","34.038411","139","222","325",196,129,96,"33",63,0.3214,0.2558,0.2954,0.6831
"2992",148627,"SAINT XAVIER UNIVERSITY",1,0,2000,"14400","36.062307","142","226","352",222,130,112,"36",76,0.3423,0.2769,0.3182,0.642
"2993",148627,"SAINT XAVIER UNIVERSITY",1,0,2001,"15000","40.357712","145","224","353",208,145,88,"31",57,0.274,0.2138,0.2493,0.6346
"2994",148627,"SAINT XAVIER UNIVERSITY",1,0,2002,"15750","45.320654","151","240","375",262,113,89,"24",65,0.2481,0.2124,0.2373,0.64
"2995",148627,"SAINT XAVIER UNIVERSITY",1,0,2003,"16500","51.309452","160","241","371",231,140,107,"32",75,0.3247,0.2286,0.2884,0.6496
"2996",148627,"SAINT XAVIER UNIVERSITY",1,0,2004,"17150","58.022752","168","250","406",259,147,130,"44",86,0.332,0.2993,0.3202,0.6158
"2997",148627,"Saint Xavier University",1,0,2005,"18350","63.519429","168","251","410",236,174,133,"50",83,0.3517,0.2874,0.3244,0.6122
"2998",148627,"Saint Xavier University",1,0,2006,"19640","66.814099","190","310","525",370,155,172,"47",125,0.3378,0.3032,0.3276,0.5905
"2999",148627,"Saint Xavier University",1,0,2007,"21016","72.588143","186","265","507",342,165,152,"50",102,0.2982,0.303,0.2998,0.5227
"3000",148627,"Saint Xavier University",1,0,2008,"22486","75.186561","176","291","547",375,172,176,"55",121,0.3227,0.3198,0.3218,0.532
"3001",148627,"Saint Xavier University",1,0,2009,"23610","76.420932","180","241","438",282,156,131,"34",97,0.344,0.2179,0.2991,0.5502
"3002",148627,"Saint Xavier University",1,0,2010,"24790","78.870802","179","239","488",308,180,153,"41",112,0.3636,0.2278,0.3135,0.4898
"3003",149222,"SOUTHERN ILLINOIS UNIVERSITY-CARBONDALE",1,0,1991,"2382","298.177409","1062","1724","2376",1018,1358,302,"139",163,0.1601,0.1024,0.1271,0.7256
"3004",149222,"SOUTHERN ILLINOIS UNIVERSITY-CARBONDALE",1,0,1992,"2556","297.72488","991","2019","2756",1203,1553,442,"195",247,0.2053,0.1256,0.1604,0.7326
"3005",149222,"SOUTHERN ILLINOIS UNIVERSITY-CARBONDALE",1,0,1993,"3052","307.944481","977","1673","2271",969,1302,318,"152",166,0.1713,0.1167,0.14,0.7367
"3006",149222,"SOUTHERN ILLINOIS UNIVERSITY-CARBONDALE",1,0,1995,"3338","334.228455","973","1698","2277",1006,1271,371,"162",209,0.2078,0.1275,0.1629,0.7457
"3007",149222,"SOUTHERN ILLINOIS UNIVERSITY-CARBONDALE",1,0,1996,"3522","341.886455","963","1679","2404",1054,1350,376,"152",224,0.2125,0.1126,0.1564,0.6984
"3008",149222,"SOUTHERN ILLINOIS UNIVERSITY-CARBONDALE",1,0,1997,"3716","349.96476","941","1682","2400",1051,1349,451,"188",263,0.2502,0.1394,0.1879,0.7008
"3009",149222,"SOUTHERN ILLINOIS UNIVERSITY-CARBONDALE",1,0,1998,"3821","347.797031","918","1851","2637",1131,1506,542,"248",294,0.2599,0.1647,0.2055,0.7019
"3010",149222,"SOUTHERN ILLINOIS UNIVERSITY-CARBONDALE",1,0,1999,"2865","352.301264","948","1628","2547",1094,1453,483,"234",249,0.2276,0.161,0.1896,0.6392
"3011",149222,"SOUTHERN ILLINOIS UNIVERSITY-CARBONDALE",1,0,2000,"2408","364.938289","1159.5","1545","2325",1036,1289,473,"201",272,0.2625,0.1559,0.2034,0.6645
"3012",149222,"SOUTHERN ILLINOIS UNIVERSITY-CARBONDALE",1,0,2001,"2482","386.240194","1371","1571","2153",967,1186,501,"220",281,0.2906,0.1855,0.2327,0.7297
"3013",149222,"SOUTHERN ILLINOIS UNIVERSITY-CARBONDALE",1,0,2002,"2928","479.348226","1279","1650","2395",1037,1358,550,"262",288,0.2777,0.1929,0.2296,0.6889
"3014",149222,"SOUTHERN ILLINOIS UNIVERSITY-CARBONDALE",1,0,2003,"4245","475.14047","1290","1757","2532",1089,1443,595,"280",315,0.2893,0.194,0.235,0.6939
"3015",149222,"SOUTHERN ILLINOIS UNIVERSITY CARBONDALE",1,0,2004,"4920","602.935318","973","1762","2545",1053,1492,646,"308",338,0.321,0.2064,0.2538,0.6923
"3016",149222,"Southern Illinois University Carbondale",1,0,2005,"5310","528.126865","954","1553","2382",1034,1348,560,"261",299,0.2892,0.1936,0.2351,0.652
"3017",149222,"Southern Illinois University Carbondale",1,0,2006,"5808","555.636743","972","1527","2278",1005,1273,586,"266",320,0.3184,0.209,0.2572,0.6703
"3018",149222,"Southern Illinois University Carbondale",1,0,2007,"6348","568.590863","926","1489","2541",1127,1414,582,"268",314,0.2786,0.1895,0.229,0.586
"3019",149222,"Southern Illinois University Carbondale",1,0,2008,"6975","614.798909","941","1560","2592",1183,1409,627,"305",322,0.2722,0.2165,0.2419,0.6019
"3020",149222,"Southern Illinois University Carbondale",1,0,2009,"7290","652.762794","952","1460","2445",1131,1314,624,"264",360,0.3183,0.2009,0.2552,0.5971
"3021",149222,"Southern Illinois University Carbondale",1,0,2010,"6975","702.427505","914","1217","2314",1104,1210,602,"283",319,0.2889,0.2339,0.2602,0.5259
"3022",149231,"SOUTHERN ILLINOIS UNIVERSITY AT EDWARDSVILLE",0,1,1991,"1965","96.591445","459","707","948",539,409,107,"30",77,0.1429,0.0733,0.1129,0.7458
"3023",149231,"SOUTHERN ILLINOIS UNIVERSITY AT EDWARDSVILLE",0,1,1992,"2158","98.626425","426","729","965",558,407,100,"32",68,0.1219,0.0786,0.1036,0.7554
"3024",149231,"SOUTHERN ILLINOIS UNIVERSITY-EDWARDSVILLE",1,0,1993,"2199","103.46551","421","711","912",523,389,113,"38",75,0.1434,0.0977,0.1239,0.7796
"3025",149231,"SOUTHERN ILLINOIS UNIVERSITY-EDWARDSVILLE",1,0,1995,"2329","116.087566","461","842","1085",644,441,154,"40",114,0.177,0.0907,0.1419,0.776
"3026",149231,"SOUTHERN ILLINOIS UNIVERSITY-EDWARDSVILLE",1,0,1996,"2469","121.910019","466","940","1176",741,435,170,"36",134,0.1808,0.0828,0.1446,0.7993
"3027",149231,"SOUTHERN ILLINOIS UNIVERSITY-EDWARDSVILLE",1,0,1997,"2586","133.986953","482","1004","1219",734,485,242,"65",177,0.2411,0.134,0.1985,0.8236
"3028",149231,"SOUTHERN ILLINOIS UNIVERSITY-EDWARDSVILLE",1,0,1998,"2664","127.771624","481","1125","1408",853,555,257,"70",187,0.2192,0.1261,0.1825,0.799
"3029",149231,"SOUTHERN ILLINOIS UNIVERSITY-EDWARDSVILLE",1,0,1999,"2143","134.62068","491","1081","1357",800,557,253,"66",187,0.2338,0.1185,0.1864,0.7966
"3030",149231,"SOUTHERN ILLINOIS UNIVERSITY-EDWARDSVILLE",1,0,2000,"2388","146.018858","488.5","1221","1495",848,647,324,"103",221,0.2606,0.1592,0.2167,0.8167
"3031",149231,"SOUTHERN ILLINOIS UNIVERSITY-EDWARDSVILLE",1,0,2001,"2574","161.635591","486","1313","1573",895,678,332,"108",224,0.2503,0.1593,0.2111,0.8347
"3032",149231,"SOUTHERN ILLINOIS UNIVERSITY-EDWARDSVILLE",1,0,2002,"2970","192.071948","494","1394","1629",866,763,356,"126",230,0.2656,0.1651,0.2185,0.8557
"3033",149231,"SOUTHERN ILLINOIS UNIVERSITY-EDWARDSVILLE",1,0,2003,"3360","188.065788","518","1427","1699",982,717,399,"129",270,0.2749,0.1799,0.2348,0.8399
"3034",149231,"SOUTHERN ILLINOIS UNIVERSITY EDWARDSVILLE",1,0,2004,"4020","246.762491","528","1470","1695",986,709,485,"162",323,0.3276,0.2285,0.2861,0.8673
"3035",149231,"Southern Illinois University Edwardsville",1,0,2005,"4350","214.485365","556","1478","1721",994,727,487,"166",321,0.3229,0.2283,0.283,0.8588
"3036",149231,"Southern Illinois University Edwardsville",1,0,2006,"4758","222.357523","578","1535","1770",1025,745,527,"163",364,0.3551,0.2188,0.2977,0.8672
"3037",149231,"Southern Illinois University Edwardsville",1,0,2007,"5228","232.729015","592","1426","1833",1026,807,509,"179",330,0.3216,0.2218,0.2777,0.778
"3038",149231,"Southern Illinois University Edwardsville",1,0,2008,"5850","254.716661","610","1492","1901",1101,800,545,"194",351,0.3188,0.2425,0.2867,0.7849
"3039",149231,"Southern Illinois University Edwardsville",1,0,2009,"6201","266.504303","622","1437","1911",1068,843,503,"198",305,0.2856,0.2349,0.2632,0.752
"3040",149231,"Southern Illinois University Edwardsville",1,0,2010,"5668","286.542204","627","1460","2022",1104,918,520,"196",324,0.2935,0.2135,0.2572,0.7221
"3041",149772,"WESTERN ILLINOIS UNIVERSITY",1,0,1991,"2241","121.201456","604","1355","1685",877,808,354,"155",199,0.2269,0.1918,0.2101,0.8042
"3042",149772,"WESTERN ILLINOIS UNIVERSITY",1,0,1992,"2454","123.698924","604","1264","1566",763,803,315,"137",178,0.2333,0.1706,0.2011,0.8072
"3043",149772,"WESTERN ILLINOIS UNIVERSITY",1,0,1993,"2548","122.190764","606","1228","1531",793,738,347,"146",201,0.2535,0.1978,0.2266,0.8021
"3044",149772,"WESTERN ILLINOIS UNIVERSITY",1,0,1995,"2702","127.791112","616","1316","1538",757,781,392,"168",224,0.2959,0.2151,0.2549,0.8557
"3045",149772,"WESTERN ILLINOIS UNIVERSITY",1,0,1996,"2810","139.946723","621","1275","1477",720,757,428,"171",257,0.3569,0.2259,0.2898,0.8632
"3046",149772,"WESTERN ILLINOIS UNIVERSITY",1,0,1997,"3036","143.096138","598","1388","1602",833,769,450,"180",270,0.3241,0.2341,0.2809,0.8664
"3047",149772,"WESTERN ILLINOIS UNIVERSITY",1,0,1998,"3185","155.598692","605","1502","1749",928,821,504,"203",301,0.3244,0.2473,0.2882,0.8588
"3048",149772,"WESTERN ILLINOIS UNIVERSITY",1,0,1999,"2730","165.249268","599","1434","1690",856,834,542,"215",327,0.382,0.2578,0.3207,0.8485
"3049",149772,"WESTERN ILLINOIS UNIVERSITY",1,0,2000,"2812","177.434335","613","1488","1762",904,858,557,"245",312,0.3451,0.2855,0.3161,0.8445
"3050",149772,"WESTERN ILLINOIS UNIVERSITY",1,0,2001,"2982","194.658773","627","1457","1677",836,841,557,"245",312,0.3732,0.2913,0.3321,0.8688
"3051",149772,"WESTERN ILLINOIS UNIVERSITY",1,0,2002,"3465","196.283319","606","1637","1917",941,976,619,"280",339,0.3603,0.2869,0.3229,0.8539
"3052",149772,"WESTERN ILLINOIS UNIVERSITY",1,0,2003,"3915","191.659816","619","1607","1938",939,999,675,"322",353,0.3759,0.3223,0.3483,0.8292
"3053",149772,"WESTERN ILLINOIS UNIVERSITY",1,0,2004,"4537","240.987536","610","1694","2056",1025,1031,681,"301",380,0.3707,0.2919,0.3312,0.8239
"3054",149772,"Western Illinois University",1,0,2005,"4968","208.23566","632","1449","1802",885,917,549,"265",284,0.3209,0.289,0.3047,0.8041
"3055",149772,"Western Illinois University",1,0,2006,"5439","215.175916","642","1556","1907",909,998,583,"303",280,0.308,0.3036,0.3057,0.8159
"3056",149772,"Western Illinois University",1,0,2007,"5895","227.236863","646","1506","1943",952,991,572,"258",314,0.3298,0.2603,0.2944,0.7751
"3057",149772,"Western Illinois University",1,0,2008,"6456","239.166808","668","1353","1806",881,925,536,"278",258,0.2928,0.3005,0.2968,0.7492
"3058",149772,"Western Illinois University",1,0,2009,"6779","248.213446","662","1193","1633",817,816,515,"226",289,0.3537,0.277,0.3154,0.7306
"3059",149772,"Western Illinois University",1,0,2010,"6588","260.583553","648","1172","1741",886,855,534,"265",269,0.3036,0.3099,0.3067,0.6732
"3060",149781,"WHEATON COLLEGE",1,0,1991,"9548","45.381516","147","504","544",277,267,373,"164",209,0.7545,0.6142,0.6857,0.9265
"3061",149781,"WHEATON COLLEGE",1,0,1992,"10280","48.08609","154","489","548",294,254,392,"172",220,0.7483,0.6772,0.7153,0.8923
"3062",149781,"WHEATON COLLEGE",1,0,1993,"10640","51.202467","156","480","546",282,264,371,"159",212,0.7518,0.6023,0.6795,0.8791
"3063",149781,"WHEATON COLLEGE",1,0,1995,"12300","57.513174","166","480","546",281,265,425,"198",227,0.8078,0.7472,0.7784,0.8791
"3064",149781,"WHEATON COLLEGE",1,0,1996,"13100","62.38245","171","489","557",278,279,424,"207",217,0.7806,0.7419,0.7612,0.8779
"3065",149781,"WHEATON COLLEGE",1,0,1997,"13780","60.502753","170","485","546",290,256,418,"189",229,0.7897,0.7383,0.7656,0.8883
"3066",149781,"WHEATON COLLEGE",1,0,1998,"14360","58.840732","170","519","573",300,273,409,"186",223,0.7433,0.6813,0.7138,0.9058
"3067",149781,"WHEATON COLLEGE",1,0,1999,"14930","61.200423","166","518","583",311,272,450,"204",246,0.791,0.75,0.7719,0.8885
"3068",149781,"WHEATON COLLEGE",1,0,2000,"15540","64.942367","211","491","568",291,277,441,"212",229,0.7869,0.7653,0.7764,0.8644
"3069",149781,"WHEATON COLLEGE",1,0,2001,"16390","68.383451","256","494","572",276,296,416,"200",216,0.7826,0.6757,0.7273,0.8636
"3070",149781,"WHEATON COLLEGE",1,0,2002,"17320","74.222338","185","489","569",286,283,447,"213",234,0.8182,0.7527,0.7856,0.8594
"3071",149781,"WHEATON COLLEGE",1,0,2003,"18500","75.507899","183","503","576",288,288,462,"223",239,0.8299,0.7743,0.8021,0.8733
"3072",149781,"WHEATON COLLEGE",1,0,2004,"20000","77.602919","188","503","595",318,277,469,"202",267,0.8396,0.7292,0.7882,0.8454
"3073",149781,"Wheaton College",1,0,2005,"21100","84.714912","193","496","578",287,291,458,"220",238,0.8293,0.756,0.7924,0.8581
"3074",149781,"Wheaton College",1,0,2006,"22450","90.536301","196","481","572",278,294,435,"219",216,0.777,0.7449,0.7605,0.8409
"3075",149781,"Wheaton College",1,0,2007,"23730","94.420858","196","486","580",292,288,432,"216",216,0.7397,0.75,0.7448,0.8379
"3076",149781,"Wheaton College",1,0,2008,"25500","101.280139","202","475","580",291,289,462,"219",243,0.8351,0.7578,0.7966,0.819
"3077",149781,"Wheaton College",1,0,2009,"26520","106.246757","202","510","620",318,302,501,"232",269,0.8459,0.7682,0.8081,0.8226
"3078",149781,"Wheaton College",1,0,2010,"27580","105.381135","199","502","602",312,290,495,"226",269,0.8622,0.7793,0.8223,0.8339
"3079",150066,"ANDERSON UNIVERSITY",1,0,1991,"8060","24.928614","103","432","460",245,215,123,"47",76,0.3102,0.2186,0.2674,0.9391
"3080",150066,"ANDERSON UNIVERSITY",1,0,1992,"8780","26.264081","123","470","507",297,210,162,"53",109,0.367,0.2524,0.3195,0.927
"3081",150066,"ANDERSON UNIVERSITY",1,0,1993,"9520","29.605914","136","394","423",251,172,131,"43",88,0.3506,0.25,0.3097,0.9314
"3082",150066,"ANDERSON UNIVERSITY",1,0,1995,"11240","35.558187","136","470","498",298,200,169,"59",110,0.3691,0.295,0.3394,0.9438
"3083",150066,"ANDERSON UNIVERSITY",1,0,1996,"11840","35.979895","137","376","406",222,184,144,"47",97,0.4369,0.2554,0.3547,0.9261
"3084",150066,"ANDERSON UNIVERSITY",1,0,1997,"12700","23.197966","136","418","451",266,185,172,"54",118,0.4436,0.2919,0.3814,0.9268
"3085",150066,"ANDERSON UNIVERSITY",1,0,1998,"13360","27.373959","135","500","534",319,215,202,"78",124,0.3887,0.3628,0.3783,0.9363
"3086",150066,"ANDERSON UNIVERSITY",1,0,1999,"13740","28.496124","135","455","498",304,194,206,"61",145,0.477,0.3144,0.4137,0.9137
"3087",150066,"ANDERSON UNIVERSITY",1,0,2000,"14680","29.43194","138","497","538",275,263,212,"77",135,0.4909,0.2928,0.3941,0.9238
"3088",150066,"ANDERSON UNIVERSITY",1,0,2001,"15380","30.90126","141","402","462",272,190,170,"45",125,0.4596,0.2368,0.368,0.8701
"3089",150066,"ANDERSON UNIVERSITY",1,0,2002,"16140","33.842","139","522","591",335,256,225,"72",153,0.4567,0.2812,0.3807,0.8832
"3090",150066,"ANDERSON UNIVERSITY",1,0,2003,"17050","38.358","139","511","559",337,222,246,"81",165,0.4896,0.3649,0.4401,0.9141
"3091",150066,"ANDERSON UNIVERSITY",1,0,2004,"17990","40.57","137","515","579",340,239,248,"92",156,0.4588,0.3849,0.4283,0.8895
"3092",150066,"Anderson University",1,0,2005,"18900","44.136","141","500","565",348,217,272,"93",179,0.5144,0.4286,0.4814,0.885
"3093",150066,"Anderson University",1,0,2006,"19990","46.601","148","397","447",245,202,206,"83",123,0.502,0.4109,0.4609,0.8881
"3094",150066,"Anderson University",1,0,2007,"20976","48.368","145","414","479",239,240,216,"90",126,0.5272,0.375,0.4509,0.8643
"3095",150066,"Anderson University",1,0,2008,"21920","48.636","140","470","540",316,224,259,"97",162,0.5127,0.433,0.4796,0.8704
"3096",150066,"Anderson University",1,0,2009,"22910","50.374","146","478","547",313,234,238,"83",155,0.4952,0.3547,0.4351,0.8739
"3097",150066,"Anderson University",1,0,2010,"23940","50.496","138","377","469",264,205,230,"79",151,0.572,0.3854,0.4904,0.8038
"3098",150136,"BALL STATE UNIVERSITY",1,0,1991,"2280","216.311817","943","3132","3447",1976,1471,1555,"602",953,0.4823,0.4092,0.4511,0.9086
"3099",150136,"BALL STATE UNIVERSITY",1,0,1992,"2464","230.299772","939","2983","3265",1841,1424,699,"236",463,0.2515,0.1657,0.2141,0.9136
"3100",150136,"BALL STATE UNIVERSITY",1,0,1993,"2656","233.69647","965","3496","3872",2104,1768,701,"230",471,0.2239,0.1301,0.181,0.9029
"3101",150136,"BALL STATE UNIVERSITY",1,0,1995,"3048","246.312324","906","3463","3855",2068,1787,787,"262",525,0.2539,0.1466,0.2042,0.8983
"3102",150136,"BALL STATE UNIVERSITY",1,0,1996,"3188","258.328678","893","3377","3763",1959,1804,726,"241",485,0.2476,0.1336,0.1929,0.8974
"3103",150136,"BALL STATE UNIVERSITY",1,0,1997,"3316","268.897104","870","3537","4047",2177,1870,837,"242",595,0.2733,0.1294,0.2068,0.874
"3104",150136,"BALL STATE UNIVERSITY",1,0,1998,"3454","277.658719","863","3126","3512",1905,1607,896,"311",585,0.3071,0.1935,0.2551,0.8901
"3105",150136,"BALL STATE UNIVERSITY",1,0,1999,"3576","280.240581","841","3171","3602",1931,1671,943,"348",595,0.3081,0.2083,0.2618,0.8803
"3106",150136,"BALL STATE UNIVERSITY",1,0,2000,"3720","288.677552","862","3242","3694",2023,1671,1062,"372",690,0.3411,0.2226,0.2875,0.8776
"3107",150136,"BALL STATE UNIVERSITY",1,0,2001,"3924","305.871664","883","3338","3743",2039,1704,1066,"344",722,0.3541,0.2019,0.2848,0.8918
"3108",150136,"BALL STATE UNIVERSITY",1,0,2002,"4320","288.046978","858","3571","4010",2207,1803,1327,"507",820,0.3715,0.2812,0.3309,0.8905
"3109",150136,"BALL STATE UNIVERSITY",1,0,2003,"4532","303.261723","896","3627","3963",2139,1824,1329,"507",822,0.3843,0.278,0.3354,0.9152
"3110",150136,"BALL STATE UNIVERSITY",1,0,2004,"5264","314.18808","903","3274","3662",1951,1711,1141,"390",751,0.3849,0.2279,0.3116,0.894
"3111",150136,"Ball State University",1,0,2005,"6030","328.765361","910","3165","3660",1892,1768,1063,"367",696,0.3679,0.2076,0.2904,0.8648
"3112",150136,"Ball State University",1,0,2006,"6360","342.150332","915","3418","3947",2027,1920,1155,"425",730,0.3601,0.2214,0.2926,0.866
"3113",150136,"Ball State University",1,0,2007,"6736","356.898495","917","3204","3747",2033,1714,1223,"432",791,0.3891,0.252,0.3264,0.8551
"3114",150136,"Ball State University",1,0,2008,"7000","385.217613","925","3447","3983",2188,1795,1384,"504",880,0.4022,0.2808,0.3475,0.8654
"3115",150136,"Ball State University",1,0,2009,"7228","396.73254","940","3494","4131",2240,1891,1542,"570",972,0.4339,0.3014,0.3733,0.8458
"3116",150136,"Ball State University",1,0,2010,"7508","405.792502","950","3259","3849",2123,1726,1588,"560",1028,0.4842,0.3244,0.4126,0.8467
"3117",150145,"BETHEL COLLEGE",1,0,1991,"7500","6.039832","33","111","116",61,55,29,"17",12,0.1967,0.3091,0.25,0.9569
"3118",150145,"BETHEL COLLEGE",1,0,1992,"7950","7.292238","33","132","152",88,64,48,"16",32,0.3636,0.25,0.3158,0.8684
"3119",150145,"BETHEL COLLEGE",1,0,1993,"8700","8.492283","36","158","168",95,73,62,"23",39,0.4105,0.3151,0.369,0.9405
"3120",150145,"BETHEL COLLEGE",1,0,1995,"9750","10.724936","48","166","184",118,66,63,"18",45,0.3814,0.2727,0.3424,0.9022
"3121",150145,"BETHEL COLLEGE",1,0,1996,"10350","12.446338","51","184","201",117,84,68,"22",46,0.3932,0.2619,0.3383,0.9154
"3122",150145,"BETHEL COLLEGE",1,0,1997,"11100","12.441796","58","201","223",144,79,97,"33",64,0.4444,0.4177,0.435,0.9013
"3123",150145,"BETHEL COLLEGE",1,0,1998,"11500","14.408788","63","257","273",173,100,104,"36",68,0.3931,0.36,0.381,0.9414
"3124",150145,"BETHEL COLLEGE",1,0,1999,"11950","15.861138","68","250","265",156,109,98,"30",68,0.4359,0.2752,0.3698,0.9434
"3125",150145,"BETHEL COLLEGE",1,0,2000,"12550","16.748774","68.5","277","294",182,112,114,"41",73,0.4011,0.3661,0.3878,0.9422
"3126",150145,"BETHEL COLLEGE",1,0,2001,"13300","17.975598","69","231","258",161,97,110,"34",76,0.472,0.3505,0.4264,0.8953
"3127",150145,"BETHEL COLLEGE",1,0,2002,"13990","18.372287","76","231","253",143,110,108,"34",74,0.5175,0.3091,0.4269,0.913
"3128",150145,"BETHEL COLLEGE",1,0,2003,"14390","20.185129","83","265","291",175,116,117,"39",78,0.4457,0.3362,0.4021,0.9107
"3129",150145,"BETHEL COLLEGE",1,0,2004,"15200","22.314441","88","278","306",174,132,125,"38",87,0.5,0.2879,0.4085,0.9085
"3130",150145,"Bethel College",1,0,2005,"15950","24.32812","84","283","310",207,103,122,"41",81,0.3913,0.3981,0.3935,0.9129
"3131",150145,"Bethel College",1,0,2006,"17450","26.275211","88","259","303",190,113,136,"41",95,0.5,0.3628,0.4488,0.8548
"3132",150145,"Bethel College",1,0,2007,"18600","27.754569","84","204","249",159,90,106,"33",73,0.4591,0.3667,0.4257,0.8193
"3133",150145,"Bethel College",1,0,2008,"19996","31.786034","91","199","242",149,93,132,"45",87,0.5839,0.4839,0.5455,0.8223
"3134",150145,"Bethel College",1,0,2009,"20978","30.115123","91","263","295",175,120,165,"60",105,0.6,0.5,0.5593,0.8915
"3135",150145,"Bethel College-Mishawaka",1,0,2010,"21990","30.869353","88","225","269",169,100,144,"51",93,0.5503,0.51,0.5353,0.8364
"3136",150163,"BUTLER UNIVERSITY",1,0,1991,"10500","47.32635","217","550","622",363,259,252,"94",158,0.4353,0.3629,0.4051,0.8842
"3137",150163,"BUTLER UNIVERSITY",1,0,1992,"11340","52.483134","216","613","666",383,283,257,"98",159,0.4151,0.3463,0.3859,0.9204
"3138",150163,"BUTLER UNIVERSITY",1,0,1993,"12280","58.638","220","646","700",437,263,288,"94",194,0.4439,0.3574,0.4114,0.9229
"3139",150163,"BUTLER UNIVERSITY",1,0,1995,"13990","62.972","231","757","847",510,337,409,"145",264,0.5176,0.4303,0.4829,0.8937
"3140",150163,"BUTLER UNIVERSITY",1,0,1996,"14900","72.248","230","626","777",475,302,426,"137",289,0.6084,0.4536,0.5483,0.8057
"3141",150163,"BUTLER UNIVERSITY",1,0,1997,"15570","67.068","227","541","699",458,241,369,"120",249,0.5437,0.4979,0.5279,0.774
"3142",150163,"BUTLER UNIVERSITY",1,0,1998,"16280","71.841","239","821","912",557,355,452,"145",307,0.5512,0.4085,0.4956,0.9002
"3143",150163,"BUTLER UNIVERSITY",1,0,1999,"17180","82.929223","245","700","861",529,332,470,"168",302,0.5709,0.506,0.5459,0.813
"3144",150163,"BUTLER UNIVERSITY",1,0,2000,"18040","80.901","260","736","868",559,309,516,"182",334,0.5975,0.589,0.5945,0.8479
"3145",150163,"BUTLER UNIVERSITY",1,0,2001,"18940","81.764","275","822","929",593,336,512,"168",344,0.5801,0.5,0.5511,0.8848
"3146",150163,"BUTLER UNIVERSITY",1,0,2002,"19990","81.453","257","836","936",595,341,485,"157",328,0.5513,0.4604,0.5182,0.8932
"3147",150163,"BUTLER UNIVERSITY",1,0,2003,"20990","83.321","289","803","972",612,360,550,"184",366,0.598,0.5111,0.5658,0.8261
"3148",150163,"BUTLER UNIVERSITY",1,0,2004,"22250","87.247","272","799","925",571,354,458,"143",315,0.5517,0.404,0.4951,0.8638
"3149",150163,"Butler University",1,0,2005,"23530","90.737","285","752","864",536,328,391,"119",272,0.5075,0.3628,0.4525,0.8704
"3150",150163,"Butler University",1,0,2006,"24710","95.199","291","811","965",604,361,479,"150",329,0.5447,0.4155,0.4964,0.8404
"3151",150163,"Butler University",1,0,2007,"26070","103.514","305","864","987",613,374,502,"157",345,0.5628,0.4198,0.5086,0.8754
"3152",150163,"Butler University",1,0,2008,"27500","112.543","307","788","934",566,368,580,"209",371,0.6555,0.5679,0.621,0.8437
"3153",150163,"Butler University",1,0,2009,"28460","118.13","325","804","944",571,373,501,"166",335,0.5867,0.445,0.5307,0.8517
"3154",150163,"Butler University",1,0,2010,"29740","123.86","332","863","1049",616,433,600,"211",389,0.6315,0.4873,0.572,0.8227
"3155",150400,"DEPAUW UNIVERSITY",1,0,1991,"12288","44.454503","155","404","475",258,217,367,"157",210,0.814,0.7235,0.7726,0.8505
"3156",150400,"DEPAUW UNIVERSITY",1,0,1992,"13000","44.390484","149","471","566",326,240,410,"169",241,0.7393,0.7042,0.7244,0.8322
"3157",150400,"DEPAUW UNIVERSITY",1,0,1993,"13700","49.188312","146","440","495",250,245,361,"179",182,0.728,0.7306,0.7293,0.8889
"3158",150400,"DEPAUW UNIVERSITY",1,0,1995,"15475","47.625328","146","479","580",328,252,434,"187",247,0.753,0.7421,0.7483,0.8259
"3159",150400,"DEPAUW UNIVERSITY",1,0,1996,"16180","53.381206","148","538","619",351,268,450,"192",258,0.735,0.7164,0.727,0.8691
"3160",150400,"DEPAUW UNIVERSITY",1,0,1997,"17050","62.305959","153","591","673",363,310,493,"228",265,0.73,0.7355,0.7325,0.8782
"3161",150400,"DEPAUW UNIVERSITY",1,0,1998,"17650","67.710047","149","510","593",344,249,423,"164",259,0.7529,0.6586,0.7133,0.86
"3162",150400,"DEPAUW UNIVERSITY",1,0,1999,"19420","73.433666","167","491","579",327,252,436,"194",242,0.7401,0.7698,0.753,0.848
"3163",150400,"DEPAUW UNIVERSITY",1,0,2000,"20200","80.265335","174.5","537","610",336,274,479,"202",277,0.8244,0.7372,0.7852,0.8803
"3164",150400,"DEPAUW UNIVERSITY",1,0,2001,"21100","90.285125","182","543","620",350,270,481,"205",276,0.7886,0.7593,0.7758,0.8758
"3165",150400,"DEPAUW UNIVERSITY",1,0,2002,"22400","94.783913","185","590","685",369,316,566,"259",307,0.832,0.8196,0.8263,0.8613
"3166",150400,"DEPAUW UNIVERSITY",1,0,2003,"24000","106.029309","209","480","580",305,275,456,"202",254,0.8328,0.7345,0.7862,0.8276
"3167",150400,"DEPAUW UNIVERSITY",1,0,2004,"25000","108.783676","213","572","661",367,294,546,"229",317,0.8638,0.7789,0.826,0.8654
"3168",150400,"DePauw University",1,0,2005,"26100","112.918993","226","505","586",337,249,470,"197",273,0.8101,0.7912,0.802,0.8618
"3169",150400,"DePauw University",1,0,2006,"27400","120.031097","221","476","595",334,261,442,"186",256,0.7665,0.7126,0.7429,0.8
"3170",150400,"DePauw University",1,0,2007,"29300","122.368114","216","524","664",369,295,493,"211",282,0.7642,0.7153,0.7425,0.7892
"3171",150400,"DePauw University",1,0,2008,"31400","93.333653","227","437","600",341,259,448,"172",276,0.8094,0.6641,0.7467,0.7283
"3172",150400,"DePauw University",1,0,2009,"32800","94.888199","220","515","717",405,312,543,"222",321,0.7926,0.7115,0.7573,0.7183
"3173",150400,"DePauw University",1,0,2010,"34440","91.938967","215","400","608",345,263,474,"202",272,0.7884,0.7681,0.7796,0.6579
"3174",150534,"UNIVERSITY OF EVANSVILLE",1,0,1991,"9910","35.058607","154","614","694",403,291,281,"101",180,0.4467,0.3471,0.4049,0.8847
"3175",150534,"UNIVERSITY OF EVANSVILLE",1,0,1992,"10700","40.872462","165","677","754",435,319,322,"117",205,0.4713,0.3668,0.4271,0.8979
"3176",150534,"UNIVERSITY OF EVANSVILLE",1,0,1993,"11130","45.689741","170","651","746",424,322,296,"113",183,0.4316,0.3509,0.3968,0.8727
"3177",150534,"UNIVERSITY OF EVANSVILLE",1,0,1995,"12600","54.973898","176","710","826",504,322,370,"131",239,0.4742,0.4068,0.4479,0.8596
"3178",150534,"UNIVERSITY OF EVANSVILLE",1,0,1996,"13220","60.300285","183","588","694",428,266,294,"99",195,0.4556,0.3722,0.4236,0.8473
"3179",150534,"UNIVERSITY OF EVANSVILLE",1,0,1997,"13600","43.426758","182","616","719",424,295,312,"108",204,0.4811,0.3661,0.4339,0.8567
"3180",150534,"UNIVERSITY OF EVANSVILLE",1,0,1998,"14400","45.770658","176","545","665",423,242,293,"92",201,0.4752,0.3802,0.4406,0.8195
"3181",150534,"UNIVERSITY OF EVANSVILLE",1,0,1999,"15200","46.457704","177","474","594",367,227,276,"97",179,0.4877,0.4273,0.4646,0.798
"3182",150534,"UNIVERSITY OF EVANSVILLE",1,0,2000,"16100","47.256898","175","422","555",320,235,237,"84",153,0.4781,0.3574,0.427,0.7604
"3183",150534,"UNIVERSITY OF EVANSVILLE",1,0,2001,"17050","48.174193","173","324","511",310,201,226,"93",133,0.429,0.4627,0.4423,0.6341
"3184",150534,"UNIVERSITY OF EVANSVILLE",1,0,2002,"17900","47.420383","168","385","600",369,231,289,"100",189,0.5122,0.4329,0.4817,0.6417
"3185",150534,"UNIVERSITY OF EVANSVILLE",1,0,2003,"18900","49.152837","168","456","662",418,244,346,"119",227,0.5431,0.4877,0.5227,0.6888
"3186",150534,"UNIVERSITY OF EVANSVILLE",1,0,2004,"19995","51.554492","167","508","634",382,252,357,"131",226,0.5916,0.5198,0.5631,0.8013
"3187",150534,"University of Evansville",1,0,2005,"21120","54.466701","174","535","670",416,254,337,"105",232,0.5577,0.4134,0.503,0.7985
"3188",150534,"University of Evansville",1,0,2006,"22370","58.32526","179","527","643",379,264,359,"139",220,0.5805,0.5265,0.5583,0.8196
"3189",150534,"University of Evansville",1,0,2007,"23710","66.004981","177","510","651",375,276,344,"129",215,0.5733,0.4674,0.5284,0.7834
"3190",150534,"University of Evansville",1,0,2008,"25130","64.016827","176","490","616",377,239,325,"116",209,0.5544,0.4854,0.5276,0.7955
"3191",150534,"University of Evansville",1,0,2009,"26010","65.428186","172","574","701",433,268,403,"152",251,0.5797,0.5672,0.5749,0.8188
"3192",150534,"University of Evansville",1,0,2010,"27310","67.144833","174","570","683",403,280,398,"136",262,0.6501,0.4857,0.5827,0.8346
"3193",150668,"GOSHEN COLLEGE",0,1,1991,"7720","14.525084","72","167","194",106,88,83,"30",53,0.5,0.3409,0.4278,0.8608
"3194",150668,"GOSHEN COLLEGE",0,1,1992,"8310","14.909855","74","177","201",104,97,73,"37",36,0.3462,0.3814,0.3632,0.8806
"3195",150668,"GOSHEN COLLEGE",0,1,1993,"8770","15.976391","84","196","229",140,89,88,"34",54,0.3857,0.382,0.3843,0.8559
"3196",150668,"GOSHEN COLLEGE",1,0,1995,"9900","19.78033","74","192","213",111,102,104,"40",64,0.5766,0.3922,0.4883,0.9014
"3197",150668,"GOSHEN COLLEGE",1,0,1996,"10900","19.902403","74","182","197",107,90,90,"39",51,0.4766,0.4333,0.4569,0.9239
"3198",150668,"GOSHEN COLLEGE",1,0,1997,"11450","17.673717","67","180","209",116,93,89,"32",57,0.4914,0.3441,0.4258,0.8612
"3199",150668,"GOSHEN COLLEGE",1,0,1998,"12150","17.865599","72","181","207",121,86,99,"39",60,0.4959,0.4535,0.4783,0.8744
"3200",150668,"GOSHEN COLLEGE",1,0,1999,"12320","19.711968","76","190","220",135,85,90,"30",60,0.4444,0.3529,0.4091,0.8636
"3201",150668,"GOSHEN COLLEGE",1,0,2000,"12870","20.412678","77","158","194",113,81,87,"30",57,0.5044,0.3704,0.4485,0.8144
"3202",150668,"GOSHEN COLLEGE",1,0,2001,"13600","22.224054","78","140","172",94,78,87,"33",54,0.5745,0.4231,0.5058,0.814
"3203",150668,"GOSHEN COLLEGE",1,0,2002,"14700","25.192112","75","107","133",81,52,74,"28",46,0.5679,0.5385,0.5564,0.8045
"3204",150668,"GOSHEN COLLEGE",1,0,2003,"16320","25.867711","69","157","181",99,82,101,"41",60,0.6061,0.5,0.558,0.8674
"3205",150668,"GOSHEN COLLEGE",1,0,2004,"18200","25.734557","65","143","168",95,73,84,"38",46,0.4842,0.5205,0.5,0.8512
"3206",150668,"Goshen College",1,0,2005,"19300","26.264186","72","162","194",108,86,113,"44",69,0.6389,0.5116,0.5825,0.8351
"3207",150668,"Goshen College",1,0,2006,"20300","26.934952","73","172","206",122,84,114,"44",70,0.5738,0.5238,0.5534,0.835
"3208",150668,"Goshen College",1,0,2007,"21300","28.902958","71","160","202",114,88,110,"44",66,0.5789,0.5,0.5446,0.7921
"3209",150668,"Goshen College",1,0,2008,"22300","30.029708","67","131","172",97,75,95,"36",59,0.6082,0.48,0.5523,0.7616
"3210",150668,"Goshen College",1,0,2009,"23400","30.243402","67","196","238",148,90,126,"45",81,0.5473,0.5,0.5294,0.8235
"3211",150668,"Goshen College",1,0,2010,"24500","29.588338","72","128","179",106,73,100,"39",61,0.5755,0.5342,0.5587,0.7151
"3212",150941,"HUNTINGTON COLLEGE",1,0,1991,"7890","9.106762","38","144","154",76,78,55,"30",25,0.3289,0.3846,0.3571,0.9351
"3213",150941,"HUNTINGTON COLLEGE",1,0,1992,"8730","9.593187","37","138","150",92,58,75,"24",51,0.5543,0.4138,0.5,0.92
"3214",150941,"HUNTINGTON COLLEGE",1,0,1993,"9490","10.143129","38","117","124",69,55,64,"26",38,0.5507,0.4727,0.5161,0.9435
"3215",150941,"HUNTINGTON COLLEGE",1,0,1995,"10800","11.532147","40","180","191",113,78,87,"27",60,0.531,0.3462,0.4555,0.9424
"3216",150941,"HUNTINGTON COLLEGE",1,0,1996,"11520","13.08464","41","169","174",104,70,95,"37",58,0.5577,0.5286,0.546,0.9713
"3217",150941,"HUNTINGTON COLLEGE",1,0,1997,"12180","14.825785","43","193","197",129,68,95,"21",74,0.5736,0.3088,0.4822,0.9797
"3218",150941,"HUNTINGTON COLLEGE",1,0,1998,"12250","16.289118","49","221","227",151,76,115,"34",81,0.5364,0.4474,0.5066,0.9736
"3219",150941,"HUNTINGTON COLLEGE",1,0,1999,"12780","13.833376","52","214","221",140,81,127,"43",84,0.6,0.5309,0.5747,0.9683
"3220",150941,"HUNTINGTON COLLEGE",1,0,2000,"13540","15.211599","53.5","200","206",109,97,100,"46",54,0.4954,0.4742,0.4854,0.9709
"3221",150941,"HUNTINGTON COLLEGE",1,0,2001,"14270","16.468775","55","212","220",135,85,117,"43",74,0.5481,0.5059,0.5318,0.9636
"3222",150941,"HUNTINGTON COLLEGE",1,0,2002,"15520","17.102989","56","224","236",145,91,110,"40",70,0.4828,0.4396,0.4661,0.9492
"3223",150941,"HUNTINGTON COLLEGE",1,0,2003,"16120","18.268984","54","184","190",103,87,94,"45",49,0.4757,0.5172,0.4947,0.9684
"3224",150941,"HUNTINGTON COLLEGE",1,0,2004,"18060","18.077959","57","196","203",123,80,108,"44",64,0.5203,0.55,0.532,0.9655
"3225",150941,"Huntington University",1,0,2005,"18060","19.770661","61","219","232",133,99,113,"45",68,0.5113,0.4545,0.4871,0.944
"3226",150941,"Huntington University",1,0,2006,"18420","20.62689","61","238","250",140,110,126,"52",74,0.5286,0.4727,0.504,0.952
"3227",150941,"Huntington University",1,0,2007,"18980","21.457988","61","233","244",138,106,138,"63",75,0.5435,0.5943,0.5656,0.9549
"3228",150941,"Huntington University",1,0,2008,"19840","22.690158","60","249","275",161,114,133,"51",82,0.5093,0.4474,0.4836,0.9055
"3229",150941,"Huntington University",1,0,2009,"20820","24.926339","62","229","250",138,112,142,"64",78,0.5652,0.5714,0.568,0.916
"3230",150941,"Huntington University",1,0,2010,"21850","24.980771","60","231","263",146,117,144,"62",82,0.5616,0.5299,0.5475,0.8783
"3231",151102,"INDIANA UNIVERSITY-PURDUE UNIVERSITY AT FORT WAYNE",1,0,1991,"1981","46.524126","301","1052","1134",607,527,34,"17",17,0.028,0.0323,0.03,0.9277
"3232",151102,"INDIANA UNIVERSITY-PURDUE UNIVERSITY AT FORT WAYNE",1,0,1992,"2144","51.665222","307","1050","1126",612,514,39,"14",25,0.0408,0.0272,0.0346,0.9325
"3233",151102,"INDIANA UNIVERSITY-PURDUE UNIVERSITY-FORT WAYNE",1,0,1993,"2310","63.237694","306","1114","1189",650,539,47,"17",30,0.0462,0.0315,0.0395,0.9369
"3234",151102,"INDIANA UNIVERSITY-PURDUE UNIVERSITY-FORT WAYNE",1,0,1995,"2709","54.205508","307","977","1063",577,486,43,"14",29,0.0503,0.0288,0.0405,0.9191
"3235",151102,"INDIANA UNIVERSITY-PURDUE UNIVERSITY-FORT WAYNE",1,0,1996,"3006","56.383012","299","1094","1196",647,549,44,"16",28,0.0433,0.0291,0.0368,0.9147
"3236",151102,"INDIANA UNIVERSITY-PURDUE UNIVERSITY-FORT WAYNE",1,0,1997,"3213","60.58387","299","1086","1196",659,537,49,"7",42,0.0637,0.013,0.041,0.908
"3237",151102,"INDIANA UNIVERSITY-PURDUE UNIVERSITY-FORT WAYNE",1,0,1998,"3350","64.100167","299","1166","1303",673,630,38,"16",22,0.0327,0.0254,0.0292,0.8949
"3238",151102,"INDIANA UNIVERSITY-PURDUE UNIVERSITY-FORT WAYNE",1,0,1999,"3159","68.424884","307","1199","1303",688,615,48,"16",32,0.0465,0.026,0.0368,0.9202
"3239",151102,"INDIANA UNIVERSITY-PURDUE UNIVERSITY-FORT WAYNE",1,0,2000,"3446","74.074368","310","1248","1337",723,614,48,"22",26,0.036,0.0358,0.0359,0.9334
"3240",151102,"INDIANA UNIVERSITY-PURDUE UNIVERSITY-FORT WAYNE",1,0,2001,"2815","76.723191","313","1307","1426",735,691,69,"30",39,0.0531,0.0434,0.0484,0.9165
"3241",151102,"INDIANA UNIVERSITY-PURDUE UNIVERSITY-FORT WAYNE",1,0,2002,"3384","74.229184","310","1296","1409",782,627,61,"24",37,0.0473,0.0383,0.0433,0.9198
"3242",151102,"INDIANA UNIVERSITY-PURDUE UNIVERSITY-FORT WAYNE",1,0,2003,"4108","83.403009","323","1218","1366",757,609,76,"29",47,0.0621,0.0476,0.0556,0.8917
"3243",151102,"INDIANA UNIVERSITY-PURDUE UNIVERSITY-FORT WAYNE",1,0,2004,"4266","91.344573","315","1352","1553",859,694,103,"29",74,0.0861,0.0418,0.0663,0.8706
"3244",151102,"Indiana University-Purdue University-Fort Wayne",1,0,2005,"4523","105.781567","306","1334","1534",850,684,82,"31",51,0.06,0.0453,0.0535,0.8696
"3245",151102,"Indiana University-Purdue University-Fort Wayne",1,0,2006,"4793","121.162769","317","1407","1608",859,749,61,"20",41,0.0477,0.0267,0.0379,0.875
"3246",151102,"Indiana University-Purdue University-Fort Wayne",1,0,2007,"4982","107.892187","338","1555","1804",942,862,91,"33",58,0.0616,0.0383,0.0504,0.862
"3247",151102,"Indiana University-Purdue University-Fort Wayne",1,0,2008,"5181","123.355157","342","1614","1905",1009,896,118,"36",82,0.0813,0.0402,0.0619,0.8472
"3248",151102,"Indiana University-Purdue University-Fort Wayne",1,0,2009,"5441","123.371222","342","1642","2040",1054,986,131,"54",77,0.0731,0.0548,0.0642,0.8049
"3249",151102,"Indiana University-Purdue University-Fort Wayne",1,0,2010,"5712","135.960639","377","1654","2117",1078,1039,134,"47",87,0.0807,0.0452,0.0633,0.7813
"3250",151111,"INDIANA UNIVERSITY-PURDUE UNIV AT INDIANAPOLIS",1,0,1991,"2277","626.324309","696","1313","1536",862,674,54,"24",30,0.0348,0.0356,0.0352,0.8548
"3251",151111,"INDIANA UNIVERSITY-PURDUE UNIV INDIANAPOLIS",1,0,1992,"2461","727.283214","686","1300","1507",837,670,42,"18",24,0.0287,0.0269,0.0279,0.8626
"3252",151111,"INDIANA UNIVERSITY-PURDUE UNIVERSITY-INDIANAPOLIS",1,0,1993,"2634","729.93924","688","1342","1509",830,679,70,"29",41,0.0494,0.0427,0.0464,0.8893
"3253",151111,"INDIANA UNIVERSITY-PURDUE UNIVERSITY-INDIANAPOLIS",1,0,1995,"3156","814.720372","672","1610","1860",1024,836,148,"65",83,0.0811,0.0778,0.0796,0.8656
"3254",151111,"INDIANA UNIVERSITY-PURDUE UNIVERSITY-INDIANAPOLIS",1,0,1996,"3300","535.558607","680","1733","2100",1172,928,87,"30",57,0.0486,0.0323,0.0414,0.8252
"3255",151111,"INDIANA UNIVERSITY-PURDUE UNIVERSITY-INDIANAPOLIS",1,0,1997,"3441","585.211583","705","1784","2154",1198,956,113,"55",58,0.0484,0.0575,0.0525,0.8282
"3256",151111,"INDIANA UNIVERSITY-PURDUE UNIVERSITY-INDIANAPOLIS",1,0,1998,"3576","632.596997","689","2164","2570",1387,1183,110,"41",69,0.0497,0.0347,0.0428,0.842
"3257",151111,"INDIANA UNIVERSITY-PURDUE UNIVERSITY-INDIANAPOLIS",1,0,1999,"3432","657.748232","683","2126","2552",1409,1143,166,"67",99,0.0703,0.0586,0.065,0.8331
"3258",151111,"INDIANA UNIVERSITY-PURDUE UNIVERSITY-INDIANAPOLIS",1,0,2000,"3570","711.518415","708.5","2081","2473",1414,1059,168,"48",120,0.0849,0.0453,0.0679,0.8415
"3259",151111,"INDIANA UNIVERSITY-PURDUE UNIVERSITY-INDIANAPOLIS",1,0,2001,"3839","768.508439","734","1911","2275",1325,950,188,"71",117,0.0883,0.0747,0.0826,0.84
"3260",151111,"INDIANA UNIVERSITY-PURDUE UNIVERSITY-INDIANAPOLIS",1,0,2002,"4183","776.380438","809","1887","2235",1286,949,195,"63",132,0.1026,0.0664,0.0872,0.8443
"3261",151111,"INDIANA UNIVERSITY-PURDUE UNIVERSITY-INDIANAPOLIS",1,0,2003,"5151","843.648107","787","1964","2336",1361,975,210,"79",131,0.0963,0.081,0.0899,0.8408
"3262",151111,"INDIANA UNIVERSITY-PURDUE UNIVERSITY-INDIANAPOLIS",1,0,2004,"5357","846.914774","854","1849","2294",1371,923,226,"80",146,0.1065,0.0867,0.0985,0.806
"3263",151111,"Indiana University-Purdue University-Indianapolis",1,0,2005,"5625","945.540497","711","1895","2396",1414,982,234,"88",146,0.1033,0.0896,0.0977,0.7909
"3264",151111,"Indiana University-Purdue University-Indianapolis",1,0,2006,"5924","994.0853","736","1992","2516",1549,967,317,"109",208,0.1343,0.1127,0.126,0.7917
"3265",151111,"Indiana University-Purdue University-Indianapolis",1,0,2007,"6221","990.784521","738","2202","2737",1659,1078,392,"144",248,0.1495,0.1336,0.1432,0.8045
"3266",151111,"Indiana University-Purdue University-Indianapolis",1,0,2008,"6531","1014.062879","758","2204","2802",1657,1145,463,"170",293,0.1768,0.1485,0.1652,0.7866
"3267",151111,"Indiana University-Purdue University-Indianapolis",1,0,2009,"6923","1071.499881","789","2230","2794",1670,1124,500,"187",313,0.1874,0.1664,0.179,0.7981
"3268",151111,"Indiana University-Purdue University-Indianapolis",1,0,2010,"7255","1059.862092","801","2036","2679",1607,1072,478,"176",302,0.1879,0.1642,0.1784,0.76
"3269",151306,"UNIVERSITY OF SOUTHERN INDIANA",1,0,1991,"1808","30.241002","158","1030","1078",611,467,86,"24",62,0.1015,0.0514,0.0798,0.9555
"3270",151306,"UNIVERSITY OF SOUTHERN INDIANA",1,0,1992,"2062","33.249645","168","1014","1080",624,456,90,"27",63,0.101,0.0592,0.0833,0.9389
"3271",151306,"UNIVERSITY OF SOUTHERN INDIANA",1,0,1993,"2163","36.203512","181","1096","1162",681,481,79,"21",58,0.0852,0.0437,0.068,0.9432
"3272",151306,"UNIVERSITY OF SOUTHERN INDIANA",1,0,1995,"2285","45.973656","205","1305","1407",813,594,138,"30",108,0.1328,0.0505,0.0981,0.9275
"3273",151306,"UNIVERSITY OF SOUTHERN INDIANA",1,0,1996,"2415","48.94881","211","1496","1573",912,661,173,"45",128,0.1404,0.0681,0.11,0.951
"3274",151306,"UNIVERSITY OF SOUTHERN INDIANA",1,0,1997,"2565","55.488985","220","1734","1839",1053,786,239,"63",176,0.1671,0.0802,0.13,0.9429
"3275",151306,"UNIVERSITY OF SOUTHERN INDIANA",1,0,1998,"2780","63.603461","238","1473","1552",945,607,197,"56",141,0.1492,0.0923,0.1269,0.9491
"3276",151306,"UNIVERSITY OF SOUTHERN INDIANA",1,0,1999,"2768","70.266061","253","1591","1674",1003,671,200,"49",151,0.1505,0.073,0.1195,0.9504
"3277",151306,"UNIVERSITY OF SOUTHERN INDIANA",1,0,2000,"2626","78.701315","258.5","1612","1729",1033,696,247,"57",190,0.1839,0.0819,0.1429,0.9323
"3278",151306,"UNIVERSITY OF SOUTHERN INDIANA",1,0,2001,"2774","81.514641","264","1788","1897",1135,762,236,"64",172,0.1515,0.084,0.1244,0.9425
"3279",151306,"UNIVERSITY OF SOUTHERN INDIANA",1,0,2002,"3051","81.92514","276","1788","1891",1152,739,217,"50",167,0.145,0.0677,0.1148,0.9455
"3280",151306,"UNIVERSITY OF SOUTHERN INDIANA",1,0,2003,"3442","85.200322","278","1835","1953",1151,802,271,"78",193,0.1677,0.0973,0.1388,0.9396
"3281",151306,"UNIVERSITY OF SOUTHERN INDIANA",1,0,2004,"3676","96.486385","284","1849","2004",1196,808,269,"71",198,0.1656,0.0879,0.1342,0.9227
"3282",151306,"University of Southern Indiana",1,0,2005,"3807","101.613633","311","1890","2042",1195,847,306,"90",216,0.1808,0.1063,0.1499,0.9256
"3283",151306,"University of Southern Indiana",1,0,2006,"4014","109.201683","296","1843","2021",1253,768,321,"70",251,0.2003,0.0911,0.1588,0.9119
"3284",151306,"University of Southern Indiana",1,0,2007,"4258","112.982354","307","1868","2074",1209,865,299,"74",225,0.1861,0.0855,0.1442,0.9007
"3285",151306,"University of Southern Indiana",1,0,2008,"4509","115.517578","323","1794","2055",1232,823,340,"83",257,0.2086,0.1009,0.1655,0.873
"3286",151306,"University of Southern Indiana",1,0,2009,"5274","120.779928","343","1809","2048",1199,849,420,"100",320,0.2669,0.1178,0.2051,0.8833
"3287",151306,"University of Southern Indiana",1,0,2010,"5540","127.561582","349","1757","2041",1179,862,378,"115",263,0.2231,0.1334,0.1852,0.8609
"3288",151324,"INDIANA STATE UNIVERSITY",1,0,1991,"2272","131.43589","605","1677","1919",969,950,276,"114",162,0.1672,0.12,0.1438,0.8739
"3289",151324,"INDIANA STATE UNIVERSITY",1,0,1992,"2452","131.985484","560","1871","2187",1161,1026,339,"124",215,0.1852,0.1209,0.155,0.8555
"3290",151324,"INDIANA STATE UNIVERSITY",1,0,1993,"2622","129.887383","548","1939","2221",1165,1056,334,"128",206,0.1768,0.1212,0.1504,0.873
"3291",151324,"INDIANA STATE UNIVERSITY",1,0,1995,"2928","140.131652","549","1661","1980",1032,948,350,"132",218,0.2112,0.1392,0.1768,0.8389
"3292",151324,"INDIANA STATE UNIVERSITY",1,0,1996,"3072","145.706848","535","1606","1911",1026,885,355,"111",244,0.2378,0.1254,0.1858,0.8404
"3293",151324,"INDIANA STATE UNIVERSITY",1,0,1997,"3196","155.01539","538","1573","1878",998,880,356,"127",229,0.2295,0.1443,0.1896,0.8376
"3294",151324,"INDIANA STATE UNIVERSITY",1,0,1998,"3324","157.352986","532","1653","1994",1062,932,368,"123",245,0.2307,0.132,0.1846,0.829
"3295",151324,"INDIANA STATE UNIVERSITY",1,0,1999,"3426","166.904571","524","1665","2014",998,1016,352,"132",220,0.2204,0.1299,0.1748,0.8267
"3296",151324,"INDIANA STATE UNIVERSITY",1,0,2000,"3564","177.206829","547.5","1766","2124",1122,1002,404,"126",278,0.2478,0.1257,0.1902,0.8315
"3297",151324,"INDIANA STATE UNIVERSITY",1,0,2001,"3672","182.148236","571","1746","2156",1166,990,413,"148",265,0.2273,0.1495,0.1916,0.8098
"3298",151324,"INDIANA STATE UNIVERSITY",1,0,2002,"4116","173.382503","539","1719","2083",1065,1018,393,"143",250,0.2347,0.1405,0.1887,0.8253
"3299",151324,"INDIANA STATE UNIVERSITY",1,0,2003,"5322","176.292516","557","1603","1974",974,1000,351,"128",223,0.229,0.128,0.1778,0.8121
"3300",151324,"INDIANA STATE UNIVERSITY",1,0,2004,"5536","181.297245","544","1445","1813",901,912,341,"128",213,0.2364,0.1404,0.1881,0.797
"3301",151324,"Indiana State University",1,0,2005,"5756","179.643447","509","1287","1622",810,812,311,"122",189,0.2333,0.1502,0.1917,0.7935
"3302",151324,"Indiana State University",1,0,2006,"6102","174.675847","467","1250","1657",827,830,335,"125",210,0.2539,0.1506,0.2022,0.7544
"3303",151324,"Indiana State University",1,0,2007,"6462","176.842916","461","1365","1820",924,896,375,"138",237,0.2565,0.154,0.206,0.75
"3304",151324,"Indiana State University",1,0,2008,"6792","186.221037","454","1405","1907",954,953,357,"151",206,0.2159,0.1584,0.1872,0.7368
"3305",151324,"Indiana State University",1,0,2009,"7226","195.691573","447","1412","1969",954,1015,393,"183",210,0.2201,0.1803,0.1996,0.7171
"3306",151324,"Indiana State University",1,0,2010,"7514","198.716342","436","1816","2687",1352,1335,497,"199",298,0.2204,0.1491,0.185,0.6758
"3307",151333,"INDIANA UNIVERSITY AT KOKOMO",1,0,1991,"1938","13.722927","73","300","315",199,116,8,"1",7,0.0352,0.0086,0.0254,0.9524
"3308",151333,"INDIANA UNIVERSITY KOKOMO",1,0,1992,"2099","15.570615","77","286","304",200,104,15,"4",11,0.055,0.0385,0.0493,0.9408
"3309",151333,"INDIANA UNIVERSITY-KOKOMO",1,0,1993,"2244","17.585069","81","319","330",208,122,14,"7",7,0.0337,0.0574,0.0424,0.9667
"3310",151333,"INDIANA UNIVERSITY-KOKOMO",1,0,1995,"2599","19.012097","78","276","294",184,110,27,"7",20,0.1087,0.0636,0.0918,0.9388
"3311",151333,"INDIANA UNIVERSITY-KOKOMO",1,0,1996,"2757","19.886124","69","319","339",227,112,20,"6",14,0.0617,0.0536,0.059,0.941
"3312",151333,"INDIANA UNIVERSITY-KOKOMO",1,0,1997,"2890","19.510016","72","291","306",204,102,17,"5",12,0.0588,0.049,0.0556,0.951
"3313",151333,"INDIANA UNIVERSITY-KOKOMO",1,0,1998,"3004","20.186382","69","319","333",230,103,25,"2",23,0.1,0.0194,0.0751,0.958
"3314",151333,"INDIANA UNIVERSITY-KOKOMO",1,0,1999,"2922","21.155963","67","283","295",213,82,27,"7",20,0.0939,0.0854,0.0915,0.9593
"3315",151333,"INDIANA UNIVERSITY-KOKOMO",1,0,2000,"3024","22.121605","67.5","334","347",223,124,28,"9",19,0.0852,0.0726,0.0807,0.9625
"3316",151333,"INDIANA UNIVERSITY-KOKOMO",1,0,2001,"3221","22.383371","68","314","343",233,110,36,"8",28,0.1202,0.0727,0.105,0.9155
"3317",151333,"INDIANA UNIVERSITY-KOKOMO",1,0,2002,"3478","22.460632","74","311","339",226,113,28,"5",23,0.1018,0.0442,0.0826,0.9174
"3318",151333,"INDIANA UNIVERSITY-KOKOMO",1,0,2003,"4117","24.269121","77","358","382",264,118,27,"5",22,0.0833,0.0424,0.0707,0.9372
"3319",151333,"INDIANA UNIVERSITY-KOKOMO",1,0,2004,"4283","22.271818","83","328","356",237,119,18,"5",13,0.0549,0.042,0.0506,0.9213
"3320",151333,"Indiana University-Kokomo",1,0,2005,"4475","25.552061","85","360","382",251,131,31,"6",25,0.0996,0.0458,0.0812,0.9424
"3321",151333,"Indiana University-Kokomo",1,0,2006,"4694","26.829425","86","297","329",210,119,26,"6",20,0.0952,0.0504,0.079,0.9027
"3322",151333,"Indiana University-Kokomo",1,0,2007,"4928","26.242333","84","343","381",234,147,27,"6",21,0.0897,0.0408,0.0709,0.9003
"3323",151333,"Indiana University-Kokomo",1,0,2008,"5174","26.157809","80","306","341",212,129,31,"6",25,0.1179,0.0465,0.0909,0.8974
"3324",151333,"Indiana University-Kokomo",1,0,2009,"5408","26.022586","72","350","406",232,174,51,"14",37,0.1595,0.0805,0.1256,0.8621
"3325",151333,"Indiana University-Kokomo",1,0,2010,"5663","26.479622","76","314","345",217,128,59,"23",36,0.1659,0.1797,0.171,0.9101
"3326",151342,"INDIANA UNIVERSITY AT SOUTH BEND",1,0,1991,"1952","29.527246","171","481","554",352,202,40,"15",25,0.071,0.0743,0.0722,0.8682
"3327",151342,"INDIANA UNIVERSITY SOUTH BEND",1,0,1992,"2105","34.159762","171","499","564",337,227,34,"11",23,0.0682,0.0485,0.0603,0.8848
"3328",151342,"INDIANA UNIVERSITY-SOUTH BEND",1,0,1993,"2290","37.417751","175","485","554",360,194,32,"16",16,0.0444,0.0825,0.0578,0.8755
"3329",151342,"INDIANA UNIVERSITY-SOUTH BEND",1,0,1995,"2742","40.151776","182","532","626",374,252,51,"19",32,0.0856,0.0754,0.0815,0.8498
"3330",151342,"INDIANA UNIVERSITY-SOUTH BEND",1,0,1996,"2856","40.71264","180","490","593",360,233,41,"9",32,0.0889,0.0386,0.0691,0.8263
"3331",151342,"INDIANA UNIVERSITY-SOUTH BEND",1,0,1997,"2985","41.515615","183","529","629",384,245,47,"20",27,0.0703,0.0816,0.0747,0.841
"3332",151342,"INDIANA UNIVERSITY-SOUTH BEND",1,0,1998,"3096","47.034512","200","624","732",427,305,31,"14",17,0.0398,0.0459,0.0423,0.8525
"3333",151342,"INDIANA UNIVERSITY-SOUTH BEND",1,0,1999,"2974","49.333491","202","562","637",382,255,37,"10",27,0.0707,0.0392,0.0581,0.8823
"3334",151342,"INDIANA UNIVERSITY-SOUTH BEND",1,0,2000,"3078","51.212432","207","562","637",349,288,22,"6",16,0.0458,0.0208,0.0345,0.8823
"3335",151342,"INDIANA UNIVERSITY-SOUTH BEND",1,0,2001,"3278","54.942947","212","639","750",449,301,40,"15",25,0.0557,0.0498,0.0533,0.852
"3336",151342,"INDIANA UNIVERSITY-SOUTH BEND",1,0,2002,"3543","68.336622","219","563","660",390,270,36,"9",27,0.0692,0.0333,0.0545,0.853
"3337",151342,"INDIANA UNIVERSITY-SOUTH BEND",1,0,2003,"4180","57.339463","220","619","707",417,290,42,"18",24,0.0576,0.0621,0.0594,0.8755
"3338",151342,"INDIANA UNIVERSITY-SOUTH BEND",1,0,2004,"4349","54.087795","237","589","704",432,272,29,"11",18,0.0417,0.0404,0.0412,0.8366
"3339",151342,"Indiana University-South Bend",1,0,2005,"4583","65.270013","233","685","805",466,339,34,"16",18,0.0386,0.0472,0.0422,0.8509
"3340",151342,"Indiana University-South Bend",1,0,2006,"4826","67.093256","234","629","772",427,345,31,"16",15,0.0351,0.0464,0.0402,0.8148
"3341",151342,"Indiana University-South Bend",1,0,2007,"5069","64.803014","237","729","876",524,352,44,"26",18,0.0344,0.0739,0.0502,0.8322
"3342",151342,"Indiana University-South Bend",1,0,2008,"5324","75.157659","235","729","943",590,353,54,"23",31,0.0525,0.0652,0.0573,0.7731
"3343",151342,"Indiana University-South Bend",1,0,2009,"5573","67.932297","251","827","1045",611,434,60,"21",39,0.0638,0.0484,0.0574,0.7914
"3344",151342,"Indiana University-South Bend",1,0,2010,"5843","68.596388","248","684","895",503,392,61,"25",36,0.0716,0.0638,0.0682,0.7642
"3345",151351,"INDIANA UNIVERSITY BLOOMINGTON",1,0,1991,"2484","532.776559","1428","4596","5208",3013,2195,2205,"881",1324,0.4394,0.4014,0.4234,0.8825
"3346",151351,"INDIANA UNIVERSITY BLOOMINGTON",1,0,1992,"2794","588.767375","1374","4881","5529",3233,2296,2231,"840",1391,0.4303,0.3659,0.4035,0.8828
"3347",151351,"INDIANA UNIVERSITY-BLOOMINGTON",1,0,1993,"2988","580.064121","1361","5174","5833",3340,2493,2427,"906",1521,0.4554,0.3634,0.4161,0.887
"3348",151351,"INDIANA UNIVERSITY-BLOOMINGTON",1,0,1995,"3582","682.151631","1344","4952","5705",3293,2412,3057,"1182",1875,0.5694,0.49,0.5358,0.868
"3349",151351,"INDIANA UNIVERSITY-BLOOMINGTON",1,0,1996,"3783","853.012883","1350","5043","5766",3376,2390,2660,"975",1685,0.4991,0.4079,0.4613,0.8746
"3350",151351,"INDIANA UNIVERSITY-BLOOMINGTON",1,0,1997,"3929","789.880175","1404","5294","6036",3497,2539,2827,"1045",1782,0.5096,0.4116,0.4684,0.8771
"3351",151351,"INDIANA UNIVERSITY-BLOOMINGTON",1,0,1998,"4068","943.814362","1411","5937","6735",3810,2925,2747,"1088",1659,0.4354,0.372,0.4079,0.8815
"3352",151351,"INDIANA UNIVERSITY-BLOOMINGTON",1,0,1999,"3752","944.402756","1396","5683","6503",3828,2675,3137,"1138",1999,0.5222,0.4254,0.4824,0.8739
"3353",151351,"INDIANA UNIVERSITY-BLOOMINGTON",1,0,2000,"3902","1028.212041","1384.5","5994","6862",3839,3023,3421,"1362",2059,0.5363,0.4505,0.4985,0.8735
"3354",151351,"INDIANA UNIVERSITY-BLOOMINGTON",1,0,2001,"4196","1079.887175","1373","5859","6728",3716,3012,3353,"1424",1929,0.5191,0.4728,0.4984,0.8708
"3355",151351,"INDIANA UNIVERSITY-BLOOMINGTON",1,0,2002,"4573","836.118811","1432","6102","6987",3895,3092,3546,"1471",2075,0.5327,0.4757,0.5075,0.8733
"3356",151351,"INDIANA UNIVERSITY-BLOOMINGTON",1,0,2003,"5756","851.698467","1486","5809","6739",3773,2966,3490,"1419",2071,0.5489,0.4784,0.5179,0.862
"3357",151351,"INDIANA UNIVERSITY-BLOOMINGTON",1,0,2004,"5986","881.854869","1562","5340","6300",3407,2893,3110,"1273",1837,0.5392,0.44,0.4937,0.8476
"3358",151351,"Indiana University-Bloomington",1,0,2005,"6291","941.797774","1589","5778","6903",3785,3118,3425,"1383",2042,0.5395,0.4436,0.4962,0.837
"3359",151351,"Indiana University-Bloomington",1,0,2006,"6657","979.719849","1615","6087","7208",3875,3333,3949,"1681",2268,0.5853,0.5044,0.5479,0.8445
"3360",151351,"Indiana University-Bloomington",1,0,2007,"7000","1089.979017","1640","5975","7167",3707,3460,4169,"1874",2295,0.6191,0.5416,0.5817,0.8337
"3361",151351,"Indiana University-Bloomington",1,0,2008,"7368","1136.766197","1682","6307","7550",3990,3560,4485,"1959",2526,0.6331,0.5503,0.594,0.8354
"3362",151351,"Indiana University-Bloomington",1,0,2009,"7722","1197.587704","1721","5833","7301",3640,3661,4387,"2001",2386,0.6555,0.5466,0.6009,0.7989
"3363",151351,"Indiana University-Bloomington",1,0,2010,"8124","1233.437046","1726","5174","6977",3659,3318,4165,"1805",2360,0.645,0.544,0.597,0.7416
"3364",151360,"INDIANA UNIVERSITY NORTHWEST",1,0,1991,"1952","24.605821","134","447","614",396,218,35,"14",21,0.053,0.0642,0.057,0.728
"3365",151360,"INDIANA UNIVERSITY NORTHWEST",1,0,1992,"2105","27.638941","151","405","597",386,211,26,"9",17,0.044,0.0427,0.0436,0.6784
"3366",151360,"INDIANA UNIVERSITY-NORTHWEST",1,0,1993,"2250","30.423706","152","473","665",415,250,26,"13",13,0.0313,0.052,0.0391,0.7113
"3367",151360,"INDIANA UNIVERSITY-NORTHWEST",1,0,1995,"2595","34.434764","150","376","599",383,216,42,"13",29,0.0757,0.0602,0.0701,0.6277
"3368",151360,"INDIANA UNIVERSITY-NORTHWEST",1,0,1996,"2768","34.488047","143","368","560",355,205,37,"14",23,0.0648,0.0683,0.0661,0.6571
"3369",151360,"INDIANA UNIVERSITY-NORTHWEST",1,0,1997,"2883","34.667229","147","315","508",340,168,21,"7",14,0.0412,0.0417,0.0413,0.6201
"3370",151360,"INDIANA UNIVERSITY-NORTHWEST",1,0,1998,"3021","36.124079","142","329","535",347,188,31,"8",23,0.0663,0.0426,0.0579,0.615
"3371",151360,"INDIANA UNIVERSITY-NORTHWEST",1,0,1999,"2955","37.286237","138","352","540",345,195,45,"16",29,0.0841,0.0821,0.0833,0.6519
"3372",151360,"INDIANA UNIVERSITY-NORTHWEST",1,0,2000,"3024","41.573537","134","332","517",318,199,33,"16",17,0.0535,0.0804,0.0638,0.6422
"3373",151360,"INDIANA UNIVERSITY-NORTHWEST",1,0,2001,"3221","41.963741","130","330","511",340,171,43,"12",31,0.0912,0.0702,0.0841,0.6458
"3374",151360,"INDIANA UNIVERSITY-NORTHWEST",1,0,2002,"3478","32.91456","141","402","602",365,237,39,"14",25,0.0685,0.0591,0.0648,0.6678
"3375",151360,"INDIANA UNIVERSITY-NORTHWEST",1,0,2003,"4117","42.195003","165","433","660",417,243,49,"14",35,0.0839,0.0576,0.0742,0.6561
"3376",151360,"INDIANA UNIVERSITY-NORTHWEST",1,0,2004,"4283","38.787286","164","401","604",375,229,28,"10",18,0.048,0.0437,0.0464,0.6639
"3377",151360,"Indiana University-Northwest",1,0,2005,"4475","46.889642","163","312","471",280,191,33,"19",14,0.05,0.0995,0.0701,0.6624
"3378",151360,"Indiana University-Northwest",1,0,2006,"4710","50.820327","167","369","561",352,209,31,"8",23,0.0653,0.0383,0.0553,0.6578
"3379",151360,"Indiana University-Northwest",1,0,2007,"4962","49.90022","168","362","556",356,200,38,"13",25,0.0702,0.065,0.0683,0.6511
"3380",151360,"Indiana University-Northwest",1,0,2008,"5228","46.973837","155","373","596",387,209,47,"13",34,0.0879,0.0622,0.0789,0.6258
"3381",151360,"Indiana University-Northwest",1,0,2009,"5478","50.135912","161","437","773",483,290,70,"22",48,0.0994,0.0759,0.0906,0.5653
"3382",151360,"Indiana University-Northwest",1,0,2010,"5752","50.313123","161","440","784",495,289,47,"13",34,0.0687,0.045,0.0599,0.5612
"3383",151379,"INDIANA UNIVERSITY SOUTHEAST",1,0,1991,"1962","22.299714","114","572","589",343,246,23,"6",17,0.0496,0.0244,0.039,0.9711
"3384",151379,"INDIANA UNIVERSITY SOUTHEAST",1,0,1992,"2115","25.539561","127","621","638",381,257,27,"6",21,0.0551,0.0233,0.0423,0.9734
"3385",151379,"INDIANA UNIVERSITY-SOUTHEAST",1,0,1993,"2260","27.643162","125","668","700",392,308,37,"12",25,0.0638,0.039,0.0529,0.9543
"3386",151379,"INDIANA UNIVERSITY-SOUTHEAST",1,0,1995,"2572","28.272272","119","570","593",357,236,74,"27",47,0.1317,0.1144,0.1248,0.9612
"3387",151379,"INDIANA UNIVERSITY-SOUTHEAST",1,0,1996,"2718","30.448764","124","629","643",375,268,60,"18",42,0.112,0.0672,0.0933,0.9782
"3388",151379,"INDIANA UNIVERSITY-SOUTHEAST",1,0,1997,"2847","31.527503","138","617","641",376,265,57,"12",45,0.1197,0.0453,0.0889,0.9626
"3389",151379,"INDIANA UNIVERSITY-SOUTHEAST",1,0,1998,"2986","34.27442","141","698","727",407,320,28,"6",22,0.0541,0.0187,0.0385,0.9601
"3390",151379,"INDIANA UNIVERSITY-SOUTHEAST",1,0,1999,"2922","36.157256","139","694","719",448,271,54,"13",41,0.0915,0.048,0.0751,0.9652
"3391",151379,"INDIANA UNIVERSITY-SOUTHEAST",1,0,2000,"3024","39.825853","145","688","700",413,287,57,"18",39,0.0944,0.0627,0.0814,0.9829
"3392",151379,"INDIANA UNIVERSITY-SOUTHEAST",1,0,2001,"3221","42.924674","151","639","722",440,282,57,"13",44,0.1,0.0461,0.0789,0.885
"3393",151379,"INDIANA UNIVERSITY-SOUTHEAST",1,0,2002,"3479","48.535469","163","627","678",419,259,53,"11",42,0.1002,0.0425,0.0782,0.9248
"3394",151379,"INDIANA UNIVERSITY-SOUTHEAST",1,0,2003,"4117","46.533877","175","622","674",400,274,53,"15",38,0.095,0.0547,0.0786,0.9228
"3395",151379,"INDIANA UNIVERSITY-SOUTHEAST",1,0,2004,"4283","42.785566","181","663","714",420,294,63,"12",51,0.1214,0.0408,0.0882,0.9286
"3396",151379,"Indiana University-Southeast",1,0,2005,"4475","52.648555","172","594","664",409,255,53,"12",41,0.1002,0.0471,0.0798,0.8946
"3397",151379,"Indiana University-Southeast",1,0,2006,"4698","52.422402","175","663","727",430,297,63,"24",39,0.0907,0.0808,0.0867,0.912
"3398",151379,"Indiana University-Southeast",1,0,2007,"4934","52.637463","178","714","783",449,334,69,"21",48,0.1069,0.0629,0.0881,0.9119
"3399",151379,"Indiana University-Southeast",1,0,2008,"5184","67.487704","180","841","970",590,380,81,"26",55,0.0932,0.0684,0.0835,0.867
"3400",151379,"Indiana University-Southeast",1,0,2009,"5417","59.483851","179","866","995",612,383,80,"27",53,0.0866,0.0705,0.0804,0.8704
"3401",151379,"Indiana University-Southeast",1,0,2010,"5672","58.651237","182","821","945",581,364,111,"29",82,0.1411,0.0797,0.1175,0.8688
"3402",151388,"INDIANA UNIVERSITY EAST",1,0,1991,"1952","10.185616","54","207","222",146,76,2,"0",2,0.0137,0,0.009,0.9324
"3403",151388,"INDIANA UNIVERSITY EAST",1,0,1992,"2105","12.27004","54","254","263",197,66,8,"2",6,0.0305,0.0303,0.0304,0.9658
"3404",151388,"INDIANA UNIVERSITY-EAST",1,0,1993,"2250","14.051225","59","247","264",168,96,8,"2",6,0.0357,0.0208,0.0303,0.9356
"3405",151388,"INDIANA UNIVERSITY-EAST",1,0,1995,"2615","15.501244","62","220","242",144,98,12,"5",7,0.0486,0.051,0.0496,0.9091
"3406",151388,"INDIANA UNIVERSITY-EAST",1,0,1996,"2728","16.930493","62","220","233",148,85,9,"3",6,0.0405,0.0353,0.0386,0.9442
"3407",151388,"INDIANA UNIVERSITY-EAST",1,0,1997,"2849","17.490572","59","259","278",193,85,14,"7",7,0.0363,0.0824,0.0504,0.9317
"3408",151388,"INDIANA UNIVERSITY-EAST",1,0,1998,"2987","18.494499","59","210","230",146,84,7,"2",5,0.0342,0.0238,0.0304,0.913
"3409",151388,"INDIANA UNIVERSITY-EAST",1,0,1999,"2922","19.460209","61","226","255",161,94,10,"1",9,0.0559,0.0106,0.0392,0.8863
"3410",151388,"INDIANA UNIVERSITY-EAST",1,0,2000,"3024","21.749083","60","230","249",161,88,10,"1",9,0.0559,0.0114,0.0402,0.9237
"3411",151388,"INDIANA UNIVERSITY-EAST",1,0,2001,"3221","23.061795","59","236","264",172,92,18,"5",13,0.0756,0.0543,0.0682,0.8939
"3412",151388,"INDIANA UNIVERSITY-EAST",1,0,2002,"3478","18.453161","69","281","303",200,103,19,"4",15,0.075,0.0388,0.0627,0.9274
"3413",151388,"INDIANA UNIVERSITY-EAST",1,0,2003,"4117","26.163374","74","283","318",203,115,20,"7",13,0.064,0.0609,0.0629,0.8899
"3414",151388,"INDIANA UNIVERSITY-EAST",1,0,2004,"4283","23.382254","77","250","270",182,88,14,"3",11,0.0604,0.0341,0.0519,0.9259
"3415",151388,"Indiana University-East",1,0,2005,"4475","27.138549","83","256","284",179,105,13,"2",11,0.0615,0.019,0.0458,0.9014
"3416",151388,"Indiana University-East",1,0,2006,"4697","26.851793","78","209","225",135,90,9,"3",6,0.0444,0.0333,0.04,0.9289
"3417",151388,"Indiana University-East",1,0,2007,"4932","25.18713","76","243","264",157,107,22,"4",18,0.1146,0.0374,0.0833,0.9205
"3418",151388,"Indiana University-East",1,0,2008,"5178","24.390156","71","262","291",190,101,26,"8",18,0.0947,0.0792,0.0893,0.9003
"3419",151388,"Indiana University-East",1,0,2009,"5416","26.69313","75","323","358",217,141,51,"11",40,0.1843,0.078,0.1425,0.9022
"3420",151388,"Indiana University-East",1,0,2010,"5676","28.192331","72","347","378",224,154,54,"15",39,0.1741,0.0974,0.1429,0.918
"3421",151777,"MANCHESTER COLLEGE",1,0,1991,"8270","16.404485","71","253","277",146,131,121,"48",73,0.5,0.3664,0.4368,0.9134
"3422",151777,"MANCHESTER COLLEGE",1,0,1992,"8960","17.975799","71","225","245",120,125,109,"51",58,0.4833,0.408,0.4449,0.9184
"3423",151777,"MANCHESTER COLLEGE",1,0,1993,"9600","17.669506","74","217","238",118,120,94,"43",51,0.4322,0.3583,0.395,0.9118
"3424",151777,"MANCHESTER COLLEGE",1,0,1995,"11470","19.001466","69","301","321",158,163,136,"61",75,0.4747,0.3742,0.4237,0.9377
"3425",151777,"MANCHESTER COLLEGE",1,0,1996,"12120","21.523812","70","278","305",151,154,113,"46",67,0.4437,0.2987,0.3705,0.9115
"3426",151777,"MANCHESTER COLLEGE",1,0,1997,"12660","16.832088","68","257","288",135,153,122,"47",75,0.5556,0.3072,0.4236,0.8924
"3427",151777,"MANCHESTER COLLEGE",1,0,1998,"13280","17.543834","65","287","309",173,136,139,"47",92,0.5318,0.3456,0.4498,0.9288
"3428",151777,"MANCHESTER COLLEGE",1,0,1999,"13930","18.443311","70","277","328",166,162,132,"41",91,0.5482,0.2531,0.4024,0.8445
"3429",151777,"MANCHESTER COLLEGE",1,0,2000,"14510","19.500731","70","292","333",178,155,142,"46",96,0.5393,0.2968,0.4264,0.8769
"3430",151777,"MANCHESTER COLLEGE",1,0,2001,"15230","19.407124","70","289","334",179,155,145,"53",92,0.514,0.3419,0.4341,0.8653
"3431",151777,"MANCHESTER COLLEGE",1,0,2002,"15990","19.930215","67","269","309",178,131,137,"54",83,0.4663,0.4122,0.4434,0.8706
"3432",151777,"MANCHESTER COLLEGE",1,0,2003,"16940","20.032967","68","298","335",168,167,127,"53",74,0.4405,0.3174,0.3791,0.8896
"3433",151777,"MANCHESTER COLLEGE",1,0,2004,"17950","21.440607","67","243","278",154,124,113,"34",79,0.513,0.2742,0.4065,0.8741
"3434",151777,"Manchester College",1,0,2005,"18860","21.990889","79","290","329",170,159,140,"50",90,0.5294,0.3145,0.4255,0.8815
"3435",151777,"Manchester College",1,0,2006,"19800","23.522302","73","270","311",137,174,136,"62",74,0.5401,0.3563,0.4373,0.8682
"3436",151777,"Manchester College",1,0,2007,"21000","23.838765","77","277","316",147,169,126,"55",71,0.483,0.3254,0.3987,0.8766
"3437",151777,"Manchester College",1,0,2008,"22000","24.944312","69","346","396",202,194,190,"77",113,0.5594,0.3969,0.4798,0.8737
"3438",151777,"Manchester College",1,0,2009,"23000","25.398496","72","383","426",210,216,198,"88",110,0.5238,0.4074,0.4648,0.8991
"3439",151777,"Manchester College",1,0,2010,"24100","25.782638","74","349","405",217,188,200,"81",119,0.5484,0.4309,0.4938,0.8617
"3440",151786,"MARIAN COLLEGE",1,0,1991,"7584","9.602937","51","195","217",154,63,53,"13",40,0.2597,0.2063,0.2442,0.8986
"3441",151786,"MARIAN COLLEGE",1,0,1992,"8594","13.2279","76","113","244",149,95,75,"32",43,0.2886,0.3368,0.3074,0.4631
"3442",151786,"MARIAN COLLEGE",1,0,1993,"9360","14.803031","78","198","239",150,89,74,"23",51,0.34,0.2584,0.3096,0.8285
"3443",151786,"MARIAN COLLEGE",1,0,1995,"10824","16.847845","74","190","255",168,87,90,"28",62,0.369,0.3218,0.3529,0.7451
"3444",151786,"MARIAN COLLEGE",1,0,1996,"11440","19.213695","72","137","221",151,70,67,"16",51,0.3377,0.2286,0.3032,0.6199
"3445",151786,"MARIAN COLLEGE",1,0,1997,"12458","14.793344","72","196","255",156,99,73,"21",52,0.3333,0.2121,0.2863,0.7686
"3446",151786,"MARIAN COLLEGE",1,0,1998,"13406","15.534987","56","162","205",158,47,70,"14",56,0.3544,0.2979,0.3415,0.7902
"3447",151786,"MARIAN COLLEGE",1,0,1999,"14012","16.422101","71","210","251",181,70,88,"19",69,0.3812,0.2714,0.3506,0.8367
"3448",151786,"MARIAN COLLEGE",1,0,2000,"14432","16.791003","67","185","208",126,82,58,"12",46,0.3651,0.1463,0.2788,0.8894
"3449",151786,"MARIAN COLLEGE",1,0,2001,"15226","17.399095","63","148","183",113,70,66,"21",45,0.3982,0.3,0.3607,0.8087
"3450",151786,"MARIAN COLLEGE",1,0,2002,"16000","17.106878","62","186","230",153,77,73,"16",57,0.3725,0.2078,0.3174,0.8087
"3451",151786,"MARIAN COLLEGE",1,0,2003,"16800","19.322929","66","201","239",162,77,71,"27",44,0.2716,0.3506,0.2971,0.841
"3452",151786,"MARIAN COLLEGE",1,0,2004,"17600","20.900373","70","210","245",166,79,84,"26",58,0.3494,0.3291,0.3429,0.8571
"3453",151786,"Marian College",1,0,2005,"18400","23.201429","72","154","189",127,62,64,"17",47,0.3701,0.2742,0.3386,0.8148
"3454",151786,"Marian College",1,0,2006,"19900","24.249214","71","240","277",148,129,108,"32",76,0.5135,0.2481,0.3899,0.8664
"3455",151786,"Marian College",1,0,2007,"20800","26.74664","67","224","271",142,129,76,"23",53,0.3732,0.1783,0.2804,0.8266
"3456",151786,"Marian College",1,0,2008,"22400","29.906742","81","262","326",158,168,111,"50",61,0.3861,0.2976,0.3405,0.8037
"3457",151786,"Marian University",1,0,2009,"24000","32.514208","86","250","312",166,146,103,"39",64,0.3855,0.2671,0.3301,0.8013
"3458",151786,"Marian University",1,0,2010,"24960","34.584234","91","266","317",166,151,124,"49",75,0.4518,0.3245,0.3912,0.8391
"3459",152080,"UNIVERSITY OF NOTRE DAME",1,0,1991,"6752","278.179137","625","1567","1880",717,1163,1635,"988",647,0.9024,0.8495,0.8697,0.8335
"3460",152080,"UNIVERSITY OF NOTRE DAME",1,0,1992,"14650","305.508566","640","1580","1879",822,1057,1631,"900",731,0.8893,0.8515,0.868,0.8409
"3461",152080,"UNIVERSITY OF NOTRE DAME",1,0,1993,"15810","319.124394","644","1602","1901",851,1050,1685,"910",775,0.9107,0.8667,0.8864,0.8427
"3462",152080,"UNIVERSITY OF NOTRE DAME",1,0,1995,"17830","376.652101","670","1586","1902",870,1032,1667,"887",780,0.8966,0.8595,0.8764,0.8339
"3463",152080,"UNIVERSITY OF NOTRE DAME",1,0,1996,"18810","393.52435","687","1589","1920",862,1058,1698,"915",783,0.9084,0.8648,0.8844,0.8276
"3464",152080,"UNIVERSITY OF NOTRE DAME",1,0,1997,"19800","395.609","698","1620","1904",875,1029,1675,"879",796,0.9097,0.8542,0.8797,0.8508
"3465",152080,"UNIVERSITY OF NOTRE DAME",1,0,1998,"20900","372.813","704","1633","1937",895,1042,1706,"891",815,0.9106,0.8551,0.8807,0.8431
"3466",152080,"UNIVERSITY OF NOTRE DAME",1,0,1999,"22030","395.408","726","1627","1967",932,1035,1739,"880",859,0.9217,0.8502,0.8841,0.8271
"3467",152080,"UNIVERSITY OF NOTRE DAME",1,0,2000,"23180","444.145","744.5","1580","1955",919,1036,1757,"921",836,0.9097,0.889,0.8987,0.8082
"3468",152080,"UNIVERSITY OF NOTRE DAME",1,0,2001,"24320","486.281","763","1636","2036",958,1078,1825,"956",869,0.9071,0.8868,0.8964,0.8035
"3469",152080,"UNIVERSITY OF NOTRE DAME",1,0,2002,"25510","535.951","760","1561","1945",935,1010,1765,"909",856,0.9155,0.9,0.9075,0.8026
"3470",152080,"UNIVERSITY OF NOTRE DAME",1,0,2003,"27170","552.463","783","1511","1995",928,1067,1797,"955",842,0.9073,0.895,0.9008,0.7574
"3471",152080,"UNIVERSITY OF NOTRE DAME",1,0,2004,"29070","584.763","780","1513","1987",947,1040,1789,"914",875,0.924,0.8788,0.9004,0.7614
"3472",152080,"University of Notre Dame",1,0,2005,"31100","615.838","877","1493","1990",935,1055,1800,"942",858,0.9176,0.8929,0.9045,0.7503
"3473",152080,"University of Notre Dame",1,0,2006,"32900","643.885","853","1445","2029",928,1101,1800,"962",838,0.903,0.8738,0.8871,0.7122
"3474",152080,"University of Notre Dame",1,0,2007,"34680","680.04","890","1471","1984",948,1036,1782,"913",869,0.9167,0.8813,0.8982,0.7414
"3475",152080,"University of Notre Dame",1,0,2008,"36340","730.195","907","1515","1991",951,1040,1806,"932",874,0.919,0.8962,0.9071,0.7609
"3476",152080,"University of Notre Dame",1,0,2009,"37970","773.206","947","1500","2055",930,1125,1867,"1009",858,0.9226,0.8969,0.9085,0.7299
"3477",152080,"University of Notre Dame",1,0,2010,"39412","829.224","982","1477","2056",966,1090,1846,"966",880,0.911,0.8862,0.8979,0.7184
"3478",152248,"PURDUE UNIVERSITY CALUMET CAMPUS",1,0,1991,"1985","36.895257","235","704","921",466,455,17,"6",11,0.0236,0.0132,0.0185,0.7644
"3479",152248,"PURDUE UNIVERSITY CALUMET CAMPUS",1,0,1992,"2145","39.975692","241","741","985",535,450,22,"8",14,0.0262,0.0178,0.0223,0.7523
"3480",152248,"PURDUE UNIVERSITY-CALUMET CAMPUS",1,0,1993,"2290","43.050978","247","607","847",475,372,64,"32",32,0.0674,0.086,0.0756,0.7166
"3481",152248,"PURDUE UNIVERSITY-CALUMET CAMPUS",1,0,1995,"2658","45.781898","251","642","906",487,419,71,"21",50,0.1027,0.0501,0.0784,0.7086
"3482",152248,"PURDUE UNIVERSITY-CALUMET CAMPUS",1,0,1996,"2775","48.809","247","741","1026",558,468,92,"42",50,0.0896,0.0897,0.0897,0.7222
"3483",152248,"PURDUE UNIVERSITY-CALUMET CAMPUS",1,0,1997,"2970","49.475694","257","771","1071",556,515,101,"49",52,0.0935,0.0951,0.0943,0.7199
"3484",152248,"PURDUE UNIVERSITY-CALUMET CAMPUS",1,0,1998,"3093","54.124336","262","745","1062",560,502,38,"17",21,0.0375,0.0339,0.0358,0.7015
"3485",152248,"PURDUE UNIVERSITY-CALUMET CAMPUS",1,0,1999,"2926","55.908451","260","800","1112",593,519,42,"13",29,0.0489,0.025,0.0378,0.7194
"3486",152248,"PURDUE UNIVERSITY-CALUMET CAMPUS",1,0,2000,"3043","58.716759","269","773","1043",577,466,37,"14",23,0.0399,0.03,0.0355,0.7411
"3487",152248,"PURDUE UNIVERSITY-CALUMET CAMPUS",1,0,2001,"3272","65.742912","278","713","958",507,451,37,"12",25,0.0493,0.0266,0.0386,0.7443
"3488",152248,"PURDUE UNIVERSITY-CALUMET CAMPUS",1,0,2002,"3125","63.798875","272","669","927",474,453,36,"16",20,0.0422,0.0353,0.0388,0.7217
"3489",152248,"PURDUE UNIVERSITY-CALUMET CAMPUS",1,0,2003,"3708","65.267035","273","741","997",527,470,56,"21",35,0.0664,0.0447,0.0562,0.7432
"3490",152248,"PURDUE UNIVERSITY-CALUMET CAMPUS",1,0,2004,"3974","68.229127","263","630","954",492,462,55,"24",31,0.063,0.0519,0.0577,0.6604
"3491",152248,"Purdue University-Calumet Campus",1,0,2005,"4212","72.700845","256","689","1093",599,494,57,"23",34,0.0568,0.0466,0.0522,0.6304
"3492",152248,"Purdue University-Calumet Campus",1,0,2006,"4464","85.461037","262","641","1036",546,490,52,"19",33,0.0604,0.0388,0.0502,0.6187
"3493",152248,"Purdue University-Calumet Campus",1,0,2007,"4666","84.97178","279","728","1220",630,590,104,"40",64,0.1016,0.0678,0.0852,0.5967
"3494",152248,"Purdue University-Calumet Campus",1,0,2008,"4875","95.03784","287","672","1213",624,589,108,"50",58,0.0929,0.0849,0.089,0.554
"3495",152248,"Purdue University-Calumet Campus",1,0,2009,"5119","102.112965","293","624","1060",499,561,92,"37",55,0.1102,0.066,0.0868,0.5887
"3496",152248,"Purdue University-Calumet Campus",1,0,2010,"5374","107.072459","297","555","965",484,481,101,"48",53,0.1095,0.0998,0.1047,0.5751
"3497",152363,"SAINT JOSEPH'S COLLEGE",1,0,1991,"9410","16.047306","48","227","252",94,158,95,"51",44,0.4681,0.3228,0.377,0.9008
"3498",152363,"SAINT JOSEPH'S COLLEGE",1,0,1992,"10030","15.607327","48","233","258",129,129,94,"40",54,0.4186,0.3101,0.3643,0.9031
"3499",152363,"SAINT JOSEPHS COLLEGE",1,0,1993,"10830","15.197381","45","262","292",140,152,110,"59",51,0.3643,0.3882,0.3767,0.8973
"3500",152363,"SAINT JOSEPHS COLLEGE",1,0,1995,"11900","19.415597","42","200","237",106,131,99,"52",47,0.4434,0.3969,0.4177,0.8439
"3501",152363,"SAINT JOSEPHS COLLEGE",1,0,1996,"12260","19.80641","49","190","212",107,105,93,"40",53,0.4953,0.381,0.4387,0.8962
"3502",152363,"SAINT JOSEPHS COLLEGE",1,0,1997,"12620","14.471046","47","239","267",138,129,112,"46",66,0.4783,0.3566,0.4195,0.8951
"3503",152363,"SAINT JOSEPHS COLLEGE",1,0,1998,"13590","14.428337","50","227","254",136,118,113,"46",67,0.4926,0.3898,0.4449,0.8937
"3504",152363,"SAINT JOSEPHS COLLEGE",1,0,1999,"14070","15.232628","54","246","290",122,168,114,"56",58,0.4754,0.3333,0.3931,0.8483
"3505",152363,"SAINT JOSEPHS COLLEGE",1,0,2000,"14920","16.481558","53.5","222","246",132,114,109,"50",59,0.447,0.4386,0.4431,0.9024
"3506",152363,"SAINT JOSEPHS COLLEGE",1,0,2001,"15880","17.573026","53","205","232",121,111,105,"43",62,0.5124,0.3874,0.4526,0.8836
"3507",152363,"SAINT JOSEPHS COLLEGE",1,0,2002,"16900","17.57729","56","242","276",155,121,108,"34",74,0.4774,0.281,0.3913,0.8768
"3508",152363,"SAINT JOSEPHS COLLEGE",1,0,2003,"17900","19.74416","56","255","306",159,147,134,"66",68,0.4277,0.449,0.4379,0.8333
"3509",152363,"SAINT JOSEPHS COLLEGE",1,0,2004,"19000","20.794184","52","210","246",145,101,128,"37",91,0.6276,0.3663,0.5203,0.8537
"3510",152363,"Saint Josephs College",1,0,2005,"19960","21.068604","56","229","266",145,121,128,"41",87,0.6,0.3388,0.4812,0.8609
"3511",152363,"Saint Josephs College",1,0,2006,"20800","21.019034","53","198","251",111,140,100,"49",51,0.4595,0.35,0.3984,0.7888
"3512",152363,"Saint Josephs College",1,0,2007,"21710","20.64284","53","226","300",138,162,107,"50",57,0.413,0.3086,0.3567,0.7533
"3513",152363,"Saint Josephs College",1,0,2008,"23000","22.440637","54","234","296",144,152,118,"51",67,0.4653,0.3355,0.3986,0.7905
"3514",152363,"Saint Josephs College",1,0,2009,"24350","22.845505","51","187","240",108,132,102,"41",61,0.5648,0.3106,0.425,0.7792
"3515",152363,"Saint Josephs College",1,0,2010,"25080","21.728209","56","191","257",120,137,111,"43",68,0.5667,0.3139,0.4319,0.7432
"3516",152530,"TAYLOR UNIVERSITY",1,0,1991,"9353","25.873547","86","439","466",248,218,247,"94",153,0.6169,0.4312,0.53,0.9421
"3517",152530,"TAYLOR UNIVERSITY-UPLAND",1,0,1992,"10000","27.908182","89","466","491",256,235,324,"153",171,0.668,0.6511,0.6599,0.9491
"3518",152530,"TAYLOR UNIVERSITY-UPLAND",1,0,1993,"10650","29.348557","94","399","435",233,202,270,"107",163,0.6996,0.5297,0.6207,0.9172
"3519",152530,"TAYLOR UNIVERSITY-UPLAND",1,0,1995,"11914","32.960732","103","389","419",224,195,270,"112",158,0.7054,0.5744,0.6444,0.9284
"3520",152530,"TAYLOR UNIVERSITY-UPLAND",1,0,1996,"12774","35.274947","102","452","485",270,215,348,"147",201,0.7444,0.6837,0.7175,0.932
"3521",152530,"TAYLOR UNIVERSITY-UPLAND",1,0,1997,"13484","30.660457","106","457","486",262,224,321,"143",178,0.6794,0.6384,0.6605,0.9403
"3522",152530,"TAYLOR UNIVERSITY-UPLAND",1,0,1998,"14456","33.603163","109","426","460",243,217,293,"128",165,0.679,0.5899,0.637,0.9261
"3523",152530,"TAYLOR UNIVERSITY-UPLAND",1,0,1999,"14900","34.275345","113","438","473",256,217,341,"142",199,0.7773,0.6544,0.7209,0.926
"3524",152530,"TAYLOR UNIVERSITY-UPLAND",1,0,2000,"15600","37.56","115.5","443","482",242,240,332,"149",183,0.7562,0.6208,0.6888,0.9191
"3525",152530,"TAYLOR UNIVERSITY-UPLAND",1,0,2001,"16350","36.507","118","464","491",251,240,341,"160",181,0.7211,0.6667,0.6945,0.945
"3526",152530,"TAYLOR UNIVERSITY-UPLAND",1,0,2002,"17270","37.296","118","414","452",244,208,322,"142",180,0.7377,0.6827,0.7124,0.9159
"3527",152530,"TAYLOR UNIVERSITY-UPLAND",1,0,2003,"18306","40.1742","119","438","468",270,198,331,"137",194,0.7185,0.6919,0.7073,0.9359
"3528",152530,"TAYLOR UNIVERSITY-UPLAND",1,0,2004,"19450","41.4588","119","446","476",265,211,334,"134",200,0.7547,0.6351,0.7017,0.937
"3529",152530,"Taylor University-Upland",1,0,2005,"20520","44.006","126","427","459",271,188,342,"142",200,0.738,0.7553,0.7451,0.9303
"3530",152530,"Taylor University",1,0,2006,"21800","46.072729","132","450","492",266,226,341,"146",195,0.7331,0.646,0.6931,0.9146
"3531",152530,"Taylor University",1,0,2007,"23030","53.708481","122","422","472",272,200,306,"129",177,0.6507,0.645,0.6483,0.8941
"3532",152530,"Taylor University",1,0,2008,"24314","57.758063","126","410","465",266,199,312,"115",197,0.7406,0.5779,0.671,0.8817
"3533",152530,"Taylor University",1,0,2009,"25164","54.356078","129","426","482",263,219,342,"141",201,0.7643,0.6438,0.7095,0.8838
"3534",152530,"Taylor University",1,0,2010,"26150","58.648554","140","417","467",270,197,308,"112",196,0.7259,0.5685,0.6595,0.8929
"3535",152600,"VALPARAISO UNIVERSITY",1,0,1991,"9900","49.728515","224","565","615",340,275,327,"114",213,0.6265,0.4145,0.5317,0.9187
"3536",152600,"VALPARAISO UNIVERSITY",1,0,1992,"10840","51.746895","225","563","601",334,267,305,"117",188,0.5629,0.4382,0.5075,0.9368
"3537",152600,"VALPARAISO UNIVERSITY",1,0,1993,"11720","56.183823","204","438","487",251,236,278,"109",169,0.6733,0.4619,0.5708,0.8994
"3538",152600,"VALPARAISO UNIVERSITY",1,0,1995,"12860","59.756209","172","574","673",370,303,405,"141",264,0.7135,0.4653,0.6018,0.8529
"3539",152600,"VALPARAISO UNIVERSITY",1,0,1996,"13980","60.764914","196","558","656",348,308,381,"149",232,0.6667,0.4838,0.5808,0.8506
"3540",152600,"VALPARAISO UNIVERSITY",1,0,1997,"14560","53.040139","201","601","702",382,320,416,"163",253,0.6623,0.5094,0.5926,0.8561
"3541",152600,"VALPARAISO UNIVERSITY",1,0,1998,"15400","56.544037","207","580","685",350,335,396,"162",234,0.6686,0.4836,0.5781,0.8467
"3542",152600,"VALPARAISO UNIVERSITY",1,0,1999,"16280","59.459637","224","660","730",376,354,429,"192",237,0.6303,0.5424,0.5877,0.9041
"3543",152600,"VALPARAISO UNIVERSITY",1,0,2000,"17100","63.348543","219","624","707",388,319,450,"188",262,0.6753,0.5893,0.6365,0.8826
"3544",152600,"VALPARAISO UNIVERSITY",1,0,2001,"18100","66.889363","214","598","660",339,321,442,"187",255,0.7522,0.5826,0.6697,0.9061
"3545",152600,"VALPARAISO UNIVERSITY",1,0,2002,"19000","69.078464","225","635","715",365,350,454,"197",257,0.7041,0.5629,0.635,0.8881
"3546",152600,"VALPARAISO UNIVERSITY",1,0,2003,"20000","71.776715","232","700","791",400,391,501,"229",272,0.68,0.5857,0.6334,0.885
"3547",152600,"VALPARAISO UNIVERSITY",1,0,2004,"21000","74.996761","237","637","746",376,370,446,"201",245,0.6516,0.5432,0.5979,0.8539
"3548",152600,"Valparaiso University",1,0,2005,"22000","81.818971","243","586","672",332,340,421,"183",238,0.7169,0.5382,0.6265,0.872
"3549",152600,"Valparaiso University",1,0,2006,"23200","87.499622","254","626","760",394,366,469,"206",263,0.6675,0.5628,0.6171,0.8237
"3550",152600,"Valparaiso University",1,0,2007,"24360","91.724226","265","580","713",370,343,413,"193",220,0.5946,0.5627,0.5792,0.8135
"3551",152600,"Valparaiso University",1,0,2008,"26070","98.056987","261","556","655",336,319,390,"169",221,0.6577,0.5298,0.5954,0.8489
"3552",152600,"Valparaiso University",1,0,2009,"27360","107.370978","242","539","671",330,341,371,"157",214,0.6485,0.4604,0.5529,0.8033
"3553",152600,"Valparaiso University",1,0,2010,"28590","105.576565","254","544","691",360,331,376,"148",228,0.6333,0.4471,0.5441,0.7873
"3554",153001,"BUENA VISTA COLLEGE",1,0,1991,"10900","20.940896","71","263","273",110,163,107,"57",50,0.4545,0.3497,0.3919,0.9634
"3555",153001,"BUENA VISTA COLLEGE",1,0,1992,"11663","26.044433","70","276","290",132,158,129,"56",73,0.553,0.3544,0.4448,0.9517
"3556",153001,"BUENA VISTA COLLEGE",1,0,1993,"12565","28.332401","70","274","284",143,141,130,"47",83,0.5804,0.3333,0.4577,0.9648
"3557",153001,"BUENA VISTA UNIVERSITY",1,0,1995,"14078","32.865908","64","341","352",167,185,168,"71",97,0.5808,0.3838,0.4773,0.9688
"3558",153001,"BUENA VISTA UNIVERSITY",1,0,1996,"14458","30.068143","72","304","311",161,150,124,"52",72,0.4472,0.3467,0.3987,0.9775
"3559",153001,"BUENA VISTA UNIVERSITY",1,0,1997,"14848","30.907815","73","374","385",185,200,169,"70",99,0.5351,0.35,0.439,0.9714
"3560",153001,"BUENA VISTA UNIVERSITY",1,0,1998,"15292","34.249903","79","309","323",165,158,165,"68",97,0.5879,0.4304,0.5108,0.9567
"3561",153001,"BUENA VISTA UNIVERSITY",1,0,1999,"15751","36.881059","84","313","322",144,178,146,"69",77,0.5347,0.3876,0.4534,0.972
"3562",153001,"BUENA VISTA UNIVERSITY",1,0,2000,"17176","30.567321","83","309","326",182,144,153,"62",91,0.5,0.4306,0.4693,0.9479
"3563",153001,"BUENA VISTA UNIVERSITY",1,0,2001,"17846","33.123131","82","353","379",189,190,166,"69",97,0.5132,0.3632,0.438,0.9314
"3564",153001,"BUENA VISTA UNIVERSITY",1,0,2002,"18738","34.368571","81","317","356",192,164,184,"79",105,0.5469,0.4817,0.5169,0.8904
"3565",153001,"BUENA VISTA UNIVERSITY",1,0,2003,"19862","35.420833","88","331","377",193,184,172,"74",98,0.5078,0.4022,0.4562,0.878
"3566",153001,"BUENA VISTA UNIVERSITY",1,0,2004,"20854","34.286799","81","280","331",173,158,150,"63",87,0.5029,0.3987,0.4532,0.8459
"3567",153001,"Buena Vista University",1,0,2005,"21688","37.497411","81","256","286",143,143,121,"50",71,0.4965,0.3497,0.4231,0.8951
"3568",153001,"Buena Vista University",1,0,2006,"22556","37.763696","82","241","265",133,132,111,"51",60,0.4511,0.3864,0.4189,0.9094
"3569",153001,"Buena Vista University",1,0,2007,"23842","40.326287","86","195","226",122,104,97,"35",62,0.5082,0.3365,0.4292,0.8628
"3570",153001,"Buena Vista University",1,0,2008,"24796","40.861744","84","213","273",117,156,96,"46",50,0.4274,0.2949,0.3516,0.7802
"3571",153001,"Buena Vista University",1,0,2009,"25540","41.466284","82","216","271",123,148,116,"55",61,0.4959,0.3716,0.428,0.797
"3572",153001,"Buena Vista University",1,0,2010,"26306","41.890055","83","200","265",139,126,117,"43",74,0.5324,0.3413,0.4415,0.7547
"3573",153108,"CENTRAL UNIVERSITY OF IOWA",0,1,1991,"9198","25.407073","88","384","414",239,175,224,"95",129,0.5397,0.5429,0.5411,0.9275
"3574",153108,"CENTRAL UNIVERSITY OF IOWA",0,1,1992,"9875","25.970467","88","394","428",235,193,242,"98",144,0.6128,0.5078,0.5654,0.9206
"3575",153108,"CENTRAL UNIVERSITY OF IOWA",0,1,1993,"10239","26.709374","89","369","397",210,187,211,"87",124,0.5905,0.4652,0.5315,0.9295
"3576",153108,"CENTRAL COLLEGE",0,1,1995,"11836","26.516018","83","378","410",249,161,247,"92",155,0.6225,0.5714,0.6024,0.922
"3577",153108,"CENTRAL COLLEGE",1,0,1996,"12304","27.234911","82","286","303",178,125,160,"58",102,0.573,0.464,0.5281,0.9439
"3578",153108,"CENTRAL COLLEGE",1,0,1997,"12802","27.841849","82","298","306",178,128,183,"67",116,0.6517,0.5234,0.598,0.9739
"3579",153108,"CENTRAL COLLEGE",1,0,1998,"13388","21.90997","81","403","411",222,189,249,"101",148,0.6667,0.5344,0.6058,0.9805
"3580",153108,"CENTRAL COLLEGE",1,0,1999,"14070","23.696267","83","386","403",219,184,7,"0",7,0.032,0,0.0174,0.9578
"3581",153108,"CENTRAL COLLEGE",1,0,2000,"14638","27.11778","82.5","353","369",214,155,226,"84",142,0.6636,0.5419,0.6125,0.9566
"3582",153108,"CENTRAL COLLEGE",1,0,2001,"15598","28.968152","82","393","412",237,175,274,"108",166,0.7004,0.6171,0.665,0.9539
"3583",153108,"CENTRAL COLLEGE",1,0,2002,"16612","32.148351","86","402","425",234,191,263,"103",160,0.6838,0.5393,0.6188,0.9459
"3584",153108,"CENTRAL COLLEGE",1,0,2003,"17609","33.324142","89","397","416",227,189,231,"87",144,0.6344,0.4603,0.5553,0.9543
"3585",153108,"CENTRAL COLLEGE",1,0,2004,"18648","37.195377","90","420","441",223,218,260,"118",142,0.6368,0.5413,0.5896,0.9524
"3586",153108,"Central College",1,0,2005,"19684","38.510734","87","339","366",203,163,213,"93",120,0.5911,0.5706,0.582,0.9262
"3587",153108,"Central College",1,0,2006,"20972","38.179426","87","383","413",218,195,256,"103",153,0.7018,0.5282,0.6199,0.9274
"3588",153108,"Central College",1,0,2007,"22230","40.474658","83","389","422",219,203,260,"111",149,0.6804,0.5468,0.6161,0.9218
"3589",153108,"Central College",1,0,2008,"23564","42.565655","88","377","404",204,200,255,"101",154,0.7549,0.505,0.6312,0.9332
"3590",153108,"Central College",1,0,2009,"24630","43.191829","88","401","442",213,229,264,"117",147,0.6901,0.5109,0.5973,0.9072
"3591",153108,"Central College",1,0,2010,"25862","43.599797","88","355","402",212,190,235,"99",136,0.6415,0.5211,0.5846,0.8831
"3592",153269,"DRAKE UNIVERSITY",1,0,1991,"11040","78.115175","271","651","744",424,320,398,"154",244,0.5755,0.4812,0.5349,0.875
"3593",153269,"DRAKE UNIVERSITY",1,0,1992,"11780","84.949598","278","731","838",476,362,407,"150",257,0.5399,0.4144,0.4857,0.8723
"3594",153269,"DRAKE UNIVERSITY",1,0,1993,"12780","90.802325","285","742","832",492,340,422,"158",264,0.5366,0.4647,0.5072,0.8918
"3595",153269,"DRAKE UNIVERSITY",1,0,1995,"14100","92.959231","270","594","734",435,299,365,"144",221,0.508,0.4816,0.4973,0.8093
"3596",153269,"DRAKE UNIVERSITY",1,0,1996,"14380","93.273716","267","537","638",385,253,352,"145",207,0.5377,0.5731,0.5517,0.8417
"3597",153269,"DRAKE UNIVERSITY",1,0,1997,"15200","76.021205","269","513","636",368,268,389,"141",248,0.6739,0.5261,0.6116,0.8066
"3598",153269,"DRAKE UNIVERSITY",1,0,1998,"16000","78.182509","259","563","670",379,291,378,"134",244,0.6438,0.4605,0.5642,0.8403
"3599",153269,"DRAKE UNIVERSITY",1,0,1999,"16480","77.74418","262","553","670",364,306,371,"151",220,0.6044,0.4935,0.5537,0.8254
"3600",153269,"DRAKE UNIVERSITY",1,0,2000,"17090","80.040966","258.5","628","760",475,285,353,"127",226,0.4758,0.4456,0.4645,0.8263
"3601",153269,"DRAKE UNIVERSITY",1,0,2001,"17580","81.404746","255","627","755",476,279,361,"122",239,0.5021,0.4373,0.4781,0.8305
"3602",153269,"DRAKE UNIVERSITY",1,0,2002,"18190","84.391849","244","650","775",459,316,360,"148",212,0.4619,0.4684,0.4645,0.8387
"3603",153269,"DRAKE UNIVERSITY",1,0,2003,"19100","85.367907","237","694","809",474,335,410,"151",259,0.5464,0.4507,0.5068,0.8578
"3604",153269,"DRAKE UNIVERSITY",1,0,2004,"20200","89.281469","249","653","782",462,320,408,"162",246,0.5325,0.5062,0.5217,0.835
"3605",153269,"Drake University",1,0,2005,"21100","92.428651","246","688","809",465,344,438,"173",265,0.5699,0.5029,0.5414,0.8504
"3606",153269,"Drake University",1,0,2006,"22270","97.235343","246","638","779",470,309,429,"173",256,0.5447,0.5599,0.5507,0.819
"3607",153269,"Drake University",1,0,2007,"23280","104.834618","257","778","923",557,366,484,"170",314,0.5637,0.4645,0.5244,0.8429
"3608",153269,"Drake University",1,0,2008,"24430","109.322553","270","797","901",544,357,507,"199",308,0.5662,0.5574,0.5627,0.8846
"3609",153269,"Drake University",1,0,2009,"25160","113.040885","275","744","860",512,348,482,"185",297,0.5801,0.5316,0.5605,0.8651
"3610",153269,"Drake University",1,0,2010,"26400","118.954937","275","754","864",474,390,513,"218",295,0.6224,0.559,0.5938,0.8727
"3611",153384,"GRINNELL COLLEGE",1,0,1991,"13742","36.149033","131","256","324",184,140,248,"104",144,0.7826,0.7429,0.7654,0.7901
"3612",153384,"GRINNELL COLLEGE",1,0,1992,"14532","38.360167","121","223","295",168,127,234,"101",133,0.7917,0.7953,0.7932,0.7559
"3613",153384,"GRINNELL COLLEGE",1,0,1993,"15368","40.925471","128","341","434",224,210,321,"151",170,0.7589,0.719,0.7396,0.7857
"3614",153384,"GRINNELL COLLEGE",1,0,1995,"16628","48.036148","143","243","307",168,139,238,"106",132,0.7857,0.7626,0.7752,0.7915
"3615",153384,"GRINNELL COLLEGE",1,0,1996,"17134","50.669598","141","268","354",210,144,271,"106",165,0.7857,0.7361,0.7655,0.7571
"3616",153384,"GRINNELL COLLEGE",1,0,1997,"17568","55.737473","142","319","413",234,179,330,"140",190,0.812,0.7821,0.799,0.7724
"3617",153384,"GRINNELL COLLEGE",1,0,1998,"18446","48.026","134","258","350",194,156,282,"127",155,0.799,0.8141,0.8057,0.7371
"3618",153384,"GRINNELL COLLEGE",1,0,1999,"18990","49.496","136","223","325",168,157,271,"126",145,0.8631,0.8025,0.8338,0.6862
"3619",153384,"GRINNELL COLLEGE",1,0,2000,"19982","58.941","148","245","363",209,154,312,"127",185,0.8852,0.8247,0.8595,0.6749
"3620",153384,"GRINNELL COLLEGE",1,0,2001,"21700","59.816","160","242","356",184,172,291,"130",161,0.875,0.7558,0.8174,0.6798
"3621",153384,"GRINNELL COLLEGE",1,0,2002,"22960","60.182","170","261","368",202,166,297,"132",165,0.8168,0.7952,0.8071,0.7092
"3622",153384,"GRINNELL COLLEGE",1,0,2003,"23898","67.932","179","285","403",214,189,315,"138",177,0.8271,0.7302,0.7816,0.7072
"3623",153384,"GRINNELL COLLEGE",1,0,2004,"25200","69.352","176","301","434",237,197,363,"155",208,0.8776,0.7868,0.8364,0.6935
"3624",153384,"Grinnell College",1,0,2005,"27060","72.545","180","245","385",206,179,320,"148",172,0.835,0.8268,0.8312,0.6364
"3625",153384,"Grinnell College",1,0,2006,"28566","77.156","183","270","405",206,199,348,"166",182,0.8835,0.8342,0.8593,0.6667
"3626",153384,"Grinnell College",1,0,2007,"29710","82.365","186","260","426",233,193,344,"152",192,0.824,0.7876,0.8075,0.6103
"3627",153384,"Grinnell College",1,0,2008,"34932","90.111","193","299","462",251,211,392,"171",221,0.8805,0.8104,0.8485,0.6472
"3628",153384,"Grinnell College",1,0,2009,"35976","94.905","189","202","377",202,175,299,"124",175,0.8663,0.7086,0.7931,0.5358
"3629",153384,"Grinnell College",1,0,2010,"36948","97.968","188","230","415",231,184,336,"140",196,0.8485,0.7609,0.8096,0.5542
"3630",153603,"IOWA STATE UNIVERSITY",1,0,1991,"2072","485.211511","1207","2787","3228",1368,1860,665,"281",384,0.2807,0.1511,0.206,0.8634
"3631",153603,"IOWA STATE UNIVERSITY",1,0,1992,"2228","474.079473","1197","2833","3333",1432,1901,723,"309",414,0.2891,0.1625,0.2169,0.85
"3632",153603,"IOWA STATE UNIVERSITY",1,0,1993,"2352","517.405184","1188","2893","3416",1435,1981,763,"327",436,0.3038,0.1651,0.2234,0.8469
"3633",153603,"IOWA STATE UNIVERSITY",1,0,1995,"2574","556.478259","1029","2937","3274",1490,1784,822,"341",481,0.3228,0.1911,0.2511,0.8971
"3634",153603,"IOWA STATE UNIVERSITY",1,0,1996,"2666","579.150812","1035","3170","3599",1592,2007,1022,"455",567,0.3562,0.2267,0.284,0.8808
"3635",153603,"IOWA STATE UNIVERSITY",1,0,1997,"2766","593.02482","1016","3500","4007",1790,2217,1081,"437",644,0.3598,0.1971,0.2698,0.8735
"3636",153603,"IOWA STATE UNIVERSITY",1,0,1998,"2874","620.011993","1006","3348","3800",1775,2025,1111,"438",673,0.3792,0.2163,0.2924,0.8811
"3637",153603,"IOWA STATE UNIVERSITY",1,0,1999,"2786","649.052671","1327","3494","4020",1830,2190,1261,"520",741,0.4049,0.2374,0.3137,0.8692
"3638",153603,"IOWA STATE UNIVERSITY",1,0,2000,"2906","688.500704","1307.5","3697","4282",1928,2354,1340,"515",825,0.4279,0.2188,0.3129,0.8634
"3639",153603,"IOWA STATE UNIVERSITY",1,0,2001,"3116","714.865818","1288","3910","4589",2087,2502,1463,"591",872,0.4178,0.2362,0.3188,0.852
"3640",153603,"IOWA STATE UNIVERSITY",1,0,2002,"3692","691.156828","1376","3557","4167",1915,2252,1399,"566",833,0.435,0.2513,0.3357,0.8536
"3641",153603,"IOWA STATE UNIVERSITY",1,0,2003,"4342","721.174932","1415","3288","3860",1683,2177,1364,"577",787,0.4676,0.265,0.3534,0.8518
"3642",153603,"IOWA STATE UNIVERSITY",1,0,2004,"4702","769.795178","1391","3142","3674",1618,2056,1348,"572",776,0.4796,0.2782,0.3669,0.8552
"3643",153603,"Iowa State University",1,0,2005,"4890","765.486372","1115","3214","3737",1629,2108,1248,"535",713,0.4377,0.2538,0.334,0.86
"3644",153603,"Iowa State University",1,0,2006,"5086","806.836319","1118","3350","3933",1780,2153,1525,"649",876,0.4921,0.3014,0.3877,0.8518
"3645",153603,"Iowa State University",1,0,2007,"5352","828.827218","1097","3671","4307",1920,2387,1622,"682",940,0.4896,0.2857,0.3766,0.8523
"3646",153603,"Iowa State University",1,0,2008,"5524","874.843627","1368","3740","4528",2074,2454,1787,"772",1015,0.4894,0.3146,0.3947,0.826
"3647",153603,"Iowa State University",1,0,2009,"5756","919.059347","1374","3501","4320",1974,2346,1757,"742",1015,0.5142,0.3163,0.4067,0.8104
"3648",153603,"Iowa State University",1,0,2010,"6102","929.746619","1305","3623","4518",2077,2441,2006,"847",1159,0.558,0.347,0.444,0.8019
"3649",153834,"LUTHER COLLEGE",1,0,1991,"10600","33.357543","145","538","578",349,229,368,"134",234,0.6705,0.5852,0.6367,0.9308
"3650",153834,"LUTHER COLLEGE",1,0,1992,"11600","37.982124","150","543","579",357,222,389,"144",245,0.6863,0.6486,0.6718,0.9378
"3651",153834,"LUTHER COLLEGE",1,0,1993,"12375","40.85588","155","554","586",341,245,411,"176",235,0.6891,0.7184,0.7014,0.9454
"3652",153834,"LUTHER COLLEGE",1,0,1995,"14100","46.369849","159","538","590",372,218,375,"122",253,0.6801,0.5596,0.6356,0.9119
"3653",153834,"LUTHER COLLEGE",1,0,1996,"14900","46.988443","160","557","615",347,268,437,"190",247,0.7118,0.709,0.7106,0.9057
"3654",153834,"LUTHER COLLEGE",1,0,1997,"15630","37.620017","165","562","629",385,244,431,"161",270,0.7013,0.6598,0.6852,0.8935
"3655",153834,"LUTHER COLLEGE",1,0,1998,"16525","39.505953","166","592","678",396,282,446,"179",267,0.6742,0.6348,0.6578,0.8732
"3656",153834,"LUTHER COLLEGE",1,0,1999,"17290","41.826617","173","552","606",354,252,393,"155",238,0.6723,0.6151,0.6485,0.9109
"3657",153834,"LUTHER COLLEGE",1,0,2000,"18080","45.126303","173.5","588","662",396,266,420,"161",259,0.654,0.6053,0.6344,0.8882
"3658",153834,"LUTHER COLLEGE",1,0,2001,"19325","46.857059","174","537","636",397,239,401,"144",257,0.6474,0.6025,0.6305,0.8443
"3659",153834,"LUTHER COLLEGE",1,0,2002,"20310","47.679828","175","541","608",365,243,371,"135",236,0.6466,0.5556,0.6102,0.8898
"3660",153834,"LUTHER COLLEGE",1,0,2003,"21600","48.57271","183","612","667",397,270,436,"172",264,0.665,0.637,0.6537,0.9175
"3661",153834,"LUTHER COLLEGE",1,0,2004,"23070","51.317566","186","601","661",387,274,435,"183",252,0.6512,0.6679,0.6581,0.9092
"3662",153834,"Luther College",1,0,2005,"24570","53.78193","182","558","629",354,275,367,"140",227,0.6412,0.5091,0.5835,0.8871
"3663",153834,"Luther College",1,0,2006,"26380","58.322076","188","542","610",350,260,417,"180",237,0.6771,0.6923,0.6836,0.8885
"3664",153834,"Luther College",1,0,2007,"28840","61.015697","182","552","659",374,285,439,"177",262,0.7005,0.6211,0.6662,0.8376
"3665",153834,"Luther College",1,0,2008,"30920","63.247936","182","511","630",371,259,469,"194",275,0.7412,0.749,0.7444,0.8111
"3666",153834,"Luther College",1,0,2009,"32140","69.780254","181","507","657",380,277,451,"190",261,0.6868,0.6859,0.6865,0.7717
"3667",153834,"Luther College",1,0,2010,"33330","75.197418","182","551","611",342,269,438,"177",261,0.7632,0.658,0.7169,0.9018
"3668",154095,"UNIVERSITY OF NORTHERN IOWA",1,0,1991,"1952","122.800808","600","1840","1949",1181,768,470,"151",319,0.2701,0.1966,0.2411,0.9441
"3669",154095,"UNIVERSITY OF NORTHERN IOWA",1,0,1992,"2228","123.874165","615","1558","1659",984,675,435,"143",292,0.2967,0.2119,0.2622,0.9391
"3670",154095,"UNIVERSITY OF NORTHERN IOWA",1,0,1993,"2352","135.711767","622","1691","1808",1112,696,491,"152",339,0.3049,0.2184,0.2716,0.9353
"3671",154095,"UNIVERSITY OF NORTHERN IOWA",1,0,1995,"2558","148.253527","636","1912","2007",1244,763,604,"170",434,0.3489,0.2228,0.3009,0.9527
"3672",154095,"UNIVERSITY OF NORTHERN IOWA",1,0,1996,"2650","157.738003","646","1899","2012",1234,778,673,"224",449,0.3639,0.2879,0.3345,0.9438
"3673",154095,"UNIVERSITY OF NORTHERN IOWA",1,0,1997,"2752","164.738387","646","1790","1920",1192,728,553,"169",384,0.3221,0.2321,0.288,0.9323
"3674",154095,"UNIVERSITY OF NORTHERN IOWA",1,0,1998,"2860","171.032484","641","1864","1982",1257,725,585,"146",439,0.3492,0.2014,0.2952,0.9405
"3675",154095,"UNIVERSITY OF NORTHERN IOWA",1,0,1999,"2786","184.610956","646","1978","2122",1303,819,713,"211",502,0.3853,0.2576,0.336,0.9321
"3676",154095,"UNIVERSITY OF NORTHERN IOWA",1,0,2000,"2906","192.923663","646.5","2009","2218",1337,881,751,"243",508,0.38,0.2758,0.3386,0.9058
"3677",154095,"UNIVERSITY OF NORTHERN IOWA",1,0,2001,"3116","210.379377","647","1878","2055",1310,745,665,"189",476,0.3634,0.2537,0.3236,0.9139
"3678",154095,"UNIVERSITY OF NORTHERN IOWA",1,0,2002,"3692","211.25539","641","1674","1821",1139,682,610,"194",416,0.3652,0.2845,0.335,0.9193
"3679",154095,"UNIVERSITY OF NORTHERN IOWA",1,0,2003,"4342","211.292202","587","1598","1739",1088,651,613,"182",431,0.3961,0.2796,0.3525,0.9189
"3680",154095,"UNIVERSITY OF NORTHERN IOWA",1,0,2004,"4702","217.447628","564","1508","1652",995,657,581,"172",409,0.4111,0.2618,0.3517,0.9128
"3681",154095,"University of Northern Iowa",1,0,2005,"4890","217.261417","597","1550","1693",1062,631,618,"184",434,0.4087,0.2916,0.365,0.9155
"3682",154095,"University of Northern Iowa",1,0,2006,"5086","226.70317","587","1525","1684",1010,674,648,"200",448,0.4436,0.2967,0.3848,0.9056
"3683",154095,"University of Northern Iowa",1,0,2007,"5352","227.66329","576","1767","1922",1177,745,708,"237",471,0.4002,0.3181,0.3684,0.9194
"3684",154095,"University of Northern Iowa",1,0,2008,"5524","242.840251","587","1804","1972",1206,766,747,"254",493,0.4088,0.3316,0.3788,0.9148
"3685",154095,"University of Northern Iowa",1,0,2009,"5756","266.86241","575","1761","1913",1194,719,721,"220",501,0.4196,0.306,0.3769,0.9205
"3686",154095,"University of Northern Iowa",1,0,2010,"6102","258.395561","577","1790","1934",1214,720,759,"229",530,0.4366,0.3181,0.3925,0.9255
"3687",155089,"FRIENDS UNIVERSITY",1,0,1991,"7155","12.965834","48","133","165",99,66,44,"12",32,0.3232,0.1818,0.2667,0.8061
"3688",155089,"FRIENDS UNIVERSITY",1,0,1992,"7655","12.274332","48","127","150",101,49,31,"6",25,0.2475,0.1224,0.2067,0.8467
"3689",155089,"FRIENDS UNIVERSITY",1,0,1993,"8185","13.999311","48","192","230",125,105,55,"22",33,0.264,0.2095,0.2391,0.8348
"3690",155089,"FRIENDS UNIVERSITY",1,0,1995,"9017","22.018381","61","161","200",109,91,43,"19",24,0.2202,0.2088,0.215,0.805
"3691",155089,"FRIENDS UNIVERSITY",1,0,1996,"9465","23.163158","63","153","196",111,85,47,"12",35,0.3153,0.1412,0.2398,0.7806
"3692",155089,"FRIENDS UNIVERSITY",1,0,1997,"9974","18.943879","63","130","179",99,80,39,"11",28,0.2828,0.1375,0.2179,0.7263
"3693",155089,"FRIENDS UNIVERSITY",1,0,1998,"10490","21.599575","67","161","195",106,89,35,"14",21,0.1981,0.1573,0.1795,0.8256
"3694",155089,"FRIENDS UNIVERSITY",1,0,1999,"10920","24.629957","69","182","226",125,101,36,"13",23,0.184,0.1287,0.1593,0.8053
"3695",155089,"FRIENDS UNIVERSITY",1,0,2000,"11460","27.20615","70","177","231",127,104,49,"18",31,0.2441,0.1731,0.2121,0.7662
"3696",155089,"FRIENDS UNIVERSITY",1,0,2001,"12210","26.592464","71","155","197",133,64,23,"6",17,0.1278,0.0938,0.1168,0.7868
"3697",155089,"FRIENDS UNIVERSITY",1,0,2002,"12845","28.793","78","163","203",121,82,35,"15",20,0.1653,0.1829,0.1724,0.803
"3698",155089,"FRIENDS UNIVERSITY",1,0,2003,"13620","28.642","75","141","201",102,99,38,"14",24,0.2353,0.1414,0.1891,0.7015
"3699",155089,"FRIENDS UNIVERSITY",1,0,2004,"14430","29.096","79","132","207",112,95,27,"14",13,0.1161,0.1474,0.1304,0.6377
"3700",155089,"Friends University",1,0,2005,"15150","29.509","72","114","151",72,79,16,"7",9,0.125,0.0886,0.106,0.755
"3701",155089,"Friends University",1,0,2006,"16050","30.956","80","101","139",64,75,12,"8",4,0.0625,0.1067,0.0863,0.7266
"3702",155089,"Friends University",1,0,2007,"17100","33.029","76","88","139",72,67,14,"7",7,0.0972,0.1045,0.1007,0.6331
"3703",155089,"Friends University",1,0,2008,"18200","34.116","75","121","169",100,69,20,"2",18,0.18,0.029,0.1183,0.716
"3704",155089,"Friends University",1,0,2009,"18930","34.242","74","161","217",114,103,62,"33",29,0.2544,0.3204,0.2857,0.7419
"3705",155089,"Friends University",1,0,2010,"19890","35.117","74","132","199",90,109,42,"17",25,0.2778,0.156,0.2111,0.6633
"3706",155317,"UNIVERSITY OF KANSAS MAIN CAMPUS",1,0,1991,"1662","278.25615","942","2810","3287",1755,1532,749,"291",458,0.261,0.1899,0.2279,0.8549
"3707",155317,"UNIVERSITY OF KANSAS MAIN CAMPUS",1,0,1992,"1798","293.408262","954","2987","3495",1778,1717,814,"304",510,0.2868,0.1771,0.2329,0.8546
"3708",155317,"UNIVERSITY OF KANSAS MAIN CAMPUS",1,0,1993,"1920","309.185927","981","3090","3603",1849,1754,843,"335",508,0.2747,0.191,0.234,0.8576
"3709",155317,"UNIVERSITY OF KANSAS MAIN CAMPUS",1,0,1995,"2182","336.061133","993","3022","3474",1857,1617,905,"351",554,0.2983,0.2171,0.2605,0.8699
"3710",155317,"UNIVERSITY OF KANSAS MAIN CAMPUS",1,0,1996,"2310","347.869278","978","3072","3546",1902,1644,926,"349",577,0.3034,0.2123,0.2611,0.8663
"3711",155317,"UNIVERSITY OF KANSAS MAIN CAMPUS",1,0,1997,"2385","366.029543","958","3261","3808",1989,1819,1093,"424",669,0.3363,0.2331,0.287,0.8564
"3712",155317,"UNIVERSITY OF KANSAS MAIN CAMPUS",1,0,1998,"2470","398.18787","943","3201","3698",2069,1629,974,"322",652,0.3151,0.1977,0.2634,0.8656
"3713",155317,"UNIVERSITY OF KANSAS MAIN CAMPUS",1,0,1999,"2090","431.715833","946","3281","3784",2099,1685,1155,"374",781,0.3721,0.222,0.3052,0.8671
"3714",155317,"UNIVERSITY OF KANSAS MAIN CAMPUS",1,0,2000,"2267","466.607659","974","3550","4119",2268,1851,1282,"455",827,0.3646,0.2458,0.3112,0.8619
"3715",155317,"UNIVERSITY OF KANSAS MAIN CAMPUS",1,0,2001,"2333","493.858353","1002","3513","4024",2198,1826,1267,"476",791,0.3599,0.2607,0.3149,0.873
"3716",155317,"UNIVERSITY OF KANSAS MAIN CAMPUS",1,0,2002,"2921","488.815493","994","3482","4013",2181,1832,1227,"477",750,0.3439,0.2604,0.3058,0.8677
"3717",155317,"UNIVERSITY OF KANSAS MAIN CAMPUS",1,0,2003,"3527","517.579663","1004","3316","3971",2126,1845,1261,"480",781,0.3674,0.2602,0.3176,0.8351
"3718",155317,"UNIVERSITY OF KANSAS MAIN CAMPUS",1,0,2004,"4163","557.779378","1000","3429","4182",2148,2034,1345,"527",818,0.3808,0.2591,0.3216,0.8199
"3719",155317,"University of Kansas Main Campus",1,0,2005,"4824","611.711806","1055","3462","4106",2115,1991,1332,"518",814,0.3849,0.2602,0.3244,0.8432
"3720",155317,"University of Kansas Main Campus",1,0,2006,"5513","663.500513","1080","3417","4092",2092,2000,1500,"607",893,0.4269,0.3035,0.3666,0.835
"3721",155317,"University of Kansas",1,0,2007,"5844","1014.247043","1228","3332","4028",2084,1944,1444,"582",862,0.4136,0.2994,0.3585,0.8272
"3722",155317,"University of Kansas",1,0,2008,"6195","957.885485","1244","3609","4435",2260,2175,1649,"670",979,0.4332,0.308,0.3718,0.8138
"3723",155317,"University of Kansas",1,0,2009,"6567","987.751979","1152","3067","3894",1984,1910,1459,"599",860,0.4335,0.3136,0.3747,0.7876
"3724",155317,"University of Kansas",1,0,2010,"7167","1025.617188","1154","2837","3489",1743,1746,1435,"603",832,0.4773,0.3454,0.4113,0.8131
"3725",155335,"KANSAS NEWMAN COLLEGE",1,0,1991,"6380","6.842018","46","71","82",61,21,15,"3",12,0.1967,0.1429,0.1829,0.8659
"3726",155335,"KANSAS NEWMAN COLLEGE",1,0,1992,"6636","8.340513","70","69","83",57,26,28,"8",20,0.3509,0.3077,0.3373,0.8313
"3727",155335,"KANSAS NEWMAN COLLEGE",1,0,1993,"7380","12.029615","71","78","98",72,26,20,"5",15,0.2083,0.1923,0.2041,0.7959
"3728",155335,"KANSAS NEWMAN COLLEGE",1,0,1995,"8100","15.092697","75","97","118",74,44,23,"6",17,0.2297,0.1364,0.1949,0.822
"3729",155335,"KANSAS NEWMAN COLLEGE",1,0,1996,"8500","15.942509","76","74","96",61,35,29,"10",19,0.3115,0.2857,0.3021,0.7708
"3730",155335,"KANSAS NEWMAN COLLEGE",1,0,1997,"9000","12.852073","82","75","89",50,39,22,"10",12,0.24,0.2564,0.2472,0.8427
"3731",155335,"NEWMAN UNIVERSITY",1,0,1998,"9000","13.783328","83","96","110",65,45,28,"8",20,0.3077,0.1778,0.2545,0.8727
"3732",155335,"NEWMAN UNIVERSITY",1,0,1999,"9000","15.32669","81","130","148",87,61,50,"18",32,0.3678,0.2951,0.3378,0.8784
"3733",155335,"NEWMAN UNIVERSITY",1,0,2000,"10148","15.072812","73","132","171",112,59,49,"14",35,0.3125,0.2373,0.2865,0.7719
"3734",155335,"NEWMAN UNIVERSITY",1,0,2001,"11060","15.363985","65","92","130",76,54,40,"18",22,0.2895,0.3333,0.3077,0.7077
"3735",155335,"NEWMAN UNIVERSITY",1,0,2002,"11890","15.385967","63","107","143",79,64,37,"17",20,0.2532,0.2656,0.2587,0.7483
"3736",155335,"NEWMAN UNIVERSITY",1,0,2003,"13198","15.56765","63","132","200",118,82,57,"19",38,0.322,0.2317,0.285,0.66
"3737",155335,"NEWMAN UNIVERSITY",1,0,2004,"14650","16.1474","71","114","216",112,104,43,"17",26,0.2321,0.1635,0.1991,0.5278
"3738",155335,"Newman University",1,0,2005,"15822","17.721843","79","112","181",84,97,31,"12",19,0.2262,0.1237,0.1713,0.6188
"3739",155335,"Newman University",1,0,2006,"17008","19.317763","70","109","167",96,71,48,"18",30,0.3125,0.2535,0.2874,0.6527
"3740",155335,"Newman University",1,0,2007,"17688","19.371616","75","94","133",72,61,44,"13",31,0.4306,0.2131,0.3308,0.7068
"3741",155335,"Newman University",1,0,2008,"18574","20.16326","80","84","115",74,41,36,"10",26,0.3514,0.2439,0.313,0.7304
"3742",155335,"Newman University",1,0,2009,"19200","21.752609","77","112","174",106,68,55,"16",39,0.3679,0.2353,0.3161,0.6437
"3743",155335,"Newman University",1,0,2010,"19872","21.481611","76","153","196",118,78,69,"23",46,0.3898,0.2949,0.352,0.7806
"3744",155399,"KANSAS STATE UNIVERSITY OF AGRICULTURE AND APP SCI",1,0,1991,"1699","247.234378","918","2467","2670",1322,1348,480,"158",322,0.2436,0.1172,0.1798,0.924
"3745",155399,"KANSAS STATE UNIVERSITY OF AGRICULTURE AND APP SCI",1,0,1992,"1841","261.053662","904","2525","2778",1357,1421,484,"189",295,0.2174,0.133,0.1742,0.9089
"3746",155399,"KANSAS STATE UNIVERSITY OF AGRICULTURE AND APP SCI",1,0,1993,"1975","254.699324","895","2503","2739",1356,1383,550,"203",347,0.2559,0.1468,0.2008,0.9138
"3747",155399,"KANSAS STATE UNIVERSITY OF AGRICULTURE AND APP SCI",1,0,1995,"2199","277.416388","831","2626","2877",1380,1497,558,"219",339,0.2457,0.1463,0.194,0.9128
"3748",155399,"KANSAS STATE UNIVERSITY OF AGRICULTURE AND APP SCI",1,0,1996,"2373","282.00088","808","2463","2681",1326,1355,583,"208",375,0.2828,0.1535,0.2175,0.9187
"3749",155399,"KANSAS STATE UNIVERSITY",1,0,1997,"2467","297.780919","862","2650","2906",1382,1524,640,"232",408,0.2952,0.1522,0.2202,0.9119
"3750",155399,"KANSAS STATE UNIVERSITY",1,0,1998,"2544","315.542898","876","2640","2921",1388,1533,755,"295",460,0.3314,0.1924,0.2585,0.9038
"3751",155399,"KANSAS STATE UNIVERSITY",1,0,1999,"2090","332.141542","876","2921","3280",1574,1706,723,"288",435,0.2764,0.1688,0.2204,0.8905
"3752",155399,"KANSAS STATE UNIVERSITY",1,0,2000,"2267","354.765504","866.5","3035","3399",1711,1688,829,"289",540,0.3156,0.1712,0.2439,0.8929
"3753",155399,"KANSAS STATE UNIVERSITY",1,0,2001,"2333","369.152274","857","2973","3358",1689,1669,836,"274",562,0.3327,0.1642,0.249,0.8853
"3754",155399,"KANSAS STATE UNIVERSITY",1,0,2002,"2918","410.004067","882","2988","3338",1652,1686,828,"278",550,0.3329,0.1649,0.2481,0.8951
"3755",155399,"KANSAS STATE UNIVERSITY",1,0,2003,"3510","435.585365","850","2794","3098",1529,1569,855,"303",552,0.361,0.1931,0.276,0.9019
"3756",155399,"KANSAS STATE UNIVERSITY",1,0,2004,"4110","453.235991","893","2869","3282",1691,1591,823,"270",553,0.327,0.1697,0.2508,0.8742
"3757",155399,"Kansas State University",1,0,2005,"4560","469.722218","888","2721","3105",1561,1544,697,"255",442,0.2832,0.1652,0.2245,0.8763
"3758",155399,"Kansas State University",1,0,2006,"4830","493.011367","921","2748","3140",1602,1538,832,"288",544,0.3396,0.1873,0.265,0.8752
"3759",155399,"Kansas State University",1,0,2007,"5625","508.912744","943","2826","3301",1629,1672,843,"290",553,0.3395,0.1734,0.2554,0.8561
"3760",155399,"Kansas State University",1,0,2008,"5954","552.415109","986","2850","3518",1780,1738,960,"339",621,0.3489,0.1951,0.2729,0.8101
"3761",155399,"Kansas State University",1,0,2009,"6186","615.479581","973","2748","3420",1686,1734,972,"343",629,0.3731,0.1978,0.2842,0.8035
"3762",155399,"Kansas State University",1,0,2010,"6672","613.684756","949","2884","3465",1753,1712,1068,"416",652,0.3719,0.243,0.3082,0.8323
"3763",155520,"MID-AMERICA NAZARENE COLLEGE",1,0,1991,"5250","11.660712","58","177","200",112,88,51,"15",36,0.3214,0.1705,0.255,0.885
"3764",155520,"MID-AMERICA NAZARENE COLLEGE",1,0,1992,"6006","13.490363","57","188","217",107,110,42,"16",26,0.243,0.1455,0.1935,0.8664
"3765",155520,"MID-AMERICA NAZARENE COLLEGE",1,0,1993,"6483","13.543164","61","184","212",97,115,36,"16",20,0.2062,0.1391,0.1698,0.8679
"3766",155520,"MIDAMERICA NAZARENE COLLEGE",1,0,1995,"7440","16.577501","64","216","246",124,122,62,"17",45,0.3629,0.1393,0.252,0.878
"3767",155520,"MIDAMERICA NAZARENE COLLEGE",1,0,1996,"8668","17.155921","67","214","230",129,101,70,"21",49,0.3798,0.2079,0.3043,0.9304
"3768",155520,"MIDAMERICA NAZARENE UNIVERSITY",1,0,1997,"9498","15.788627","67","234","256",140,116,107,"38",69,0.4929,0.3276,0.418,0.9141
"3769",155520,"MIDAMERICA NAZARENE UNIVERSITY",1,0,1998,"10122","18.177652","67","229","254",114,140,64,"27",37,0.3246,0.1929,0.252,0.9016
"3770",155520,"MIDAMERICA NAZARENE UNIVERSITY",1,0,1999,"9580","18.594657","72","189","205",111,94,71,"28",43,0.3874,0.2979,0.3463,0.922
"3771",155520,"MIDAMERICA NAZARENE UNIVERSITY",1,0,2000,"10150","19.910308","71.5","235","260",133,127,113,"39",74,0.5564,0.3071,0.4346,0.9038
"3772",155520,"MIDAMERICA NAZARENE UNIVERSITY",1,0,2001,"10650","20.486177","71","230","248",124,124,74,"20",54,0.4355,0.1613,0.2984,0.9274
"3773",155520,"MIDAMERICA NAZARENE UNIVERSITY",1,0,2002,"11270","21.369849","74","281","306",156,150,128,"46",82,0.5256,0.3067,0.4183,0.9183
"3774",155520,"MIDAMERICA NAZARENE UNIVERSITY",1,0,2003,"11910","21.274705","70","227","260",125,135,103,"41",62,0.496,0.3037,0.3962,0.8731
"3775",155520,"MIDAMERICA NAZARENE UNIVERSITY",1,0,2004,"12630","22.409184","73","212","249",117,132,84,"40",44,0.3761,0.303,0.3373,0.8514
"3776",155520,"MidAmerica Nazarene University",1,0,2005,"13754","23.631977","77","177","216",109,107,61,"21",40,0.367,0.1963,0.2824,0.8194
"3777",155520,"MidAmerica Nazarene University",1,0,2006,"14968","24.460514","79","218","239",118,121,82,"36",46,0.3898,0.2975,0.3431,0.9121
"3778",155520,"MidAmerica Nazarene University",1,0,2007,"16090","25.93795","82","186","217",109,108,89,"33",56,0.5138,0.3056,0.4101,0.8571
"3779",155520,"MidAmerica Nazarene University",1,0,2008,"17216","27.584193","80","177","208",114,94,69,"25",44,0.386,0.266,0.3317,0.851
"3780",155520,"MidAmerica Nazarene University",1,0,2009,"18146","28.084246","81","159","198",110,88,83,"29",54,0.4909,0.3295,0.4192,0.803
"3781",155520,"MidAmerica Nazarene University",1,0,2010,"19250","29.152407","86","185","232",120,112,100,"36",64,0.5333,0.3214,0.431,0.7974
"3782",155627,"OTTAWA UNIVERSITY",1,0,1991,"6450","12.131185","34","97","120",48,72,19,"11",8,0.1667,0.1528,0.1583,0.8083
"3783",155627,"OTTAWA UNIVERSITY",1,0,1992,"6900","12.293531","34","93","119",43,76,24,"9",15,0.3488,0.1184,0.2017,0.7815
"3784",155627,"OTTAWA UNIVERSITY",1,0,1993,"7250","14.087944","30","110","130",51,79,39,"16",23,0.451,0.2025,0.3,0.8462
"3785",155627,"OTTAWA UNIVERSITY",1,0,1995,"7960","17.050867","27","115","137",44,93,21,"9",12,0.2727,0.0968,0.1533,0.8394
"3786",155627,"OTTAWA UNIVERSITY",1,0,1996,"8350","13.178589","30","117","130",48,82,52,"23",29,0.6042,0.2805,0.4,0.9
"3787",155627,"OTTAWA UNIVERSITY",1,0,1997,"8850","10.978242","31","113","149",39,110,39,"23",16,0.4103,0.2091,0.2617,0.7584
"3788",155627,"OTTAWA UNIVERSITY",1,0,1998,"9560","8.876684","27","91","117",43,74,24,"10",14,0.3256,0.1351,0.2051,0.7778
"3789",155627,"OTTAWA UNIVERSITY",1,0,1999,"10040","9.537797","30","92","136",50,86,22,"10",12,0.24,0.1163,0.1618,0.6765
"3790",155627,"OTTAWA UNIVERSITY",1,0,2000,"10750","10.847627","25.5","84","111",40,71,30,"12",18,0.45,0.169,0.2703,0.7568
"3791",155627,"OTTAWA UNIVERSITY",1,0,2001,"11550","11.643659","21","104","132",46,86,35,"11",24,0.5217,0.1279,0.2652,0.7879
"3792",155627,"OTTAWA UNIVERSITY",1,0,2002,"12200","12.279011","18","76","112",35,77,32,"15",17,0.4857,0.1948,0.2857,0.6786
"3793",155627,"OTTAWA UNIVERSITY",1,0,2003,"12810","12.967018","24","86","114",47,67,28,"6",22,0.4681,0.0896,0.2456,0.7544
"3794",155627,"OTTAWA UNIVERSITY",1,0,2004,"13850","27.805493","22","65","79",30,49,23,"11",12,0.4,0.2245,0.2911,0.8228
"3795",155627,"Ottawa University",1,0,2005,"14500","26.497989","20","90","113",47,66,36,"19",17,0.3617,0.2879,0.3186,0.7965
"3796",155627,"Ottawa University",1,0,2006,"15500","27.254652","25","78","90",38,52,19,"6",13,0.3421,0.1154,0.2111,0.8667
"3797",155627,"Ottawa University",1,0,2007,"17000","31.240883","26","109","161",79,82,35,"11",24,0.3038,0.1341,0.2174,0.677
"3798",155627,"Ottawa University",1,0,2008,"18070","32.137006","28","121","201",100,101,40,"17",23,0.23,0.1683,0.199,0.602
"3799",155627,"Ottawa University",1,0,2009,"19100","33.802449","27","96","150",67,83,55,"30",25,0.3731,0.3614,0.3667,0.64
"3800",155627,"Ottawa University-Ottawa",1,0,2010,"20000","37.692145","27","101","156",66,90,37,"12",25,0.3788,0.1333,0.2372,0.6474
"3801",155937,"STERLING COLLEGE",1,0,1991,"6800","6.1265","30","108","131",55,76,42,"20",22,0.4,0.2632,0.3206,0.8244
"3802",155937,"STERLING COLLEGE",1,0,1992,"7230","7.559174","31","106","118",52,66,33,"9",24,0.4615,0.1364,0.2797,0.8983
"3803",155937,"STERLING COLLEGE",1,0,1993,"7890","7.62805","30","144","156",76,80,42,"18",24,0.3158,0.225,0.2692,0.9231
"3804",155937,"STERLING COLLEGE",1,0,1995,"8926","8.959795","32","98","120",63,57,42,"12",30,0.4762,0.2105,0.35,0.8167
"3805",155937,"STERLING COLLEGE",1,0,1996,"9596","7.88953","31","125","146",72,74,50,"18",32,0.4444,0.2432,0.3425,0.8562
"3806",155937,"STERLING COLLEGE",1,0,1997,"10076","8.27213","30","118","140",56,84,45,"21",24,0.4286,0.25,0.3214,0.8429
"3807",155937,"STERLING COLLEGE",1,0,1998,"10504","8.328619","31","141","161",81,80,52,"18",34,0.4198,0.225,0.323,0.8758
"3808",155937,"STERLING COLLEGE",1,0,1999,"11030","8.582381","31","106","110",63,47,61,"20",41,0.6508,0.4255,0.5545,0.9636
"3809",155937,"STERLING COLLEGE",1,0,2000,"11582","9.32931","32.5","109","126",60,66,47,"18",29,0.4833,0.2727,0.373,0.8651
"3810",155937,"STERLING COLLEGE",1,0,2001,"12100","10.0307","34","86","105",51,54,39,"16",23,0.451,0.2963,0.3714,0.819
"3811",155937,"STERLING COLLEGE",1,0,2002,"12750","11.840179","38","76","98",50,48,43,"14",29,0.58,0.2917,0.4388,0.7755
"3812",155937,"STERLING COLLEGE",1,0,2003,"13150","11.806273","34","92","124",57,67,44,"16",28,0.4912,0.2388,0.3548,0.7419
"3813",155937,"STERLING COLLEGE",1,0,2004,"13807","8.905472","37","110","136",52,84,36,"19",17,0.3269,0.2262,0.2647,0.8088
"3814",155937,"Sterling College",1,0,2005,"13806","11.775703","37","104","126",57,69,38,"16",22,0.386,0.2319,0.3016,0.8254
"3815",155937,"Sterling College",1,0,2006,"14300","9.845531","34","155","197",79,118,40,"10",30,0.3797,0.0847,0.203,0.7868
"3816",155937,"Sterling College",1,0,2007,"15500","10.780291","37","118","165",70,95,50,"25",25,0.3571,0.2632,0.303,0.7152
"3817",155937,"Sterling College",1,0,2008,"16500","11.283635","39","122","150",71,79,44,"15",29,0.4085,0.1899,0.2933,0.8133
"3818",155937,"Sterling College",1,0,2009,"18000","11.809942","41","143","182",82,100,49,"24",25,0.3049,0.24,0.2692,0.7857
"3819",155937,"Sterling College",1,0,2010,"19000","11.885103","44","120","149",70,79,50,"21",29,0.4143,0.2658,0.3356,0.8054
"3820",156213,"ASBURY COLLEGE",1,0,1991,"7350","13.596039","71","236","250",144,106,78,"31",47,0.3264,0.2925,0.312,0.944
"3821",156213,"ASBURY COLLEGE",1,0,1992,"7863","14.529325","72","259","268",165,103,95,"38",57,0.3455,0.3689,0.3545,0.9664
"3822",156213,"ASBURY COLLEGE",1,0,1993,"8322","15.276625","69","251","268",177,91,109,"36",73,0.4124,0.3956,0.4067,0.9366
"3823",156213,"ASBURY COLLEGE",1,0,1995,"9819","17.745554","80","286","298",180,118,140,"65",75,0.4167,0.5508,0.4698,0.9597
"3824",156213,"ASBURY COLLEGE",1,0,1996,"10595","19.383831","84","272","289",184,105,133,"50",83,0.4511,0.4762,0.4602,0.9412
"3825",156213,"ASBURY COLLEGE",1,0,1997,"11237","18.390554","86","343","365",223,142,179,"66",113,0.5067,0.4648,0.4904,0.9397
"3826",156213,"ASBURY COLLEGE",1,0,1998,"12020","20.466178","86","325","333",204,129,211,"82",129,0.6324,0.6357,0.6336,0.976
"3827",156213,"ASBURY COLLEGE",1,0,1999,"12810","23.19666","87","309","326",198,128,200,"76",124,0.6263,0.5938,0.6135,0.9479
"3828",156213,"ASBURY COLLEGE",1,0,2000,"13744","20.448385","89.5","294","304",180,124,166,"60",106,0.5889,0.4839,0.5461,0.9671
"3829",156213,"ASBURY COLLEGE",1,0,2001,"14624","22.553518","92","319","331",206,125,178,"66",112,0.5437,0.528,0.5378,0.9637
"3830",156213,"ASBURY COLLEGE",1,0,2002,"15574","24.367655","92","313","323",200,123,195,"80",115,0.575,0.6504,0.6037,0.969
"3831",156213,"ASBURY COLLEGE",1,0,2003,"16352","24.566635","90","249","258",146,112,148,"68",80,0.5479,0.6071,0.5736,0.9651
"3832",156213,"ASBURY COLLEGE",1,0,2004,"17660","24.291624","88","288","302",183,119,160,"68",92,0.5027,0.5714,0.5298,0.9536
"3833",156213,"Asbury College",1,0,2005,"18808","25.099515","86","259","276",173,103,168,"64",104,0.6012,0.6214,0.6087,0.9384
"3834",156213,"Asbury College",1,0,2006,"19260","25.882592","82","263","276",161,115,178,"67",111,0.6894,0.5826,0.6449,0.9529
"3835",156213,"Asbury College",1,0,2007,"21132","25.698084","79","293","311",173,138,175,"65",110,0.6358,0.471,0.5627,0.9421
"3836",156213,"Asbury College",1,0,2008,"22242","24.918434","80","283","313",208,105,173,"57",116,0.5577,0.5429,0.5527,0.9042
"3837",156213,"Asbury College",1,0,2009,"22242","27.377149","83","291","315",198,117,168,"64",104,0.5253,0.547,0.5333,0.9238
"3838",156213,"Asbury University",1,0,2010,"23132","28.286798","85","252","285",187,98,149,"51",98,0.5241,0.5204,0.5228,0.8842
"3839",156286,"BELLARMINE COLLEGE",1,0,1991,"7160","14.675487","80","250","267",157,110,122,"42",80,0.5096,0.3818,0.4569,0.9363
"3840",156286,"BELLARMINE COLLEGE",1,0,1992,"7580","16.749954","81","261","283",155,128,98,"40",58,0.3742,0.3125,0.3463,0.9223
"3841",156286,"BELLARMINE COLLEGE",1,0,1993,"8072","17.76216","84","291","309",172,137,135,"65",70,0.407,0.4745,0.4369,0.9417
"3842",156286,"BELLARMINE COLLEGE",1,0,1995,"9550","21.201807","91","312","329",189,140,151,"49",102,0.5397,0.35,0.459,0.9483
"3843",156286,"BELLARMINE COLLEGE",1,0,1996,"10320","22.223188","89","302","327",203,124,164,"57",107,0.5271,0.4597,0.5015,0.9235
"3844",156286,"BELLARMINE COLLEGE",1,0,1997,"10970","19.602275","86","302","318",178,140,155,"62",93,0.5225,0.4429,0.4874,0.9497
"3845",156286,"BELLARMINE COLLEGE",1,0,1998,"11770","20.305274","94","337","362",212,150,165,"61",104,0.4906,0.4067,0.4558,0.9309
"3846",156286,"BELLARMINE COLLEGE",1,0,1999,"12480","22.132471","103","304","324",223,101,182,"54",128,0.574,0.5347,0.5617,0.9383
"3847",156286,"BELLARMINE UNIVERSITY",1,0,2000,"13590","23.272934","106","325","355",224,131,172,"63",109,0.4866,0.4809,0.4845,0.9155
"3848",156286,"BELLARMINE UNIVERSITY",1,0,2001,"14990","24.737673","109","343","376",255,121,178,"47",131,0.5137,0.3884,0.4734,0.9122
"3849",156286,"BELLARMINE UNIVERSITY",1,0,2002,"16340","28.569291","115","292","325",214,111,165,"46",119,0.5561,0.4144,0.5077,0.8985
"3850",156286,"BELLARMINE UNIVERSITY",1,0,2003,"17820","30.748502","115","410","450",289,161,235,"79",156,0.5398,0.4907,0.5222,0.9111
"3851",156286,"BELLARMINE UNIVERSITY",1,0,2004,"19250","34.887828","118","374","407",271,136,225,"58",167,0.6162,0.4265,0.5528,0.9189
"3852",156286,"Bellarmine University",1,0,2005,"20800","35.754566","114","389","435",282,153,224,"69",155,0.5496,0.451,0.5149,0.8943
"3853",156286,"Bellarmine University",1,0,2006,"23300","37.318432","112","372","429",279,150,206,"60",146,0.5233,0.4,0.4802,0.8671
"3854",156286,"Bellarmine University",1,0,2007,"25200","40.216194","126","495","567",351,216,304,"97",207,0.5897,0.4491,0.5362,0.873
"3855",156286,"Bellarmine University",1,0,2008,"27000","44.4009","142","468","567",356,211,301,"109",192,0.5393,0.5166,0.5309,0.8254
"3856",156286,"Bellarmine University",1,0,2009,"27800","51.444673","138","524","600",383,217,303,"98",205,0.5352,0.4516,0.505,0.8733
"3857",156286,"Bellarmine University",1,0,2010,"29160","51.624417","138","470","573",362,211,301,"107",194,0.5359,0.5071,0.5253,0.8202
"3858",156295,"BEREA COLLEGE",1,0,1991,"177","44.126906","113","359","436",246,190,147,"58",89,0.3618,0.3053,0.3372,0.8234
"3859",156295,"BEREA COLLEGE",1,0,1992,"183","47.016541","111","324","397",206,191,148,"66",82,0.3981,0.3455,0.3728,0.8161
"3860",156295,"BEREA COLLEGE",1,0,1993,"183","49.505608","112","382","453",230,223,150,"78",72,0.313,0.3498,0.3311,0.8433
"3861",156295,"BEREA COLLEGE",1,0,1995,"188","50.554283","113","347","416",220,196,146,"64",82,0.3727,0.3265,0.351,0.8341
"3862",156295,"BEREA COLLEGE",1,0,1996,"195","54.076274","116","313","396",225,171,125,"53",72,0.32,0.3099,0.3157,0.7904
"3863",156295,"BEREA COLLEGE",1,0,1997,"195","45.557025","118","321","404",239,165,118,"36",82,0.3431,0.2182,0.2921,0.7946
"3864",156295,"BEREA COLLEGE",1,0,1998,"195","47.598812","118","312","414",237,177,161,"70",91,0.384,0.3955,0.3889,0.7536
"3865",156295,"BEREA COLLEGE",1,0,1999,"0","50.297586","122","313","423",233,190,150,"57",93,0.3991,0.3,0.3546,0.74
"3866",156295,"BEREA COLLEGE",1,0,2000,"0","49.725071","126.5","315","421",245,176,169,"60",109,0.4449,0.3409,0.4014,0.7482
"3867",156295,"BEREA COLLEGE",1,0,2001,"0","55.712873","131","314","424",241,183,192,"76",116,0.4813,0.4153,0.4528,0.7406
"3868",156295,"BEREA COLLEGE",1,0,2002,"0","60.827565","134","240","356",206,150,158,"61",97,0.4709,0.4067,0.4438,0.6742
"3869",156295,"BEREA COLLEGE",1,0,2003,"0","63.829436","130","284","396",240,156,203,"83",120,0.5,0.5321,0.5126,0.7172
"3870",156295,"BEREA COLLEGE",1,0,2004,"0","55.426358","134","265","400",209,191,201,"84",117,0.5598,0.4398,0.5025,0.6625
"3871",156295,"Berea College",1,0,2005,"0","62.54145","136","261","378",219,159,161,"67",94,0.4292,0.4214,0.4259,0.6905
"3872",156295,"Berea College",1,0,2006,"0","63.888149","133","266","388",220,168,185,"78",107,0.4864,0.4643,0.4768,0.6856
"3873",156295,"Berea College",1,0,2007,"0","66.081142","132","296","420",252,168,197,"72",125,0.496,0.4286,0.469,0.7048
"3874",156295,"Berea College",1,0,2008,"0","67.964732","144","289","413",241,172,184,"72",112,0.4647,0.4186,0.4455,0.6998
"3875",156295,"Berea College",1,0,2009,"0","69.161495","137","266","391",221,170,174,"74",100,0.4525,0.4353,0.445,0.6803
"3876",156295,"Berea College",1,0,2010,"0","70.533608","123","300","429",230,199,204,"72",132,0.5739,0.3618,0.4755,0.6993
"3877",156365,"CAMPBELLSVILLE COLLEGE",1,0,1991,"4900","8.298343","43","236","255",122,133,29,"6",23,0.1885,0.0451,0.1137,0.9255
"3878",156365,"CAMPBELLSVILLE COLLEGE",1,0,1992,"5400","9.746423","45","189","208",85,123,27,"9",18,0.2118,0.0732,0.1298,0.9087
"3879",156365,"CAMPBELLSVILLE COLLEGE",1,0,1993,"5720","10.506148","46","255","286",122,164,48,"19",29,0.2377,0.1159,0.1678,0.8916
"3880",156365,"CAMPBELLSVILLE UNIVERSITY",1,0,1995,"6420","12.962407","53","301","322",156,166,84,"34",50,0.3205,0.2048,0.2609,0.9348
"3881",156365,"CAMPBELLSVILLE UNIVERSITY",1,0,1996,"6800","14.460531","60","271","295",151,144,66,"21",45,0.298,0.1458,0.2237,0.9186
"3882",156365,"CAMPBELLSVILLE UNIVERSITY",1,0,1997,"7200","10.719324","60","310","342",182,160,93,"32",61,0.3352,0.2,0.2719,0.9064
"3883",156365,"CAMPBELLSVILLE UNIVERSITY",1,0,1998,"7400","11.806168","66","311","359",194,165,82,"25",57,0.2938,0.1515,0.2284,0.8663
"3884",156365,"CAMPBELLSVILLE UNIVERSITY",1,0,1999,"8000","13.75425","68","260","290",155,135,77,"31",46,0.2968,0.2296,0.2655,0.8966
"3885",156365,"CAMPBELLSVILLE UNIVERSITY",1,0,2000,"8790","14.114831","69","289","317",167,150,88,"25",63,0.3772,0.1667,0.2776,0.9117
"3886",156365,"CAMPBELLSVILLE UNIVERSITY",1,0,2001,"9800","15.930861","70","306","330",175,155,58,"24",34,0.1943,0.1548,0.1758,0.9273
"3887",156365,"CAMPBELLSVILLE UNIVERSITY",1,0,2002,"11160","17.722591","70","261","288",138,150,61,"18",43,0.3116,0.12,0.2118,0.9062
"3888",156365,"CAMPBELLSVILLE UNIVERSITY",1,0,2003,"12504","19.557506","73","299","351",162,189,86,"37",49,0.3025,0.1958,0.245,0.8519
"3889",156365,"CAMPBELLSVILLE UNIVERSITY",1,0,2004,"13632","20.166983","82","335","381",178,203,102,"39",63,0.3539,0.1921,0.2677,0.8793
"3890",156365,"Campbellsville University",1,0,2005,"15140","23.497399","86","298","345",174,171,83,"29",54,0.3103,0.1696,0.2406,0.8638
"3891",156365,"Campbellsville University",1,0,2006,"15960","23.531093","91","294","346",182,164,81,"32",49,0.2692,0.1951,0.2341,0.8497
"3892",156365,"Campbellsville University",1,0,2007,"16880","24.195419","98","295","377",168,209,98,"47",51,0.3036,0.2249,0.2599,0.7825
"3893",156365,"Campbellsville University",1,0,2008,"17700","26.988467","105","327","442",192,250,112,"56",56,0.2917,0.224,0.2534,0.7398
"3894",156365,"Campbellsville University",1,0,2009,"18410","29.333511","115","403","515",260,255,127,"44",83,0.3192,0.1725,0.2466,0.7825
"3895",156365,"Campbellsville University",1,0,2010,"19310","32.483261","128","374","502",247,255,122,"46",76,0.3077,0.1804,0.243,0.745
"3896",156541,"CUMBERLAND COLLEGE",1,0,1991,"5296","19.700219","108","414","460",240,220,77,"29",48,0.2,0.1318,0.1674,0.9
"3897",156541,"CUMBERLAND COLLEGE",1,0,1992,"5880","20.90336","99","305","332",185,147,97,"36",61,0.3297,0.2449,0.2922,0.9187
"3898",156541,"CUMBERLAND COLLEGE",1,0,1993,"6230","19.31687","97","372","397",205,192,80,"24",56,0.2732,0.125,0.2015,0.937
"3899",156541,"CUMBERLAND COLLEGE",1,0,1995,"7130","21.375136","87","355","377",204,173,107,"33",74,0.3627,0.1908,0.2838,0.9416
"3900",156541,"CUMBERLAND COLLEGE",1,0,1996,"7930","22.056684","90","400","421",210,211,95,"40",55,0.2619,0.1896,0.2257,0.9501
"3901",156541,"CUMBERLAND COLLEGE",1,0,1997,"8430","19.419014","88","391","418",227,191,87,"30",57,0.2511,0.1571,0.2081,0.9354
"3902",156541,"CUMBERLAND COLLEGE",1,0,1998,"8980","22.695101","95","375","412",177,235,87,"30",57,0.322,0.1277,0.2112,0.9102
"3903",156541,"CUMBERLAND COLLEGE",1,0,1999,"9298","22.645095","98","382","403",201,202,114,"41",73,0.3632,0.203,0.2829,0.9479
"3904",156541,"CUMBERLAND COLLEGE",1,0,2000,"9698","23.835885","98","376","403",195,208,82,"37",45,0.2308,0.1779,0.2035,0.933
"3905",156541,"CUMBERLAND COLLEGE",1,0,2001,"10000","26.565784","98","364","406",203,203,93,"33",60,0.2956,0.1626,0.2291,0.8966
"3906",156541,"CUMBERLAND COLLEGE",1,0,2002,"10598","28.416419","98","348","386",209,177,93,"31",62,0.2967,0.1751,0.2409,0.9016
"3907",156541,"CUMBERLAND COLLEGE",1,0,2003,"11098","29.731639","93","354","401",191,210,98,"33",65,0.3403,0.1571,0.2444,0.8828
"3908",156541,"CUMBERLAND COLLEGE",1,0,2004,"11498","25.881129","89","368","418",190,228,104,"36",68,0.3579,0.1579,0.2488,0.8804
"3909",156541,"University of the Cumberlands",1,0,2005,"12298","25.670018","86","369","424",192,232,111,"48",63,0.3281,0.2069,0.2618,0.8703
"3910",156541,"University of the Cumberlands",1,0,2006,"13298","26.894106","93","300","349",177,172,99,"34",65,0.3672,0.1977,0.2837,0.8596
"3911",156541,"University of the Cumberlands",1,0,2007,"13298","28.08375","86","399","481",217,264,115,"45",70,0.3226,0.1705,0.2391,0.8295
"3912",156541,"University of the Cumberlands",1,0,2008,"14298","29.858806","94","349","478",223,255,120,"38",82,0.3677,0.149,0.251,0.7301
"3913",156541,"University of the Cumberlands",1,0,2009,"15298","33.163705","99","388","453",211,242,107,"31",76,0.3602,0.1281,0.2362,0.8565
"3914",156541,"University of the Cumberlands",1,0,2010,"16664","33.551865","105","369","446",202,244,144,"66",78,0.3861,0.2705,0.3229,0.8274
"3915",156745,"GEORGETOWN COLLEGE",1,0,1991,"6250","16.692108","68","297","309",161,148,103,"38",65,0.4037,0.2568,0.3333,0.9612
"3916",156745,"GEORGETOWN COLLEGE",1,0,1992,"6760","18.18444","69","318","325",174,151,109,"37",72,0.4138,0.245,0.3354,0.9785
"3917",156745,"GEORGETOWN COLLEGE",1,0,1993,"7300","18.60509","69","265","285",153,132,79,"20",59,0.3856,0.1515,0.2772,0.9298
"3918",156745,"GEORGETOWN COLLEGE",1,0,1995,"8840","20.1658","73","294","304",201,103,134,"30",104,0.5174,0.2913,0.4408,0.9671
"3919",156745,"GEORGETOWN COLLEGE",1,0,1996,"9540","21.707519","76","317","326",193,133,131,"41",90,0.4663,0.3083,0.4018,0.9724
"3920",156745,"GEORGETOWN COLLEGE",1,0,1997,"10190","19.005835","81","385","394",239,155,208,"59",149,0.6234,0.3806,0.5279,0.9772
"3921",156745,"GEORGETOWN COLLEGE",1,0,1998,"10800","25.225964","86","395","408",224,184,194,"61",133,0.5938,0.3315,0.4755,0.9681
"3922",156745,"GEORGETOWN COLLEGE",1,0,1999,"11350","29.741671","87","333","340",205,135,158,"51",107,0.522,0.3778,0.4647,0.9794
"3923",156745,"GEORGETOWN COLLEGE",1,0,2000,"12140","30.607947","89.5","319","331",189,142,158,"49",109,0.5767,0.3451,0.4773,0.9637
"3924",156745,"GEORGETOWN COLLEGE",1,0,2001,"13200","30.35936","92","345","356",203,153,173,"69",104,0.5123,0.451,0.486,0.9691
"3925",156745,"GEORGETOWN COLLEGE",1,0,2002,"14260","31.542614","92","312","328",199,129,150,"53",97,0.4874,0.4109,0.4573,0.9512
"3926",156745,"GEORGETOWN COLLEGE",1,0,2003,"15690","31.496544","87","349","368",213,155,181,"54",127,0.5962,0.3484,0.4918,0.9484
"3927",156745,"GEORGETOWN COLLEGE",1,0,2004,"17750","30.5248","101","332","354",192,162,205,"73",132,0.6875,0.4506,0.5791,0.9379
"3928",156745,"Georgetown College",1,0,2005,"19170","31.705048","101","394","416",216,200,209,"83",126,0.5833,0.415,0.5024,0.9471
"3929",156745,"Georgetown College",1,0,2006,"20700","35.051907","106","346","363",226,137,185,"53",132,0.5841,0.3869,0.5096,0.9532
"3930",156745,"Georgetown College",1,0,2007,"22360","36.36715","111","289","366",206,160,180,"59",121,0.5874,0.3688,0.4918,0.7896
"3931",156745,"Georgetown College",1,0,2008,"24150","37.674084","111","334","379",209,170,169,"61",108,0.5167,0.3588,0.4459,0.8813
"3932",156745,"Georgetown College",1,0,2009,"26080","37.534603","110","342","378",211,167,186,"63",123,0.5829,0.3772,0.4921,0.9048
"3933",156745,"Georgetown College",1,0,2010,"27640","37.421793","113","297","336",191,145,172,"57",115,0.6021,0.3931,0.5119,0.8839
"3934",157058,"KENTUCKY STATE UNIVERSITY",1,0,1991,"1332","30.873233","124","122","390",215,175,33,"9",24,0.1116,0.0514,0.0846,0.3128
"3935",157058,"KENTUCKY STATE UNIVERSITY",1,0,1992,"1440","35.280678","124","90","393",226,167,16,"4",12,0.0531,0.024,0.0407,0.229
"3936",157058,"KENTUCKY STATE UNIVERSITY",1,0,1993,"1600","34.655725","122","101","335",163,172,18,"7",11,0.0675,0.0407,0.0537,0.3015
"3937",157058,"KENTUCKY STATE UNIVERSITY",1,0,1995,"1860","39.179304","127","96","370",189,181,13,"10",3,0.0159,0.0552,0.0351,0.2595
"3938",157058,"KENTUCKY STATE UNIVERSITY",1,0,1996,"1950","40.21692","123","74","364",163,201,27,"7",20,0.1227,0.0348,0.0742,0.2033
"3939",157058,"KENTUCKY STATE UNIVERSITY",1,0,1997,"2050","41.728527","121","65","302",172,130,33,"5",28,0.1628,0.0385,0.1093,0.2152
"3940",157058,"KENTUCKY STATE UNIVERSITY",1,0,1998,"2170","42.200489","125","87","379",215,164,34,"9",25,0.1163,0.0549,0.0897,0.2296
"3941",157058,"KENTUCKY STATE UNIVERSITY",1,0,1999,"2020","43.484197","126","61","366",186,180,40,"8",32,0.172,0.0444,0.1093,0.1667
"3942",157058,"KENTUCKY STATE UNIVERSITY",1,0,2000,"2100","47.460932","146.5","64","340",171,169,49,"17",32,0.1871,0.1006,0.1441,0.1882
"3943",157058,"KENTUCKY STATE UNIVERSITY",1,0,2001,"2100","55.256096","167","57","387",199,188,31,"4",27,0.1357,0.0213,0.0801,0.1473
"3944",157058,"KENTUCKY STATE UNIVERSITY",1,0,2002,"2630","49.201089","136","50","373",203,170,34,"6",28,0.1379,0.0353,0.0912,0.134
"3945",157058,"KENTUCKY STATE UNIVERSITY",1,0,2003,"2828","52.335736","148","62","309",162,147,23,"9",14,0.0864,0.0612,0.0744,0.2006
"3946",157058,"KENTUCKY STATE UNIVERSITY",1,0,2004,"3110","55.811436","152","66","346",196,150,37,"8",29,0.148,0.0533,0.1069,0.1908
"3947",157058,"Kentucky State University",1,0,2005,"3550","55.187466","152","60","408",223,185,17,"4",13,0.0583,0.0216,0.0417,0.1471
"3948",157058,"Kentucky State University",1,0,2006,"3900","56.374945","129","64","569",277,292,21,"6",15,0.0542,0.0205,0.0369,0.1125
"3949",157058,"Kentucky State University",1,0,2007,"4270","56.14357","139","62","602",343,259,39,"5",34,0.0991,0.0193,0.0648,0.103
"3950",157058,"Kentucky State University",1,0,2008,"4942","61.301794","131","58","566",293,273,32,"7",25,0.0853,0.0256,0.0565,0.1025
"3951",157058,"Kentucky State University",1,0,2009,"5086","66.473069","128","53","476",265,211,24,"7",17,0.0642,0.0332,0.0504,0.1113
"3952",157058,"Kentucky State University",1,0,2010,"4920","67.637596","129","47","569",316,253,25,"8",17,0.0538,0.0316,0.0439,0.0826
"3953",157076,"KENTUCKY WESLEYAN COLLEGE",1,0,1991,"6690","8.923084","50","180","204",75,129,48,"24",24,0.32,0.186,0.2353,0.8824
"3954",157076,"KENTUCKY WESLEYAN COLLEGE",1,0,1992,"7170","9.866435","50","138","147",71,76,41,"13",28,0.3944,0.1711,0.2789,0.9388
"3955",157076,"KENTUCKY WESLEYAN COLLEGE",1,0,1993,"7600","9.733433","51","161","173",79,94,41,"17",24,0.3038,0.1809,0.237,0.9306
"3956",157076,"KENTUCKY WESLEYAN COLLEGE",1,0,1995,"9100","11.467393","48","147","151",79,72,49,"17",32,0.4051,0.2361,0.3245,0.9735
"3957",157076,"KENTUCKY WESLEYAN COLLEGE",1,0,1996,"9100","10.35158","47","169","179",103,76,44,"22",22,0.2136,0.2895,0.2458,0.9441
"3958",157076,"KENTUCKY WESLEYAN COLLEGE",1,0,1997,"9220","8.105355","43","191","203",131,72,84,"27",57,0.4351,0.375,0.4138,0.9409
"3959",157076,"KENTUCKY WESLEYAN COLLEGE",1,0,1998,"9730","8.75346","43","140","152",95,57,53,"18",35,0.3684,0.3158,0.3487,0.9211
"3960",157076,"KENTUCKY WESLEYAN COLLEGE",1,0,1999,"9770","8.679707","41","183","191",102,89,51,"18",33,0.3235,0.2022,0.267,0.9581
"3961",157076,"KENTUCKY WESLEYAN COLLEGE",1,0,2000,"10070","9.668138","42","150","159",75,84,37,"12",25,0.3333,0.1429,0.2327,0.9434
"3962",157076,"KENTUCKY WESLEYAN COLLEGE",1,0,2001,"10570","10.433776","43","145","164",60,104,24,"8",16,0.2667,0.0769,0.1463,0.8841
"3963",157076,"KENTUCKY WESLEYAN COLLEGE",1,0,2002,"11100","8.791903","39","123","150",77,73,44,"13",31,0.4026,0.1781,0.2933,0.82
"3964",157076,"KENTUCKY WESLEYAN COLLEGE",1,0,2003,"11700","10.084945","34","145","165",91,74,58,"19",39,0.4286,0.2568,0.3515,0.8788
"3965",157076,"KENTUCKY WESLEYAN COLLEGE",1,0,2004,"12160","10.384625","34","164","210",93,117,64,"25",39,0.4194,0.2137,0.3048,0.781
"3966",157076,"Kentucky Wesleyan College",1,0,2005,"12590","10.37749","34","160","209",100,109,67,"22",45,0.45,0.2018,0.3206,0.7656
"3967",157076,"Kentucky Wesleyan College",1,0,2006,"13200","11.713939","40","256","326",127,199,82,"41",41,0.3228,0.206,0.2515,0.7853
"3968",157076,"Kentucky Wesleyan College",1,0,2007,"14100","13.762693","42","221","280",120,160,69,"27",42,0.35,0.1688,0.2464,0.7893
"3969",157076,"Kentucky Wesleyan College",1,0,2008,"15500","14.538574","45","171","219",103,116,81,"44",37,0.3592,0.3793,0.3699,0.7808
"3970",157076,"Kentucky Wesleyan College",1,0,2009,"16870","14.847492","43","156","227",118,109,79,"30",49,0.4153,0.2752,0.348,0.6872
"3971",157076,"Kentucky Wesleyan College",1,0,2010,"17980","13.998616","41","148","202",96,106,64,"26",38,0.3958,0.2453,0.3168,0.7327
"3972",157085,"UNIVERSITY OF KENTUCKY",1,0,1991,"1844","632.036282","1223","2500","2817",1434,1383,389,"138",251,0.175,0.0998,0.1381,0.8875
"3973",157085,"UNIVERSITY OF KENTUCKY",1,0,1992,"1998","686.842082","1200","2280","2562",1374,1188,528,"195",333,0.2424,0.1641,0.2061,0.8899
"3974",157085,"UNIVERSITY OF KENTUCKY",1,0,1993,"2278","689.77493","1200","2341","2662",1391,1271,599,"210",389,0.2797,0.1652,0.225,0.8794
"3975",157085,"UNIVERSITY OF KENTUCKY",1,0,1995,"2594","763.774796","1238","2306","2612",1383,1229,620,"235",385,0.2784,0.1912,0.2374,0.8828
"3976",157085,"UNIVERSITY OF KENTUCKY",1,0,1996,"2676","825.834782","1239","2329","2640",1459,1181,720,"253",467,0.3201,0.2142,0.2727,0.8822
"3977",157085,"UNIVERSITY OF KENTUCKY",1,0,1997,"2736","944.743298","1222","2408","2740",1499,1241,743,"281",462,0.3082,0.2264,0.2712,0.8788
"3978",157085,"UNIVERSITY OF KENTUCKY",1,0,1998,"3016","968.51539","1228","2595","2931",1548,1383,815,"331",484,0.3127,0.2393,0.2781,0.8854
"3979",157085,"UNIVERSITY OF KENTUCKY",1,0,1999,"2960","994.07189","1239","2468","2742",1499,1243,792,"293",499,0.3329,0.2357,0.2888,0.9001
"3980",157085,"UNIVERSITY OF KENTUCKY",1,0,2000,"3110","1099.255061","1202","2640","2971",1590,1381,884,"333",551,0.3465,0.2411,0.2975,0.8886
"3981",157085,"UNIVERSITY OF KENTUCKY",1,0,2001,"3270","1162.072272","1165","2852","3129",1679,1450,942,"374",568,0.3383,0.2579,0.3011,0.9115
"3982",157085,"UNIVERSITY OF KENTUCKY",1,0,2002,"3480","1173.388138","1202","3347","3701",1999,1702,1045,"362",683,0.3417,0.2127,0.2824,0.9044
"3983",157085,"UNIVERSITY OF KENTUCKY",1,0,2003,"4002","1225.735548","1209","3289","3678",1951,1727,1160,"460",700,0.3588,0.2664,0.3154,0.8942
"3984",157085,"UNIVERSITY OF KENTUCKY",1,0,2004,"4602","1376.644996","1198","3464","3935",2097,1838,1276,"486",790,0.3767,0.2644,0.3243,0.8803
"3985",157085,"University of Kentucky",1,0,2005,"5162","1487.991918","1211","3437","3824",2045,1779,1291,"502",789,0.3858,0.2822,0.3376,0.8988
"3986",157085,"University of Kentucky",1,0,2006,"5782","1646.220429","1233","3517","4113",2201,1912,1253,"443",810,0.368,0.2317,0.3046,0.8551
"3987",157085,"University of Kentucky",1,0,2007,"6302","1831.421509","1251","3271","3826",2006,1820,1276,"498",778,0.3878,0.2736,0.3335,0.8549
"3988",157085,"University of Kentucky",1,0,2008,"6870","1930.755477","1245","3391","4074",2086,1988,1323,"513",810,0.3883,0.258,0.3247,0.8324
"3989",157085,"University of Kentucky",1,0,2009,"7214","2045.197261","1276","3368","4105",2102,2003,1438,"551",887,0.422,0.2751,0.3503,0.8205
"3990",157085,"University of Kentucky",1,0,2010,"7656","2135.513798","1313","3376","4270",2203,2067,1625,"615",1010,0.4585,0.2975,0.3806,0.7906
"3991",157289,"UNIVERSITY OF LOUISVILLE",1,0,1991,"1740","308.133","676","1701","2050",1007,1043,105,"28",77,0.0765,0.0268,0.0512,0.8298
"3992",157289,"UNIVERSITY OF LOUISVILLE",1,0,1992,"1880","316.007181","681","1404","1745",843,902,133,"45",88,0.1044,0.0499,0.0762,0.8046
"3993",157289,"UNIVERSITY OF LOUISVILLE",1,0,1993,"2170","317.523","674","1384","1743",858,885,157,"57",100,0.1166,0.0644,0.0901,0.794
"3994",157289,"UNIVERSITY OF LOUISVILLE",1,0,1995,"2470","324.474","672","1451","1835",903,932,193,"69",124,0.1373,0.074,0.1052,0.7907
"3995",157289,"UNIVERSITY OF LOUISVILLE",1,0,1996,"2570","381.565","691","1463","1861",950,911,197,"69",128,0.1347,0.0757,0.1059,0.7861
"3996",157289,"UNIVERSITY OF LOUISVILLE",1,0,1997,"2630","398.975","704","1528","1931",1024,907,241,"86",155,0.1514,0.0948,0.1248,0.7913
"3997",157289,"UNIVERSITY OF LOUISVILLE",1,0,1998,"2920","426.697","703","1662","2032",1011,1021,222,"81",141,0.1395,0.0793,0.1093,0.8179
"3998",157289,"UNIVERSITY OF LOUISVILLE",1,0,1999,"2960","435.904","756","1838","2297",1232,1065,289,"90",199,0.1615,0.0845,0.1258,0.8002
"3999",157289,"UNIVERSITY OF LOUISVILLE",1,0,2000,"3149","472.684","738","1802","2249",1162,1087,321,"113",208,0.179,0.104,0.1427,0.8012
"4000",157289,"UNIVERSITY OF LOUISVILLE",1,0,2001,"3794","507.879","720","1786","2209",1150,1059,351,"137",214,0.1861,0.1294,0.1589,0.8085
"4001",157289,"UNIVERSITY OF LOUISVILLE",1,0,2002,"4082","497.31","726","1773","2209",1153,1056,428,"157",271,0.235,0.1487,0.1938,0.8026
"4002",157289,"UNIVERSITY OF LOUISVILLE",1,0,2003,"4450","520.618","780","1789","2197",1118,1079,468,"173",295,0.2639,0.1603,0.213,0.8143
"4003",157289,"UNIVERSITY OF LOUISVILLE",1,0,2004,"5040","559.08","796","1867","2303",1197,1106,489,"164",325,0.2715,0.1483,0.2123,0.8107
"4004",157289,"University of Louisville",1,0,2005,"5532","592.81","802","1799","2255",1144,1111,497,"205",292,0.2552,0.1845,0.2204,0.7978
"4005",157289,"University of Louisville",1,0,2006,"6252","633.497","829","1916","2380",1230,1150,628,"257",371,0.3016,0.2235,0.2639,0.805
"4006",157289,"University of Louisville",1,0,2007,"6940","688.009","861","2033","2525",1314,1211,634,"262",372,0.2831,0.2164,0.2511,0.8051
"4007",157289,"University of Louisville",1,0,2008,"7564","746.516","862","2076","2548",1344,1204,915,"391",524,0.3899,0.3248,0.3591,0.8148
"4008",157289,"University of Louisville",1,0,2009,"7944","759.036","867","1943","2441",1273,1168,622,"270",352,0.2765,0.2312,0.2548,0.796
"4009",157289,"University of Louisville",1,0,2010,"8424","788.836","894","1955","2507",1266,1241,696,"308",388,0.3065,0.2482,0.2776,0.7798
"4010",157386,"MOREHEAD STATE UNIVERSITY",1,0,1991,"1510","66.258056","346","1197","1261",674,587,99,"32",67,0.0994,0.0545,0.0785,0.9492
"4011",157386,"MOREHEAD STATE UNIVERSITY",1,0,1992,"1630","72.293403","328","1260","1349",769,580,133,"39",94,0.1222,0.0672,0.0986,0.934
"4012",157386,"MOREHEAD STATE UNIVERSITY",1,0,1993,"1800","70.428174","336","1201","1266",706,560,143,"41",102,0.1445,0.0732,0.113,0.9487
"4013",157386,"MOREHEAD STATE UNIVERSITY",1,0,1995,"2000","77.995871","337","1069","1119",646,473,104,"7",97,0.1502,0.0148,0.0929,0.9553
"4014",157386,"MOREHEAD STATE UNIVERSITY",1,0,1996,"2090","79.584309","326","1176","1271",687,584,157,"55",102,0.1485,0.0942,0.1235,0.9253
"4015",157386,"MOREHEAD STATE UNIVERSITY",1,0,1997,"2150","79.55202","317","1134","1227",674,553,160,"55",105,0.1558,0.0995,0.1304,0.9242
"4016",157386,"MOREHEAD STATE UNIVERSITY",1,0,1998,"2270","84.733204","321","1255","1369",739,630,157,"48",109,0.1475,0.0762,0.1147,0.9167
"4017",157386,"MOREHEAD STATE UNIVERSITY",1,0,1999,"2020","87.28027","320","1242","1325",756,569,156,"55",101,0.1336,0.0967,0.1177,0.9374
"4018",157386,"MOREHEAD STATE UNIVERSITY",1,0,2000,"2510","89.88705","330","1397","1473",849,624,181,"59",122,0.1437,0.0946,0.1229,0.9484
"4019",157386,"MOREHEAD STATE UNIVERSITY",1,0,2001,"2710","99.231281","340","1482","1588",894,694,185,"66",119,0.1331,0.0951,0.1165,0.9332
"4020",157386,"MOREHEAD STATE UNIVERSITY",1,0,2002,"2926","99.184298","353","1461","1563",882,681,172,"59",113,0.1281,0.0866,0.11,0.9347
"4021",157386,"MOREHEAD STATE UNIVERSITY",1,0,2003,"3364","104.490255","361","1462","1555",867,688,185,"60",125,0.1442,0.0872,0.119,0.9402
"4022",157386,"MOREHEAD STATE UNIVERSITY",1,0,2004,"3840","111.150836","358","1223","1307",737,570,125,"39",86,0.1167,0.0684,0.0956,0.9357
"4023",157386,"Morehead State University",1,0,2005,"4320","113.934298","378","1205","1310",745,565,162,"55",107,0.1436,0.0973,0.1237,0.9198
"4024",157386,"Morehead State University",1,0,2006,"4870","119.287006","384","1236","1330",741,589,201,"65",136,0.1835,0.1104,0.1511,0.9293
"4025",157386,"Morehead State University",1,0,2007,"5280","121.52127","379","1347","1445",803,642,257,"87",170,0.2117,0.1355,0.1779,0.9322
"4026",157386,"Morehead State University",1,0,2008,"5400","136.089464","369","1210","1313",777,536,235,"78",157,0.2021,0.1455,0.179,0.9216
"4027",157386,"Morehead State University",1,0,2009,"6036","138.253157","370","1143","1240",708,532,231,"74",157,0.2218,0.1391,0.1863,0.9218
"4028",157386,"Morehead State University",1,0,2010,"6492","143.067085","374","1072","1175",662,513,294,"118",176,0.2659,0.23,0.2502,0.9123
"4029",157401,"MURRAY STATE UNIVERSITY",1,0,1991,"1410","75.364999","363","1056","1147",633,514,120,"34",86,0.1359,0.0661,0.1046,0.9207
"4030",157401,"MURRAY STATE UNIVERSITY",1,0,1992,"1600","77.582227","337","911","982",538,444,223,"76",147,0.2732,0.1712,0.2271,0.9277
"4031",157401,"MURRAY STATE UNIVERSITY",1,0,1993,"1780","75.618444","336","861","946",510,436,228,"77",151,0.2961,0.1766,0.241,0.9101
"4032",157401,"MURRAY STATE UNIVERSITY",1,0,1995,"1960","82.135863","338","1095","1201",661,540,262,"82",180,0.2723,0.1519,0.2182,0.9117
"4033",157401,"MURRAY STATE UNIVERSITY",1,0,1996,"2060","89.468447","347","1242","1366",749,617,339,"105",234,0.3124,0.1702,0.2482,0.9092
"4034",157401,"MURRAY STATE UNIVERSITY",1,0,1997,"2120","97.930532","355","1087","1206",691,515,184,"51",133,0.1925,0.099,0.1526,0.9013
"4035",157401,"MURRAY STATE UNIVERSITY",1,0,1998,"2300","97.67807","369","1133","1275",707,568,341,"122",219,0.3098,0.2148,0.2675,0.8886
"4036",157401,"MURRAY STATE UNIVERSITY",1,0,1999,"2020","108.057766","371","1051","1177",666,511,345,"114",231,0.3468,0.2231,0.2931,0.8929
"4037",157401,"MURRAY STATE UNIVERSITY",1,0,2000,"2172","109.577946","373.5","1070","1210",730,480,348,"108",240,0.3288,0.225,0.2876,0.8843
"4038",157401,"MURRAY STATE UNIVERSITY",1,0,2001,"2334","118.603427","376","1282","1409",827,582,423,"135",288,0.3482,0.232,0.3002,0.9099
"4039",157401,"MURRAY STATE UNIVERSITY",1,0,2002,"2540","115.70167","390","1322","1467",879,588,439,"130",309,0.3515,0.2211,0.2993,0.9012
"4040",157401,"MURRAY STATE UNIVERSITY",1,0,2003,"2944","123.446641","393","1321","1500",876,624,477,"160",317,0.3619,0.2564,0.318,0.8807
"4041",157401,"MURRAY STATE UNIVERSITY",1,0,2004,"3420","125.822523","380","1282","1414",804,610,531,"176",355,0.4415,0.2885,0.3755,0.9066
"4042",157401,"Murray State University",1,0,2005,"3792","133.401782","385","1310","1442",841,601,532,"180",352,0.4185,0.2995,0.3689,0.9085
"4043",157401,"Murray State University",1,0,2006,"4284","139.964959","396","1222","1390",822,568,391,"123",268,0.326,0.2165,0.2813,0.8791
"4044",157401,"Murray State University",1,0,2007,"4650","146.306557","395","1222","1393",835,558,397,"128",269,0.3222,0.2294,0.285,0.8772
"4045",157401,"Murray State University",1,0,2008,"4932","153.008332","398","1232","1452",875,577,415,"120",295,0.3371,0.208,0.2858,0.8485
"4046",157401,"Murray State University",1,0,2009,"5130","157.751286","406","1127","1374",837,537,330,"101",229,0.2736,0.1881,0.2402,0.8202
"4047",157401,"Murray State University",1,0,2010,"5388","164.111115","401","1152","1363",830,533,344,"104",240,0.2892,0.1951,0.2524,0.8452
"4048",157447,"NORTHERN KENTUCKY UNIVERSITY",1,0,1991,"1410","55.877751","351","1221","1282",698,584,42,"14",28,0.0401,0.024,0.0328,0.9524
"4049",157447,"NORTHERN KENTUCKY UNIVERSITY",1,0,1992,"1560","61.330506","351","1299","1359",714,645,49,"12",37,0.0518,0.0186,0.0361,0.9558
"4050",157447,"NORTHERN KENTUCKY UNIVERSITY",1,0,1993,"1720","65.073543","360","1450","1517",890,627,55,"11",44,0.0494,0.0175,0.0363,0.9558
"4051",157447,"NORTHERN KENTUCKY UNIVERSITY",1,0,1995,"1960","74.152918","373","1471","1545",873,672,79,"22",57,0.0653,0.0327,0.0511,0.9521
"4052",157447,"NORTHERN KENTUCKY UNIVERSITY",1,0,1996,"2020","76.953","373","1407","1487",823,664,71,"16",55,0.0668,0.0241,0.0477,0.9462
"4053",157447,"NORTHERN KENTUCKY UNIVERSITY",1,0,1997,"2120","77.372","378","1569","1657",949,708,84,"21",63,0.0664,0.0297,0.0507,0.9469
"4054",157447,"NORTHERN KENTUCKY UNIVERSITY",1,0,1998,"2248","81.971","394","1525","1627",956,671,118,"32",86,0.09,0.0477,0.0725,0.9373
"4055",157447,"NORTHERN KENTUCKY UNIVERSITY",1,0,1999,"2100","90.237","424","1578","1696",969,727,35,"13",22,0.0227,0.0179,0.0206,0.9304
"4056",157447,"NORTHERN KENTUCKY UNIVERSITY",1,0,2000,"2328","94.901","456","1551","1682",974,708,114,"37",77,0.0791,0.0523,0.0678,0.9221
"4057",157447,"NORTHERN KENTUCKY UNIVERSITY",1,0,2001,"2460","101.229","488","1635","1787",1008,779,149,"52",97,0.0962,0.0668,0.0834,0.9149
"4058",157447,"NORTHERN KENTUCKY UNIVERSITY",1,0,2002,"3216","103.987","488","1713","1907",1084,823,185,"66",119,0.1098,0.0802,0.097,0.8983
"4059",157447,"NORTHERN KENTUCKY UNIVERSITY",1,0,2003,"3744","117.893","498","1785","1962",1108,854,155,"35",120,0.1083,0.041,0.079,0.9098
"4060",157447,"NORTHERN KENTUCKY UNIVERSITY",1,0,2004,"4368","123.531","522","1739","1915",1123,792,151,"43",108,0.0962,0.0543,0.0789,0.9081
"4061",157447,"Northern Kentucky University",1,0,2005,"4968","131.583","544","1588","1759",1000,759,185,"50",135,0.135,0.0659,0.1052,0.9028
"4062",157447,"Northern Kentucky University",1,0,2006,"5448","142.99","575","1668","1908",1069,839,230,"83",147,0.1375,0.0989,0.1205,0.8742
"4063",157447,"Northern Kentucky University",1,0,2007,"5952","155.791","597","1623","1896",1068,828,253,"84",169,0.1582,0.1014,0.1334,0.856
"4064",157447,"Northern Kentucky University",1,0,2008,"6528","173.262","523","1684","2001",1117,884,252,"77",175,0.1567,0.0871,0.1259,0.8416
"4065",157447,"Northern Kentucky University",1,0,2009,"6792","195.491","532","1837","2187",1219,968,340,"121",219,0.1797,0.125,0.1555,0.84
"4066",157447,"Northern Kentucky University",1,0,2010,"7128","194.918","525","1785","2230",1238,992,321,"116",205,0.1656,0.1169,0.1439,0.8004
"4067",157535,"PIKEVILLE COLLEGE",1,0,1991,"4200","9.505815","56","177","181",134,47,25,"6",19,0.1418,0.1277,0.1381,0.9779
"4068",157535,"PIKEVILLE COLLEGE",1,0,1992,"4900","9.854355","54","197","198",139,59,17,"8",9,0.0647,0.1356,0.0859,0.9949
"4069",157535,"PIKEVILLE COLLEGE",1,0,1993,"5500","10.238669","58","163","167",117,50,20,"7",13,0.1111,0.14,0.1198,0.976
"4070",157535,"PIKEVILLE COLLEGE",1,0,1995,"6000","9.750881","59","220","227",154,73,34,"8",26,0.1688,0.1096,0.1498,0.9692
"4071",157535,"PIKEVILLE COLLEGE",1,0,1996,"6500","11.680597","53","211","211",144,67,34,"11",23,0.1597,0.1642,0.1611,1
"4072",157535,"PIKEVILLE COLLEGE",1,0,1997,"6500","10.855737","57","178","178",110,68,25,"8",17,0.1545,0.1176,0.1404,1
"4073",157535,"PIKEVILLE COLLEGE",1,0,1998,"7500","11.573803","61","169","169",110,59,30,"12",18,0.1636,0.2034,0.1775,1
"4074",157535,"PIKEVILLE COLLEGE",1,0,1999,"7500","13.086561","68","203","206",140,66,41,"10",31,0.2214,0.1515,0.199,0.9854
"4075",157535,"PIKEVILLE COLLEGE",1,0,2000,"7800","16.031889","74.5","232","282",137,145,45,"7",38,0.2774,0.0483,0.1596,0.8227
"4076",157535,"PIKEVILLE COLLEGE",1,0,2001,"8200","16.947196","81","218","258",142,116,41,"11",30,0.2113,0.0948,0.1589,0.845
"4077",157535,"PIKEVILLE COLLEGE",1,0,2002,"9000","19.199514","66","206","226",129,97,40,"9",31,0.2403,0.0928,0.177,0.9115
"4078",157535,"PIKEVILLE COLLEGE",1,0,2003,"9900","20.387539","62","133","147",67,80,27,"10",17,0.2537,0.125,0.1837,0.9048
"4079",157535,"PIKEVILLE COLLEGE",1,0,2004,"10500","20.56779","56","167","175",103,72,31,"8",23,0.2233,0.1111,0.1771,0.9543
"4080",157535,"Pikeville College",1,0,2005,"11500","19.130667","55","190","206",98,108,31,"8",23,0.2347,0.0741,0.1505,0.9223
"4081",157535,"Pikeville College",1,0,2006,"12750","20.624721","56","180","220",105,115,26,"4",22,0.2095,0.0348,0.1182,0.8182
"4082",157535,"Pikeville College",1,0,2007,"13750","21.78754","61","200","233",103,130,35,"15",20,0.1942,0.1154,0.1502,0.8584
"4083",157535,"Pikeville College",1,0,2008,"14250","23.111274","59","156","177",83,94,41,"13",28,0.3373,0.1383,0.2316,0.8814
"4084",157535,"Pikeville College",1,0,2009,"14535","23.441757","54","148","185",62,123,38,"20",18,0.2903,0.1626,0.2054,0.8
"4085",157535,"Pikeville College",1,0,2010,"15250","21.632783","56","335","393",154,239,56,"22",34,0.2208,0.0921,0.1425,0.8524
"4086",157951,"WESTERN KENTUCKY UNIVERSITY",1,0,1991,"1440","102.08526","560","2044","2263",1267,996,259,"77",182,0.1436,0.0773,0.1144,0.9032
"4087",157951,"WESTERN KENTUCKY UNIVERSITY",1,0,1992,"1544","109.865655","560","2005","2192",1261,931,271,"80",191,0.1515,0.0859,0.1236,0.9147
"4088",157951,"WESTERN KENTUCKY UNIVERSITY",1,0,1993,"1704","108.036543","553","1990","2201",1222,979,238,"80",158,0.1293,0.0817,0.1081,0.9041
"4089",157951,"WESTERN KENTUCKY UNIVERSITY",1,0,1995,"1910","117.7345","542","2182","2454",1364,1090,496,"159",337,0.2471,0.1459,0.2021,0.8892
"4090",157951,"WESTERN KENTUCKY UNIVERSITY",1,0,1996,"1970","121.956148","546","1999","2257",1234,1023,471,"164",307,0.2488,0.1603,0.2087,0.8857
"4091",157951,"WESTERN KENTUCKY UNIVERSITY",1,0,1997,"2140","128.553","542","1955","2205",1244,961,445,"148",297,0.2387,0.154,0.2018,0.8866
"4092",157951,"WESTERN KENTUCKY UNIVERSITY",1,0,1998,"2260","136.627204","553","2058","2353",1347,1006,542,"190",352,0.2613,0.1889,0.2303,0.8746
"4093",157951,"WESTERN KENTUCKY UNIVERSITY",1,0,1999,"2020","149.8288","562","2201","2480",1447,1033,568,"204",364,0.2516,0.1975,0.229,0.8875
"4094",157951,"WESTERN KENTUCKY UNIVERSITY",1,0,2000,"2150","175.991","580.5","2145","2477",1444,1033,634,"202",432,0.2992,0.1955,0.256,0.866
"4095",157951,"WESTERN KENTUCKY UNIVERSITY",1,0,2001,"2290","164.533447","599","2281","2640",1563,1077,651,"192",459,0.2937,0.1783,0.2466,0.864
"4096",157951,"WESTERN KENTUCKY UNIVERSITY",1,0,2002,"3120","166.029549","614","2533","2954",1714,1240,513,"136",377,0.22,0.1097,0.1737,0.8575
"4097",157951,"WESTERN KENTUCKY UNIVERSITY",1,0,2003,"3232","178.317989","646","2620","3034",1782,1252,541,"169",372,0.2088,0.135,0.1783,0.8635
"4098",157951,"WESTERN KENTUCKY UNIVERSITY",1,0,2004,"4596","191.549466","679","2441","2918",1647,1271,456,"155",301,0.1828,0.122,0.1563,0.8365
"4099",157951,"Western Kentucky University",1,0,2005,"5316","204.39177","686","2549","3002",1680,1322,539,"189",350,0.2083,0.143,0.1795,0.8491
"4100",157951,"Western Kentucky University",1,0,2006,"5952","224.213246","720","2529","3118",1768,1350,649,"217",432,0.2443,0.1607,0.2081,0.8111
"4101",157951,"Western Kentucky University",1,0,2007,"6416","237.142548","719","2470","3013",1716,1297,610,"197",413,0.2407,0.1519,0.2025,0.8198
"4102",157951,"Western Kentucky University",1,0,2008,"6930","255.001146","719","2545","3203",1821,1382,684,"247",437,0.24,0.1787,0.2135,0.7946
"4103",157951,"Western Kentucky University",1,0,2009,"7200","270.488546","728","2605","3288",1783,1505,700,"249",451,0.2529,0.1654,0.2129,0.7923
"4104",157951,"Western Kentucky University",1,0,2010,"7560","287.98873","742","2610","3279",1865,1414,747,"228",519,0.2783,0.1612,0.2278,0.796
"4105",158477,"CENTENARY COLLEGE OF LOUISIANA",1,0,1991,"7220","13.034506","69","175","207",124,83,87,"29",58,0.4677,0.3494,0.4203,0.8454
"4106",158477,"CENTENARY COLLEGE OF LOUISIANA",1,0,1992,"7550","13.116711","69","214","249",146,103,84,"38",46,0.3151,0.3689,0.3373,0.8594
"4107",158477,"CENTENARY COLLEGE OF LOUISIANA",1,0,1993,"8406","14.372279","66","185","211",121,90,80,"33",47,0.3884,0.3667,0.3791,0.8768
"4108",158477,"CENTENARY COLLEGE OF LOUISIANA",1,0,1995,"10122","15.852519","68","188","213",134,79,91,"26",65,0.4851,0.3291,0.4272,0.8826
"4109",158477,"CENTENARY COLLEGE OF LOUISIANA",1,0,1996,"10400","17.687687","65","175","190",103,87,74,"29",45,0.4369,0.3333,0.3895,0.9211
"4110",158477,"CENTENARY COLLEGE OF LOUISIANA",1,0,1997,"11050","15.76372","70","190","226",116,110,88,"28",60,0.5172,0.2545,0.3894,0.8407
"4111",158477,"CENTENARY COLLEGE OF LOUISIANA",1,0,1998,"12100","16.392784","69","257","294",180,114,126,"34",92,0.5111,0.2982,0.4286,0.8741
"4112",158477,"CENTENARY COLLEGE OF LOUISIANA",1,0,1999,"13200","18.233685","71","230","270",162,108,112,"34",78,0.4815,0.3148,0.4148,0.8519
"4113",158477,"CENTENARY COLLEGE OF LOUISIANA",1,0,2000,"14200","20.947129","73.5","198","229",152,77,99,"33",66,0.4342,0.4286,0.4323,0.8646
"4114",158477,"CENTENARY COLLEGE OF LOUISIANA",1,0,2001,"15400","23.987962","76","224","256",168,88,116,"31",85,0.506,0.3523,0.4531,0.875
"4115",158477,"CENTENARY COLLEGE OF LOUISIANA",1,0,2002,"16000","25.667817","73","227","272",163,109,122,"42",80,0.4908,0.3853,0.4485,0.8346
"4116",158477,"CENTENARY COLLEGE OF LOUISIANA",1,0,2003,"16750","26.958633","75","155","197",113,84,101,"34",67,0.5929,0.4048,0.5127,0.7868
"4117",158477,"CENTENARY COLLEGE OF LOUISIANA",1,0,2004,"16750","26.380855","71","245","282",190,92,145,"42",103,0.5421,0.4565,0.5142,0.8688
"4118",158477,"Centenary College of Louisiana",1,0,2005,"17750","27.133887","72","198","232",145,87,104,"33",71,0.4897,0.3793,0.4483,0.8534
"4119",158477,"Centenary College of Louisiana",1,0,2006,"18900","28.355601","73","196","241",136,105,104,"45",59,0.4338,0.4286,0.4315,0.8133
"4120",158477,"Centenary College of Louisiana",1,0,2007,"19850","30.497463","72","160","200",114,86,97,"35",62,0.5439,0.407,0.485,0.8
"4121",158477,"Centenary College of Louisiana",1,0,2008,"20940","30.924609","71","202","246",148,98,104,"41",63,0.4257,0.4184,0.4228,0.8211
"4122",158477,"Centenary College of Louisiana",1,0,2009,"21790","31.656741","70","205","278",162,116,128,"49",79,0.4877,0.4224,0.4604,0.7374
"4123",158477,"Centenary College of Louisiana",1,0,2010,"22880","28.565495","67","131","192",104,88,81,"29",52,0.5,0.3295,0.4219,0.6823
"4124",159009,"GRAMBLING STATE UNIVERSITY",1,0,1991,"1802","59.068379","269","6","1325",741,584,121,"30",91,0.1228,0.0514,0.0913,0.0045
"4125",159009,"GRAMBLING STATE UNIVERSITY",1,0,1992,"1788","63.570278","284","13","1385",775,610,109,"30",79,0.1019,0.0492,0.0787,0.0094
"4126",159009,"GRAMBLING STATE UNIVERSITY",1,0,1993,"2088","64.521583","267","2","1620",859,761,160,"34",126,0.1467,0.0447,0.0988,0.0012
"4127",159009,"GRAMBLING STATE UNIVERSITY",1,0,1995,"2088","71.629603","286","2","1121",569,552,107,"23",84,0.1476,0.0417,0.0955,0.0018
"4128",159009,"GRAMBLING STATE UNIVERSITY",1,0,1996,"2112","77.417655","292","4","1091",574,517,90,"27",63,0.1098,0.0522,0.0825,0.0037
"4129",159009,"GRAMBLING STATE UNIVERSITY",1,0,1997,"2022","74.452783","311","0","799",408,391,52,"25",27,0.0662,0.0639,0.0651,0
"4130",159009,"GRAMBLING STATE UNIVERSITY",1,0,1998,"2208","70.592746","263","1","771",359,412,71,"23",48,0.1337,0.0558,0.0921,0.0013
"4131",159009,"GRAMBLING STATE UNIVERSITY",1,0,1999,"2301","68.16807","241","3","690",367,323,88,"24",64,0.1744,0.0743,0.1275,0.0043
"4132",159009,"GRAMBLING STATE UNIVERSITY",1,0,2000,"2589","67.182413","242.5","9","908",513,395,182,"46",136,0.2651,0.1165,0.2004,0.0099
"4133",159009,"GRAMBLING STATE UNIVERSITY",1,0,2001,"1900","71.249766","244","3","884",479,405,94,"23",71,0.1482,0.0568,0.1063,0.0034
"4134",159009,"GRAMBLING STATE UNIVERSITY",1,0,2002,"1980","68.009334","241","2","850",430,420,107,"44",63,0.1465,0.1048,0.1259,0.0024
"4135",159009,"GRAMBLING STATE UNIVERSITY",1,0,2003,"2352","70.83721","246","12","1022",570,452,124,"29",95,0.1667,0.0642,0.1213,0.0117
"4136",159009,"GRAMBLING STATE UNIVERSITY",1,0,2004,"2280","72.376406","244","10","1132",675,457,115,"33",82,0.1215,0.0722,0.1016,0.0088
"4137",159009,"Grambling State University",1,0,2005,"2232","75.651516","251","7","1129",568,561,82,"22",60,0.1056,0.0392,0.0726,0.0062
"4138",159009,"Grambling State University",1,0,2006,"2232","77.307201","248","4","1119",609,510,108,"33",75,0.1232,0.0647,0.0965,0.0036
"4139",159009,"Grambling State University",1,0,2007,"2232","85.480797","249","8","1184",610,574,83,"24",59,0.0967,0.0418,0.0701,0.0068
"4140",159009,"Grambling State University",1,0,2008,"2414","107.501469","258","7","1203",626,577,144,"53",91,0.1454,0.0919,0.1197,0.0058
"4141",159009,"Grambling State University",1,0,2009,"2606","102.069431","242","6","910",548,362,177,"65",112,0.2044,0.1796,0.1945,0.0066
"4142",159009,"Grambling State University",1,0,2010,"3018","101.296351","238","5","706",384,322,183,"63",120,0.3125,0.1957,0.2592,0.0071
"4143",159391,"LOUISIANA ST UNIV & AGRL & MECH & HEBERT LAWS CTR",1,0,1991,"2058","402.616255","1494","2744","3342",1779,1563,579,"201",378,0.2125,0.1286,0.1732,0.8211
"4144",159391,"LOUISIANA ST UNIV & AGRL & MECH & HEBERT LAWS CTR",1,0,1992,"2173","416.055012","1510","2880","3503",1884,1619,651,"219",432,0.2293,0.1353,0.1858,0.8222
"4145",159391,"LOUISIANA ST UNIV & AGRL & MECH & HEBERT LAWS CTR",1,0,1993,"2625","421.506967","1439","2549","3178",1697,1481,586,"182",404,0.2381,0.1229,0.1844,0.8021
"4146",159391,"LOUISIANA ST UNIV & AGRL & MECH & HEBERT LAWS CTR",1,0,1995,"2663","447.351823","1453","2969","3646",2007,1639,746,"257",489,0.2436,0.1568,0.2046,0.8143
"4147",159391,"LOUISIANA ST UNIV & AGRL & MECH & HEBERT LAWS CTR",1,0,1996,"2687","465.612405","1456","3184","3992",2169,1823,867,"264",603,0.278,0.1448,0.2172,0.7976
"4148",159391,"LOUISIANA STATE UNIV & AG & MECH & HEBERT LAWS CTR",1,0,1997,"2711","481.557155","1460","3504","4443",2533,1910,959,"319",640,0.2527,0.167,0.2158,0.7887
"4149",159391,"LOUISIANA STATE UNIV & AG & MECH & HEBERT LAW CTR",1,0,1998,"2871","499.492487","1515","4076","5066",2874,2192,1198,"399",799,0.278,0.182,0.2365,0.8046
"4150",159391,"LOUISIANA STATE UNIV & AG & MECH & HEBERT LAWS CTR",1,0,1999,"2301","532.801458","1528","4159","5173",2956,2217,1262,"398",864,0.2923,0.1795,0.244,0.804
"4151",159391,"LOUISIANA STATE UNIV & AG & MECH & HEBERT LAWS CTR",1,0,2000,"2551","586.972976","1401","4148","5072",2803,2269,1229,"431",798,0.2847,0.19,0.2423,0.8178
"4152",159391,"LOUISIANA STATE UNIV & AG & MECH & HEBERT LAWS CTR",1,0,2001,"2551","608.757268","1274","4297","5214",2873,2341,1282,"424",858,0.2986,0.1811,0.2459,0.8241
"4153",159391,"LOUISIANA STATE UNIV & AG & MECH & HEBERT LAWS CTR",1,0,2002,"2635","628.609523","1274","4282","5170",2842,2328,1353,"464",889,0.3128,0.1993,0.2617,0.8282
"4154",159391,"LOUISIANA STATE UNIV & AG & MECH & HEBERT LAWS CTR",1,0,2003,"2739","670.293933","1279","4402","5359",2938,2421,1396,"468",928,0.3159,0.1933,0.2605,0.8214
"4155",159391,"LOUISIANA STATE UNIV & AG & MECH & HEBERT LAWS CTR",1,0,2004,"2855","715.812402","1276","4607","5692",3099,2593,1492,"539",953,0.3075,0.2079,0.2621,0.8094
"4156",159391,"Louisiana State University and Agricultural & Mechanical College",1,0,2005,"2981","780.277638","1277","4075","4966",2653,2313,1440,"576",864,0.3257,0.249,0.29,0.8206
"4157",159391,"Louisiana State University and Agricultural & Mechanical College",1,0,2006,"2981","818.646245","1241","3711","4503",2449,2054,1530,"584",946,0.3863,0.2843,0.3398,0.8241
"4158",159391,"Louisiana State University and Agricultural & Mechanical College",1,0,2007,"2981","859.169719","1267","3741","4585",2415,2170,1737,"658",1079,0.4468,0.3032,0.3788,0.8159
"4159",159391,"Louisiana State University and Agricultural & Mechanical College",1,0,2008,"3215","981.805747","1319","4084","5131",2781,2350,1900,"699",1201,0.4319,0.2974,0.3703,0.7959
"4160",159391,"Louisiana State University and Agricultural & Mechanical College",1,0,2009,"3469","1021.2033","1305","3785","4776",2516,2260,1823,"665",1158,0.4603,0.2942,0.3817,0.7925
"4161",159391,"Louisiana State University and Agricultural & Mechanical College",1,0,2010,"3968","983.155299","1238","4257","5477",2904,2573,2145,"777",1368,0.4711,0.302,0.3916,0.7773
"4162",159647,"LOUISIANA TECH UNIVERSITY",0,1,1991,"1841","72.416998","397","1247","1834",827,1007,278,"108",170,0.2056,0.1072,0.1516,0.6799
"4163",159647,"LOUISIANA TECH UNIVERSITY",0,1,1992,"1868","81.502453","407","1174","1473",703,770,264,"86",178,0.2532,0.1117,0.1792,0.797
"4164",159647,"LOUISIANA TECHNICAL UNIVERSITY",0,1,1993,"2169","81.589648","389","1173","1411",672,739,258,"96",162,0.2411,0.1299,0.1828,0.8313
"4165",159647,"LOUISIANA TECH UNIVERSITY",0,1,1995,"2274","85.773899","381","1040","1278",598,680,281,"103",178,0.2977,0.1515,0.2199,0.8138
"4166",159647,"LOUISIANA TECH UNIVERSITY",0,1,1996,"2352","86.806191","371","1057","1279",618,661,330,"133",197,0.3188,0.2012,0.258,0.8264
"4167",159647,"LOUISIANA TECH UNIVERSITY",0,1,1997,"2517","90.813109","363","1163","1428",714,714,361,"133",228,0.3193,0.1863,0.2528,0.8144
"4168",159647,"LOUISIANA TECH UNIVERSITY",0,1,1998,"2532","97.085473","366","1342","1621",794,827,449,"178",271,0.3413,0.2152,0.277,0.8279
"4169",159647,"LOUISIANA TECH UNIVERSITY",0,1,1999,"2379","101.947266","369","1391","1753",840,913,478,"199",279,0.3321,0.218,0.2727,0.7935
"4170",159647,"LOUISIANA TECH UNIVERSITY",0,1,2000,"2778","107.751352","371","1425","1795",819,976,480,"222",258,0.315,0.2275,0.2674,0.7939
"4171",159647,"LOUISIANA TECH UNIVERSITY",0,1,2001,"2922","113.789791","373","1391","1770",850,920,481,"211",270,0.3176,0.2293,0.2718,0.7859
"4172",159647,"LOUISIANA TECH UNIVERSITY",0,1,2002,"2919","112.538383","389","1448","1936",947,989,500,"202",298,0.3147,0.2042,0.2583,0.7479
"4173",159647,"LOUISIANA TECH UNIVERSITY",0,1,2003,"3462","126.5833","397","1493","1948",958,990,485,"190",295,0.3079,0.1919,0.249,0.7664
"4174",159647,"LOUISIANA TECH UNIVERSITY",0,1,2004,"3795","130.894709","394","1151","1644",730,914,432,"189",243,0.3329,0.2068,0.2628,0.7001
"4175",159647,"Louisiana Tech University",0,1,2005,"3951","129.180173","378","1304","1653",762,891,446,"177",269,0.353,0.1987,0.2698,0.7889
"4176",159647,"Louisiana Tech University",0,1,2006,"4383","133.132174","380","1204","1625",753,872,426,"185",241,0.3201,0.2122,0.2622,0.7409
"4177",159647,"Louisiana Tech University",0,1,2007,"4458","142.498663","432","1193","1522",704,818,432,"180",252,0.358,0.22,0.2838,0.7838
"4178",159647,"Louisiana Tech University",0,1,2008,"4911","167.341326","434","1136","1503",695,808,428,"187",241,0.3468,0.2314,0.2848,0.7558
"4179",159647,"Louisiana Tech University",0,1,2009,"5091","174.236371","398","948","1448",622,826,438,"209",229,0.3682,0.253,0.3025,0.6547
"4180",159647,"Louisiana Tech University",0,1,2010,"3640","162.388283","374","1116","1530",679,851,504,"220",284,0.4183,0.2585,0.3294,0.7294
"4181",159717,"MCNEESE STATE UNIVERSITY",1,0,1991,"1626","42.642616","314","1058","1253",652,601,83,"23",60,0.092,0.0383,0.0662,0.8444
"4182",159717,"MCNEESE STATE UNIVERSITY",1,0,1992,"1626","44.260668","292","1062","1272",705,567,64,"16",48,0.0681,0.0282,0.0503,0.8349
"4183",159717,"MCNEESE STATE UNIVERSITY",1,0,1993,"1968","46.440636","290","1024","1307",702,605,66,"13",53,0.0755,0.0215,0.0505,0.7835
"4184",159717,"MCNEESE STATE UNIVERSITY",1,0,1995,"1998","50.049365","287","1067","1376",775,601,71,"22",49,0.0632,0.0366,0.0516,0.7754
"4185",159717,"MCNEESE STATE UNIVERSITY",1,0,1996,"1998","51.080909","286","1046","1357",750,607,105,"24",81,0.108,0.0395,0.0774,0.7708
"4186",159717,"MCNEESE STATE UNIVERSITY",1,0,1997,"1998","53.591835","275","1118","1447",779,668,116,"27",89,0.1142,0.0404,0.0802,0.7726
"4187",159717,"MCNEESE STATE UNIVERSITY",1,0,1998,"2128","51.443083","281","1088","1433",802,631,141,"35",106,0.1322,0.0555,0.0984,0.7592
"4188",159717,"MCNEESE STATE UNIVERSITY",1,0,1999,"1650","52.580821","280","1016","1275",636,639,127,"34",93,0.1462,0.0532,0.0996,0.7969
"4189",159717,"MCNEESE STATE UNIVERSITY",1,0,2000,"1900","57.116375","277","1035","1320",767,553,110,"31",79,0.103,0.0561,0.0833,0.7841
"4190",159717,"MCNEESE STATE UNIVERSITY",1,0,2001,"1900","60.757174","274","1077","1350",745,605,151,"56",95,0.1275,0.0926,0.1119,0.7978
"4191",159717,"MCNEESE STATE UNIVERSITY",1,0,2002,"1974","62.547103","282","1024","1358",762,596,179,"67",112,0.147,0.1124,0.1318,0.7541
"4192",159717,"MCNEESE STATE UNIVERSITY",1,0,2003,"2050","65.884999","293","1076","1506",843,663,176,"51",125,0.1483,0.0769,0.1169,0.7145
"4193",159717,"MCNEESE STATE UNIVERSITY",1,0,2004,"2134","69.164853","300","1186","1603",923,680,196,"61",135,0.1463,0.0897,0.1223,0.7399
"4194",159717,"McNeese State University",1,0,2005,"2226","72.01912","305","982","1311",743,568,177,"52",125,0.1682,0.0915,0.135,0.749
"4195",159717,"McNeese State University",1,0,2006,"2226","74.83178","302","996","1272",741,531,195,"60",135,0.1822,0.113,0.1533,0.783
"4196",159717,"McNeese State University",1,0,2007,"2226","85.959155","315","920","1247",717,530,163,"55",108,0.1506,0.1038,0.1307,0.7378
"4197",159717,"McNeese State University",1,0,2008,"2386","105.955883","322","943","1272",742,530,203,"62",141,0.19,0.117,0.1596,0.7414
"4198",159717,"McNeese State University",1,0,2009,"2556","102.557391","307","927","1221",728,493,256,"83",173,0.2376,0.1684,0.2097,0.7592
"4199",159717,"McNeese State University",1,0,2010,"2916","98.882391","316","943","1259",756,503,261,"84",177,0.2341,0.167,0.2073,0.749
"4200",159966,"NICHOLLS STATE UNIVERSITY",1,0,1991,"1591","37.59075","274","996","1204",698,506,57,"13",44,0.063,0.0257,0.0473,0.8272
"4201",159966,"NICHOLLS STATE UNIVERSITY",1,0,1992,"1661","40.253161","279","854","1059",613,446,53,"10",43,0.0701,0.0224,0.05,0.8064
"4202",159966,"NICHOLLS STATE UNIVERSITY",1,0,1993,"1981","40.783585","286","756","969",586,383,33,"12",21,0.0358,0.0313,0.0341,0.7802
"4203",159966,"NICHOLLS STATE UNIVERSITY",1,0,1995,"2016","43.00556","280","866","1170",672,498,76,"19",57,0.0848,0.0382,0.065,0.7402
"4204",159966,"NICHOLLS STATE UNIVERSITY",1,0,1996,"2016","43.907186","275","741","1008",603,405,54,"13",41,0.068,0.0321,0.0536,0.7351
"4205",159966,"NICHOLLS STATE UNIVERSITY",1,0,1997,"2136","45.293075","274","760","1075",646,429,81,"14",67,0.1037,0.0326,0.0753,0.707
"4206",159966,"NICHOLLS STATE UNIVERSITY",1,0,1998,"2136","47.393413","272","1009","1351",781,570,117,"22",95,0.1216,0.0386,0.0866,0.7469
"4207",159966,"NICHOLLS STATE UNIVERSITY",1,0,1999,"1645","52.621384","267","1109","1445",860,585,129,"30",99,0.1151,0.0513,0.0893,0.7675
"4208",159966,"NICHOLLS STATE UNIVERSITY",1,0,2000,"1895","52.758398","271","1075","1460",882,578,118,"26",92,0.1043,0.045,0.0808,0.7363
"4209",159966,"NICHOLLS STATE UNIVERSITY",1,0,2001,"1895","53.939196","275","1007","1408",841,567,121,"28",93,0.1106,0.0494,0.0859,0.7152
"4210",159966,"NICHOLLS STATE UNIVERSITY",1,0,2002,"1967","52.194511","268","1000","1404",821,583,120,"27",93,0.1133,0.0463,0.0855,0.7123
"4211",159966,"NICHOLLS STATE UNIVERSITY",1,0,2003,"2045","55.551589","283","955","1391",813,578,121,"36",85,0.1046,0.0623,0.087,0.6866
"4212",159966,"NICHOLLS STATE UNIVERSITY",1,0,2004,"2135","63.150731","285","1068","1574",939,635,146,"44",102,0.1086,0.0693,0.0928,0.6785
"4213",159966,"Nicholls State University",1,0,2005,"2231","64.729509","289","893","1171",703,468,163,"62",101,0.1437,0.1325,0.1392,0.7626
"4214",159966,"Nicholls State University",1,0,2006,"2231","66.003685","285","788","1069",650,419,170,"44",126,0.1938,0.105,0.159,0.7371
"4215",159966,"Nicholls State University",1,0,2007,"2231","70.273922","288","905","1156",696,460,196,"59",137,0.1968,0.1283,0.1696,0.7829
"4216",159966,"Nicholls State University",1,0,2008,"2411","90.863874","297","861","1217",712,505,207,"60",147,0.2065,0.1188,0.1701,0.7075
"4217",159966,"Nicholls State University",1,0,2009,"2603","95.568802","275","880","1212",707,505,200,"67",133,0.1881,0.1327,0.165,0.7261
"4218",159966,"Nicholls State University",1,0,2010,"3024","89.883322","256","774","1048",652,396,201,"63",138,0.2117,0.1591,0.1918,0.7385
"4219",160038,"NORTHWESTERN STATE UNIVERSITY OF LOUISIANA",1,0,1991,"1771","39.464726","209","850","1179",710,469,110,"24",86,0.1211,0.0512,0.0933,0.7209
"4220",160038,"NORTHWESTERN STATE UNIVERSITY OF LOUISIANA",1,0,1992,"1771","43.274761","253","878","1227",737,490,108,"30",78,0.1058,0.0612,0.088,0.7156
"4221",160038,"NORTHWESTERN STATE UNIVERSITY OF LOUISIANA",1,0,1993,"2071","48.842036","248","918","1380",824,556,112,"28",84,0.1019,0.0504,0.0812,0.6652
"4222",160038,"NORTHWESTERN STATE UNIVERSITY OF LOUISIANA",1,0,1995,"2067","54.445772","262","1023","1556",947,609,165,"41",124,0.1309,0.0673,0.106,0.6575
"4223",160038,"NORTHWESTERN STATE UNIVERSITY OF LOUISIANA",1,0,1996,"2067","56.920091","265","942","1480",891,589,22,"5",17,0.0191,0.0085,0.0149,0.6365
"4224",160038,"NORTHWESTERN STATE UNIVERSITY OF LOUISIANA",1,0,1997,"2057","60.172585","277","857","1415",878,537,129,"35",94,0.1071,0.0652,0.0912,0.6057
"4225",160038,"NORTHWESTERN STATE UNIVERSITY OF LOUISIANA",1,0,1998,"2177","60.390222","257","808","1364",857,507,157,"43",114,0.133,0.0848,0.1151,0.5924
"4226",160038,"NORTHWESTERN STATE UNIVERSITY OF LOUISIANA",1,0,1999,"2030","62.074813","316","1037","1656",988,668,184,"71",113,0.1144,0.1063,0.1111,0.6262
"4227",160038,"NORTHWESTERN STATE UNIVERSITY OF LOUISIANA",1,0,2000,"2086","66.182561","288.5","979","1555",959,596,194,"56",138,0.1439,0.094,0.1248,0.6296
"4228",160038,"NORTHWESTERN STATE UNIVERSITY OF LOUISIANA",1,0,2001,"1970","69.657087","261","948","1543",951,592,198,"43",155,0.163,0.0726,0.1283,0.6144
"4229",160038,"NORTHWESTERN STATE UNIVERSITY OF LOUISIANA",1,0,2002,"1976","70.530094","274","993","1875",1093,782,216,"80",136,0.1244,0.1023,0.1152,0.5296
"4230",160038,"NORTHWESTERN STATE UNIVERSITY OF LOUISIANA",1,0,2003,"2054","76.663032","287","961","1826",1117,709,227,"71",156,0.1397,0.1001,0.1243,0.5263
"4231",160038,"NORTHWESTERN STATE UNIVERSITY OF LOUISIANA",1,0,2004,"2144","83.058568","311","902","1793",1084,709,187,"55",132,0.1218,0.0776,0.1043,0.5031
"4232",160038,"Northwestern State University of Louisiana",1,0,2005,"2240","86.177964","309","791","1417",869,548,218,"71",147,0.1692,0.1296,0.1538,0.5582
"4233",160038,"Northwestern State University of Louisiana",1,0,2006,"2240","84.292543","304","777","1324",854,470,214,"62",152,0.178,0.1319,0.1616,0.5869
"4234",160038,"Northwestern State University of Louisiana",1,0,2007,"2240","90.264137","321","769","1281",812,469,223,"69",154,0.1897,0.1471,0.1741,0.6003
"4235",160038,"Northwestern State University of Louisiana",1,0,2008,"2412","112.123775","341","664","1183",736,447,225,"69",156,0.212,0.1544,0.1902,0.5613
"4236",160038,"Northwestern State University of Louisiana",1,0,2009,"2594","114.857472","320","677","1235",781,454,231,"64",167,0.2138,0.141,0.187,0.5482
"4237",160038,"Northwestern State University of Louisiana",1,0,2010,"3002","106.544175","275","583","1056",678,378,213,"60",153,0.2257,0.1587,0.2017,0.5521
"4238",160612,"SOUTHEASTERN LOUISIANA UNIVERSITY",1,0,1991,"1607","50.604031","341","1739","1898",1075,823,53,"9",44,0.0409,0.0109,0.0279,0.9162
"4239",160612,"SOUTHEASTERN LOUISIANA UNIVERSITY",1,0,1992,"1610","55.77877","372","1960","2199",1285,914,86,"21",65,0.0506,0.023,0.0391,0.8913
"4240",160612,"SOUTHEASTERN LOUISIANA UNIVERSITY",1,0,1993,"1760","64.288431","389","1950","2192",1222,970,77,"19",58,0.0475,0.0196,0.0351,0.8896
"4241",160612,"SOUTHEASTERN LOUISIANA UNIVERSITY",1,0,1995,"2050","75.234286","432","2037","2367",1387,980,94,"21",73,0.0526,0.0214,0.0397,0.8606
"4242",160612,"SOUTHEASTERN LOUISIANA UNIVERSITY",1,0,1996,"2050","78.116307","438","2014","2337",1273,1064,107,"33",74,0.0581,0.031,0.0458,0.8618
"4243",160612,"SOUTHEASTERN LOUISIANA UNIVERSITY",1,0,1997,"2050","84.376714","437","2090","2487",1371,1116,107,"24",83,0.0605,0.0215,0.043,0.8404
"4244",160612,"SOUTHEASTERN LOUISIANA UNIVERSITY",1,0,1998,"2150","90.724202","456","2148","2588",1471,1117,156,"50",106,0.0721,0.0448,0.0603,0.83
"4245",160612,"SOUTHEASTERN LOUISIANA UNIVERSITY",1,0,1999,"2210","92.675726","450","1910","2315",1361,954,170,"44",126,0.0926,0.0461,0.0734,0.8251
"4246",160612,"SOUTHEASTERN LOUISIANA UNIVERSITY",1,0,2000,"2490","100.131527","466.5","1839","2220",1351,869,176,"59",117,0.0866,0.0679,0.0793,0.8284
"4247",160612,"SOUTHEASTERN LOUISIANA UNIVERSITY",1,0,2001,"2607","104.076298","483","1657","2007",1209,798,199,"51",148,0.1224,0.0639,0.0992,0.8256
"4248",160612,"SOUTHEASTERN LOUISIANA UNIVERSITY",1,0,2002,"2618","109.360179","479","1879","2382",1370,1012,168,"49",119,0.0869,0.0484,0.0705,0.7888
"4249",160612,"SOUTHEASTERN LOUISIANA UNIVERSITY",1,0,2003,"2951","123.689933","488","1933","2539",1451,1088,221,"72",149,0.1027,0.0662,0.087,0.7613
"4250",160612,"SOUTHEASTERN LOUISIANA UNIVERSITY",1,0,2004,"3191","147.069343","487","1700","2137",1250,887,210,"68",142,0.1136,0.0767,0.0983,0.7955
"4251",160612,"Southeastern Louisiana University",1,0,2005,"3341","140.949373","503","1689","2228",1388,840,252,"74",178,0.1282,0.0881,0.1131,0.7581
"4252",160612,"Southeastern Louisiana University",1,0,2006,"2216","143.074532","508","1968","2665",1604,1061,320,"93",227,0.1415,0.0877,0.1201,0.7385
"4253",160612,"Southeastern Louisiana University",1,0,2007,"2216","149.634536","528","1895","2524",1458,1066,336,"102",234,0.1605,0.0957,0.1331,0.7508
"4254",160612,"Southeastern Louisiana University",1,0,2008,"2376","186.159005","540","1915","2613",1538,1075,358,"112",246,0.1599,0.1042,0.137,0.7329
"4255",160612,"Southeastern Louisiana University",1,0,2009,"2546","189.496337","541","1851","2508",1497,1011,359,"118",241,0.161,0.1167,0.1431,0.738
"4256",160612,"Southeastern Louisiana University",1,0,2010,"2993","175.198883","477","1853","2414",1408,1006,408,"133",275,0.1953,0.1322,0.169,0.7676
"4257",160621,"SOUTHERN UNIVERSITY AND A & M COL AT BATON ROUGE",1,0,1991,"1580","79.024501","471","23","1907",985,922,59,"10",49,0.0497,0.0108,0.0309,0.0121
"4258",160621,"SOUTHERN UNIVERSITY AND A & M COL AT BATON ROUGE",1,0,1992,"1588","85.73082","433","30","2033",1066,967,91,"20",71,0.0666,0.0207,0.0448,0.0148
"4259",160621,"SOUTHERN UNIVERSITY AND A & M COLLEGE-BATON ROUGE",1,0,1993,"2028","89.627819","446","56","1658",862,796,80,"16",64,0.0742,0.0201,0.0483,0.0338
"4260",160621,"SOUTHERN UNIVERSITY AND A & M COLLEGE",1,0,1995,"2028","100.635987","434","9","1846",991,855,101,"21",80,0.0807,0.0246,0.0547,0.0049
"4261",160621,"SOUTHERN UNIVERSITY AND A & M COLLEGE",1,0,1996,"2028","105.348239","469","10","1910",1041,869,129,"24",105,0.1009,0.0276,0.0675,0.0052
"4262",160621,"SOUTHERN UNIVERSITY AND A & M COLLEGE",1,0,1997,"2068","109.70344","451","12","1853",997,856,106,"28",78,0.0782,0.0327,0.0572,0.0065
"4263",160621,"SOUTHERN UNIVERSITY AND A & M COLLEGE",1,0,1998,"2208","114.765492","460","6","1715",911,804,110,"25",85,0.0933,0.0311,0.0641,0.0035
"4264",160621,"SOUTHERN UNIVERSITY AND A & M COLLEGE",1,0,1999,"2286","115.979191","465","4","1287",693,594,86,"19",67,0.0967,0.032,0.0668,0.0031
"4265",160621,"SOUTHERN UNIVERSITY AND A & M COLLEGE",1,0,2000,"2286","119.238226","439","7","1766",996,770,2,"2",0,0,0.0026,0.0011,0.004
"4266",160621,"SOUTHERN UNIVERSITY AND A & M COLLEGE",1,0,2001,"2682","121.745121","413","9","1206",690,516,75,"14",61,0.0884,0.0271,0.0622,0.0075
"4267",160621,"SOUTHERN UNIVERSITY AND A & M COLLEGE",1,0,2002,"2702","124.139614","425","7","1176",673,503,77,"14",63,0.0936,0.0278,0.0655,0.006
"4268",160621,"SOUTHERN UNIVERSITY AND A & M COLLEGE",1,0,2003,"3066","136.873368","436","11","1351",782,569,77,"16",61,0.078,0.0281,0.057,0.0081
"4269",160621,"SOUTHERN UNIVERSITY AND A & M COLLEGE",1,0,2004,"3440","143.729476","420","6","1575",931,644,115,"30",85,0.0913,0.0466,0.073,0.0038
"4270",160621,"Southern University and A & M College",1,0,2005,"3592","156.441425","404","6","1434",797,637,290,"93",197,0.2472,0.146,0.2022,0.0042
"4271",160621,"Southern University and A & M College",1,0,2006,"3602","153.186768","446","2","1136",659,477,132,"33",99,0.1502,0.0692,0.1162,0.0018
"4272",160621,"Southern University and A & M College",1,0,2007,"3666","161.780043","437","7","1178",658,520,95,"18",77,0.117,0.0346,0.0806,0.0059
"4273",160621,"Southern University and A & M College",1,0,2008,"3906","185.123526","434","10","1034",605,429,62,"19",43,0.0711,0.0443,0.06,0.0097
"4274",160621,"Southern University and A & M College",1,0,2009,"4100","184.955867","373","18","992",539,453,96,"31",65,0.1206,0.0684,0.0968,0.0181
"4275",160621,"Southern University and A & M College",1,0,2010,"4584","159.537048","379","15","852",488,364,60,"18",42,0.0861,0.0495,0.0704,0.0176
"4276",160658,"UNIVERSITY OF SOUTHWESTERN LOUISIANA",1,0,1991,"1568","98.149561","576","1705","2383",1300,1083,88,"26",62,0.0477,0.024,0.0369,0.7155
"4277",160658,"UNIVERSITY OF SOUTHWESTERN LOUISIANA",1,0,1992,"1597","106.728592","582","1797","2563",1396,1167,77,"25",52,0.0372,0.0214,0.03,0.7011
"4278",160658,"UNIVERSITY OF SOUTHWESTERN LOUISIANA",1,0,1993,"1897","114.463907","531","1787","2524",1378,1146,110,"32",78,0.0566,0.0279,0.0436,0.708
"4279",160658,"UNIVERSITY OF SOUTHWESTERN LOUISIANA",1,0,1995,"1897","119.265206","563","1799","2609",1453,1156,110,"24",86,0.0592,0.0208,0.0422,0.6895
"4280",160658,"UNIVERSITY OF SOUTHWESTERN LOUISIANA",1,0,1996,"1885","122.114194","553","1801","2674",1461,1213,161,"41",120,0.0821,0.0338,0.0602,0.6735
"4281",160658,"UNIVERSITY OF SOUTHWESTERN LOUISIANA",1,0,1997,"1885","126.699897","545","1796","2764",1543,1221,169,"44",125,0.081,0.036,0.0611,0.6498
"4282",160658,"UNIVERSITY OF SOUTHWESTERN LOUISIANA",1,0,1998,"2010","134.499106","536","1962","2931",1621,1310,249,"69",180,0.111,0.0527,0.085,0.6694
"4283",160658,"UNIVERSITY OF LOUISIANA AT LAFAYETTE",1,0,1999,"2013","139.628632","525","1777","2402",1300,1102,298,"94",204,0.1569,0.0853,0.1241,0.7398
"4284",160658,"UNIVERSITY OF LOUISIANA AT LAFAYETTE",1,0,2000,"2277","147.136143","527.5","1742","2291",1302,989,314,"103",211,0.1621,0.1041,0.1371,0.7604
"4285",160658,"UNIVERSITY OF LOUISIANA AT LAFAYETTE",1,0,2001,"2314","143.546632","530","1775","2301",1306,995,322,"93",229,0.1753,0.0935,0.1399,0.7714
"4286",160658,"UNIVERSITY OF LOUISIANA AT LAFAYETTE",1,0,2002,"2386","145.622672","532","1817","2385",1326,1059,293,"77",216,0.1629,0.0727,0.1229,0.7618
"4287",160658,"UNIVERSITY OF LOUISIANA AT LAFAYETTE",1,0,2003,"2700","152.569481","536","1976","2576",1437,1139,333,"86",247,0.1719,0.0755,0.1293,0.7671
"4288",160658,"UNIVERSITY OF LOUISIANA AT LAFAYETTE",1,0,2004,"3228","158.339559","534","1974","2643",1517,1126,345,"101",244,0.1608,0.0897,0.1305,0.7469
"4289",160658,"University of Louisiana at Lafayette",1,0,2005,"3324","166.642568","531","2027","2730",1538,1192,329,"102",227,0.1476,0.0856,0.1205,0.7425
"4290",160658,"University of Louisiana at Lafayette",1,0,2006,"3382","173.090796","530","2053","2799",1604,1195,362,"108",254,0.1584,0.0904,0.1293,0.7335
"4291",160658,"University of Louisiana at Lafayette",1,0,2007,"3402","184.522052","576","2026","2691",1554,1137,361,"111",250,0.1609,0.0976,0.1342,0.7529
"4292",160658,"University of Louisiana at Lafayette",1,0,2008,"3574","235.166322","591","1927","2566",1435,1131,373,"128",245,0.1707,0.1132,0.1454,0.751
"4293",160658,"University of Louisiana at Lafayette",1,0,2009,"4016","238.122102","600","1818","2553",1427,1126,373,"126",247,0.1731,0.1119,0.1461,0.7121
"4294",160658,"University of Louisiana-Lafayette",1,0,2010,"4426","239.919721","596","1997","2914",1629,1285,465,"141",324,0.1989,0.1097,0.1596,0.6853
"4295",161004,"BOWDOIN COLLEGE",1,0,1991,"16070","49.809495","123","335","398",185,213,341,"182",159,0.8595,0.8545,0.8568,0.8417
"4296",161004,"BOWDOIN COLLEGE",1,0,1992,"17035","45.96","122","350","409",224,185,347,"154",193,0.8616,0.8324,0.8484,0.8557
"4297",161004,"BOWDOIN COLLEGE",1,0,1993,"18300","48.907","123","347","418",218,200,356,"163",193,0.8853,0.815,0.8517,0.8301
"4298",161004,"BOWDOIN COLLEGE",1,0,1995,"20555","55.658","131","328","446",225,221,369,"180",189,0.84,0.8145,0.8274,0.7354
"4299",161004,"BOWDOIN COLLEGE",1,0,1996,"21750","59.698","131","374","443",223,220,369,"175",194,0.87,0.7955,0.833,0.8442
"4300",161004,"BOWDOIN COLLEGE",1,0,1997,"22460","55.583","137","314","473",246,227,384,"175",209,0.8496,0.7709,0.8118,0.6638
"4301",161004,"BOWDOIN COLLEGE",1,0,1998,"23895","60.746","140","352","433",213,220,361,"181",180,0.8451,0.8227,0.8337,0.8129
"4302",161004,"BOWDOIN COLLEGE",1,0,1999,"24435","67.789","146","389","464",259,205,418,"183",235,0.9073,0.8927,0.9009,0.8384
"4303",161004,"BOWDOIN COLLEGE",1,0,2000,"25345","74.768","148.5","347","452",221,231,379,"188",191,0.8643,0.8139,0.8385,0.7677
"4304",161004,"BOWDOIN COLLEGE",1,0,2001,"26700","84.034","151","344","452",228,224,374,"191",183,0.8026,0.8527,0.8274,0.7611
"4305",161004,"BOWDOIN COLLEGE",1,0,2002,"28070","89.873","165","321","457",237,220,384,"196",188,0.7932,0.8909,0.8403,0.7024
"4306",161004,"BOWDOIN COLLEGE",1,0,2003,"29470","89.673","168","333","464",236,228,412,"202",210,0.8898,0.886,0.8879,0.7177
"4307",161004,"BOWDOIN COLLEGE",1,0,2004,"30944","91.847","152","312","470",235,235,421,"212",209,0.8894,0.9021,0.8957,0.6638
"4308",161004,"Bowdoin College",1,0,2005,"32650","96.269","177","327","477",257,220,420,"189",231,0.8988,0.8591,0.8805,0.6855
"4309",161004,"Bowdoin College",1,0,2006,"34280","103.618","172","334","474",253,221,430,"193",237,0.9368,0.8733,0.9072,0.7046
"4310",161004,"Bowdoin College",1,0,2007,"35990","109.074","185","314","475",250,225,416,"196",220,0.88,0.8711,0.8758,0.6611
"4311",161004,"Bowdoin College",1,0,2008,"37790","117.198","199","312","488",232,256,420,"203",217,0.9353,0.793,0.8607,0.6393
"4312",161004,"Bowdoin College",1,0,2009,"39605","121.979","198","320","493",253,240,422,"200",222,0.8775,0.8333,0.856,0.6491
"4313",161004,"Bowdoin College",1,0,2010,"41150","122.241","204","320","507",249,258,453,"230",223,0.8956,0.8915,0.8935,0.6312
"4314",161226,"UNIVERSITY OF MAINE AT FARMINGTON",1,0,1991,"2340","21.609197","95","444","457",337,120,157,"30",127,0.3769,0.25,0.3435,0.9716
"4315",161226,"UNIVERSITY OF MAINE AT FARMINGTON",1,0,1992,"2670","22.158523","105","423","441",302,139,126,"31",95,0.3146,0.223,0.2857,0.9592
"4316",161226,"UNIVERSITY OF MAINE AT FARMINGTON",1,0,1993,"2910","22.29374","101","408","419",317,102,169,"24",145,0.4574,0.2353,0.4033,0.9737
"4317",161226,"UNIVERSITY OF MAINE AT FARMINGTON",1,0,1995,"3220","23.850591","105","451","473",335,138,153,"35",118,0.3522,0.2536,0.3235,0.9535
"4318",161226,"UNIVERSITY OF MAINE AT FARMINGTON",1,0,1996,"3370","24.554484","99","435","477",332,145,147,"32",115,0.3464,0.2207,0.3082,0.9119
"4319",161226,"UNIVERSITY OF MAINE AT FARMINGTON",1,0,1997,"3520","26.334493","96","440","466",308,158,148,"28",120,0.3896,0.1772,0.3176,0.9442
"4320",161226,"UNIVERSITY OF MAINE AT FARMINGTON",1,0,1998,"3686","26.558577","98","435","484",333,151,155,"41",114,0.3423,0.2715,0.3202,0.8988
"4321",161226,"UNIVERSITY OF MAINE AT FARMINGTON",1,0,1999,"3390","28.975837","103","368","470",344,126,197,"48",149,0.4331,0.381,0.4191,0.783
"4322",161226,"UNIVERSITY OF MAINE AT FARMINGTON",1,0,2000,"3540","30.376972","107","412","475",329,146,176,"40",136,0.4134,0.274,0.3705,0.8674
"4323",161226,"UNIVERSITY OF MAINE AT FARMINGTON",1,0,2001,"3735","32.50936","111","423","479",323,156,174,"45",129,0.3994,0.2885,0.3633,0.8831
"4324",161226,"UNIVERSITY OF MAINE AT FARMINGTON",1,0,2002,"3990","31.402","111","437","453",295,158,156,"40",116,0.3932,0.2532,0.3444,0.9647
"4325",161226,"UNIVERSITY OF MAINE AT FARMINGTON",1,0,2003,"4290","32.212","102","454","482",339,143,221,"59",162,0.4779,0.4126,0.4585,0.9419
"4326",161226,"UNIVERSITY OF MAINE AT FARMINGTON",1,0,2004,"4650","34.167","102","494","510",342,168,196,"46",150,0.4386,0.2738,0.3843,0.9686
"4327",161226,"University of Maine at Farmington",1,0,2005,"5010","35.36","102","334","559",387,172,229,"60",169,0.4367,0.3488,0.4097,0.5975
"4328",161226,"University of Maine at Farmington",1,0,2006,"5824","37.606","130","454","511",351,160,209,"49",160,0.4558,0.3062,0.409,0.8885
"4329",161226,"University of Maine at Farmington",1,0,2007,"6528","39.111","129","432","479",327,152,181,"45",136,0.4159,0.2961,0.3779,0.9019
"4330",161226,"University of Maine at Farmington",1,0,2008,"7296","41.437","123","431","512",335,177,184,"47",137,0.409,0.2655,0.3594,0.8418
"4331",161226,"University of Maine at Farmington",1,0,2009,"7712","43.09","120","427","487",312,175,210,"64",146,0.4679,0.3657,0.4312,0.8768
"4332",161226,"University of Maine at Farmington",1,0,2010,"8032","43.013","120","488","555",352,203,242,"68",174,0.4943,0.335,0.436,0.8793
"4333",161235,"UNIVERSITY OF MAINE AT FORT KENT",1,0,1991,"2250","5.376767","28","65","86",53,33,11,"3",8,0.1509,0.0909,0.1279,0.7558
"4334",161235,"UNIVERSITY OF MAINE AT FORT KENT",1,0,1992,"2580","5.547817","31","95","97",43,54,8,"3",5,0.1163,0.0556,0.0825,0.9794
"4335",161235,"UNIVERSITY OF MAINE AT FORT KENT",1,0,1993,"2760","5.939786","33","81","81",46,35,6,"0",6,0.1304,0,0.0741,1
"4336",161235,"UNIVERSITY OF MAINE AT FORT KENT",1,0,1995,"2930","6.050798","33","72","74",34,40,6,"2",4,0.1176,0.05,0.0811,0.973
"4337",161235,"UNIVERSITY OF MAINE AT FORT KENT",1,0,1996,"2990","5.865832","30","82","84",49,35,9,"1",8,0.1633,0.0286,0.1071,0.9762
"4338",161235,"UNIVERSITY OF MAINE AT FORT KENT",1,0,1997,"3140","6.712218","33","77","77",47,30,5,"0",5,0.1064,0,0.0649,1
"4339",161235,"UNIVERSITY OF MAINE AT FORT KENT",1,0,1998,"3284","6.497048","30","24","93",40,53,9,"1",8,0.2,0.0189,0.0968,0.2581
"4340",161235,"UNIVERSITY OF MAINE AT FORT KENT",1,0,1999,"3090","7.153876","30","19","109",64,45,17,"3",14,0.2188,0.0667,0.156,0.1743
"4341",161235,"UNIVERSITY OF MAINE AT FORT KENT",1,0,2000,"3150","8.396205","32","80","82",38,44,4,"1",3,0.0789,0.0227,0.0488,0.9756
"4342",161235,"UNIVERSITY OF MAINE AT FORT KENT",1,0,2001,"3270","9.053341","34","89","99",49,50,24,"8",16,0.3265,0.16,0.2424,0.899
"4343",161235,"UNIVERSITY OF MAINE AT FORT KENT",1,0,2002,"3420","10.456","35","119","130",61,69,30,"15",15,0.2459,0.2174,0.2308,0.9154
"4344",161235,"UNIVERSITY OF MAINE AT FORT KENT",1,0,2003,"3690","11.042","30","112","126",62,64,19,"4",15,0.2419,0.0625,0.1508,0.8889
"4345",161235,"UNIVERSITY OF MAINE AT FORT KENT",1,0,2004,"3960","10.443","33","157","166",85,81,17,"2",15,0.1765,0.0247,0.1024,0.9458
"4346",161235,"University of Maine at Fort Kent",1,0,2005,"4290","11.993","36","121","129",69,60,22,"9",13,0.1884,0.15,0.1705,0.938
"4347",161235,"University of Maine at Fort Kent",1,0,2006,"4650","12.554","41","106","116",67,49,2,"1",1,0.0149,0.0204,0.0172,0.9138
"4348",161235,"University of Maine at Fort Kent",1,0,2007,"5100","13.545","41","89","110",60,50,36,"18",18,0.3,0.36,0.3273,0.8091
"4349",161235,"University of Maine at Fort Kent",1,0,2008,"5700","14.48","38","91","111",60,51,27,"14",13,0.2167,0.2745,0.2432,0.8198
"4350",161235,"University of Maine at Fort Kent",1,0,2009,"6030","14.442","36","101","118",69,49,20,"5",15,0.2174,0.102,0.1695,0.8559
"4351",161235,"University of Maine at Fort Kent",1,0,2010,"6330","14.002","35","139","153",94,59,27,"6",21,0.2234,0.1017,0.1765,0.9085
"4352",161244,"UNIVERSITY OF MAINE AT MACHIAS",1,0,1991,"2275","7.544089","41","139","146",91,55,11,"4",7,0.0769,0.0727,0.0753,0.9521
"4353",161244,"UNIVERSITY OF MAINE AT MACHIAS",1,0,1992,"2605","7.883451","42","119","139",98,41,12,"3",9,0.0918,0.0732,0.0863,0.8561
"4354",161244,"UNIVERSITY OF MAINE AT MACHIAS",1,0,1993,"2785","8.087405","39","115","133",84,49,10,"6",4,0.0476,0.1224,0.0752,0.8647
"4355",161244,"UNIVERSITY OF MAINE AT MACHIAS",1,0,1995,"2935","8.6469","36","121","129",73,56,10,"5",5,0.0685,0.0893,0.0775,0.938
"4356",161244,"UNIVERSITY OF MAINE AT MACHIAS",1,0,1996,"3035","8.529142","37","123","143",86,57,9,"3",6,0.0698,0.0526,0.0629,0.8601
"4357",161244,"UNIVERSITY OF MAINE AT MACHIAS",1,0,1997,"3225","9.451005","41","107","121",63,58,9,"3",6,0.0952,0.0517,0.0744,0.8843
"4358",161244,"UNIVERSITY OF MAINE AT MACHIAS",1,0,1998,"3345","10.014973","38","135","148",95,53,8,"2",6,0.0632,0.0377,0.0541,0.9122
"4359",161244,"UNIVERSITY OF MAINE AT MACHIAS",1,0,1999,"3090","10.128015","33","112","121",83,38,15,"4",11,0.1325,0.1053,0.124,0.9256
"4360",161244,"UNIVERSITY OF MAINE AT MACHIAS",1,0,2000,"3150","9.809702","34.5","116","127",85,42,13,"4",9,0.1059,0.0952,0.1024,0.9134
"4361",161244,"UNIVERSITY OF MAINE AT MACHIAS",1,0,2001,"3270","10.024383","36","130","155",105,50,32,"6",26,0.2476,0.12,0.2065,0.8387
"4362",161244,"UNIVERSITY OF MAINE AT MACHIAS",1,0,2002,"3420","10.103","35","124","132",81,51,19,"9",10,0.1235,0.1765,0.1439,0.9394
"4363",161244,"UNIVERSITY OF MAINE AT MACHIAS",1,0,2003,"3636","10.97","30","120","142",92,50,17,"1",16,0.1739,0.02,0.1197,0.8451
"4364",161244,"UNIVERSITY OF MAINE AT MACHIAS",1,0,2004,"3960","11.172","29","71","80",54,26,14,"3",11,0.2037,0.1154,0.175,0.8875
"4365",161244,"University of Maine at Machias",1,0,2005,"4290","10.761","30","92","106",71,35,17,"5",12,0.169,0.1429,0.1604,0.8679
"4366",161244,"University of Maine at Machias",1,0,2006,"4650","11.051","30","96","99",59,40,10,"6",4,0.0678,0.15,0.101,0.9697
"4367",161244,"University of Maine at Machias",1,0,2007,"5100","11.636","33","100","110",72,38,15,"6",9,0.125,0.1579,0.1364,0.9091
"4368",161244,"University of Maine at Machias",1,0,2008,"5700","12.573","33","91","105",62,43,23,"8",15,0.2419,0.186,0.219,0.8667
"4369",161244,"University of Maine at Machias",1,0,2009,"6030","12.675","31","83","101",67,34,16,"4",12,0.1791,0.1176,0.1584,0.8218
"4370",161244,"University of Maine at Machias",1,0,2010,"6330","12.744","31","83","105",61,44,18,"6",12,0.1967,0.1364,0.1714,0.7905
"4371",161253,"UNIVERSITY OF MAINE AT ORONO",1,0,1991,"2718","169.349026","468","1513","1589",710,879,324,"140",184,0.2592,0.1593,0.2039,0.9522
"4372",161253,"UNIVERSITY OF MAINE",1,0,1992,"3086","169.343619","446","1317","1413",630,783,293,"128",165,0.2619,0.1635,0.2074,0.9321
"4373",161253,"UNIVERSITY OF MAINE",1,0,1993,"3406","171.50794","452","1144","1211",522,689,320,"131",189,0.3621,0.1901,0.2642,0.9447
"4374",161253,"UNIVERSITY OF MAINE",1,0,1995,"3925","181.078683","397","1054","1118",526,592,322,"148",174,0.3308,0.25,0.288,0.9428
"4375",161253,"UNIVERSITY OF MAINE",1,0,1996,"4139","180.390423","380","1186","1264",549,715,340,"156",184,0.3352,0.2182,0.269,0.9383
"4376",161253,"UNIVERSITY OF MAINE",1,0,1997,"4339","185.363419","370","1008","1091",513,578,327,"144",183,0.3567,0.2491,0.2997,0.9239
"4377",161253,"UNIVERSITY OF MAINE",1,0,1998,"4551","186.516142","347","1248","1342",671,671,418,"165",253,0.377,0.2459,0.3115,0.93
"4378",161253,"UNIVERSITY OF MAINE",1,0,1999,"3960","203.938082","361","1411","1521",718,803,430,"176",254,0.3538,0.2192,0.2827,0.9277
"4379",161253,"UNIVERSITY OF MAINE",1,0,2000,"4050","221.07342","376.5","1507","1589",781,808,536,"222",314,0.402,0.2748,0.3373,0.9484
"4380",161253,"UNIVERSITY OF MAINE",1,0,2001,"5116","236.826534","392","1436","1545",737,808,495,"214",281,0.3813,0.2649,0.3204,0.9294
"4381",161253,"UNIVERSITY OF MAINE",1,0,2002,"4380","247.778","393","1552","1651",808,843,554,"246",308,0.3812,0.2918,0.3356,0.94
"4382",161253,"UNIVERSITY OF MAINE",1,0,2003,"4710","260.322","380","1399","1599",812,787,538,"235",303,0.3732,0.2986,0.3365,0.8749
"4383",161253,"UNIVERSITY OF MAINE",1,0,2004,"5040","271.282","369","1414","1607",777,830,550,"236",314,0.4041,0.2843,0.3423,0.8799
"4384",161253,"University of Maine",1,0,2005,"5520","280.032","372","1513","1703",842,861,615,"262",353,0.4192,0.3043,0.3611,0.8884
"4385",161253,"University of Maine",1,0,2006,"5970","289.288","398","1692","1807",875,932,648,"296",352,0.4023,0.3176,0.3586,0.9364
"4386",161253,"University of Maine",1,0,2007,"6540","293.588","632","1583","1816",863,953,648,"301",347,0.4021,0.3158,0.3568,0.8717
"4387",161253,"University of Maine",1,0,2008,"7170","316.237","635","1634","1931",947,984,717,"320",397,0.4192,0.3252,0.3713,0.8462
"4388",161253,"University of Maine",1,0,2009,"7590","326.441","602","1399","1654",756,898,550,"288",262,0.3466,0.3207,0.3325,0.8458
"4389",161253,"University of Maine",1,0,2010,"8010","326.575","589","1447","1713",828,885,622,"283",339,0.4094,0.3198,0.3631,0.8447
"4390",161554,"UNIVERSITY OF SOUTHERN MAINE",1,0,1991,"2454","73.568548","306","737","763",419,344,68,"23",45,0.1074,0.0669,0.0891,0.9659
"4391",161554,"UNIVERSITY OF SOUTHERN MAINE",1,0,1992,"2814","77.227596","298","659","682",365,317,51,"17",34,0.0932,0.0536,0.0748,0.9663
"4392",161554,"UNIVERSITY OF SOUTHERN MAINE",1,0,1993,"3054","79.300884","291","699","732",390,342,48,"18",30,0.0769,0.0526,0.0656,0.9549
"4393",161554,"UNIVERSITY OF SOUTHERN MAINE",1,0,1995,"3500","88.358164","305","606","620",358,262,66,"23",43,0.1201,0.0878,0.1065,0.9774
"4394",161554,"UNIVERSITY OF SOUTHERN MAINE",1,0,1996,"3710","94.121783","315","664","683",383,300,56,"17",39,0.1018,0.0567,0.082,0.9722
"4395",161554,"UNIVERSITY OF SOUTHERN MAINE",1,0,1997,"3938","98.724365","313","732","760",450,310,90,"31",59,0.1311,0.1,0.1184,0.9632
"4396",161554,"UNIVERSITY OF SOUTHERN MAINE",1,0,1998,"4102","103.403079","307","765","789",463,326,66,"18",48,0.1037,0.0552,0.0837,0.9696
"4397",161554,"UNIVERSITY OF SOUTHERN MAINE",1,0,1999,"3630","111.190096","293","777","815",477,338,96,"24",72,0.1509,0.071,0.1178,0.9534
"4398",161554,"UNIVERSITY OF SOUTHERN MAINE",1,0,2000,"3720","118.491746","324.5","825","855",489,366,81,"21",60,0.1227,0.0574,0.0947,0.9649
"4399",161554,"UNIVERSITY OF SOUTHERN MAINE",1,0,2001,"3855","130.293713","356","897","922",538,384,93,"26",67,0.1245,0.0677,0.1009,0.9729
"4400",161554,"UNIVERSITY OF SOUTHERN MAINE",1,0,2002,"4020","136.107","352","863","895",519,376,118,"39",79,0.1522,0.1037,0.1318,0.9642
"4401",161554,"UNIVERSITY OF SOUTHERN MAINE",1,0,2003,"4320","151.264","339","816","851",496,355,106,"24",82,0.1653,0.0676,0.1246,0.9589
"4402",161554,"UNIVERSITY OF SOUTHERN MAINE",1,0,2004,"4620","161.068","334","793","871",524,347,146,"39",107,0.2042,0.1124,0.1676,0.9104
"4403",161554,"University of Southern Maine",1,0,2005,"4980","162.202","344","622","911",518,393,88,"31",57,0.11,0.0789,0.0966,0.6828
"4404",161554,"University of Southern Maine",1,0,2006,"5400","170.428","385","830","888",511,377,84,"25",59,0.1155,0.0663,0.0946,0.9347
"4405",161554,"University of Southern Maine",1,0,2007,"5940","181.355","384","738","900",499,401,87,"32",55,0.1102,0.0798,0.0967,0.82
"4406",161554,"University of Southern Maine",1,0,2008,"6540","185.794","372","811","991",531,460,126,"53",73,0.1375,0.1152,0.1271,0.8184
"4407",161554,"University of Southern Maine",1,0,2009,"6930","183.6","345","685","825",447,378,107,"27",80,0.179,0.0714,0.1297,0.8303
"4408",161554,"University of Southern Maine",1,0,2010,"7260","181.629","355","632","763",394,369,104,"43",61,0.1548,0.1165,0.1363,0.8283
"4409",162007,"BOWIE STATE UNIVERSITY",1,0,1991,"2254","31.612733","117","20","310",189,121,37,"7",30,0.1587,0.0579,0.1194,0.0645
"4410",162007,"BOWIE STATE UNIVERSITY",1,0,1992,"2514","31.378087","126","15","329",199,130,35,"6",29,0.1457,0.0462,0.1064,0.0456
"4411",162007,"BOWIE STATE UNIVERSITY",1,0,1993,"2736","32.361288","127","6","257",152,105,30,"9",21,0.1382,0.0857,0.1167,0.0233
"4412",162007,"BOWIE STATE UNIVERSITY",1,0,1995,"3019","37.072473","146","22","435",260,175,62,"11",51,0.1962,0.0629,0.1425,0.0506
"4413",162007,"BOWIE STATE UNIVERSITY",1,0,1996,"3103","40.030002","139","21","301",169,132,41,"9",32,0.1893,0.0682,0.1362,0.0698
"4414",162007,"BOWIE STATE UNIVERSITY",1,0,1997,"3357","40.495295","137","18","357",190,167,44,"8",36,0.1895,0.0479,0.1232,0.0504
"4415",162007,"BOWIE STATE UNIVERSITY",1,0,1998,"3467","43.430478","159","23","418",225,193,49,"7",42,0.1867,0.0363,0.1172,0.055
"4416",162007,"BOWIE STATE UNIVERSITY",1,0,1999,"2828","45.038693","155","23","343",189,154,45,"12",33,0.1746,0.0779,0.1312,0.0671
"4417",162007,"BOWIE STATE UNIVERSITY",1,0,2000,"2940","49.713511","152","10","361",195,166,47,"13",34,0.1744,0.0783,0.1302,0.0277
"4418",162007,"BOWIE STATE UNIVERSITY",1,0,2001,"2941","54.761142","149","12","594",356,238,89,"21",68,0.191,0.0882,0.1498,0.0202
"4419",162007,"BOWIE STATE UNIVERSITY",1,0,2002,"3102","53.069509","145","15","566",352,214,102,"24",78,0.2216,0.1121,0.1802,0.0265
"4420",162007,"BOWIE STATE UNIVERSITY",1,0,2003,"3551","64.881484","164","18","762",479,283,98,"18",80,0.167,0.0636,0.1286,0.0236
"4421",162007,"BOWIE STATE UNIVERSITY",1,0,2004,"4047","66.949947","191","18","627",408,219,94,"16",78,0.1912,0.0731,0.1499,0.0287
"4422",162007,"Bowie State University",1,0,2005,"4286","65.028604","192","21","923",567,356,203,"53",150,0.2646,0.1489,0.2199,0.0228
"4423",162007,"Bowie State University",1,0,2006,"4286","69.351088","206","6","765",475,290,83,"20",63,0.1326,0.069,0.1085,0.0078
"4424",162007,"Bowie State University",1,0,2007,"4286","72.755856","215","10","820",506,314,106,"19",87,0.1719,0.0605,0.1293,0.0122
"4425",162007,"Bowie State University",1,0,2008,"4286","77.055585","219","11","664",393,271,52,"12",40,0.1018,0.0443,0.0783,0.0166
"4426",162007,"Bowie State University",1,0,2009,"4286","80.328685","230","8","635",401,234,71,"18",53,0.1322,0.0769,0.1118,0.0126
"4427",162007,"Bowie State University",1,0,2010,"4415","83.351564","229","9","608",353,255,73,"17",56,0.1586,0.0667,0.1201,0.0148
"4428",162210,"COLUMBIA UNION COLLEGE",1,0,1991,"8200","13.405469","50","39","78",45,33,19,"6",13,0.2889,0.1818,0.2436,0.5
"4429",162210,"COLUMBIA UNION COLLEGE",1,0,1992,"9180","14.25171","45","24","69",46,23,12,"1",11,0.2391,0.0435,0.1739,0.3478
"4430",162210,"COLUMBIA UNION COLLEGE",1,0,1993,"9500","13.1073","42","27","94",52,42,17,"7",10,0.1923,0.1667,0.1809,0.2872
"4431",162210,"COLUMBIA UNION COLLEGE",1,0,1995,"10775","13.715591","57","82","137",84,53,24,"9",15,0.1786,0.1698,0.1752,0.5985
"4432",162210,"COLUMBIA UNION COLLEGE",1,0,1996,"11240","15.57186","50","52","154",79,75,20,"6",14,0.1772,0.08,0.1299,0.3377
"4433",162210,"COLUMBIA UNION COLLEGE",1,0,1997,"11790","16.624842","45","67","164",99,65,34,"11",23,0.2323,0.1692,0.2073,0.4085
"4434",162210,"COLUMBIA UNION COLLEGE",1,0,1998,"12275","16.823254","51","64","140",67,73,17,"7",10,0.1493,0.0959,0.1214,0.4571
"4435",162210,"COLUMBIA UNION COLLEGE",1,0,1999,"12200","18.312327","43","63","175",115,60,25,"6",19,0.1652,0.1,0.1429,0.36
"4436",162210,"COLUMBIA UNION COLLEGE",1,0,2000,"12810","18.707489","46","41","158",89,69,22,"4",18,0.2022,0.058,0.1392,0.2595
"4437",162210,"COLUMBIA UNION COLLEGE",1,0,2001,"13450","23.069466","49","52","153",95,58,26,"3",23,0.2421,0.0517,0.1699,0.3399
"4438",162210,"COLUMBIA UNION COLLEGE",1,0,2002,"13998","24.668715","55","36","176",104,72,17,"2",15,0.1442,0.0278,0.0966,0.2045
"4439",162210,"COLUMBIA UNION COLLEGE",1,0,2003,"14698","27.516444","54","30","187",120,67,24,"6",18,0.15,0.0896,0.1283,0.1604
"4440",162210,"COLUMBIA UNION COLLEGE",1,0,2004,"15433","29.09297","52","37","208",130,78,26,"4",22,0.1692,0.0513,0.125,0.1779
"4441",162210,"Columbia Union College",1,0,2005,"16514","29.499724","54","23","172",113,59,23,"9",14,0.1239,0.1525,0.1337,0.1337
"4442",162210,"Columbia Union College",1,0,2006,"17339","23.808817","50","23","144",84,60,18,"5",13,0.1548,0.0833,0.125,0.1597
"4443",162210,"Columbia Union College",1,0,2007,"18200","22.047652","51","17","126",83,43,22,"5",17,0.2048,0.1163,0.1746,0.1349
"4444",162210,"Columbia Union College",1,0,2008,"18200","23.988467","48","9","98",61,37,16,"4",12,0.1967,0.1081,0.1633,0.0918
"4445",162210,"Washington Adventist University",1,0,2009,"18200","23.384169","44","16","144",83,61,21,"7",14,0.1687,0.1148,0.1458,0.1111
"4446",162210,"Washington Adventist University",1,0,2010,"18900","25.457776","48","19","123",83,40,21,"2",19,0.2289,0.05,0.1707,0.1545
"4447",162283,"COPPIN STATE COLLEGE",1,0,1991,"2281","23.457342","105","19","311",195,116,29,"6",23,0.1179,0.0517,0.0932,0.0611
"4448",162283,"COPPIN STATE COLLEGE",1,0,1992,"2533","22.521129","101","12","350",183,167,14,"1",13,0.071,0.006,0.04,0.0343
"4449",162283,"COPPIN STATE COLLEGE",1,0,1993,"2605","25.009587","104","33","500",264,236,26,"6",20,0.0758,0.0254,0.052,0.066
"4450",162283,"COPPIN STATE COLLEGE",1,0,1995,"2749","28.776637","106","1","439",303,136,31,"8",23,0.0759,0.0588,0.0706,0.0023
"4451",162283,"COPPIN STATE COLLEGE",1,0,1996,"2867","29.565063","110","8","513",357,156,33,"11",22,0.0616,0.0705,0.0643,0.0156
"4452",162283,"COPPIN STATE COLLEGE",1,0,1997,"3012","33.952846","110","7","382",268,114,17,"3",14,0.0522,0.0263,0.0445,0.0183
"4453",162283,"COPPIN STATE COLLEGE",1,0,1998,"3164","34.934968","114","7","457",337,120,32,"10",22,0.0653,0.0833,0.07,0.0153
"4454",162283,"COPPIN STATE COLLEGE",1,0,1999,"3261","36.673056","113","2","441",306,135,39,"12",27,0.0882,0.0889,0.0884,0.0045
"4455",162283,"COPPIN STATE COLLEGE",1,0,2000,"2503","38.595683","110","1","417",289,128,20,"4",16,0.0554,0.0312,0.048,0.0024
"4456",162283,"COPPIN STATE COLLEGE",1,0,2001,"2856","42.771652","107","4","540",384,156,36,"4",32,0.0833,0.0256,0.0667,0.0074
"4457",162283,"COPPIN STATE COLLEGE",1,0,2002,"2877","48.274027","115","1","578",430,148,30,"3",27,0.0628,0.0203,0.0519,0.0017
"4458",162283,"COPPIN STATE COLLEGE",1,0,2003,"3142","47.508124","125","4","571",432,139,29,"9",20,0.0463,0.0647,0.0508,0.007
"4459",162283,"COPPIN STATE UNIVERSITY",1,0,2004,"3330","47.455002","130","2","588",446,142,27,"5",22,0.0493,0.0352,0.0459,0.0034
"4460",162283,"Coppin State University",1,0,2005,"4530","58.408","131","0","661",502,159,24,"4",20,0.0398,0.0252,0.0363,0
"4461",162283,"Coppin State University",1,0,2006,"3527","54.766468","133","2","494",390,104,28,"3",25,0.0641,0.0288,0.0567,0.004
"4462",162283,"Coppin State University",1,0,2007,"3527","68.167736","143","0","555",421,134,23,"9",14,0.0333,0.0672,0.0414,0
"4463",162283,"Coppin State University",1,0,2008,"3527","64.786192","162","0","570",428,142,28,"6",22,0.0514,0.0423,0.0491,0
"4464",162283,"Coppin State University",1,0,2009,"3527","73.13583","158","1","541",392,149,29,"2",27,0.0689,0.0134,0.0536,0.0018
"4465",162283,"Coppin State University",1,0,2010,"3633","76.587898","155","9","511",357,154,29,"7",22,0.0616,0.0455,0.0568,0.0176
"4466",162584,"FROSTBURG STATE UNIVERSITY",1,0,1991,"2247","43.549998","245","654","762",381,381,187,"67",120,0.315,0.1759,0.2454,0.8583
"4467",162584,"FROSTBURG STATE UNIVERSITY",1,0,1992,"2396","43.345642","233","735","839",454,385,236,"68",168,0.37,0.1766,0.2813,0.876
"4468",162584,"FROSTBURG STATE UNIVERSITY",1,0,1993,"2666","42.983861","228","779","910",433,477,210,"87",123,0.2841,0.1824,0.2308,0.856
"4469",162584,"FROSTBURG STATE UNIVERSITY",1,0,1995,"3072","49.51784","238","783","909",433,476,194,"68",126,0.291,0.1429,0.2134,0.8614
"4470",162584,"FROSTBURG STATE UNIVERSITY",1,0,1996,"3290","50.774248","237","793","975",482,493,195,"70",125,0.2593,0.142,0.2,0.8133
"4471",162584,"FROSTBURG STATE UNIVERSITY",1,0,1997,"3544","53.373236","239","720","865",444,421,210,"71",139,0.3131,0.1686,0.2428,0.8324
"4472",162584,"FROSTBURG STATE UNIVERSITY",1,0,1998,"3776","55.674251","237","721","932",486,446,181,"66",115,0.2366,0.148,0.1942,0.7736
"4473",162584,"FROSTBURG STATE UNIVERSITY",1,0,1999,"3216","59.263701","236","714","932",508,424,165,"52",113,0.2224,0.1226,0.177,0.7661
"4474",162584,"FROSTBURG STATE UNIVERSITY",1,0,2000,"3342","62.829553","242.5","796","1028",499,529,199,"64",135,0.2705,0.121,0.1936,0.7743
"4475",162584,"FROSTBURG STATE UNIVERSITY",1,0,2001,"3444","69.759568","249","740","923",471,452,204,"65",139,0.2951,0.1438,0.221,0.8017
"4476",162584,"FROSTBURG STATE UNIVERSITY",1,0,2002,"3632","67.551344","243","800","999",492,507,220,"67",153,0.311,0.1321,0.2202,0.8008
"4477",162584,"FROSTBURG STATE UNIVERSITY",1,0,2003,"4316","70.824451","236","781","988",450,538,216,"85",131,0.2911,0.158,0.2186,0.7905
"4478",162584,"FROSTBURG STATE UNIVERSITY",1,0,2004,"4720","70.520726","227","739","955",427,528,207,"78",129,0.3021,0.1477,0.2168,0.7738
"4479",162584,"Frostburg State University",1,0,2005,"5000","71.885665","231","654","928",448,480,181,"60",121,0.2701,0.125,0.195,0.7047
"4480",162584,"Frostburg State University",1,0,2006,"5000","76.649141","235","702","1011",459,552,175,"65",110,0.2397,0.1178,0.1731,0.6944
"4481",162584,"Frostburg State University",1,0,2007,"5000","80.297421","233","680","1057",520,537,233,"92",141,0.2712,0.1713,0.2204,0.6433
"4482",162584,"Frostburg State University",1,0,2008,"5000","83.472374","242","653","1030",478,552,201,"86",115,0.2406,0.1558,0.1951,0.634
"4483",162584,"Frostburg State University",1,0,2009,"5000","88.702438","240","606","1028",505,523,217,"67",150,0.297,0.1281,0.2111,0.5895
"4484",162584,"Frostburg State University",1,0,2010,"5150","88.476904","243","649","1028",472,556,223,"93",130,0.2754,0.1673,0.2169,0.6313
"4485",162654,"GOUCHER COLLEGE",1,0,1991,"12685","22.257216","74","167","203",142,61,121,"31",90,0.6338,0.5082,0.5961,0.8227
"4486",162654,"GOUCHER COLLEGE",1,0,1992,"13446","23.24017","77","184","223",155,68,131,"27",104,0.671,0.3971,0.5874,0.8251
"4487",162654,"GOUCHER COLLEGE",1,0,1993,"14300","25.945634","75","177","242",168,74,138,"34",104,0.619,0.4595,0.5702,0.7314
"4488",162654,"GOUCHER COLLEGE",1,0,1995,"16630","32.031202","74","196","277",193,84,154,"41",113,0.5855,0.4881,0.556,0.7076
"4489",162654,"GOUCHER COLLEGE",1,0,1996,"17635","35.625531","76","194","268",188,80,165,"38",127,0.6755,0.475,0.6157,0.7239
"4490",162654,"GOUCHER COLLEGE",1,0,1997,"18525","27.744995","78","250","335",255,80,212,"49",163,0.6392,0.6125,0.6328,0.7463
"4491",162654,"GOUCHER COLLEGE",1,0,1998,"19565","30.247381","78","233","302",213,89,169,"36",133,0.6244,0.4045,0.5596,0.7715
"4492",162654,"GOUCHER COLLEGE",1,0,1999,"20200","31.89277","78","222","322",224,98,176,"54",122,0.5446,0.551,0.5466,0.6894
"4493",162654,"GOUCHER COLLEGE",1,0,2000,"21000","35.768095","78","218","365",258,107,227,"57",170,0.6589,0.5327,0.6219,0.5973
"4494",162654,"GOUCHER COLLEGE",1,0,2001,"22000","39.55038","78","203","341",247,94,197,"45",152,0.6154,0.4787,0.5777,0.5953
"4495",162654,"GOUCHER COLLEGE",1,0,2002,"22950","41.206","96","211","365",265,100,208,"48",160,0.6038,0.48,0.5699,0.5781
"4496",162654,"GOUCHER COLLEGE",1,0,2003,"24150","43.345","98","246","342",207,135,207,"60",147,0.7101,0.4444,0.6053,0.7193
"4497",162654,"GOUCHER COLLEGE",1,0,2004,"25570","44.381","104","282","401",270,131,241,"62",179,0.663,0.4733,0.601,0.7032
"4498",162654,"Goucher College",1,0,2005,"27100","47.759","113","241","340",217,123,210,"68",142,0.6544,0.5528,0.6176,0.7088
"4499",162654,"Goucher College",1,0,2006,"28900","53.484","130","324","450",303,147,255,"70",185,0.6106,0.4762,0.5667,0.72
"4500",162654,"Goucher College",1,0,2007,"30636","55.512","127","299","399",277,122,236,"67",169,0.6101,0.5492,0.5915,0.7494
"4501",162654,"Goucher College",1,0,2008,"32168","58.515","130","225","360",262,98,205,"54",151,0.5763,0.551,0.5694,0.625
"4502",162654,"Goucher College",1,0,2009,"33294","61.099155","130","255","398",276,122,227,"53",174,0.6304,0.4344,0.5704,0.6407
"4503",162654,"Goucher College",1,0,2010,"34626","61.046","131","271","388",259,129,185,"50",135,0.5212,0.3876,0.4768,0.6985
"4504",162760,"HOOD COLLEGE",1,0,1991,"12208","22.071968","74","85","145",143,2,70,"1",69,0.4825,0.5,0.4828,0.5862
"4505",162760,"HOOD COLLEGE",1,0,1992,"12208","22.428064","74","92","150",143,7,91,"4",87,0.6084,0.5714,0.6067,0.6133
"4506",162760,"HOOD COLLEGE",1,0,1993,"13258","21.274067","76","108","163",161,2,102,"0",102,0.6335,0,0.6258,0.6626
"4507",162760,"HOOD COLLEGE",1,0,1995,"14930","23.601007","77","117","177",172,5,103,"2",101,0.5872,0.4,0.5819,0.661
"4508",162760,"HOOD COLLEGE",1,0,1996,"15522","24.846259","77","74","129",128,1,73,"0",73,0.5703,0,0.5659,0.5736
"4509",162760,"HOOD COLLEGE",1,0,1997,"16418","28.984541","75","105","162",158,4,109,"3",106,0.6709,0.75,0.6728,0.6481
"4510",162760,"HOOD COLLEGE",1,0,1998,"17010","25.59081","69","80","149",144,5,97,"2",95,0.6597,0.4,0.651,0.5369
"4511",162760,"HOOD COLLEGE",1,0,1999,"17275","27.199973","73","85","156",152,4,100,"1",99,0.6513,0.25,0.641,0.5449
"4512",162760,"HOOD COLLEGE",1,0,2000,"18295","27.683836","73","85","131",128,3,90,"3",87,0.6797,1,0.687,0.6489
"4513",162760,"HOOD COLLEGE",1,0,2001,"18795","27.390404","73","83","112",110,2,76,"2",74,0.6727,1,0.6786,0.7411
"4514",162760,"HOOD COLLEGE",1,0,2002,"19360","26.247305","78","114","179",172,7,108,"3",105,0.6105,0.4286,0.6034,0.6369
"4515",162760,"HOOD COLLEGE",1,0,2003,"19940","30.817918","76","113","181",143,38,110,"20",90,0.6294,0.5263,0.6077,0.6243
"4516",162760,"HOOD COLLEGE",1,0,2004,"20940","31.201984","76","183","242",189,53,160,"31",129,0.6825,0.5849,0.6612,0.7562
"4517",162760,"Hood College",1,0,2005,"22000","32.426668","81","169","236",156,80,142,"44",98,0.6282,0.55,0.6017,0.7161
"4518",162760,"Hood College",1,0,2006,"23320","33.822104","81","201","278",185,93,137,"38",99,0.5351,0.4086,0.4928,0.723
"4519",162760,"Hood College",1,0,2007,"24720","34.6903","81","211","295",193,102,163,"48",115,0.5959,0.4706,0.5525,0.7153
"4520",162760,"Hood College",1,0,2008,"26200","36.378043","80","220","308",200,108,179,"57",122,0.61,0.5278,0.5812,0.7143
"4521",162760,"Hood College",1,0,2009,"27770","38.765775","80","164","251",168,83,136,"46",90,0.5357,0.5542,0.5418,0.6534
"4522",162760,"Hood College",1,0,2010,"29440","37.834952","83","217","327",210,117,165,"52",113,0.5381,0.4444,0.5046,0.6636
"4523",162928,"JOHNS HOPKINS UNIVERSITY",1,0,1991,"16400","1172.183","743","582","846",304,542,707,"444",263,0.8651,0.8192,0.8357,0.6879
"4524",162928,"JOHNS HOPKINS UNIVERSITY",1,0,1992,"17420","1250.451716","759","586","847",325,522,685,"402",283,0.8708,0.7701,0.8087,0.6919
"4525",162928,"JOHNS HOPKINS UNIVERSITY",1,0,1993,"17900","1310.065","767","43","64",32,32,37,"16",21,0.6562,0.5,0.5781,0.6719
"4526",162928,"JOHNS HOPKINS UNIVERSITY",1,0,1995,"19750","1442.145","848","584","873",332,541,683,"401",282,0.8494,0.7412,0.7824,0.669
"4527",162928,"JOHNS HOPKINS UNIVERSITY",1,0,1996,"20740","1494.790201","860","646","1018",408,610,826,"483",343,0.8407,0.7918,0.8114,0.6346
"4528",162928,"JOHNS HOPKINS UNIVERSITY",1,0,1997,"21700","1542.076","867","620","941",411,530,749,"411",338,0.8224,0.7755,0.796,0.6589
"4529",162928,"JOHNS HOPKINS UNIVERSITY",1,0,1998,"22680","1634.582","966","719","1077",467,610,864,"469",395,0.8458,0.7689,0.8022,0.6676
"4530",162928,"JOHNS HOPKINS UNIVERSITY",1,0,1999,"23660","1695.94","998","760","1098",441,657,868,"503",365,0.8277,0.7656,0.7905,0.6922
"4531",162928,"JOHNS HOPKINS UNIVERSITY",1,0,2000,"24930","1794.167","1032","684","1067",456,611,876,"483",393,0.8618,0.7905,0.821,0.641
"4532",162928,"JOHNS HOPKINS UNIVERSITY",1,0,2001,"26210","1964.832","1066","729","1077",435,642,884,"510",374,0.8598,0.7944,0.8208,0.6769
"4533",162928,"JOHNS HOPKINS UNIVERSITY",1,0,2002,"27390","2231.521","1089","766","1203",539,664,960,"501",459,0.8516,0.7545,0.798,0.6367
"4534",162928,"JOHNS HOPKINS UNIVERSITY",1,0,2003,"28730","2485.895","1094","706","1122",499,623,919,"488",431,0.8637,0.7833,0.8191,0.6292
"4535",162928,"JOHNS HOPKINS UNIVERSITY",1,0,2004,"30140","2712.507","1144","661","1127",525,602,928,"480",448,0.8533,0.7973,0.8234,0.5865
"4536",162928,"Johns Hopkins University",1,0,2005,"31620","2900.839","1171","774","1228",587,641,1036,"523",513,0.8739,0.8159,0.8436,0.6303
"4537",162928,"Johns Hopkins University",1,0,2006,"33900","3082.842","1123","786","1304",643,661,1127,"563",564,0.8771,0.8517,0.8643,0.6028
"4538",162928,"Johns Hopkins University",1,0,2007,"35900","3310.391","1127","675","1260",607,653,1095,"545",550,0.9061,0.8346,0.869,0.5357
"4539",162928,"Johns Hopkins University",1,0,2008,"37700","3485.281","1203","693","1315",612,703,1140,"587",553,0.9036,0.835,0.8669,0.527
"4540",162928,"Johns Hopkins University",1,0,2009,"39150","3789.862","1060","703","1427",663,764,1240,"643",597,0.9005,0.8416,0.869,0.4926
"4541",162928,"Johns Hopkins University",1,0,2010,"40680","4019.378","936","744","1322",646,676,1150,"577",573,0.887,0.8536,0.8699,0.5628
"4542",163046,"LOYOLA COLLEGE",1,0,1991,"10490","69.323734","213","617","700",400,300,475,"171",304,0.76,0.57,0.6786,0.8814
"4543",163046,"LOYOLA COLLEGE",1,0,1992,"11270","71.334202","220","690","792",452,340,565,"229",336,0.7434,0.6735,0.7134,0.8712
"4544",163046,"LOYOLA COLLEGE",1,0,1993,"12165","75.109147","222","672","739",436,303,515,"181",334,0.7661,0.5974,0.6969,0.9093
"4545",163046,"LOYOLA COLLEGE",1,0,1995,"14260","85.321985","221","687","798",450,348,581,"240",341,0.7578,0.6897,0.7281,0.8609
"4546",163046,"LOYOLA COLLEGE",1,0,1996,"15460","89.565081","218","707","812",443,369,592,"245",347,0.7833,0.664,0.7291,0.8707
"4547",163046,"LOYOLA COLLEGE",1,0,1997,"16560","80.920032","225","734","833",478,355,650,"258",392,0.8201,0.7268,0.7803,0.8812
"4548",163046,"LOYOLA COLLEGE",1,0,1998,"18460","81.292559","232","741","854",485,369,668,"276",392,0.8082,0.748,0.7822,0.8677
"4549",163046,"LOYOLA COLLEGE",1,0,1999,"19660","96.807419","235","853","941",530,411,734,"292",442,0.834,0.7105,0.78,0.9065
"4550",163046,"LOYOLA COLLEGE",1,0,2000,"21230","92.89213","250","818","909",520,389,699,"277",422,0.8115,0.7121,0.769,0.8999
"4551",163046,"LOYOLA COLLEGE",1,0,2001,"21462","94.422862","265","796","880",517,363,679,"252",427,0.8259,0.6942,0.7716,0.9045
"4552",163046,"LOYOLA COLLEGE",1,0,2002,"23200","106.85419","272","781","901",527,374,733,"295",438,0.8311,0.7888,0.8135,0.8668
"4553",163046,"LOYOLA COLLEGE IN MARYLAND",1,0,2003,"25140","120.609917","284","796","915",545,370,704,"277",427,0.7835,0.7486,0.7694,0.8699
"4554",163046,"LOYOLA COLLEGE IN MARYLAND",1,0,2004,"26803","120.298564","294","825","951",579,372,726,"277",449,0.7755,0.7446,0.7634,0.8675
"4555",163046,"Loyola College in Maryland",1,0,2005,"28683","128.017928","303","757","898",526,372,711,"291",420,0.7985,0.7823,0.7918,0.843
"4556",163046,"Loyola College in Maryland",1,0,2006,"30615","138.228798","305","818","946",596,350,749,"263",486,0.8154,0.7514,0.7918,0.8647
"4557",163046,"Loyola College in Maryland",1,0,2007,"32838","147.329632","324","823","979",545,434,777,"320",457,0.8385,0.7373,0.7937,0.8407
"4558",163046,"Loyola College in Maryland",1,0,2008,"35055","153.398831","334","896","1066",637,429,825,"307",518,0.8132,0.7156,0.7739,0.8405
"4559",163046,"Loyola University Maryland",1,0,2009,"36510","166.176815","292","831","968",592,376,740,"275",465,0.7855,0.7314,0.7645,0.8585
"4560",163046,"Loyola University-Baltimore",1,0,2010,"37950","166.406786","328","838","1019",630,389,818,"311",507,0.8048,0.7995,0.8027,0.8224
"4561",163268,"UNIVERSITY OF MARYLAND BALTIMORE COUNTY CAMPUS",1,0,1991,"2672","104.418466","364","558","910",467,443,185,"71",114,0.2441,0.1603,0.2033,0.6132
"4562",163268,"UNIVERSITY OF MARYLAND BALTIMORE COUNTY CAMPUS",1,0,1992,"2856","101.588308","349","599","884",437,447,200,"79",121,0.2769,0.1767,0.2262,0.6776
"4563",163268,"UNIVERSITY OF MARYLAND BALTIMORE COUNTY",1,0,1993,"3338","110.946656","353","646","929",419,510,215,"97",118,0.2816,0.1902,0.2314,0.6954
"4564",163268,"UNIVERSITY OF MARYLAND-BALTIMORE COUNTY",1,0,1995,"3852","131.886365","359","601","968",485,483,295,"115",180,0.3711,0.2381,0.3048,0.6209
"4565",163268,"UNIVERSITY OF MARYLAND-BALTIMORE COUNTY",1,0,1996,"4136","141.039977","381","638","1005",505,500,280,"106",174,0.3446,0.212,0.2786,0.6348
"4566",163268,"UNIVERSITY OF MARYLAND-BALTIMORE COUNTY",1,0,1997,"4570","156.160187","384","658","1135",605,530,343,"133",210,0.3471,0.2509,0.3022,0.5797
"4567",163268,"UNIVERSITY OF MARYLAND-BALTIMORE COUNTY",1,0,1998,"4846","167.189438","401","746","1246",609,637,347,"138",209,0.3432,0.2166,0.2785,0.5987
"4568",163268,"UNIVERSITY OF MARYLAND-BALTIMORE COUNTY",1,0,1999,"4046","185.12422","410","855","1396",638,758,417,"188",229,0.3589,0.248,0.2987,0.6125
"4569",163268,"UNIVERSITY OF MARYLAND-BALTIMORE COUNTY",1,0,2000,"4206","207.63864","428","794","1307",601,706,362,"150",212,0.3527,0.2125,0.277,0.6075
"4570",163268,"UNIVERSITY OF MARYLAND-BALTIMORE COUNTY",1,0,2001,"4374","240.871262","446","827","1332",603,729,461,"204",257,0.4262,0.2798,0.3461,0.6209
"4571",163268,"UNIVERSITY OF MARYLAND-BALTIMORE COUNTY",1,0,2002,"4614","249.159013","469","856","1356",572,784,437,"210",227,0.3969,0.2679,0.3223,0.6313
"4572",163268,"UNIVERSITY OF MARYLAND-BALTIMORE COUNTY",1,0,2003,"5570","257.623501","464","881","1487",657,830,506,"215",291,0.4429,0.259,0.3403,0.5925
"4573",163268,"UNIVERSITY OF MARYLAND-BALTIMORE COUNTY",1,0,2004,"6120","257.969325","456","864","1403",560,843,472,"249",223,0.3982,0.2954,0.3364,0.6158
"4574",163268,"University of Maryland-Baltimore County",1,0,2005,"6484","271.172586","458","818","1414",584,830,466,"237",229,0.3921,0.2855,0.3296,0.5785
"4575",163268,"University of Maryland-Baltimore County",1,0,2006,"6484","277.977793","482","756","1419",626,793,523,"233",290,0.4633,0.2938,0.3686,0.5328
"4576",163268,"University of Maryland-Baltimore County",1,0,2007,"6484","293.637677","473","740","1423",655,768,523,"230",293,0.4473,0.2995,0.3675,0.52
"4577",163268,"University of Maryland-Baltimore County",1,0,2008,"6484","306.78745","483","774","1555",650,905,531,"237",294,0.4523,0.2619,0.3415,0.4977
"4578",163268,"University of Maryland-Baltimore County",1,0,2009,"6484","326.045873","480","797","1522",656,866,574,"257",317,0.4832,0.2968,0.3771,0.5237
"4579",163268,"University of Maryland-Baltimore County",1,0,2010,"6679","325.148879","481","735","1484",599,885,558,"275",283,0.4725,0.3107,0.376,0.4953
"4580",163286,"UNIVERSITY OF MARYLAND COLLEGE PARK CAMPUS",1,0,1991,"2429","611.115345","1298","2003","3069",1406,1663,928,"361",567,0.4033,0.2171,0.3024,0.6527
"4581",163286,"UNIVERSITY OF MARYLAND COLLEGE PARK CAMPUS",1,0,1992,"2778","521.842645","1276","2002","3032",1470,1562,966,"379",587,0.3993,0.2426,0.3186,0.6603
"4582",163286,"UNIVERSITY OF MARYLAND COLLEGE PARK CAMPUS",1,0,1993,"3179","556.12104","1285","1920","3153",1461,1692,1051,"447",604,0.4134,0.2642,0.3333,0.6089
"4583",163286,"UNIVERSITY OF MARYLAND COLLEGE PARK CAMPUS",1,0,1995,"3794","634.895161","1484","2188","3577",1722,1855,1343,"539",804,0.4669,0.2906,0.3755,0.6117
"4584",163286,"UNIVERSITY OF MARYLAND COLLEGE PARK CAMPUS",1,0,1996,"4169","673.070966","1496","2198","3539",1720,1819,1449,"585",864,0.5023,0.3216,0.4094,0.6211
"4585",163286,"UNIVERSITY OF MARYLAND-COLLEGE PARK",1,0,1997,"4460","726.928155","1519","2449","3950",1873,2077,1699,"731",968,0.5168,0.3519,0.4301,0.62
"4586",163286,"UNIVERSITY OF MARYLAND-COLLEGE PARK",1,0,1998,"4699","767.86246","1363","2528","4039",2007,2032,1858,"801",1057,0.5267,0.3942,0.46,0.6259
"4587",163286,"UNIVERSITY OF MARYLAND-COLLEGE PARK",1,0,1999,"4050","846.862931","1389","2447","3871",1796,2075,1943,"884",1059,0.5896,0.426,0.5019,0.6321
"4588",163286,"UNIVERSITY OF MARYLAND-COLLEGE PARK",1,0,2000,"4172","908.650545","1467.5","2463","3929",1896,2033,2141,"933",1208,0.6371,0.4589,0.5449,0.6269
"4589",163286,"UNIVERSITY OF MARYLAND-COLLEGE PARK",1,0,2001,"4334","1017.727987","1546","2755","4341",2063,2278,2535,"1169",1366,0.6621,0.5132,0.584,0.6346
"4590",163286,"UNIVERSITY OF MARYLAND-COLLEGE PARK",1,0,2002,"4572","1120.722744","1589","2493","3886",1961,1925,2452,"1128",1324,0.6752,0.586,0.631,0.6415
"4591",163286,"UNIVERSITY OF MARYLAND-COLLEGE PARK",1,0,2003,"5568","1079.969945","1539","2444","4045",2031,2014,2539,"1158",1381,0.68,0.575,0.6277,0.6042
"4592",163286,"UNIVERSITY OF MARYLAND-COLLEGE PARK",1,0,2004,"6200","1094.683388","1527","2435","4174",2055,2119,2607,"1173",1434,0.6978,0.5536,0.6246,0.5834
"4593",163286,"University of Maryland-College Park",1,0,2005,"6566","1159.263059","1523","2421","4192",2081,2111,2769,"1273",1496,0.7189,0.603,0.6605,0.5775
"4594",163286,"University of Maryland-College Park",1,0,2006,"6566","1234.445186","1580","2189","3944",1896,2048,2493,"1179",1314,0.693,0.5757,0.6321,0.555
"4595",163286,"University of Maryland-College Park",1,0,2007,"6566","1250.072141","1597","2566","4229",2028,2201,2772,"1300",1472,0.7258,0.5906,0.6555,0.6068
"4596",163286,"University of Maryland-College Park",1,0,2008,"6566","1371.423157","1642","2287","3907",1824,2083,2610,"1298",1312,0.7193,0.6231,0.668,0.5854
"4597",163286,"University of Maryland-College Park",1,0,2009,"6566","1405.879489","1618","2630","4199",1953,2246,2912,"1448",1464,0.7496,0.6447,0.6935,0.6263
"4598",163286,"University of Maryland-College Park",1,0,2010,"6763","1418.558134","1613","2175","3930",1856,2074,2700,"1314",1386,0.7468,0.6336,0.687,0.5534
"4599",163453,"MORGAN STATE UNIVERSITY",1,0,1991,"2198","57.718803","223","6","919",552,367,139,"29",110,0.1993,0.079,0.1513,0.0065
"4600",163453,"MORGAN STATE UNIVERSITY",1,0,1992,"2438","60.212386","230","7","967",572,395,168,"37",131,0.229,0.0937,0.1737,0.0072
"4601",163453,"MORGAN STATE UNIVERSITY",1,0,1993,"2526","63.984504","235","12","944",567,377,138,"26",112,0.1975,0.069,0.1462,0.0127
"4602",163453,"MORGAN STATE UNIVERSITY",1,0,1995,"2832","79.812793","240","9","959",580,379,166,"30",136,0.2345,0.0792,0.1731,0.0094
"4603",163453,"MORGAN STATE UNIVERSITY",1,0,1996,"3126","84.70814","220","5","917",546,371,162,"27",135,0.2473,0.0728,0.1767,0.0055
"4604",163453,"MORGAN STATE UNIVERSITY",1,0,1997,"3412","93.90247","243","7","1016",588,428,176,"30",146,0.2483,0.0701,0.1732,0.0069
"4605",163453,"MORGAN STATE UNIVERSITY",1,0,1998,"3706","95.0609","195","6","1136",674,462,166,"42",124,0.184,0.0909,0.1461,0.0053
"4606",163453,"MORGAN STATE UNIVERSITY",1,0,1999,"2906","102.411071","198","6","1152",661,491,208,"41",167,0.2526,0.0835,0.1806,0.0052
"4607",163453,"MORGAN STATE UNIVERSITY",1,0,2000,"3030","122.164928","279","4","1107",689,418,204,"60",144,0.209,0.1435,0.1843,0.0036
"4608",163453,"MORGAN STATE UNIVERSITY",1,0,2001,"3150","126.454295","360","2","1125",663,462,172,"39",133,0.2006,0.0844,0.1529,0.0018
"4609",163453,"MORGAN STATE UNIVERSITY",1,0,2002,"4698","142.198224","296","6","1247",741,506,139,"26",113,0.1525,0.0514,0.1115,0.0048
"4610",163453,"MORGAN STATE UNIVERSITY",1,0,2003,"5078","138.135278","299","5","1220",699,521,138,"34",104,0.1488,0.0653,0.1131,0.0041
"4611",163453,"MORGAN STATE UNIVERSITY",1,0,2004,"4000","133.161113","265","10","1336",750,586,153,"32",121,0.1613,0.0546,0.1145,0.0075
"4612",163453,"Morgan State University",1,0,2005,"4280","144.53805","323","8","764",408,356,89,"22",67,0.1642,0.0618,0.1165,0.0105
"4613",163453,"Morgan State University",1,0,2006,"4280","150.774977","319","13","1368",773,595,165,"46",119,0.1539,0.0773,0.1206,0.0095
"4614",163453,"Morgan State University",1,0,2007,"4280","166.626947","425","10","1286",698,588,143,"42",101,0.1447,0.0714,0.1112,0.0078
"4615",163453,"Morgan State University",1,0,2008,"4280","174.231093","436","14","1430",808,622,169,"46",123,0.1522,0.074,0.1182,0.0098
"4616",163453,"Morgan State University",1,0,2009,"4280","177.331803","437","11","1261",715,546,121,"35",86,0.1203,0.0641,0.096,0.0087
"4617",163453,"Morgan State University",1,0,2010,"4408","179.528591","464","5","1208",663,545,115,"32",83,0.1252,0.0587,0.0952,0.0041
"4618",163462,"MOUNT SAINT MARYS COLLEGE",1,0,1991,"9875","26.526454","90","289","320",170,150,195,"85",110,0.6471,0.5667,0.6094,0.9031
"4619",163462,"MOUNT SAINT MARYS COLLEGE",1,0,1992,"10675","27.305365","86","310","346",190,156,209,"89",120,0.6316,0.5705,0.604,0.896
"4620",163462,"MOUNT SAINT MARYS COLLEGE",1,0,1993,"11725","29.347459","85","287","325",166,159,218,"99",119,0.7169,0.6226,0.6708,0.8831
"4621",163462,"MOUNT SAINT MARYS COLLEGE",1,0,1995,"14120","34.25308","94","272","315",169,146,205,"95",110,0.6509,0.6507,0.6508,0.8635
"4622",163462,"MOUNT SAINT MARYS COLLEGE",1,0,1996,"14885","36.700676","97","307","367",207,160,214,"80",134,0.6473,0.5,0.5831,0.8365
"4623",163462,"MOUNT SAINT MARYS COLLEGE",1,0,1997,"15650","31.238055","100","277","325",179,146,221,"95",126,0.7039,0.6507,0.68,0.8523
"4624",163462,"MOUNT SAINT MARYS COLLEGE",1,0,1998,"16100","31.757864","97","345","410",213,197,249,"113",136,0.6385,0.5736,0.6073,0.8415
"4625",163462,"MOUNT SAINT MARYS COLLEGE",1,0,1999,"16520","30.613273","97","319","369",221,148,238,"94",144,0.6516,0.6351,0.645,0.8645
"4626",163462,"MOUNT SAINT MARYS COLLEGE",1,0,2000,"17200","30.89873","101","326","383",223,160,255,"109",146,0.6547,0.6812,0.6658,0.8512
"4627",163462,"MOUNT SAINT MARYS COLLEGE",1,0,2001,"18480","32.585815","105","316","355",197,158,230,"105",125,0.6345,0.6646,0.6479,0.8901
"4628",163462,"MOUNT SAINT MARYS COLLEGE",1,0,2002,"19700","34.504469","103","346","399",211,188,233,"97",136,0.6445,0.516,0.584,0.8672
"4629",163462,"MOUNT SAINT MARYS COLLEGE",1,0,2003,"20800","38.389289","103","347","395",237,158,279,"110",169,0.7131,0.6962,0.7063,0.8785
"4630",163462,"MOUNT ST MARY'S UNIVERSITY",1,0,2004,"21430","42.516621","103","323","391",243,148,270,"99",171,0.7037,0.6689,0.6905,0.8261
"4631",163462,"Mount St Mary's University",1,0,2005,"22500","43.037009","105","363","437",267,170,315,"127",188,0.7041,0.7471,0.7208,0.8307
"4632",163462,"Mount St Mary's University",1,0,2006,"23630","45.614695","112","347","426",244,182,265,"97",168,0.6885,0.533,0.6221,0.8146
"4633",163462,"Mount St Mary's University",1,0,2007,"25290","48.153943","116","363","448",256,192,275,"114",161,0.6289,0.5938,0.6138,0.8103
"4634",163462,"Mount St Mary's University",1,0,2008,"26960","53.217005","117","325","410",218,192,236,"99",137,0.6284,0.5156,0.5756,0.7927
"4635",163462,"Mount St. Mary's University",1,0,2009,"28420","55.893925","114","353","464",268,196,298,"126",172,0.6418,0.6429,0.6422,0.7608
"4636",163462,"Mount St Mary's University",1,0,2010,"29650","58.49158","111","307","424",241,183,275,"101",174,0.722,0.5519,0.6486,0.7241
"4637",163851,"SALISBURY STATE UNIVERSITY",1,0,1991,"2544","43.929499","238","658","711",387,324,293,"99",194,0.5013,0.3056,0.4121,0.9255
"4638",163851,"SALISBURY STATE UNIVERSITY",1,0,1992,"2754","43.886676","236","569","634",372,262,264,"78",186,0.5,0.2977,0.4164,0.8975
"4639",163851,"SALISBURY STATE UNIVERSITY",1,0,1993,"3026","49.51772","240","653","726",405,321,297,"92",205,0.5062,0.2866,0.4091,0.8994
"4640",163851,"SALISBURY STATE UNIVERSITY",1,0,1995,"3440","56.942936","245","591","642",412,230,322,"101",221,0.5364,0.4391,0.5016,0.9206
"4641",163851,"SALISBURY STATE UNIVERSITY",1,0,1996,"3608","60.128428","254","611","689",393,296,311,"98",213,0.542,0.3311,0.4514,0.8868
"4642",163851,"SALISBURY STATE UNIVERSITY",1,0,1997,"3842","61.150013","254","818","886",515,371,418,"133",285,0.5534,0.3585,0.4718,0.9233
"4643",163851,"SALISBURY STATE UNIVERSITY",1,0,1998,"4002","66.403218","263","778","935",534,401,438,"139",299,0.5599,0.3466,0.4684,0.8321
"4644",163851,"SALISBURY STATE UNIVERSITY",1,0,1999,"2856","65.700325","261","765","877",537,340,458,"149",309,0.5754,0.4382,0.5222,0.8723
"4645",163851,"SALISBURY STATE UNIVERSITY",1,0,2000,"3092","74.529683","276","827","939",546,393,488,"163",325,0.5952,0.4148,0.5197,0.8807
"4646",163851,"SALISBURY UNIVERSITY",1,0,2001,"3216","83.85234","291","749","945",542,403,429,"135",294,0.5424,0.335,0.454,0.7926
"4647",163851,"SALISBURY UNIVERSITY",1,0,2002,"3394","85.267161","298","722","908",529,379,417,"121",296,0.5595,0.3193,0.4593,0.7952
"4648",163851,"SALISBURY UNIVERSITY",1,0,2003,"4134","88.939443","299","714","947",531,416,433,"142",291,0.548,0.3413,0.4572,0.754
"4649",163851,"SALISBURY UNIVERSITY",1,0,2004,"4546","85.96239","314","797","981",536,445,457,"148",309,0.5765,0.3326,0.4659,0.8124
"4650",163851,"Salisbury University",1,0,2005,"4814","90.153143","323","786","952",525,427,442,"146",296,0.5638,0.3419,0.4643,0.8256
"4651",163851,"Salisbury University",1,0,2006,"4814","95.573012","337","822","1028",588,440,502,"171",331,0.5629,0.3886,0.4883,0.7996
"4652",163851,"Salisbury University",1,0,2007,"4814","103.933255","363","926","1142",646,496,533,"172",361,0.5588,0.3468,0.4667,0.8109
"4653",163851,"Salisbury University",1,0,2008,"4814","109.621348","379","994","1198",694,504,533,"151",382,0.5504,0.2996,0.4449,0.8297
"4654",163851,"Salisbury University",1,0,2009,"4814","120.534709","380","1032","1273",738,535,577,"169",408,0.5528,0.3159,0.4533,0.8107
"4655",163851,"Salisbury University",1,0,2010,"4960","119.5577","388","949","1248",770,478,595,"176",419,0.5442,0.3682,0.4768,0.7604
"4656",163912,"SAINT MARYS COLLEGE OF MARYLAND",1,0,1991,"3210","22.049468","96","178","227",132,95,147,"51",96,0.7273,0.5368,0.6476,0.7841
"4657",163912,"SAINT MARYS COLLEGE OF MARYLAND",1,0,1992,"3880","20.553679","96","185","234",133,101,129,"53",76,0.5714,0.5248,0.5513,0.7906
"4658",163912,"SAINT MARYS COLLEGE OF MARYLAND",1,0,1993,"4400","21.548296","97","225","284",153,131,166,"68",98,0.6405,0.5191,0.5845,0.7923
"4659",163912,"SAINT MARYS COLLEGE OF MARYLAND",1,0,1995,"5435","25.375535","104","289","352",201,151,207,"81",126,0.6269,0.5364,0.5881,0.821
"4660",163912,"SAINT MARYS COLLEGE OF MARYLAND",1,0,1996,"6005","27.710775","108","253","312",180,132,221,"93",128,0.7111,0.7045,0.7083,0.8109
"4661",163912,"SAINT MARYS COLLEGE OF MARYLAND",1,0,1997,"6575","29.227523","109","286","345",194,151,232,"92",140,0.7216,0.6093,0.6725,0.829
"4662",163912,"SAINT MARYS COLLEGE OF MARYLAND",1,0,1998,"6875","31.953231","111","264","331",181,150,211,"77",134,0.7403,0.5133,0.6375,0.7976
"4663",163912,"ST MARY'S COLLEGE OF MARYLAND",1,0,1999,"6100","32.960936","116","221","276",157,119,176,"70",106,0.6752,0.5882,0.6377,0.8007
"4664",163912,"ST MARY'S COLLEGE OF MARYLAND",1,0,2000,"6285","35.314971","121.5","318","375",220,155,262,"94",168,0.7636,0.6065,0.6987,0.848
"4665",163912,"ST MARY'S COLLEGE OF MARYLAND",1,0,2001,"6474","38.357128","127","372","457",287,170,344,"114",230,0.8014,0.6706,0.7527,0.814
"4666",163912,"ST MARY'S COLLEGE OF MARYLAND",1,0,2002,"6925","41.101344","130","338","425",243,182,286,"113",173,0.7119,0.6209,0.6729,0.7953
"4667",163912,"ST MARY'S COLLEGE OF MARYLAND",1,0,2003,"7550","42.240429","126","322","421",249,172,300,"106",194,0.7791,0.6163,0.7126,0.7648
"4668",163912,"ST MARY'S COLLEGE OF MARYLAND",1,0,2004,"8092","43.793113","128","338","431",233,198,303,"122",181,0.7768,0.6162,0.703,0.7842
"4669",163912,"St Mary's College of Maryland",1,0,2005,"9063","48.809942","137","369","488",295,193,341,"130",211,0.7153,0.6736,0.6988,0.7561
"4670",163912,"St Mary's College of Maryland",1,0,2006,"9498","51.981293","145","320","428",249,179,309,"118",191,0.7671,0.6592,0.722,0.7477
"4671",163912,"St Mary's College of Maryland",1,0,2007,"9973","56.665591","152","360","464",256,208,331,"134",197,0.7695,0.6442,0.7134,0.7759
"4672",163912,"St Mary's College of Maryland",1,0,2008,"10472","60.426082","154","361","458",279,179,332,"119",213,0.7634,0.6648,0.7249,0.7882
"4673",163912,"St. Mary's College of Maryland",1,0,2009,"10995","62.387166","143","384","486",273,213,327,"121",206,0.7546,0.5681,0.6728,0.7901
"4674",163912,"St Mary's College of Maryland",1,0,2010,"11325","62.451307","144","333","443",277,166,289,"96",193,0.6968,0.5783,0.6524,0.7517
"4675",164076,"TOWSON STATE UNIVERSITY",1,0,1991,"2458","107.493165","483","1014","1237",735,502,335,"78",257,0.3497,0.1554,0.2708,0.8197
"4676",164076,"TOWSON STATE UNIVERSITY",1,0,1992,"2828","112.997546","481","1131","1336",824,512,365,"99",266,0.3228,0.1934,0.2732,0.8466
"4677",164076,"TOWSON STATE UNIVERSITY",1,0,1993,"3122","113.685049","471","990","1215",721,494,348,"90",258,0.3578,0.1822,0.2864,0.8148
"4678",164076,"TOWSON STATE UNIVERSITY",1,0,1995,"3530","124.364731","465","1237","1488",934,554,468,"121",347,0.3715,0.2184,0.3145,0.8313
"4679",164076,"TOWSON STATE UNIVERSITY",1,0,1996,"3822","130.803972","454","1550","1851",1127,724,513,"127",386,0.3425,0.1754,0.2771,0.8374
"4680",164076,"TOWSON UNIVERSITY",1,0,1997,"4120","147.883957","450","1480","1808",1079,729,557,"166",391,0.3624,0.2277,0.3081,0.8186
"4681",164076,"TOWSON UNIVERSITY",1,0,1998,"4336","164.218856","458","1570","1923",1175,748,573,"183",390,0.3319,0.2447,0.298,0.8164
"4682",164076,"TOWSON UNIVERSITY",1,0,1999,"3332","181.951182","521","1692","2103",1277,826,610,"170",440,0.3446,0.2058,0.2901,0.8046
"4683",164076,"TOWSON UNIVERSITY",1,0,2000,"3466","199.298712","546","1613","1981",1198,783,630,"190",440,0.3673,0.2427,0.318,0.8142
"4684",164076,"TOWSON UNIVERSITY",1,0,2001,"3605","218.254223","571","1505","1910",1245,665,681,"169",512,0.4112,0.2541,0.3565,0.788
"4685",164076,"TOWSON UNIVERSITY",1,0,2002,"3804","205.980472","585","1765","2198",1385,813,815,"229",586,0.4231,0.2817,0.3708,0.803
"4686",164076,"TOWSON UNIVERSITY",1,0,2003,"4528","216.872185","611","1262","1756",1192,564,763,"181",582,0.4883,0.3209,0.4345,0.7187
"4687",164076,"TOWSON UNIVERSITY",1,0,2004,"4890","212.704856","622","1485","2082",1376,706,835,"229",606,0.4404,0.3244,0.4011,0.7133
"4688",164076,"Towson University",1,0,2005,"5180","227.346768","663","1688","2314",1455,859,910,"270",640,0.4399,0.3143,0.3933,0.7295
"4689",164076,"Towson University",1,0,2006,"5180","238.501755","691","1905","2688",1697,991,1047,"307",740,0.4361,0.3098,0.3895,0.7087
"4690",164076,"Towson University",1,0,2007,"5180","262.740874","728","2027","2649",1670,979,1069,"314",755,0.4521,0.3207,0.4035,0.7652
"4691",164076,"Towson University",1,0,2008,"5180","284.943244","788","2052","2825",1786,1039,1210,"385",825,0.4619,0.3705,0.4283,0.7264
"4692",164076,"Towson University",1,0,2009,"5180","303.69577","822","1693","2395",1564,831,1076,"275",801,0.5121,0.3309,0.4493,0.7069
"4693",164076,"Towson University",1,0,2010,"5336","305.15637","830","1786","2427",1593,834,1125,"310",815,0.5116,0.3717,0.4635,0.7359
"4694",164173,"VILLA JULIE COLLEGE",1,0,1991,"5770","9.147891","43","211","269",233,36,44,"6",38,0.1631,0.1667,0.1636,0.7844
"4695",164173,"VILLA JULIE COLLEGE",1,0,1992,"6320","10.166349","40","172","200",154,46,44,"7",37,0.2403,0.1522,0.22,0.86
"4696",164173,"VILLA JULIE COLLEGE",1,0,1993,"6880","11.399255","42","164","218",171,47,53,"10",43,0.2515,0.2128,0.2431,0.7523
"4697",164173,"VILLA JULIE COLLEGE",1,0,1995,"8200","13.905926","65","210","253",180,73,94,"26",68,0.3778,0.3562,0.3715,0.83
"4698",164173,"VILLA JULIE COLLEGE",1,0,1996,"8610","14.597812","67","214","286",205,81,89,"20",69,0.3366,0.2469,0.3112,0.7483
"4699",164173,"VILLA JULIE COLLEGE",1,0,1997,"9240","16.466052","64","312","367",259,108,122,"21",101,0.39,0.1944,0.3324,0.8501
"4700",164173,"VILLA JULIE COLLEGE",1,0,1998,"9976","18.550235","68","394","443",305,138,163,"46",117,0.3836,0.3333,0.3679,0.8894
"4701",164173,"VILLA JULIE COLLEGE",1,0,1999,"10250","18.365223","72","373","421",288,133,211,"60",151,0.5243,0.4511,0.5012,0.886
"4702",164173,"VILLA JULIE COLLEGE",1,0,2000,"10750","20.681814","75.5","345","425",313,112,220,"51",169,0.5399,0.4554,0.5176,0.8118
"4703",164173,"VILLA JULIE COLLEGE",1,0,2001,"11300","22.486157","79","412","512",374,138,246,"56",190,0.508,0.4058,0.4805,0.8047
"4704",164173,"VILLA JULIE COLLEGE",1,0,2002,"11978","25.095035","80","406","487",365,122,281,"63",218,0.5973,0.5164,0.577,0.8337
"4705",164173,"VILLA JULIE COLLEGE",1,0,2003,"12816","28.577218","85","422","539",384,155,247,"63",184,0.4792,0.4065,0.4583,0.7829
"4706",164173,"VILLA JULIE COLLEGE",1,0,2004,"13715","31.223812","91","428","561",378,183,252,"81",171,0.4524,0.4426,0.4492,0.7629
"4707",164173,"Villa Julie College",1,0,2005,"14674","38.856267","93","395","537",373,164,236,"61",175,0.4692,0.372,0.4395,0.7356
"4708",164173,"Villa Julie College",1,0,2006,"15700","45.304849","105","455","643",454,189,315,"85",230,0.5066,0.4497,0.4899,0.7076
"4709",164173,"Villa Julie College",1,0,2007,"16800","53.118539","112","444","604",436,168,254,"61",193,0.4427,0.3631,0.4205,0.7351
"4710",164173,"Stevenson University",1,0,2008,"17976","59.156382","111","473","626",436,190,301,"81",220,0.5046,0.4263,0.4808,0.7556
"4711",164173,"Stevenson University",1,0,2009,"19234","63.087323","110","338","522",346,176,220,"62",158,0.4566,0.3523,0.4215,0.6475
"4712",164173,"Stevenson University",1,0,2010,"20580","66.398508","111","481","877",535,342,331,"98",233,0.4355,0.2865,0.3774,0.5485
"4713",164216,"WASHINGTON COLLEGE",1,0,1991,"12312","19.785989","58","161","182",99,83,105,"40",65,0.6566,0.4819,0.5769,0.8846
"4714",164216,"WASHINGTON COLLEGE",1,0,1992,"13226","20.322397","62","237","276",145,131,160,"70",90,0.6207,0.5344,0.5797,0.8587
"4715",164216,"WASHINGTON COLLEGE",1,0,1993,"13952","22.39636","66","178","213",123,90,132,"46",86,0.6992,0.5111,0.6197,0.8357
"4716",164216,"WASHINGTON COLLEGE",1,0,1995,"16440","23.769159","64","197","241",134,107,144,"60",84,0.6269,0.5607,0.5975,0.8174
"4717",164216,"WASHINGTON COLLEGE",1,0,1996,"16800","25.11693","63","261","312",198,114,203,"67",136,0.6869,0.5877,0.6506,0.8365
"4718",164216,"WASHINGTON COLLEGE",1,0,1997,"17800","21.01628","65","244","290",162,128,182,"79",103,0.6358,0.6172,0.6276,0.8414
"4719",164216,"WASHINGTON COLLEGE",1,0,1998,"18750","23.31344","68","234","278",174,104,163,"53",110,0.6322,0.5096,0.5863,0.8417
"4720",164216,"WASHINGTON COLLEGE",1,0,1999,"19750","24.899239","72","235","282",175,107,175,"54",121,0.6914,0.5047,0.6206,0.8333
"4721",164216,"WASHINGTON COLLEGE",1,0,2000,"20750","26.629089","75.5","328","374",236,138,255,"80",175,0.7415,0.5797,0.6818,0.877
"4722",164216,"WASHINGTON COLLEGE",1,0,2001,"21750","29.424178","79","263","338",204,134,234,"89",145,0.7108,0.6642,0.6923,0.7781
"4723",164216,"WASHINGTON COLLEGE",1,0,2002,"22740","31.872097","80","309","368",243,125,276,"88",188,0.7737,0.704,0.75,0.8397
"4724",164216,"WASHINGTON COLLEGE",1,0,2003,"24240","34.308595","76","308","361",228,133,272,"93",179,0.7851,0.6992,0.7535,0.8532
"4725",164216,"WASHINGTON COLLEGE",1,0,2004,"25990","36.310104","79","262","304",185,119,205,"71",134,0.7243,0.5966,0.6743,0.8618
"4726",164216,"Washington College",1,0,2005,"28230","38.616067","79","297","345",201,144,247,"90",157,0.7811,0.625,0.7159,0.8609
"4727",164216,"Washington College",1,0,2006,"29640","43.513707","82","266","312",179,133,202,"80",122,0.6816,0.6015,0.6474,0.8526
"4728",164216,"Washington College",1,0,2007,"31570","45.707051","93","270","324",197,127,210,"69",141,0.7157,0.5433,0.6481,0.8333
"4729",164216,"Washington College",1,0,2008,"33385","49.954332","95","354","415",248,167,291,"108",183,0.7379,0.6467,0.7012,0.853
"4730",164216,"Washington College",1,0,2009,"34690","48.903881","90","329","378",215,163,269,"111",158,0.7349,0.681,0.7116,0.8704
"4731",164216,"Washington College",1,0,2010,"36078","55.138924","91","353","421",238,183,293,"109",184,0.7731,0.5956,0.696,0.8385
"4732",164270,"WESTERN MARYLAND COLLEGE",1,0,1991,"12505","26.945","85","234","278",132,146,160,"71",89,0.6742,0.4863,0.5755,0.8417
"4733",164270,"WESTERN MARYLAND COLLEGE",1,0,1992,"13130","27.016","84","270","300",160,140,164,"62",102,0.6375,0.4429,0.5467,0.9
"4734",164270,"WESTERN MARYLAND COLLEGE",1,0,1993,"13750","27.947","79","225","258",132,126,145,"62",83,0.6288,0.4921,0.562,0.8721
"4735",164270,"WESTERN MARYLAND COLLEGE",1,0,1995,"15300","30.749","77","294","316",163,153,206,"80",126,0.773,0.5229,0.6519,0.9304
"4736",164270,"WESTERN MARYLAND COLLEGE",1,0,1996,"16125","33.878","82","340","385",199,186,236,"100",136,0.6834,0.5376,0.613,0.8831
"4737",164270,"WESTERN MARYLAND COLLEGE",1,0,1997,"16850","29.09","89","363","427",241,186,274,"98",176,0.7303,0.5269,0.6417,0.8501
"4738",164270,"WESTERN MARYLAND COLLEGE",1,0,1998,"17730","31.284","83","274","331",173,158,210,"86",124,0.7168,0.5443,0.6344,0.8278
"4739",164270,"WESTERN MARYLAND COLLEGE",1,0,1999,"18650","32.251","84","338","412",204,208,261,"107",154,0.7549,0.5144,0.6335,0.8204
"4740",164270,"WESTERN MARYLAND COLLEGE",1,0,2000,"19600","36.073","88.5","376","442",247,195,293,"109",184,0.7449,0.559,0.6629,0.8507
"4741",164270,"WESTERN MARYLAND COLLEGE",1,0,2001,"20550","39.527","93","293","368",209,159,244,"88",156,0.7464,0.5535,0.663,0.7962
"4742",164270,"MCDANIEL COLLEGE",1,0,2002,"21760","40.544","92","342","440",253,187,307,"124",183,0.7233,0.6631,0.6977,0.7773
"4743",164270,"MCDANIEL COLLEGE",1,0,2003,"22860","43.603","133","383","451",249,202,274,"94",180,0.7229,0.4653,0.6075,0.8492
"4744",164270,"MCDANIEL COLLEGE",1,0,2004,"24500","44.37","128","296","357",196,161,237,"100",137,0.699,0.6211,0.6639,0.8291
"4745",164270,"McDaniel College",1,0,2005,"25710","46.883","123","379","447",246,201,314,"136",178,0.7236,0.6766,0.7025,0.8479
"4746",164270,"McDaniel College",1,0,2006,"26980","50.143","121","404","476",260,216,324,"126",198,0.7615,0.5833,0.6807,0.8487
"4747",164270,"McDaniel College",1,0,2007,"28640","54.722","130","378","439",226,213,279,"118",161,0.7124,0.554,0.6355,0.861
"4748",164270,"McDaniel College",1,0,2008,"30780","57.99","135","345","426",223,203,263,"117",146,0.6547,0.5764,0.6174,0.8099
"4749",164270,"McDaniel College",1,0,2009,"32000","60.058","127","329","420",195,225,266,"124",142,0.7282,0.5511,0.6333,0.7833
"4750",164270,"McDaniel College",1,0,2010,"33280","60.125","128","319","408",213,195,250,"93",157,0.7371,0.4769,0.6127,0.7819
"4751",164447,"AMERICAN INTERNATIONAL COLLEGE",1,0,1991,"8117","14.93931","67","196","250",110,140,84,"43",41,0.3727,0.3071,0.336,0.784
"4752",164447,"AMERICAN INTERNATIONAL COLLEGE",1,0,1992,"8298","16.320672","69","164","225",95,130,71,"38",33,0.3474,0.2923,0.3156,0.7289
"4753",164447,"AMERICAN INTERNATIONAL COLLEGE",1,0,1993,"8690","17.252327","72","165","240",110,130,68,"32",36,0.3273,0.2462,0.2833,0.6875
"4754",164447,"AMERICAN INTERNATIONAL COLLEGE",1,0,1995,"9714","20.150466","74","176","260",104,156,84,"37",47,0.4519,0.2372,0.3231,0.6769
"4755",164447,"AMERICAN INTERNATIONAL COLLEGE",1,0,1996,"10276","22.522034","76","165","253",133,120,79,"30",49,0.3684,0.25,0.3123,0.6522
"4756",164447,"AMERICAN INTERNATIONAL COLLEGE",1,0,1997,"11244","16.873828","81","165","253",133,120,79,"30",49,0.3684,0.25,0.3123,0.6522
"4757",164447,"AMERICAN INTERNATIONAL COLLEGE",1,0,1998,"11800","18.462458","83","149","226",96,130,57,"22",35,0.3646,0.1692,0.2522,0.6593
"4758",164447,"AMERICAN INTERNATIONAL COLLEGE",1,0,1999,"12338","19.522991","83","106","240",92,148,77,"33",44,0.4783,0.223,0.3208,0.4417
"4759",164447,"AMERICAN INTERNATIONAL COLLEGE",1,0,2000,"13600","20.548986","81.5","115","239",123,116,112,"63",49,0.3984,0.5431,0.4686,0.4812
"4760",164447,"AMERICAN INTERNATIONAL COLLEGE",1,0,2001,"14800","21.210928","80","105","197",98,99,91,"34",57,0.5816,0.3434,0.4619,0.533
"4761",164447,"AMERICAN INTERNATIONAL COLLEGE",1,0,2002,"15700","22.448612","79","116","256",117,139,55,"21",34,0.2906,0.1511,0.2148,0.4531
"4762",164447,"AMERICAN INTERNATIONAL COLLEGE",1,0,2003,"16700","27.095333","78","172","327",174,153,105,"45",60,0.3448,0.2941,0.3211,0.526
"4763",164447,"AMERICAN INTERNATIONAL COLLEGE",1,0,2004,"18000","24.078358","75","174","321",167,154,83,"35",48,0.2874,0.2273,0.2586,0.5421
"4764",164447,"American International College",1,0,2005,"19800","28.862628","77","177","328",160,168,65,"32",33,0.2062,0.1905,0.1982,0.5396
"4765",164447,"American International College",1,0,2006,"20990","27.968286","79","130","282",148,134,81,"29",52,0.3514,0.2164,0.2872,0.461
"4766",164447,"American International College",1,0,2007,"22500","31.406807","76","167","390",202,188,111,"55",56,0.2772,0.2926,0.2846,0.4282
"4767",164447,"American International College",1,0,2008,"24100","35.316046","80","145","371",185,186,102,"46",56,0.3027,0.2473,0.2749,0.3908
"4768",164447,"American International College",1,0,2009,"25550","44.023022","88","112","354",165,189,88,"40",48,0.2909,0.2116,0.2486,0.3164
"4769",164447,"American International College",1,0,2010,"26700","45.603061","81","143","367",168,199,107,"47",60,0.3571,0.2362,0.2916,0.3896
"4770",164492,"ANNA MARIA COLLEGE",1,0,1991,"9880","7.692627","32","100","116",87,29,54,"9",45,0.5172,0.3103,0.4655,0.8621
"4771",164492,"ANNA MARIA COLLEGE",1,0,1992,"10380","7.809764","32","71","80",48,32,35,"16",19,0.3958,0.5,0.4375,0.8875
"4772",164492,"ANNA MARIA COLLEGE",1,0,1993,"10800","8.363408","33","86","94",62,32,50,"17",33,0.5323,0.5312,0.5319,0.9149
"4773",164492,"ANNA MARIA COLLEGE",1,0,1995,"11780","9.491741","31","55","69",43,26,28,"7",21,0.4884,0.2692,0.4058,0.7971
"4774",164492,"ANNA MARIA COLLEGE",1,0,1996,"11780","10.530849","31","105","112",69,43,53,"24",29,0.4203,0.5581,0.4732,0.9375
"4775",164492,"ANNA MARIA COLLEGE",1,0,1997,"12240","11.182477","34","119","135",90,45,54,"19",35,0.3889,0.4222,0.4,0.8815
"4776",164492,"ANNA MARIA COLLEGE",1,0,1998,"12690","9.549798","25","123","153",116,37,70,"19",51,0.4397,0.5135,0.4575,0.8039
"4777",164492,"ANNA MARIA COLLEGE",1,0,1999,"12200","10.459913","36","110","134",90,44,64,"23",41,0.4556,0.5227,0.4776,0.8209
"4778",164492,"ANNA MARIA COLLEGE",1,0,2000,"13495","9.899029","35","128","149",110,39,81,"18",63,0.5727,0.4615,0.5436,0.8591
"4779",164492,"ANNA MARIA COLLEGE",1,0,2001,"15250","10.391854","34","119","140",97,43,69,"24",45,0.4639,0.5581,0.4929,0.85
"4780",164492,"ANNA MARIA COLLEGE",1,0,2002,"16410","10.701031","37","142","159",108,51,82,"29",53,0.4907,0.5686,0.5157,0.8931
"4781",164492,"ANNA MARIA COLLEGE",1,0,2003,"17495","11.538671","39","131","154",102,52,76,"19",57,0.5588,0.3654,0.4935,0.8506
"4782",164492,"ANNA MARIA COLLEGE",1,0,2004,"18545","10.608283","34","152","189",107,82,69,"32",37,0.3458,0.3902,0.3651,0.8042
"4783",164492,"Anna Maria College",1,0,2005,"19900","11.203825","38","127","156",79,77,58,"27",31,0.3924,0.3506,0.3718,0.8141
"4784",164492,"Anna Maria College",1,0,2006,"21094","12.33394","40","145","181",105,76,71,"24",47,0.4476,0.3158,0.3923,0.8011
"4785",164492,"Anna Maria College",1,0,2007,"22360","14.917657","47","195","258",137,121,112,"45",67,0.4891,0.3719,0.4341,0.7558
"4786",164492,"Anna Maria College",1,0,2008,"23500","18.312184","50","190","245",135,110,81,"38",43,0.3185,0.3455,0.3306,0.7755
"4787",164492,"Anna Maria College",1,0,2009,"24192","20.005165","52","245","373",172,201,95,"46",49,0.2849,0.2289,0.2547,0.6568
"4788",164492,"Anna Maria College",1,0,2010,"25632","21.573406","49","165","287",140,147,95,"43",52,0.3714,0.2925,0.331,0.5749
"4789",164562,"ASSUMPTION COLLEGE",1,0,1991,"9835","26.574386","108","440","447",286,161,298,"110",188,0.6573,0.6832,0.6667,0.9843
"4790",164562,"ASSUMPTION COLLEGE",1,0,1992,"10320","28.791164","111","428","446",287,159,304,"102",202,0.7038,0.6415,0.6816,0.9596
"4791",164562,"ASSUMPTION COLLEGE",1,0,1993,"11595","30.986784","107","478","491",302,189,299,"108",191,0.6325,0.5714,0.609,0.9735
"4792",164562,"ASSUMPTION COLLEGE",1,0,1995,"12825","33.888073","108","354","446",262,184,295,"119",176,0.6718,0.6467,0.6614,0.7937
"4793",164562,"ASSUMPTION COLLEGE",1,0,1996,"13845","35.681539","109","391","431",266,165,296,"112",184,0.6917,0.6788,0.6868,0.9072
"4794",164562,"ASSUMPTION COLLEGE",1,0,1997,"14845","37.704241","116","515","582",365,217,386,"137",249,0.6822,0.6313,0.6632,0.8849
"4795",164562,"ASSUMPTION COLLEGE",1,0,1998,"15905","31.865908","113","474","522",334,188,402,"138",264,0.7904,0.734,0.7701,0.908
"4796",164562,"ASSUMPTION COLLEGE",1,0,1999,"17320","32.624654","111","482","592",361,231,404,"150",254,0.7036,0.6494,0.6824,0.8142
"4797",164562,"ASSUMPTION COLLEGE",1,0,2000,"17950","35.474185","119","518","593",367,226,409,"114",295,0.8038,0.5044,0.6897,0.8735
"4798",164562,"ASSUMPTION COLLEGE",1,0,2001,"18800","39.495982","127","418","604",369,235,402,"148",254,0.6883,0.6298,0.6656,0.6921
"4799",164562,"ASSUMPTION COLLEGE",1,0,2002,"19835","43.490872","144","534","618",381,237,451,"168",283,0.7428,0.7089,0.7298,0.8641
"4800",164562,"ASSUMPTION COLLEGE",1,0,2003,"21000","46.812137","130","535","640",408,232,409,"140",269,0.6593,0.6034,0.6391,0.8359
"4801",164562,"ASSUMPTION COLLEGE",1,0,2004,"22260","48.172014","134","536","633",364,269,447,"170",277,0.761,0.632,0.7062,0.8468
"4802",164562,"Assumption College",1,0,2005,"23930","50.047546","135","426","565",328,237,369,"132",237,0.7226,0.557,0.6531,0.754
"4803",164562,"Assumption College",1,0,2006,"25985","53.315504","148","533","675",397,278,484,"183",301,0.7582,0.6583,0.717,0.7896
"4804",164562,"Assumption College",1,0,2007,"27320","57.023417","153","460","594",331,263,417,"176",241,0.7281,0.6692,0.702,0.7744
"4805",164562,"Assumption College",1,0,2008,"28686","61.789151","157","439","606",357,249,402,"151",251,0.7031,0.6064,0.6634,0.7244
"4806",164562,"Assumption College",1,0,2009,"29806","63.288523","155","379","515",294,221,363,"135",228,0.7755,0.6109,0.7049,0.7359
"4807",164562,"Assumption College",1,0,2010,"30940","62.889671","156","449","590",369,221,423,"141",282,0.7642,0.638,0.7169,0.761
"4808",165015,"BRANDEIS UNIVERSITY",1,0,1991,"16475","127.07484","340","585","745",392,353,546,"247",299,0.7628,0.6997,0.7329,0.7852
"4809",165015,"BRANDEIS UNIVERSITY",1,0,1992,"17726","132.391788","328","597","757",413,344,556,"250",306,0.7409,0.7267,0.7345,0.7886
"4810",165015,"BRANDEIS UNIVERSITY",1,0,1993,"18955","140.433744","299","547","704",379,325,531,"238",293,0.7731,0.7323,0.7543,0.777
"4811",165015,"BRANDEIS UNIVERSITY",1,0,1995,"20935","157.954525","317","697","874",483,391,702,"306",396,0.8199,0.7826,0.8032,0.7975
"4812",165015,"BRANDEIS UNIVERSITY",1,0,1996,"21917","166.522936","308","617","761",393,368,608,"275",333,0.8473,0.7473,0.7989,0.8108
"4813",165015,"BRANDEIS UNIVERSITY",1,0,1997,"22360","139.407567","309","628","794",470,324,633,"250",383,0.8149,0.7716,0.7972,0.7909
"4814",165015,"BRANDEIS UNIVERSITY",1,0,1998,"23360","148.028643","309","662","850",477,373,715,"293",422,0.8847,0.7855,0.8412,0.7788
"4815",165015,"BRANDEIS UNIVERSITY",1,0,1999,"24421","158.884523","316","569","793",446,347,663,"275",388,0.87,0.7925,0.8361,0.7175
"4816",165015,"BRANDEIS UNIVERSITY",1,0,2000,"25392","165.136928","321","568","858",475,383,714,"301",413,0.8695,0.7859,0.8322,0.662
"4817",165015,"BRANDEIS UNIVERSITY",1,0,2001,"26281","175.932405","326","499","735",416,319,629,"261",368,0.8846,0.8182,0.8558,0.6789
"4818",165015,"BRANDEIS UNIVERSITY",1,0,2002,"27345","180.743705","339","591","837",456,381,708,"316",392,0.8596,0.8294,0.8459,0.7061
"4819",165015,"BRANDEIS UNIVERSITY",1,0,2003,"28999","193.082746","336","541","824",486,338,692,"285",407,0.8374,0.8432,0.8398,0.6566
"4820",165015,"BRANDEIS UNIVERSITY",1,0,2004,"30160","201.898106","333","496","761",417,344,655,"287",368,0.8825,0.8343,0.8607,0.6518
"4821",165015,"Brandeis University",1,0,2005,"31532","217.21201","343","453","737",397,340,647,"287",360,0.9068,0.8441,0.8779,0.6147
"4822",165015,"Brandeis University",1,0,2006,"32951","233.926343","352","407","764",416,348,656,"291",365,0.8774,0.8362,0.8586,0.5327
"4823",165015,"Brandeis University",1,0,2007,"34566","246.208976","351","377","701",391,310,604,"264",340,0.8696,0.8516,0.8616,0.5378
"4824",165015,"Brandeis University",1,0,2008,"36122","269.662065","360","341","754",426,328,643,"274",369,0.8662,0.8354,0.8528,0.4523
"4825",165015,"Brandeis University",1,0,2009,"37530","314.260142","358","331","775",434,341,621,"255",366,0.8433,0.7478,0.8013,0.4271
"4826",165015,"Brandeis University",1,0,2010,"38994","277.500897","363","354","686",370,316,569,"247",322,0.8703,0.7816,0.8294,0.516
"4827",165024,"BRIDGEWATER STATE COLLEGE",1,0,1991,"2882","36.898953","306","910","982",568,414,265,"67",198,0.3486,0.1618,0.2699,0.9267
"4828",165024,"BRIDGEWATER STATE COLLEGE",1,0,1992,"2952","38.790516","244","857","963",567,396,213,"54",159,0.2804,0.1364,0.2212,0.8899
"4829",165024,"BRIDGEWATER STATE COLLEGE",1,0,1993,"3373","44.524027","255","927","1045",590,455,196,"68",128,0.2169,0.1495,0.1876,0.8871
"4830",165024,"BRIDGEWATER STATE COLLEGE",1,0,1995,"3462","67.426809","258","928","1087",620,467,211,"57",154,0.2484,0.1221,0.1941,0.8537
"4831",165024,"BRIDGEWATER STATE COLLEGE",1,0,1996,"3392","62.211809","260","972","1155",697,458,222,"52",170,0.2439,0.1135,0.1922,0.8416
"4832",165024,"BRIDGEWATER STATE COLLEGE",1,0,1997,"3324","64.112283","262","964","1147",672,475,206,"46",160,0.2381,0.0968,0.1796,0.8405
"4833",165024,"BRIDGEWATER STATE COLLEGE",1,0,1998,"3134","67.010707","259","967","1128",695,433,260,"75",185,0.2662,0.1732,0.2305,0.8573
"4834",165024,"BRIDGEWATER STATE COLLEGE",1,0,1999,"1032","70.044575","249","897","1079",657,422,208,"43",165,0.2511,0.1019,0.1928,0.8313
"4835",165024,"BRIDGEWATER STATE COLLEGE",1,0,2000,"1030","77.274082","255.5","1030","1244",760,484,290,"87",203,0.2671,0.1798,0.2331,0.828
"4836",165024,"BRIDGEWATER STATE COLLEGE",1,0,2001,"910","80.889285","262","961","1139",695,444,255,"59",196,0.282,0.1329,0.2239,0.8437
"4837",165024,"BRIDGEWATER STATE COLLEGE",1,0,2002,"910","76.713562","252","1031","1272",769,503,277,"72",205,0.2666,0.1431,0.2178,0.8105
"4838",165024,"BRIDGEWATER STATE COLLEGE",1,0,2003,"910","76.199114","258","1078","1285",745,540,320,"93",227,0.3047,0.1722,0.249,0.8389
"4839",165024,"BRIDGEWATER STATE COLLEGE",1,0,2004,"910","88.104794","262","1040","1266",713,553,306,"99",207,0.2903,0.179,0.2417,0.8215
"4840",165024,"Bridgewater State College",1,0,2005,"910","95.275977","273","1066","1314",746,568,339,"113",226,0.3029,0.1989,0.258,0.8113
"4841",165024,"Bridgewater State College",1,0,2006,"910","104.749797","292","1099","1321",737,584,368,"135",233,0.3161,0.2312,0.2786,0.8319
"4842",165024,"Bridgewater State College",1,0,2007,"910","115.961552","299","1272","1551",935,616,445,"139",306,0.3273,0.2256,0.2869,0.8201
"4843",165024,"Bridgewater State College",1,0,2008,"910","134.865199","306","1239","1464",915,549,412,"134",278,0.3038,0.2441,0.2814,0.8463
"4844",165024,"Bridgewater State College",1,0,2009,"910","127.788105","304","1194","1453",866,587,420,"162",258,0.2979,0.276,0.2891,0.8217
"4845",165024,"Bridgewater State University",1,0,2010,"910","138.084409","309","1208","1431",812,619,458,"174",284,0.3498,0.2811,0.3201,0.8442
"4846",165334,"CLARK UNIVERSITY",1,0,1991,"15380","57.024","161","322","561",307,254,344,"137",207,0.6743,0.5394,0.6132,0.574
"4847",165334,"CLARK UNIVERSITY",1,0,1992,"16200","59.449","159","344","527",317,210,280,"106",174,0.5489,0.5048,0.5313,0.6528
"4848",165334,"CLARK UNIVERSITY",1,0,1993,"17000","59.614","160","273","443",257,186,251,"102",149,0.5798,0.5484,0.5666,0.6163
"4849",165334,"CLARK UNIVERSITY",1,0,1995,"19140","65.214","153","299","505",318,187,311,"103",208,0.6541,0.5508,0.6158,0.5921
"4850",165334,"CLARK UNIVERSITY",1,0,1996,"20040","66.321","158","350","527",301,226,336,"128",208,0.691,0.5664,0.6376,0.6641
"4851",165334,"CLARK UNIVERSITY",1,0,1997,"20940","0.051975","156","351","520",313,207,313,"110",203,0.6486,0.5314,0.6019,0.675
"4852",165334,"CLARK UNIVERSITY",1,0,1998,"21740","54.965","151","321","501",305,196,323,"119",204,0.6689,0.6071,0.6447,0.6407
"4853",165334,"CLARK UNIVERSITY",1,0,1999,"22400","57.085","150","315","486",304,182,308,"112",196,0.6447,0.6154,0.6337,0.6481
"4854",165334,"CLARK UNIVERSITY",1,0,2000,"23300","58.709","157","329","497",292,205,315,"120",195,0.6678,0.5854,0.6338,0.662
"4855",165334,"CLARK UNIVERSITY",1,0,2001,"24400","61.513","164","342","511",330,181,354,"123",231,0.7,0.6796,0.6928,0.6693
"4856",165334,"CLARK UNIVERSITY",1,0,2002,"25600","64.207","166","379","576",357,219,387,"148",239,0.6695,0.6758,0.6719,0.658
"4857",165334,"CLARK UNIVERSITY",1,0,2003,"26700","69.623","167","342","537",324,213,391,"150",241,0.7438,0.7042,0.7281,0.6369
"4858",165334,"CLARK UNIVERSITY",1,0,2004,"28000","70.291","171","327","523",328,195,383,"137",246,0.75,0.7026,0.7323,0.6252
"4859",165334,"Clark University",1,0,2005,"29300","74.795","167","383","557",338,219,422,"161",261,0.7722,0.7352,0.7576,0.6876
"4860",165334,"Clark University",1,0,2006,"31200","80.286","174","399","563",345,218,425,"159",266,0.771,0.7294,0.7549,0.7087
"4861",165334,"Clark University",1,0,2007,"32600","82.228","178","402","572",361,211,432,"157",275,0.7618,0.7441,0.7552,0.7028
"4862",165334,"Clark University",1,0,2008,"33900","90.76","189","408","586",348,238,424,"162",262,0.7529,0.6807,0.7235,0.6962
"4863",165334,"Clark University",1,0,2009,"34900","91.548","202","401","548",356,192,422,"144",278,0.7809,0.75,0.7701,0.7318
"4864",165334,"Clark University",1,0,2010,"36100","91.841","194","404","575",328,247,411,"172",239,0.7287,0.6964,0.7148,0.7026
"4865",165662,"EMERSON COLLEGE",1,0,1991,"13273","38.036197","91","345","399",269,130,217,"89",128,0.4758,0.6846,0.5439,0.8647
"4866",165662,"EMERSON COLLEGE",1,0,1992,"13817","40.033024","92","348","408",276,132,198,"70",128,0.4638,0.5303,0.4853,0.8529
"4867",165662,"EMERSON COLLEGE",1,0,1993,"14743","43.919081","92","369","427",263,164,256,"100",156,0.5932,0.6098,0.5995,0.8642
"4868",165662,"EMERSON COLLEGE",1,0,1995,"16259","52.677284","93","405","526",313,213,310,"121",189,0.6038,0.5681,0.5894,0.77
"4869",165662,"EMERSON COLLEGE",1,0,1996,"17085","56.100206","94","423","547",318,229,358,"161",197,0.6195,0.7031,0.6545,0.7733
"4870",165662,"EMERSON COLLEGE",1,0,1997,"18242","47.889247","103","447","547",333,214,343,"130",213,0.6396,0.6075,0.6271,0.8172
"4871",165662,"EMERSON COLLEGE",1,0,1998,"19028","52.966777","106","517","612",368,244,377,"150",227,0.6168,0.6148,0.616,0.8448
"4872",165662,"EMERSON COLLEGE",1,0,1999,"18816","54.441654","109","495","653",361,292,433,"192",241,0.6676,0.6575,0.6631,0.758
"4873",165662,"EMERSON COLLEGE",1,0,2000,"19520","57.153851","112.5","550","641",396,245,461,"179",282,0.7121,0.7306,0.7192,0.858
"4874",165662,"EMERSON COLLEGE",1,0,2001,"20224","60.460179","116","490","643",406,237,440,"163",277,0.6823,0.6878,0.6843,0.7621
"4875",165662,"EMERSON COLLEGE",1,0,2002,"21120","63.635355","122","513","656",419,237,473,"179",294,0.7017,0.7553,0.721,0.782
"4876",165662,"EMERSON COLLEGE",1,0,2003,"22144","66.627727","128","554","706",413,293,525,"229",296,0.7167,0.7816,0.7436,0.7847
"4877",165662,"EMERSON COLLEGE",1,0,2004,"22976","76.189345","138","523","700",402,298,533,"242",291,0.7239,0.8121,0.7614,0.7471
"4878",165662,"Emerson College",1,0,2005,"24064","84.200285","143","557","715",417,298,571,"243",328,0.7866,0.8154,0.7986,0.779
"4879",165662,"Emerson College",1,0,2006,"25248","87.787565","149","540","728",409,319,578,"254",324,0.7922,0.7962,0.794,0.7418
"4880",165662,"Emerson College",1,0,2007,"26880","91.124352","159","651","842",477,365,671,"274",397,0.8323,0.7507,0.7969,0.7732
"4881",165662,"Emerson College",1,0,2008,"28352","105.124319","163","429","772",466,306,598,"243",355,0.7618,0.7941,0.7746,0.5557
"4882",165662,"Emerson College",1,0,2009,"29408","110.349302","177","376","764",486,278,593,"215",378,0.7778,0.7734,0.7762,0.4921
"4883",165662,"Emerson College",1,0,2010,"30752","111.360949","183","499","824",529,295,634,"219",415,0.7845,0.7424,0.7694,0.6056
"4884",165671,"EMMANUEL COLLEGE",1,0,1991,"10070","13.082176","45","90","138",138,0,51,"0",51,0.3696,NA,0.3696,0.6522
"4885",165671,"EMMANUEL COLLEGE",1,0,1992,"10966","13.813455","52","96","149",149,0,52,"0",52,0.349,NA,0.349,0.6443
"4886",165671,"EMMANUEL COLLEGE",1,0,1993,"11973","15.878854","44","84","133",133,0,59,"0",59,0.4436,NA,0.4436,0.6316
"4887",165671,"EMMANUEL COLLEGE",1,0,1995,"14055","18.562635","49","65","100",100,0,43,"0",43,0.43,NA,0.43,0.65
"4888",165671,"EMMANUEL COLLEGE",1,0,1996,"14523","18.577032","48","42","86",86,0,45,"0",45,0.5233,NA,0.5233,0.4884
"4889",165671,"EMMANUEL COLLEGE",1,0,1997,"15094","17.268443","48","50","112",112,0,59,"0",59,0.5268,NA,0.5268,0.4464
"4890",165671,"EMMANUEL COLLEGE",1,0,1998,"15786","17.792769","47","85","151",151,0,80,"0",80,0.5298,NA,0.5298,0.5629
"4891",165671,"EMMANUEL COLLEGE",1,0,1999,"15488","17.846901","47","85","133",133,0,60,"0",60,0.4511,NA,0.4511,0.6391
"4892",165671,"EMMANUEL COLLEGE",1,0,2000,"16112","18.786111","47.5","87","165",165,0,82,"0",82,0.497,NA,0.497,0.5273
"4893",165671,"EMMANUEL COLLEGE",1,0,2001,"16800","21.069662","48","136","277",189,88,128,"32",96,0.5079,0.3636,0.4621,0.491
"4894",165671,"EMMANUEL COLLEGE",1,0,2002,"17800","21.054286","51","215","322",258,64,179,"31",148,0.5736,0.4844,0.5559,0.6677
"4895",165671,"EMMANUEL COLLEGE",1,0,2003,"18900","25.811517","53","270","406",299,107,222,"47",175,0.5853,0.4393,0.5468,0.665
"4896",165671,"EMMANUEL COLLEGE",1,0,2004,"20100","27.583778","57","288","455",332,123,237,"58",179,0.5392,0.4715,0.5209,0.633
"4897",165671,"Emmanuel College",1,0,2005,"21900","33.157302","66","318","438",327,111,237,"63",174,0.5321,0.5676,0.5411,0.726
"4898",165671,"Emmanuel College",1,0,2006,"23800","38.115173","76","368","467",344,123,233,"55",178,0.5174,0.4472,0.4989,0.788
"4899",165671,"Emmanuel College",1,0,2007,"26100","43.035409","86","421","582",436,146,299,"74",225,0.5161,0.5068,0.5137,0.7234
"4900",165671,"Emmanuel College",1,0,2008,"28200","50.727563","92","344","480",346,134,268,"73",195,0.5636,0.5448,0.5583,0.7167
"4901",165671,"Emmanuel College",1,0,2009,"29200","50.080725","82","322","423",308,115,235,"60",175,0.5682,0.5217,0.5556,0.7612
"4902",165671,"Emmanuel College",1,0,2010,"30600","51.816005","91","326","528",386,142,318,"81",237,0.614,0.5704,0.6023,0.6174
"4903",165820,"FITCHBURG STATE COLLEGE",1,0,1991,"3134","25.925592","223","706","759",462,297,183,"55",128,0.2771,0.1852,0.2411,0.9302
"4904",165820,"FITCHBURG STATE COLLEGE",1,0,1992,"3206","28.959056","225","463","538",297,241,128,"32",96,0.3232,0.1328,0.2379,0.8606
"4905",165820,"FITCHBURG STATE COLLEGE",1,0,1993,"3234","29.922936","224","499","550",304,246,97,"18",79,0.2599,0.0732,0.1764,0.9073
"4906",165820,"FITCHBURG STATE COLLEGE",1,0,1995,"3316","37.047156","213","468","574",329,245,106,"20",86,0.2614,0.0816,0.1847,0.8153
"4907",165820,"FITCHBURG STATE COLLEGE",1,0,1996,"3246","43.901192","208","360","436",265,171,95,"19",76,0.2868,0.1111,0.2179,0.8257
"4908",165820,"FITCHBURG STATE COLLEGE",1,0,1997,"3346","44.491647","203","310","488",270,218,104,"29",75,0.2778,0.133,0.2131,0.6352
"4909",165820,"FITCHBURG STATE COLLEGE",1,0,1998,"3198","47.067279","204","369","503",281,222,81,"24",57,0.2028,0.1081,0.161,0.7336
"4910",165820,"FITCHBURG STATE COLLEGE",1,0,1999,"1090","47.527792","200","295","345",202,143,73,"23",50,0.2475,0.1608,0.2116,0.8551
"4911",165820,"FITCHBURG STATE COLLEGE",1,0,2000,"1030","49.473059","200.5","383","448",275,173,119,"30",89,0.3236,0.1734,0.2656,0.8549
"4912",165820,"FITCHBURG STATE COLLEGE",1,0,2001,"970","53.088412","201","352","405",220,185,91,"29",62,0.2818,0.1568,0.2247,0.8691
"4913",165820,"FITCHBURG STATE COLLEGE",1,0,2002,"970","50.424742","184","432","496",292,204,119,"41",78,0.2671,0.201,0.2399,0.871
"4914",165820,"FITCHBURG STATE COLLEGE",1,0,2003,"970","50.356089","168","516","585",320,265,144,"50",94,0.2938,0.1887,0.2462,0.8821
"4915",165820,"FITCHBURG STATE COLLEGE",1,0,2004,"970","49.725779","166","592","713",386,327,153,"52",101,0.2617,0.159,0.2146,0.8303
"4916",165820,"Fitchburg State College",1,0,2005,"970","54.058708","166","525","599",297,302,125,"54",71,0.2391,0.1788,0.2087,0.8765
"4917",165820,"Fitchburg State College",1,0,2006,"970","57.959077","174","611","728",383,345,172,"63",109,0.2846,0.1826,0.2363,0.8393
"4918",165820,"Fitchburg State College",1,0,2007,"970","63.092444","176","570","698",366,332,142,"56",86,0.235,0.1687,0.2034,0.8166
"4919",165820,"Fitchburg State College",1,0,2008,"970","68.405002","184","646","763",421,342,227,"76",151,0.3587,0.2222,0.2975,0.8467
"4920",165820,"Fitchburg State College",1,0,2009,"970","67.192314","180","682","781",410,371,217,"89",128,0.3122,0.2399,0.2778,0.8732
"4921",165820,"Fitchburg State University",1,0,2010,"970","68.594527","176","491","721",413,308,246,"86",160,0.3874,0.2792,0.3412,0.681
"4922",165866,"FRAMINGHAM STATE COLLEGE",1,0,1991,"2889","21.933786","166","347","385",251,134,114,"22",92,0.3665,0.1642,0.2961,0.9013
"4923",165866,"FRAMINGHAM STATE COLLEGE",1,0,1992,"2995","21.055056","169","515","577",382,195,154,"35",119,0.3115,0.1795,0.2669,0.8925
"4924",165866,"FRAMINGHAM STATE COLLEGE",1,0,1993,"3154","24.833714","176","450","517",339,178,117,"21",96,0.2832,0.118,0.2263,0.8704
"4925",165866,"FRAMINGHAM STATE COLLEGE",1,0,1995,"3308","28.518687","171","500","600",404,196,122,"28",94,0.2327,0.1429,0.2033,0.8333
"4926",165866,"FRAMINGHAM STATE COLLEGE",1,0,1996,"3238","37.071146","168","570","644",429,215,127,"26",101,0.2354,0.1209,0.1972,0.8851
"4927",165866,"FRAMINGHAM STATE COLLEGE",1,0,1997,"3160","39.834766","168","512","590",397,193,120,"25",95,0.2393,0.1295,0.2034,0.8678
"4928",165866,"FRAMINGHAM STATE COLLEGE",1,0,1998,"3070","40.89881","161","514","601",381,220,136,"27",109,0.2861,0.1227,0.2263,0.8552
"4929",165866,"FRAMINGHAM STATE COLLEGE",1,0,1999,"1090","42.724007","164","469","559",402,157,130,"27",103,0.2562,0.172,0.2326,0.839
"4930",165866,"FRAMINGHAM STATE COLLEGE",1,0,2000,"1030","45.292974","162.5","506","612",434,178,153,"30",123,0.2834,0.1685,0.25,0.8268
"4931",165866,"FRAMINGHAM STATE COLLEGE",1,0,2001,"970","48.137207","161","557","645",455,190,145,"28",117,0.2571,0.1474,0.2248,0.8636
"4932",165866,"FRAMINGHAM STATE COLLEGE",1,0,2002,"970","46.414122","166","622","716",500,216,193,"38",155,0.31,0.1759,0.2696,0.8687
"4933",165866,"FRAMINGHAM STATE COLLEGE",1,0,2003,"970","44.565907","161","526","617",441,176,202,"45",157,0.356,0.2557,0.3274,0.8525
"4934",165866,"FRAMINGHAM STATE COLLEGE",1,0,2004,"970","45.597337","158","546","642",434,208,187,"49",138,0.318,0.2356,0.2913,0.8505
"4935",165866,"Framingham State College",1,0,2005,"970","50.416525","167","563","666",461,205,210,"44",166,0.3601,0.2146,0.3153,0.8453
"4936",165866,"Framingham State College",1,0,2006,"970","53.942062","164","583","714",496,218,242,"57",185,0.373,0.2615,0.3389,0.8165
"4937",165866,"Framingham State College",1,0,2007,"970","61.181782","165","517","633",420,213,212,"52",160,0.381,0.2441,0.3349,0.8167
"4938",165866,"Framingham State College",1,0,2008,"970","68.374693","166","551","644",450,194,213,"49",164,0.3644,0.2526,0.3307,0.8556
"4939",165866,"Framingham State College",1,0,2009,"970","63.993241","164","609","719",520,199,261,"59",202,0.3885,0.2965,0.363,0.847
"4940",165866,"Framingham State University",1,0,2010,"970","70.269003","163","565","719",481,238,245,"59",186,0.3867,0.2479,0.3408,0.7858
"4941",165936,"GORDON COLLEGE",1,0,1991,"11400","20.68131","71","236","282",171,111,122,"41",81,0.4737,0.3694,0.4326,0.8369
"4942",165936,"GORDON COLLEGE",1,0,1992,"12090","22.227242","70","253","292",193,99,140,"39",101,0.5233,0.3939,0.4795,0.8664
"4943",165936,"GORDON COLLEGE",1,0,1993,"12720","23.779966","71","270","298",186,112,98,"27",71,0.3817,0.2411,0.3289,0.906
"4944",165936,"GORDON COLLEGE",1,0,1995,"13950","26.116411","72","303","330",226,104,152,"43",109,0.4823,0.4135,0.4606,0.9182
"4945",165936,"GORDON COLLEGE",1,0,1996,"14690","27.470336","72","301","326",210,116,152,"41",111,0.5286,0.3534,0.4663,0.9233
"4946",165936,"GORDON COLLEGE",1,0,1997,"15150","23.034273","75","381","406",279,127,206,"68",138,0.4946,0.5354,0.5074,0.9384
"4947",165936,"GORDON COLLEGE",1,0,1998,"15760","24.492547","79","391","417",289,128,214,"65",149,0.5156,0.5078,0.5132,0.9376
"4948",165936,"GORDON COLLEGE",1,0,1999,"15740","27.696774","83","356","382",243,139,205,"61",144,0.5926,0.4388,0.5366,0.9319
"4949",165936,"GORDON COLLEGE",1,0,2000,"16550","29.763625","85","389","411",274,137,233,"71",162,0.5912,0.5182,0.5669,0.9465
"4950",165936,"GORDON COLLEGE",1,0,2001,"17378","31.642373","87","407","441",313,128,246,"63",183,0.5847,0.4922,0.5578,0.9229
"4951",165936,"GORDON COLLEGE",1,0,2002,"18230","35.928438","93","353","400",266,134,248,"77",171,0.6429,0.5746,0.62,0.8825
"4952",165936,"GORDON COLLEGE",1,0,2003,"19334","39.123409","91","382","427",274,153,260,"86",174,0.635,0.5621,0.6089,0.8946
"4953",165936,"GORDON COLLEGE",1,0,2004,"20494","41.24326","94","343","401",264,137,235,"75",160,0.6061,0.5474,0.586,0.8554
"4954",165936,"Gordon College",1,0,2005,"21930","43.88558","95","368","414",259,155,254,"79",175,0.6757,0.5097,0.6135,0.8889
"4955",165936,"Gordon College",1,0,2006,"23224","46.37311","97","340","380",250,130,225,"71",154,0.616,0.5462,0.5921,0.8947
"4956",165936,"Gordon College",1,0,2007,"24652","47.645636","99","392","454",286,168,264,"95",169,0.5909,0.5655,0.5815,0.8634
"4957",165936,"Gordon College",1,0,2008,"26132","51.950741","98","354","419",260,159,256,"91",165,0.6346,0.5723,0.611,0.8449
"4958",165936,"Gordon College",1,0,2009,"27152","52.723233","94","313","381",237,144,233,"71",162,0.6835,0.4931,0.6115,0.8215
"4959",165936,"Gordon College",1,0,2010,"28210","51.322431","97","276","348",212,136,212,"80",132,0.6226,0.5882,0.6092,0.7931
"4960",166027,"HARVARD UNIVERSITY",1,0,1991,"15410","1184.781","1533","925","1601",669,932,1347,"759",588,0.8789,0.8144,0.8413,0.5778
"4961",166027,"HARVARD UNIVERSITY",1,0,1992,"16454","1262.269","1498","667","1603",686,917,1380,"782",598,0.8717,0.8528,0.8609,0.4161
"4962",166027,"HARVARD UNIVERSITY",1,0,1993,"17470","1327.024","1362","669","1601",715,886,1358,"743",615,0.8601,0.8386,0.8482,0.4179
"4963",166027,"HARVARD UNIVERSITY",1,0,1995,"19472","1469.446","1115","779","1606",738,868,1343,"705",638,0.8645,0.8122,0.8362,0.4851
"4964",166027,"HARVARD UNIVERSITY",1,0,1996,"20424","1520.985","1129","685","1611",721,890,1390,"754",636,0.8821,0.8472,0.8628,0.4252
"4965",166027,"HARVARD UNIVERSITY",1,0,1997,"21266","1531.781","1156","629","1642",782,860,1436,"744",692,0.8849,0.8651,0.8745,0.3831
"4966",166027,"HARVARD UNIVERSITY",1,0,1998,"22028","1629.514","1247","711","1650",772,878,1423,"748",675,0.8744,0.8519,0.8624,0.4309
"4967",166027,"HARVARD UNIVERSITY",1,0,1999,"22054","1784.112","1272","770","1647",775,872,1429,"757",672,0.8671,0.8681,0.8676,0.4675
"4968",166027,"HARVARD UNIVERSITY",1,0,2000,"22694","1902.469","1318.5","731","1638",755,883,1431,"757",674,0.8927,0.8573,0.8736,0.4463
"4969",166027,"HARVARD UNIVERSITY",1,0,2001,"23457","2063.27","1365","749","1637",786,851,1448,"742",706,0.8982,0.8719,0.8845,0.4575
"4970",166027,"HARVARD UNIVERSITY",1,0,2002,"24630","2286.586","1387","838","1619",783,836,1422,"710",712,0.9093,0.8493,0.8783,0.5176
"4971",166027,"HARVARD UNIVERSITY",1,0,2003,"26066","2432.944","1349","803","1633",782,851,1433,"726",707,0.9041,0.8531,0.8775,0.4917
"4972",166027,"HARVARD UNIVERSITY",1,0,2004,"27448","2560.919","1352","757","1638",823,815,1427,"688",739,0.8979,0.8442,0.8712,0.4621
"4973",166027,"Harvard University",1,0,2005,"28752","2757.373","1550","776","1637",819,818,1421,"698",723,0.8828,0.8533,0.8681,0.474
"4974",166027,"Harvard University",1,0,2006,"30275","2999.503","1560","739","1679",878,801,1448,"664",784,0.8929,0.829,0.8624,0.4401
"4975",166027,"Harvard University",1,0,2007,"31456","3170.65","1607","694","1657",839,818,1434,"695",739,0.8808,0.8496,0.8654,0.4188
"4976",166027,"Harvard University",1,0,2008,"32557","3464.893","1644","741","1656",836,820,1420,"677",743,0.8888,0.8256,0.8575,0.4475
"4977",166027,"Harvard University",1,0,2009,"33696","3756.071","1661","742","1662",837,825,1425,"673",752,0.8984,0.8158,0.8574,0.4465
"4978",166027,"Harvard University",1,0,2010,"34976","3729.582","1739","767","1663",827,836,1434,"708",726,0.8779,0.8469,0.8623,0.4612
"4979",166124,"COLLEGE OF THE HOLY CROSS",1,0,1991,"15530","65.169048","179","653","728",344,384,631,"329",302,0.8779,0.8568,0.8668,0.897
"4980",166124,"COLLEGE OF THE HOLY CROSS",1,0,1992,"16300","71.163517","186","724","765",428,337,698,"308",390,0.9112,0.9139,0.9124,0.9464
"4981",166124,"COLLEGE OF THE HOLY CROSS",1,0,1993,"17200","75.667114","186","625","658",350,308,598,"277",321,0.9171,0.8994,0.9088,0.9498
"4982",166124,"COLLEGE OF THE HOLY CROSS",1,0,1995,"18900","85.392833","186","612","710",384,326,618,"287",331,0.862,0.8804,0.8704,0.862
"4983",166124,"COLLEGE OF THE HOLY CROSS",1,0,1996,"19700","89.383664","190","567","688",349,339,611,"287",324,0.9284,0.8466,0.8881,0.8241
"4984",166124,"COLLEGE OF THE HOLY CROSS",1,0,1997,"21080","71.608798","188","584","726",409,317,635,"270",365,0.8924,0.8517,0.8747,0.8044
"4985",166124,"COLLEGE OF THE HOLY CROSS",1,0,1998,"22005","74.758944","191","561","723",354,369,623,"305",318,0.8983,0.8266,0.8617,0.7759
"4986",166124,"COLLEGE OF THE HOLY CROSS",1,0,1999,"22500","81.666959","195","566","722",383,339,645,"298",347,0.906,0.8791,0.8934,0.7839
"4987",166124,"COLLEGE OF THE HOLY CROSS",1,0,2000,"23400","88.918915","191.5","551","706",376,330,626,"284",342,0.9096,0.8606,0.8867,0.7805
"4988",166124,"COLLEGE OF THE HOLY CROSS",1,0,2001,"24600","92.382955","188","533","691",366,325,609,"274",335,0.9153,0.8431,0.8813,0.7713
"4989",166124,"COLLEGE OF THE HOLY CROSS",1,0,2002,"26000","98.304893","197","508","669",348,321,644,"300",344,0.9885,0.9346,0.9626,0.7593
"4990",166124,"COLLEGE OF THE HOLY CROSS",1,0,2003,"27560","104.840867","226","546","698",378,320,607,"270",337,0.8915,0.8438,0.8696,0.7822
"4991",166124,"COLLEGE OF THE HOLY CROSS",1,0,2004,"29220","108.834346","236","524","703",389,314,635,"274",361,0.928,0.8726,0.9033,0.7454
"4992",166124,"College of the Holy Cross",1,0,2005,"30960","113.377166","234","505","723",399,324,645,"281",364,0.9123,0.8673,0.8921,0.6985
"4993",166124,"College of the Holy Cross",1,0,2006,"32820","120.624257","232","538","751",415,336,675,"293",382,0.9205,0.872,0.8988,0.7164
"4994",166124,"College of the Holy Cross",1,0,2007,"34630","126.387055","236","460","718",398,320,639,"272",367,0.9221,0.85,0.89,0.6407
"4995",166124,"College of the Holy Cross",1,0,2008,"36710","133.464239","257","448","737",420,317,664,"285",379,0.9024,0.8991,0.9009,0.6079
"4996",166124,"College of the Holy Cross",1,0,2009,"38180","142.72403","241","539","746",379,367,666,"320",346,0.9129,0.8719,0.8928,0.7225
"4997",166124,"College of the Holy Cross",1,0,2010,"39330","140.764771","249","464","727",379,348,645,"298",347,0.9156,0.8563,0.8872,0.6382
"4998",166513,"UNIVERSITY OF MASSACHUSETTS AT LOWELL",1,0,1991,"4337","89.706681","471","902","1075",386,689,276,"146",130,0.3368,0.2119,0.2567,0.8391
"4999",166513,"UNIVERSITY OF MASSACHUSETTS AT LOWELL",1,0,1992,"4513","112.028006","462","806","964",340,624,239,"134",105,0.3088,0.2147,0.2479,0.8361
"5000",166513,"UNIVERSITY OF MASSACHUSETTS-LOWELL",1,0,1993,"4602","118.76576","476","886","1033",392,641,217,"108",109,0.2781,0.1685,0.2101,0.8577
"5001",166513,"UNIVERSITY OF MASSACHUSETTS-LOWELL",1,0,1995,"4606","127.153423","434","874","1102",422,680,195,"90",105,0.2488,0.1324,0.177,0.7931
"5002",166513,"UNIVERSITY OF MASSACHUSETTS-LOWELL",1,0,1996,"4512","132.191443","406","811","1022",428,594,228,"96",132,0.3084,0.1616,0.2231,0.7935
"5003",166513,"UNIVERSITY OF MASSACHUSETTS-LOWELL",1,0,1997,"4422","131.205131","416","768","989",367,622,232,"104",128,0.3488,0.1672,0.2346,0.7765
"5004",166513,"UNIVERSITY OF MASSACHUSETTS-LOWELL",1,0,1998,"4337","142.792","415","792","997",366,631,235,"116",119,0.3251,0.1838,0.2357,0.7944
"5005",166513,"UNIVERSITY OF MASSACHUSETTS-LOWELL",1,0,1999,"1454","144.45","411","587","935",368,567,230,"91",139,0.3777,0.1605,0.246,0.6278
"5006",166513,"UNIVERSITY OF MASSACHUSETTS-LOWELL",1,0,2000,"1454","153.437","405","670","996",373,623,299,"140",159,0.4263,0.2247,0.3002,0.6727
"5007",166513,"UNIVERSITY OF MASSACHUSETTS-LOWELL",1,0,2001,"1454","165.314","399","568","967",349,618,269,"128",141,0.404,0.2071,0.2782,0.5874
"5008",166513,"UNIVERSITY OF MASSACHUSETTS-LOWELL",1,0,2002,"1454","155.316","359","716","1013",371,642,289,"138",151,0.407,0.215,0.2853,0.7068
"5009",166513,"UNIVERSITY OF MASSACHUSETTS-LOWELL",1,0,2003,"1454","156.069","361","842","1008",393,615,291,"145",146,0.3715,0.2358,0.2887,0.8353
"5010",166513,"UNIVERSITY OF MASSACHUSETTS-LOWELL",1,0,2004,"1454","162.653","361","791","996",333,663,286,"134",152,0.4565,0.2021,0.2871,0.7942
"5011",166513,"University of Massachusetts-Lowell",1,0,2005,"1454","194.043","383","840","1062",390,672,318,"160",158,0.4051,0.2381,0.2994,0.791
"5012",166513,"University of Massachusetts-Lowell",1,0,2006,"1454","208.581","405","908","1208",451,757,355,"190",165,0.3659,0.251,0.2939,0.7517
"5013",166513,"University of Massachusetts-Lowell",1,0,2007,"1454","220.998","406","971","1220",424,796,346,"179",167,0.3939,0.2249,0.2836,0.7959
"5014",166513,"University of Massachusetts-Lowell",1,0,2008,"1454","231.092","414","1139","1514",540,974,411,"213",198,0.3667,0.2187,0.2715,0.7523
"5015",166513,"University of Massachusetts-Lowell",1,0,2009,"1454","231.826","402","1102","1499",548,951,465,"243",222,0.4051,0.2555,0.3102,0.7352
"5016",166513,"University of Massachusetts-Lowell",1,0,2010,"1454","249.209","434","1196","1601",575,1026,514,"272",242,0.4209,0.2651,0.321,0.747
"5017",166629,"UNIVERSITY OF MASSACHUSETTS AT AMHERST",1,0,1991,"4863","405.904643","1138","2863","3435",1665,1770,1271,"511",760,0.4565,0.2887,0.37,0.8335
"5018",166629,"UNIVERSITY OF MASSACHUSETTS AT AMHERST",1,0,1992,"5062","395.249651","1152","3239","3993",1940,2053,1329,"538",791,0.4077,0.2621,0.3328,0.8112
"5019",166629,"UNIVERSITY OF MASSACHUSETTS-AMHERST",1,0,1993,"5467","442.172","1172","3187","3926",1908,2018,1436,"577",859,0.4502,0.2859,0.3658,0.8118
"5020",166629,"UNIVERSITY OF MASSACHUSETTS-AMHERST",1,0,1995,"5514","487.145","1146","3166","3959",1946,2013,1429,"583",846,0.4347,0.2896,0.3609,0.7997
"5021",166629,"UNIVERSITY OF MASSACHUSETTS-AMHERST",1,0,1996,"5413","501.023","1164","2951","4073",1964,2109,1577,"660",917,0.4669,0.3129,0.3872,0.7245
"5022",166629,"UNIVERSITY OF MASSACHUSETTS-AMHERST",1,0,1997,"5329","543.62","1154","2729","3831",2012,1819,1635,"614",1021,0.5075,0.3375,0.4268,0.7123
"5023",166629,"UNIVERSITY OF MASSACHUSETTS-AMHERST",1,0,1998,"5229","574.743236","1140","2840","3953",2021,1932,1651,"625",1026,0.5077,0.3235,0.4177,0.7184
"5024",166629,"UNIVERSITY OF MASSACHUSETTS-AMHERST",1,0,1999,"1714","569.604","1161","3065","4144",2199,1945,1824,"701",1123,0.5107,0.3604,0.4402,0.7396
"5025",166629,"UNIVERSITY OF MASSACHUSETTS-AMHERST",1,0,2000,"1714","598.259","1156","2933","3803",2086,1717,1768,"667",1101,0.5278,0.3885,0.4649,0.7712
"5026",166629,"UNIVERSITY OF MASSACHUSETTS-AMHERST",1,0,2001,"1714","615.978","1151","3316","4289",2298,1991,2046,"783",1263,0.5496,0.3933,0.477,0.7731
"5027",166629,"UNIVERSITY OF MASSACHUSETTS-AMHERST",1,0,2002,"1714","578.229","1063","2678","3411",1799,1612,1682,"707",975,0.542,0.4386,0.4931,0.7851
"5028",166629,"UNIVERSITY OF MASSACHUSETTS-AMHERST",1,0,2003,"1714","573.142","1078","3237","4149",2060,2089,1958,"850",1108,0.5379,0.4069,0.4719,0.7802
"5029",166629,"UNIVERSITY OF MASSACHUSETTS-AMHERST",1,0,2004,"1714","602.55","1100","3325","4311",2126,2185,2196,"968",1228,0.5776,0.443,0.5094,0.7713
"5030",166629,"University of Massachusetts-Amherst",1,0,2005,"1714","691.482","1148","3541","4510",2316,2194,2268,"970",1298,0.5604,0.4421,0.5029,0.7851
"5031",166629,"University of Massachusetts-Amherst",1,0,2006,"1714","730.497","1168","3116","4265",2174,2091,2259,"1002",1257,0.5782,0.4792,0.5297,0.7306
"5032",166629,"University of Massachusetts Amherst",1,0,2007,"1714","763.047","1175","3165","4374",2321,2053,2504,"1060",1444,0.6221,0.5163,0.5725,0.7236
"5033",166629,"University of Massachusetts Amherst",1,0,2008,"1714","799.926","1180","2869","4256",2200,2056,2594,"1140",1454,0.6609,0.5545,0.6095,0.6741
"5034",166629,"University of Massachusetts Amherst",1,0,2009,"1714","807.314","1180","2653","4215",2175,2040,2703,"1192",1511,0.6947,0.5843,0.6413,0.6294
"5035",166629,"University of Massachusetts Amherst",1,0,2010,"1714","820.854","1173","2958","4543",2296,2247,2986,"1336",1650,0.7186,0.5946,0.6573,0.6511
"5036",166638,"UNIVERSITY OF MASSACHUSETTS AT BOSTON",1,0,1991,"3937","108.559944","445","296","529",270,259,68,"27",41,0.1519,0.1042,0.1285,0.5595
"5037",166638,"UNIVERSITY OF MASSACHUSETTS AT BOSTON",1,0,1992,"4094","108.822716","457","280","534",256,278,48,"18",30,0.1172,0.0647,0.0899,0.5243
"5038",166638,"UNIVERSITY OF MASSACHUSETTS-BOSTON",1,0,1993,"4253","126.910523","473","275","546",253,293,44,"15",29,0.1146,0.0512,0.0806,0.5037
"5039",166638,"UNIVERSITY OF MASSACHUSETTS-BOSTON",1,0,1995,"4405","135.648591","464","229","502",222,280,38,"17",21,0.0946,0.0607,0.0757,0.4562
"5040",166638,"UNIVERSITY OF MASSACHUSETTS-BOSTON",1,0,1996,"4348","141.15793","449","260","538",274,264,55,"14",41,0.1496,0.053,0.1022,0.4833
"5041",166638,"UNIVERSITY OF MASSACHUSETTS-BOSTON",1,0,1997,"4290","147.619652","452","232","533",284,249,65,"25",40,0.1408,0.1004,0.122,0.4353
"5042",166638,"UNIVERSITY OF MASSACHUSETTS-BOSTON",1,0,1998,"4197","153.872213","448","256","579",307,272,69,"29",40,0.1303,0.1066,0.1192,0.4421
"5043",166638,"UNIVERSITY OF MASSACHUSETTS-BOSTON",1,0,1999,"1714","158.262344","456","287","671",368,303,102,"33",69,0.1875,0.1089,0.152,0.4277
"5044",166638,"UNIVERSITY OF MASSACHUSETTS-BOSTON",1,0,2000,"1714","169.795","462","271","593",326,267,91,"14",77,0.2362,0.0524,0.1535,0.457
"5045",166638,"UNIVERSITY OF MASSACHUSETTS-BOSTON",1,0,2001,"1714","184.735","468","277","676",359,317,67,"22",45,0.1253,0.0694,0.0991,0.4098
"5046",166638,"UNIVERSITY OF MASSACHUSETTS-BOSTON",1,0,2002,"1714","188.017","427","218","534",307,227,64,"16",48,0.1564,0.0705,0.1199,0.4082
"5047",166638,"UNIVERSITY OF MASSACHUSETTS-BOSTON",1,0,2003,"1714","192.452","433","260","602",353,249,60,"21",39,0.1105,0.0843,0.0997,0.4319
"5048",166638,"UNIVERSITY OF MASSACHUSETTS-BOSTON",1,0,2004,"1714","200.735","435","216","543",323,220,61,"12",49,0.1517,0.0545,0.1123,0.3978
"5049",166638,"University of Massachusetts-Boston",1,0,2005,"1714","227.57","445","328","723",419,304,100,"34",66,0.1575,0.1118,0.1383,0.4537
"5050",166638,"University of Massachusetts-Boston",1,0,2006,"1714","244.051","435","388","846",484,362,109,"29",80,0.1653,0.0801,0.1288,0.4586
"5051",166638,"University of Massachusetts-Boston",1,0,2007,"1714","257.392","444","419","950",558,392,144,"42",102,0.1828,0.1071,0.1516,0.4411
"5052",166638,"University of Massachusetts-Boston",1,0,2008,"1714","267.615","462","441","972",570,402,154,"60",94,0.1649,0.1493,0.1584,0.4537
"5053",166638,"University of Massachusetts-Boston",1,0,2009,"1714","269.591","499","429","934",545,389,154,"53",101,0.1853,0.1362,0.1649,0.4593
"5054",166638,"University of Massachusetts-Boston",1,0,2010,"1714","277.418","525","459","1067",595,472,194,"55",139,0.2336,0.1165,0.1818,0.4302
"5055",166683,"MASSACHUSETTS INSTITUTE OF TECHNOLOGY",1,0,1991,"16900","1089.212","986","511","1048",367,681,825,"516",309,0.842,0.7577,0.7872,0.4876
"5056",166683,"MASSACHUSETTS INSTITUTE OF TECHNOLOGY",1,0,1992,"18000","1092.549","989","549","1137",398,739,919,"583",336,0.8442,0.7889,0.8083,0.4828
"5057",166683,"MASSACHUSETTS INSTITUTE OF TECHNOLOGY",1,0,1993,"19000","1132.191","989","492","1074",366,708,874,"546",328,0.8962,0.7712,0.8138,0.4581
"5058",166683,"MASSACHUSETTS INSTITUTE OF TECHNOLOGY",1,0,1995,"21000","1167.241","981","546","1115",468,647,921,"517",404,0.8632,0.7991,0.826,0.4897
"5059",166683,"MASSACHUSETTS INSTITUTE OF TECHNOLOGY",1,0,1996,"22000","1223.867","906","359","1065",446,619,875,"498",377,0.8453,0.8045,0.8216,0.3371
"5060",166683,"MASSACHUSETTS INSTITUTE OF TECHNOLOGY",1,0,1997,"23100","1186.573","942","370","1066",405,661,861,"521",340,0.8395,0.7882,0.8077,0.3471
"5061",166683,"MASSACHUSETTS INSTITUTE OF TECHNOLOGY",1,0,1998,"24050","0","958","364","1042",446,596,840,"466",374,0.8386,0.7819,0.8061,0.3493
"5062",166683,"MASSACHUSETTS INSTITUTE OF TECHNOLOGY",1,0,1999,"25000","1287.287","951","369","1049",448,601,863,"473",390,0.8705,0.787,0.8227,0.3518
"5063",166683,"MASSACHUSETTS INSTITUTE OF TECHNOLOGY",1,0,2000,"26050","1289.988","964","347","1010",425,585,825,"468",357,0.84,0.8,0.8168,0.3436
"5064",166683,"MASSACHUSETTS INSTITUTE OF TECHNOLOGY",1,0,2001,"26960","1385.108","977","383","1027",426,601,857,"479",378,0.8873,0.797,0.8345,0.3729
"5065",166683,"MASSACHUSETTS INSTITUTE OF TECHNOLOGY",1,0,2002,"28030","1535.949","1044","340","977",420,557,806,"446",360,0.8571,0.8007,0.825,0.348
"5066",166683,"MASSACHUSETTS INSTITUTE OF TECHNOLOGY",1,0,2003,"29400","1686.573","1043","368","1018",459,559,842,"450",392,0.854,0.805,0.8271,0.3615
"5067",166683,"MASSACHUSETTS INSTITUTE OF TECHNOLOGY",1,0,2004,"30600","1839.905","1055","388","1076",457,619,909,"507",402,0.8796,0.8191,0.8448,0.3606
"5068",166683,"Massachusetts Institute of Technology",1,0,2005,"32100","2035.146","1117","393","995",465,530,847,"436",411,0.8839,0.8226,0.8513,0.395
"5069",166683,"Massachusetts Institute of Technology",1,0,2006,"33400","2181.696","1202","373","1001",447,554,837,"457",380,0.8501,0.8249,0.8362,0.3726
"5070",166683,"Massachusetts Institute of Technology",1,0,2007,"34750","2207.621","1200","412","1068",492,576,892,"463",429,0.872,0.8038,0.8352,0.3858
"5071",166683,"Massachusetts Institute of Technology",1,0,2008,"36140","2301.687","1215","359","1046",487,559,849,"441",408,0.8378,0.7889,0.8117,0.3432
"5072",166683,"Massachusetts Institute of Technology",1,0,2009,"37510","2461.286","1200","390","1066",477,589,874,"462",412,0.8637,0.7844,0.8199,0.3659
"5073",166683,"Massachusetts Institute of Technology",1,0,2010,"38940","2382.566","1189","416","1063",479,584,898,"478",420,0.8768,0.8185,0.8448,0.3913
"5074",167288,"NORTH ADAMS STATE COLLEGE",1,0,1991,"3218","16.50601","98","397","423",211,212,81,"26",55,0.2607,0.1226,0.1915,0.9385
"5075",167288,"NORTH ADAMS STATE COLLEGE",1,0,1992,"3345","18.156114","90","187","203",105,98,49,"18",31,0.2952,0.1837,0.2414,0.9212
"5076",167288,"NORTH ADAMS STATE COLLEGE",1,0,1993,"3493","17.624397","91","205","228",107,121,39,"11",28,0.2617,0.0909,0.1711,0.8991
"5077",167288,"NORTH ADAMS STATE COLLEGE",1,0,1995,"3555","19.713024","95","272","290",171,119,80,"15",65,0.3801,0.1261,0.2759,0.9379
"5078",167288,"NORTH ADAMS STATE COLLEGE",1,0,1996,"3485","22.890453","88","283","311",176,135,101,"35",66,0.375,0.2593,0.3248,0.91
"5079",167288,"MASSACHUSETTS COLLEGE OF LIBERAL ARTS",1,0,1997,"3437","24.531121","90","241","274",152,122,89,"30",59,0.3882,0.2459,0.3248,0.8796
"5080",167288,"MASSACHUSETTS COLLEGE OF LIBERAL ARTS",1,0,1998,"3377","25.210961","84","172","209",131,78,66,"17",49,0.374,0.2179,0.3158,0.823
"5081",167288,"MASSACHUSETTS COLLEGE OF LIBERAL ARTS",1,0,1999,"1090","25.638632","84","181","220",135,85,78,"27",51,0.3778,0.3176,0.3545,0.8227
"5082",167288,"MASSACHUSETTS COLLEGE OF LIBERAL ARTS",1,0,2000,"1090","26.989196","85","202","224",126,98,80,"32",48,0.381,0.3265,0.3571,0.9018
"5083",167288,"MASSACHUSETTS COLLEGE OF LIBERAL ARTS",1,0,2001,"1030","27.142712","86","232","268",171,97,85,"26",59,0.345,0.268,0.3172,0.8657
"5084",167288,"MASSACHUSETTS COLLEGE OF LIBERAL ARTS",1,0,2002,"1030","27.314897","80","240","265",159,106,106,"38",68,0.4277,0.3585,0.4,0.9057
"5085",167288,"MASSACHUSETTS COLLEGE OF LIBERAL ARTS",1,0,2003,"1030","26.627463","80","221","244",149,95,91,"28",63,0.4228,0.2947,0.373,0.9057
"5086",167288,"MASSACHUSETTS COLLEGE OF LIBERAL ARTS",1,0,2004,"1030","27.158548","76","231","263",161,102,99,"28",71,0.441,0.2745,0.3764,0.8783
"5087",167288,"Massachusetts College of Liberal Arts",1,0,2005,"1030","30.3899","85","238","271",177,94,104,"36",68,0.3842,0.383,0.3838,0.8782
"5088",167288,"Massachusetts College of Liberal Arts",1,0,2006,"1030","33.401714","87","246","299",175,124,94,"33",61,0.3486,0.2661,0.3144,0.8227
"5089",167288,"Massachusetts College of Liberal Arts",1,0,2007,"1030","36.271288","84","285","334",207,127,128,"37",91,0.4396,0.2913,0.3832,0.8533
"5090",167288,"Massachusetts College of Liberal Arts",1,0,2008,"1030","38.789498","90","265","325",193,132,109,"38",71,0.3679,0.2879,0.3354,0.8154
"5091",167288,"Massachusetts College of Liberal Arts",1,0,2009,"1030","37.821348","84","265","347",229,118,119,"40",79,0.345,0.339,0.3429,0.7637
"5092",167288,"Massachusetts College of Liberal Arts",1,0,2010,"1030","38.649694","89","249","351",225,126,133,"41",92,0.4089,0.3254,0.3789,0.7094
"5093",167987,"UNIVERSITY OF MASSACHUSETTS AT DARTMOUTH",1,0,1991,"3053","62.118456","313","878","989",515,474,285,"109",176,0.3417,0.23,0.2882,0.8878
"5094",167987,"UNIVERSITY OF MASSACHUSETTS DARTMOUTH",1,0,1992,"3163","61.843368","315","800","869",453,416,223,"75",148,0.3267,0.1803,0.2566,0.9206
"5095",167987,"UNIVERSITY OF MASSACHUSETTS-DARTMOUTH",1,0,1993,"3568","63.036006","330","853","985",489,496,234,"87",147,0.3006,0.1754,0.2376,0.866
"5096",167987,"UNIVERSITY OF MASSACHUSETTS-DARTMOUTH",1,0,1995,"4122","80.044691","333","709","886",420,466,253,"90",163,0.3881,0.1931,0.2856,0.8002
"5097",167987,"UNIVERSITY OF MASSACHUSETTS-DARTMOUTH",1,0,1996,"4151","85.30356","326","619","825",429,396,240,"71",169,0.3939,0.1793,0.2909,0.7503
"5098",167987,"UNIVERSITY OF MASSACHUSETTS-DARTMOUTH",1,0,1997,"4254","85.371777","317","638","835",440,395,217,"72",145,0.3295,0.1823,0.2599,0.7641
"5099",167987,"UNIVERSITY OF MASSACHUSETTS-DARTMOUTH",1,0,1998,"4171","94.389876","334","853","1086",535,551,284,"102",182,0.3402,0.1851,0.2615,0.7855
"5100",167987,"UNIVERSITY OF MASSACHUSETTS-DARTMOUTH",1,0,1999,"1417","101.109373","340","891","1131",556,575,316,"126",190,0.3417,0.2191,0.2794,0.7878
"5101",167987,"UNIVERSITY OF MASSACHUSETTS-DARTMOUTH",1,0,2000,"1417","108.148","347.5","1040","1300",642,658,363,"142",221,0.3442,0.2158,0.2792,0.8
"5102",167987,"UNIVERSITY OF MASSACHUSETTS-DARTMOUTH",1,0,2001,"1417","129.29256","355","924","1148",575,573,310,"125",185,0.3217,0.2182,0.27,0.8049
"5103",167987,"UNIVERSITY OF MASSACHUSETTS-DARTMOUTH",1,0,2002,"1417","131.071","321","1351","1699",825,874,452,"191",261,0.3164,0.2185,0.266,0.7952
"5104",167987,"UNIVERSITY OF MASSACHUSETTS-DARTMOUTH",1,0,2003,"1417","122.249","329","1215","1510",764,746,489,"187",302,0.3953,0.2507,0.3238,0.8046
"5105",167987,"UNIVERSITY OF MASSACHUSETTS-DARTMOUTH",1,0,2004,"1417","137.248","340","1173","1456",715,741,416,"147",269,0.3762,0.1984,0.2857,0.8056
"5106",167987,"University of Massachusetts-Dartmouth",1,0,2005,"1417","160.281","355","1394","1703",816,887,505,"212",293,0.3591,0.239,0.2965,0.8186
"5107",167987,"University of Massachusetts-Dartmouth",1,0,2006,"1417","173.341","359","1460","1763",866,897,559,"248",311,0.3591,0.2765,0.3171,0.8281
"5108",167987,"University of Massachusetts-Dartmouth",1,0,2007,"1417","192.085","365","1590","1901",859,1042,575,"262",313,0.3644,0.2514,0.3025,0.8364
"5109",167987,"University of Massachusetts-Dartmouth",1,0,2008,"1417","204.056","368","1447","1768",837,931,485,"210",275,0.3286,0.2256,0.2743,0.8184
"5110",167987,"University of Massachusetts-Dartmouth",1,0,2009,"1417","195.692","369","1400","1780",822,958,494,"212",282,0.3431,0.2213,0.2775,0.7865
"5111",167987,"University of Massachusetts-Dartmouth",1,0,2010,"1417","200.57","375","1085","1667",765,902,471,"208",263,0.3438,0.2306,0.2825,0.6509
"5112",167996,"STONEHILL COLLEGE",1,0,1991,"10240","25.685119","109","494","518",279,239,359,"160",199,0.7133,0.6695,0.6931,0.9537
"5113",167996,"STONEHILL COLLEGE",1,0,1992,"10820","35.017223","112","494","514",314,200,387,"135",252,0.8025,0.675,0.7529,0.9611
"5114",167996,"STONEHILL COLLEGE",1,0,1993,"11420","35.586054","116","552","585",331,254,411,"159",252,0.7613,0.626,0.7026,0.9436
"5115",167996,"STONEHILL COLLEGE",1,0,1995,"13284","40.379959","118","499","547",328,219,443,"166",277,0.8445,0.758,0.8099,0.9122
"5116",167996,"STONEHILL COLLEGE",1,0,1996,"14170","37.037074","118","509","551",310,241,419,"169",250,0.8065,0.7012,0.7604,0.9238
"5117",167996,"STONEHILL COLLEGE",1,0,1997,"14856","44.055882","119","486","530",287,243,429,"185",244,0.8502,0.7613,0.8094,0.917
"5118",167996,"STONEHILL COLLEGE",1,0,1998,"15730","37.910276","122","495","531",313,218,421,"168",253,0.8083,0.7706,0.7928,0.9322
"5119",167996,"STONEHILL COLLEGE",1,0,1999,"15736","40.663683","123","522","572",333,239,458,"185",273,0.8198,0.7741,0.8007,0.9126
"5120",167996,"STONEHILL COLLEGE",1,0,2000,"16680","42.372469","125","582","629",363,266,517,"210",307,0.8457,0.7895,0.8219,0.9253
"5121",167996,"STONEHILL COLLEGE",1,0,2001,"17680","45.531118","127","522","586",328,258,479,"203",276,0.8415,0.7868,0.8174,0.8908
"5122",167996,"STONEHILL COLLEGE",1,0,2002,"19094","47.927811","125","517","566",342,224,448,"160",288,0.8421,0.7143,0.7915,0.9134
"5123",167996,"STONEHILL COLLEGE",1,0,2003,"20432","52.00412","130","496","565",307,258,451,"193",258,0.8404,0.7481,0.7982,0.8779
"5124",167996,"STONEHILL COLLEGE",1,0,2004,"22068","56.058759","133","554","614",384,230,494,"171",323,0.8411,0.7435,0.8046,0.9023
"5125",167996,"Stonehill College",1,0,2005,"24160","59.624546","136","557","616",354,262,478,"190",288,0.8136,0.7252,0.776,0.9042
"5126",167996,"Stonehill College",1,0,2006,"26345","64.352392","135","542","594",363,231,469,"173",296,0.8154,0.7489,0.7896,0.9125
"5127",167996,"Stonehill College",1,0,2007,"28065","66.312241","145","615","659",409,250,539,"199",340,0.8313,0.796,0.8179,0.9332
"5128",167996,"Stonehill College",1,0,2008,"30150","72.209311","148","570","634",384,250,503,"185",318,0.8281,0.74,0.7934,0.8991
"5129",167996,"Stonehill College",1,0,2009,"31210","76.842067","152","611","683",397,286,564,"219",345,0.869,0.7657,0.8258,0.8946
"5130",167996,"Stonehill College",1,0,2010,"32620","79.369464","155","629","727",469,258,556,"180",376,0.8017,0.6977,0.7648,0.8652
"5131",168005,"SUFFOLK UNIVERSITY",1,0,1991,"8535","50.029768","214","299","421",214,207,137,"55",82,0.3832,0.2657,0.3254,0.7102
"5132",168005,"SUFFOLK UNIVERSITY",1,0,1992,"9150","54.70796","226","274","382",190,192,113,"43",70,0.3684,0.224,0.2958,0.7173
"5133",168005,"SUFFOLK UNIVERSITY",1,0,1993,"9940","60.320262","232","207","357",185,172,114,"43",71,0.3838,0.25,0.3193,0.5798
"5134",168005,"SUFFOLK UNIVERSITY",1,0,1995,"11450","71.451979","233","231","386",214,172,110,"39",71,0.3318,0.2267,0.285,0.5984
"5135",168005,"SUFFOLK UNIVERSITY",1,0,1996,"12200","75.266884","246","314","507",288,219,140,"46",94,0.3264,0.21,0.2761,0.6193
"5136",168005,"SUFFOLK UNIVERSITY",1,0,1997,"12900","73.180517","249","340","525",299,226,198,"70",128,0.4281,0.3097,0.3771,0.6476
"5137",168005,"SUFFOLK UNIVERSITY",1,0,1998,"13740","79.998004","258","385","620",355,265,208,"75",133,0.3746,0.283,0.3355,0.621
"5138",168005,"SUFFOLK UNIVERSITY",1,0,1999,"14580","87.6075","264","423","672",381,291,240,"72",168,0.4409,0.2474,0.3571,0.6295
"5139",168005,"SUFFOLK UNIVERSITY",1,0,2000,"15538","98.103575","277","417","645",371,274,243,"87",156,0.4205,0.3175,0.3767,0.6465
"5140",168005,"SUFFOLK UNIVERSITY",1,0,2001,"16536","107.406389","290","433","710",393,317,285,"116",169,0.43,0.3659,0.4014,0.6099
"5141",168005,"SUFFOLK UNIVERSITY",1,0,2002,"17610","118.578041","295","497","787",481,306,307,"88",219,0.4553,0.2876,0.3901,0.6315
"5142",168005,"SUFFOLK UNIVERSITY",1,0,2003,"18670","126.618514","317","614","914",542,372,320,"117",203,0.3745,0.3145,0.3501,0.6718
"5143",168005,"SUFFOLK UNIVERSITY",1,0,2004,"19790","141.113917","321","643","1014",589,425,350,"123",227,0.3854,0.2894,0.3452,0.6341
"5144",168005,"Suffolk University",1,0,2005,"21140","173.59321","339","768","1127",682,445,416,"143",273,0.4003,0.3213,0.3691,0.6815
"5145",168005,"Suffolk University",1,0,2006,"22610","175.147177","355","861","1286",735,551,520,"197",323,0.4395,0.3575,0.4044,0.6695
"5146",168005,"Suffolk University",1,0,2007,"24190","191.692118","388","821","1308",752,556,531,"218",313,0.4162,0.3921,0.406,0.6277
"5147",168005,"Suffolk University",1,0,2008,"25850","215.686177","400","884","1557",920,637,607,"215",392,0.4261,0.3375,0.3899,0.5678
"5148",168005,"Suffolk University",1,0,2009,"27100","226.66086","396","588","1257",736,521,510,"182",328,0.4457,0.3493,0.4057,0.4678
"5149",168005,"Suffolk University",1,0,2010,"28414","230.625472","387","727","1307",739,568,582,"221",361,0.4885,0.3891,0.4453,0.5562
"5150",168148,"TUFTS UNIVERSITY",1,0,1991,"16755","252.669491","418","729","1155",640,515,870,"378",492,0.7688,0.734,0.7532,0.6312
"5151",168148,"TUFTS UNIVERSITY",1,0,1992,"17897","266.344599","421","782","1211",638,573,921,"426",495,0.7759,0.7435,0.7605,0.6457
"5152",168148,"TUFTS UNIVERSITY",1,0,1993,"18793","283.763467","427","750","1193",632,561,923,"422",501,0.7927,0.7522,0.7737,0.6287
"5153",168148,"TUFTS UNIVERSITY",1,0,1995,"21086","318.530682","517","650","1147",594,553,944,"439",505,0.8502,0.7939,0.823,0.5667
"5154",168148,"TUFTS UNIVERSITY",1,0,1996,"21957","333.268486","526","639","1179",597,582,950,"452",498,0.8342,0.7766,0.8058,0.542
"5155",168148,"TUFTS UNIVERSITY",1,0,1997,"22811","304.28626","479","695","1270",659,611,1063,"498",565,0.8574,0.8151,0.837,0.5472
"5156",168148,"TUFTS UNIVERSITY",1,0,1998,"23709","322.396329","480","684","1236",668,568,1040,"466",574,0.8593,0.8204,0.8414,0.5534
"5157",168148,"TUFTS UNIVERSITY",1,0,1999,"24126","345.710864","529","758","1345",741,604,1134,"497",637,0.8596,0.8228,0.8431,0.5636
"5158",168148,"TUFTS UNIVERSITY",1,0,2000,"25062","359.09279","533.5","618","1181",637,544,1022,"464",558,0.876,0.8529,0.8654,0.5233
"5159",168148,"TUFTS UNIVERSITY",1,0,2001,"26213","389.73107","538","601","1163",640,523,970,"426",544,0.85,0.8145,0.834,0.5168
"5160",168148,"TUFTS UNIVERSITY",1,0,2002,"27450","411.335756","564","676","1276",736,540,1094,"455",639,0.8682,0.8426,0.8574,0.5298
"5161",168148,"TUFTS UNIVERSITY",1,0,2003,"28896","448.246484","579","696","1281",664,617,1087,"507",580,0.8735,0.8217,0.8486,0.5433
"5162",168148,"TUFTS UNIVERSITY",1,0,2004,"30377","477.536745","584","748","1273",635,638,1101,"537",564,0.8882,0.8417,0.8649,0.5876
"5163",168148,"Tufts University",1,0,2005,"31828","503.994843","615","806","1364",682,682,1159,"559",600,0.8798,0.8196,0.8497,0.5909
"5164",168148,"Tufts University",1,0,2006,"33906","538.830616","626","779","1280",648,632,1120,"543",577,0.8904,0.8592,0.875,0.6086
"5165",168148,"Tufts University",1,0,2007,"35842","579.059557","629","791","1370",703,667,1194,"570",624,0.8876,0.8546,0.8715,0.5774
"5166",168148,"Tufts University",1,0,2008,"37952","614.945648","623","758","1298",702,596,1141,"511",630,0.8974,0.8574,0.879,0.584
"5167",168148,"Tufts University",1,0,2009,"39432","656.212472","636","789","1302",669,633,1141,"542",599,0.8954,0.8562,0.8763,0.606
"5168",168148,"Tufts University",1,0,2010,"40664","670.337492","658","772","1313",649,664,1138,"560",578,0.8906,0.8434,0.8667,0.588
"5169",168254,"WESTERN NEW ENGLAND COLLEGE",1,0,1991,"7962","37.149521","144","404","428",166,262,165,"81",84,0.506,0.3092,0.3855,0.9439
"5170",168254,"WESTERN NEW ENGLAND COLLEGE",1,0,1992,"8426","37.739629","135","395","431",182,249,145,"82",63,0.3462,0.3293,0.3364,0.9165
"5171",168254,"WESTERN NEW ENGLAND COLLEGE",1,0,1993,"9314","37.058742","137","356","392",149,243,120,"64",56,0.3758,0.2634,0.3061,0.9082
"5172",168254,"WESTERN NEW ENGLAND COLLEGE",1,0,1995,"10310","38.644916","138","484","580",222,358,223,"116",107,0.482,0.324,0.3845,0.8345
"5173",168254,"WESTERN NEW ENGLAND COLLEGE",1,0,1996,"10810","43.639487","134","391","478",174,304,173,"104",69,0.3966,0.3421,0.3619,0.818
"5174",168254,"WESTERN NEW ENGLAND COLLEGE",1,0,1997,"11448","40.899509","134","418","526",220,306,210,"98",112,0.5091,0.3203,0.3992,0.7947
"5175",168254,"WESTERN NEW ENGLAND COLLEGE",1,0,1998,"12130","42.825978","136","456","535",238,297,231,"119",112,0.4706,0.4007,0.4318,0.8523
"5176",168254,"WESTERN NEW ENGLAND COLLEGE",1,0,1999,"11954","46.171222","139","568","618",271,347,268,"145",123,0.4539,0.4179,0.4337,0.9191
"5177",168254,"WESTERN NEW ENGLAND COLLEGE",1,0,2000,"14354","48.83394","146.5","498","560",262,298,268,"140",128,0.4885,0.4698,0.4786,0.8893
"5178",168254,"WESTERN NEW ENGLAND COLLEGE",1,0,2001,"14567","51.541286","154","562","654",287,367,346,"176",170,0.5923,0.4796,0.5291,0.8593
"5179",168254,"WESTERN NEW ENGLAND COLLEGE",1,0,2002,"16144","55.010349","154","586","682",301,381,298,"151",147,0.4884,0.3963,0.437,0.8592
"5180",168254,"WESTERN NEW ENGLAND COLLEGE",1,0,2003,"19460","58.873768","157","583","672",279,393,275,"148",127,0.4552,0.3766,0.4092,0.8676
"5181",168254,"WESTERN NEW ENGLAND COLLEGE",1,0,2004,"20570","65.113761","159","700","798",302,496,353,"197",156,0.5166,0.3972,0.4424,0.8772
"5182",168254,"Western New England College",1,0,2005,"21600","68.760105","164","575","662",244,418,341,"188",153,0.627,0.4498,0.5151,0.8686
"5183",168254,"Western New England College",1,0,2006,"22982","74.599349","169","645","719",259,460,367,"211",156,0.6023,0.4587,0.5104,0.8971
"5184",168254,"Western New England College",1,0,2007,"24224","75.124694","177","628","713",293,420,372,"193",179,0.6109,0.4595,0.5217,0.8808
"5185",168254,"Western New England College",1,0,2008,"25556","79.161149","180","642","735",281,454,370,"206",164,0.5836,0.4537,0.5034,0.8735
"5186",168254,"Western New England College",1,0,2009,"26822","83.994051","188","558","683",257,426,322,"187",135,0.5253,0.439,0.4714,0.817
"5187",168254,"Western New England University",1,0,2010,"27762","86.158261","194","589","736",303,433,373,"213",160,0.5281,0.4919,0.5068,0.8003
"5188",168281,"WHEATON COLLEGE",1,0,1991,"15650","30.320389","89","269","319",210,109,222,"62",160,0.7619,0.5688,0.6959,0.8433
"5189",168281,"WHEATON COLLEGE",1,0,1992,"16650","33.025832","93","349","412",274,138,265,"87",178,0.6496,0.6304,0.6432,0.8471
"5190",168281,"WHEATON COLLEGE",1,0,1993,"17670","35.161998","91","341","417",300,117,263,"71",192,0.64,0.6068,0.6307,0.8177
"5191",168281,"WHEATON COLLEGE",1,0,1995,"19020","38.403185","93","312","359",249,110,241,"72",169,0.6787,0.6545,0.6713,0.8691
"5192",168281,"WHEATON COLLEGE",1,0,1996,"19740","40.193948","92","369","445",315,130,295,"82",213,0.6762,0.6308,0.6629,0.8292
"5193",168281,"WHEATON COLLEGE",1,0,1997,"20820","34.401519","93","364","438",277,161,298,"97",201,0.7256,0.6025,0.6804,0.8311
"5194",168281,"WHEATON COLLEGE",1,0,1998,"21840","38.769744","93","347","435",294,141,291,"79",212,0.7211,0.5603,0.669,0.7977
"5195",168281,"WHEATON COLLEGE",1,0,1999,"22950","40.844581","96","351","427",281,146,298,"85",213,0.758,0.5822,0.6979,0.822
"5196",168281,"WHEATON COLLEGE",1,0,2000,"24225","42.702119","108","378","450",286,164,318,"104",214,0.7483,0.6341,0.7067,0.84
"5197",168281,"WHEATON COLLEGE",1,0,2001,"25565","47.167677","120","397","494",328,166,364,"114",250,0.7622,0.6867,0.7368,0.8036
"5198",168281,"WHEATON COLLEGE",1,0,2002,"27105","52.038507","122","335","411",255,156,316,"106",210,0.8235,0.6795,0.7689,0.8151
"5199",168281,"WHEATON COLLEGE",1,0,2003,"28675","53.650114","121","338","445",286,159,324,"104",220,0.7692,0.6541,0.7281,0.7596
"5200",168281,"WHEATON COLLEGE",1,0,2004,"30355","57.377001","126","343","443",280,163,310,"114",196,0.7,0.6994,0.6998,0.7743
"5201",168281,"Wheaton College",1,0,2005,"32115","60.631671","129","371","467",301,166,341,"119",222,0.7375,0.7169,0.7302,0.7944
"5202",168281,"Wheaton College",1,0,2006,"34365","64.419174","127","332","410",239,171,317,"125",192,0.8033,0.731,0.7732,0.8098
"5203",168281,"Wheaton College",1,0,2007,"36430","66.969614","141","301","418",262,156,297,"98",199,0.7595,0.6282,0.7105,0.7201
"5204",168281,"Wheaton College",1,0,2008,"38585","71.25225","144","319","420",259,161,313,"116",197,0.7606,0.7205,0.7452,0.7595
"5205",168281,"Wheaton College",1,0,2009,"39565","72.237487","145","296","423",261,162,322,"118",204,0.7816,0.7284,0.7612,0.6998
"5206",168281,"Wheaton College",1,0,2010,"40790","71.487402","148","301","450",306,144,342,"103",239,0.781,0.7153,0.76,0.6689
"5207",168342,"WILLIAMS COLLEGE",1,0,1991,"16785","72.653599","218","365","517",246,271,467,"238",229,0.9309,0.8782,0.9033,0.706
"5208",168342,"WILLIAMS COLLEGE",1,0,1992,"17840","72.652013","213","377","518",258,260,454,"225",229,0.8876,0.8654,0.8764,0.7278
"5209",168342,"WILLIAMS COLLEGE",1,0,1993,"18795","75.644992","213","376","527",269,258,467,"222",245,0.9108,0.8605,0.8861,0.7135
"5210",168342,"WILLIAMS COLLEGE",1,0,1995,"20790","80.440102","211","383","524",243,281,453,"237",216,0.8889,0.8434,0.8645,0.7309
"5211",168342,"WILLIAMS COLLEGE",1,0,1996,"21910","92.111868","215","410","553",276,277,507,"248",259,0.9384,0.8953,0.9168,0.7414
"5212",168342,"WILLIAMS COLLEGE",1,0,1997,"23050","83.624831","212","386","544",266,278,499,"253",246,0.9248,0.9101,0.9173,0.7096
"5213",168342,"WILLIAMS COLLEGE",1,0,1998,"23860","87.024325","217","386","537",265,272,492,"252",240,0.9057,0.9265,0.9162,0.7188
"5214",168342,"WILLIAMS COLLEGE",1,0,1999,"24619","94.447165","219","384","544",264,280,487,"244",243,0.9205,0.8714,0.8952,0.7059
"5215",168342,"WILLIAMS COLLEGE",1,0,2000,"24619","99.997857","220","387","528",260,268,483,"240",243,0.9346,0.8955,0.9148,0.733
"5216",168342,"WILLIAMS COLLEGE",1,0,2001,"25352","113.763564","221","372","520",257,263,475,"236",239,0.93,0.8973,0.9135,0.7154
"5217",168342,"WILLIAMS COLLEGE",1,0,2002,"26326","116.603408","271","360","539",291,248,492,"226",266,0.9141,0.9113,0.9128,0.6679
"5218",168342,"WILLIAMS COLLEGE",1,0,2003,"27890","126.30238","247","344","533",272,261,497,"245",252,0.9265,0.9387,0.9325,0.6454
"5219",168342,"WILLIAMS COLLEGE",1,0,2004,"29786","135.05659","247","349","532",272,260,484,"234",250,0.9191,0.9,0.9098,0.656
"5220",168342,"Williams College",1,0,2005,"31548","144.333549","275","343","536",280,256,477,"226",251,0.8964,0.8828,0.8899,0.6399
"5221",168342,"Williams College",1,0,2006,"33478","157.777313","285","342","533",280,253,484,"223",261,0.9321,0.8814,0.9081,0.6417
"5222",168342,"Williams College",1,0,2007,"35438","166.037295","270","336","539",258,281,483,"248",235,0.9109,0.8826,0.8961,0.6234
"5223",168342,"Williams College",1,0,2008,"37400","181.192585","278","316","538",284,254,476,"222",254,0.8944,0.874,0.8848,0.5874
"5224",168342,"Williams College",1,0,2009,"39250","203.833028","275","330","545",293,252,481,"216",265,0.9044,0.8571,0.8826,0.6055
"5225",168342,"Williams College",1,0,2010,"41190","175.615673","275","324","548",288,260,471,"215",256,0.8889,0.8269,0.8595,0.5912
"5226",168546,"ALBION COLLEGE",1,0,1991,"11064","30.312814","111","504","548",266,282,349,"179",170,0.6391,0.6348,0.6369,0.9197
"5227",168546,"ALBION COLLEGE",1,0,1992,"12294","32.725491","112","470","508",242,266,330,"173",157,0.6488,0.6504,0.6496,0.9252
"5228",168546,"ALBION COLLEGE",1,0,1993,"13676","36.685478","109","411","488",251,237,270,"145",125,0.498,0.6118,0.5533,0.8422
"5229",168546,"ALBION COLLEGE",1,0,1995,"15478","41.408794","104","400","473",238,235,334,"150",184,0.7731,0.6383,0.7061,0.8457
"5230",168546,"ALBION COLLEGE",1,0,1996,"16160","40.76346","105","358","433",227,206,278,"120",158,0.696,0.5825,0.642,0.8268
"5231",168546,"ALBION COLLEGE",1,0,1997,"16806","30.296667","106","391","474",260,214,301,"114",187,0.7192,0.5327,0.635,0.8249
"5232",168546,"ALBION COLLEGE",1,0,1998,"17712","32.086676","110","380","448",248,200,298,"126",172,0.6935,0.63,0.6652,0.8482
"5233",168546,"ALBION COLLEGE",1,0,1999,"18234","33.720732","107","345","411",219,192,275,"110",165,0.7534,0.5729,0.6691,0.8394
"5234",168546,"ALBION COLLEGE",1,0,2000,"18690","35.368228","114","328","405",253,152,270,"86",184,0.7273,0.5658,0.6667,0.8099
"5235",168546,"ALBION COLLEGE",1,0,2001,"19390","41.752136","121","390","450",226,224,267,"115",152,0.6726,0.5134,0.5933,0.8667
"5236",168546,"ALBION COLLEGE",1,0,2002,"20458","42.306851","123","472","525",293,232,330,"129",201,0.686,0.556,0.6286,0.899
"5237",168546,"ALBION COLLEGE",1,0,2003,"21692","43.345552","118","443","486",263,223,306,"118",188,0.7148,0.5291,0.6296,0.9115
"5238",168546,"ALBION COLLEGE",1,0,2004,"22650","43.333779","131","490","559",310,249,358,"149",209,0.6742,0.5984,0.6404,0.8766
"5239",168546,"Albion College",1,0,2005,"24012","46.15186","141","512","571",315,256,372,"160",212,0.673,0.625,0.6515,0.8967
"5240",168546,"Albion College",1,0,2006,"25668","48.576676","135","413","480",260,220,297,"118",179,0.6885,0.5364,0.6188,0.8604
"5241",168546,"Albion College",1,0,2007,"27054","49.239667","135","444","500",258,242,322,"144",178,0.6899,0.595,0.644,0.888
"5242",168546,"Albion College",1,0,2008,"28380","51.869186","143","423","485",242,243,297,"137",160,0.6612,0.5638,0.6124,0.8722
"5243",168546,"Albion College",1,0,2009,"29488","55.555207","125","345","434",218,216,241,"106",135,0.6193,0.4907,0.5553,0.7949
"5244",168546,"Albion College",1,0,2010,"30650","52.561178","114","322","383",196,187,235,"102",133,0.6786,0.5455,0.6136,0.8407
"5245",168786,"AQUINAS COLLEGE",1,0,1991,"8960","21.411712","83","197","231",134,97,65,"26",39,0.291,0.268,0.2814,0.8528
"5246",168786,"AQUINAS COLLEGE",1,0,1992,"9722","20.66474","87","191","233",162,71,50,"14",36,0.2222,0.1972,0.2146,0.8197
"5247",168786,"AQUINAS COLLEGE",1,0,1993,"10402","22.105266","90","195","219",152,67,67,"14",53,0.3487,0.209,0.3059,0.8904
"5248",168786,"AQUINAS COLLEGE",1,0,1995,"11852","22.038467","79","222","241",139,102,69,"28",41,0.295,0.2745,0.2863,0.9212
"5249",168786,"AQUINAS COLLEGE",1,0,1996,"12534","23.139554","76","251","283",177,106,92,"28",64,0.3616,0.2642,0.3251,0.8869
"5250",168786,"AQUINAS COLLEGE",1,0,1997,"12910","19.383956","72","310","329",204,125,79,"30",49,0.2402,0.24,0.2401,0.9422
"5251",168786,"AQUINAS COLLEGE",1,0,1998,"13168","20.725919","82","317","346",213,133,75,"23",52,0.2441,0.1729,0.2168,0.9162
"5252",168786,"AQUINAS COLLEGE",1,0,1999,"13366","23.841906","82","318","347",227,120,93,"32",61,0.2687,0.2667,0.268,0.9164
"5253",168786,"AQUINAS COLLEGE",1,0,2000,"14034","26.602707","89","337","362",244,118,89,"24",65,0.2664,0.2034,0.2459,0.9309
"5254",168786,"AQUINAS COLLEGE",1,0,2001,"14876","26.203498","96","304","321",227,94,107,"29",78,0.3436,0.3085,0.3333,0.947
"5255",168786,"AQUINAS COLLEGE",1,0,2002,"15620","27.52189","95","310","346",216,130,85,"25",60,0.2778,0.1923,0.2457,0.896
"5256",168786,"AQUINAS COLLEGE",1,0,2003,"16400","28.370844","96","264","284",182,102,94,"31",63,0.3462,0.3039,0.331,0.9296
"5257",168786,"AQUINAS COLLEGE",1,0,2004,"16992","29.796026","94","284","316",199,117,119,"45",74,0.3719,0.3846,0.3766,0.8987
"5258",168786,"Aquinas College",1,0,2005,"17926","28.978369","94","317","364",240,124,160,"49",111,0.4625,0.3952,0.4396,0.8709
"5259",168786,"Aquinas College",1,0,2006,"19000","29.840191","92","332","387",252,135,192,"67",125,0.496,0.4963,0.4961,0.8579
"5260",168786,"Aquinas College",1,0,2007,"20048","30.303751","86","361","410",269,141,124,"35",89,0.3309,0.2482,0.3024,0.8805
"5261",168786,"Aquinas College",1,0,2008,"21150","32.12669","89","401","456",283,173,138,"43",95,0.3357,0.2486,0.3026,0.8794
"5262",168786,"Aquinas College",1,0,2009,"22314","34.423854","90","349","402",271,131,158,"46",112,0.4133,0.3511,0.393,0.8682
"5263",168786,"Aquinas College",1,0,2010,"23206","33.38106","92","365","428",255,173,140,"53",87,0.3412,0.3064,0.3271,0.8528
"5264",169080,"CALVIN COLLEGE",1,0,1991,"8100","52.11842","236","751","858",489,369,412,"168",244,0.499,0.4553,0.4802,0.8753
"5265",169080,"CALVIN COLLEGE",1,0,1992,"8630","52.779428","225","716","803",474,329,369,"145",224,0.4726,0.4407,0.4595,0.8917
"5266",169080,"CALVIN COLLEGE",1,0,1993,"9450","53.268654","212","785","908",524,384,471,"194",277,0.5286,0.5052,0.5187,0.8645
"5267",169080,"CALVIN COLLEGE",1,0,1995,"10995","58.869482","238","915","1013",571,442,506,"215",291,0.5096,0.4864,0.4995,0.9033
"5268",169080,"CALVIN COLLEGE",1,0,1996,"11655","64.539711","258","846","960",565,395,545,"209",336,0.5947,0.5291,0.5677,0.8812
"5269",169080,"CALVIN COLLEGE",1,0,1997,"12225","56.669918","261","940","1053",614,439,595,"243",352,0.5733,0.5535,0.5651,0.8927
"5270",169080,"CALVIN COLLEGE",1,0,1998,"12915","58.696797","266","847","974",536,438,559,"236",323,0.6026,0.5388,0.5739,0.8696
"5271",169080,"CALVIN COLLEGE",1,0,1999,"13420","62.275256","273","914","1059",591,468,574,"225",349,0.5905,0.4808,0.542,0.8631
"5272",169080,"CALVIN COLLEGE",1,0,2000,"14040","66.853262","282","893","1050",594,456,585,"241",344,0.5791,0.5285,0.5571,0.8505
"5273",169080,"CALVIN COLLEGE",1,0,2001,"14870","73.680268","291","863","1026",601,425,571,"214",357,0.594,0.5035,0.5565,0.8411
"5274",169080,"CALVIN COLLEGE",1,0,2002,"15750","78.809777","300","905","1045",577,468,586,"228",358,0.6205,0.4872,0.5608,0.866
"5275",169080,"CALVIN COLLEGE",1,0,2003,"16775","84.763018","302","876","1041",577,464,572,"230",342,0.5927,0.4957,0.5495,0.8415
"5276",169080,"CALVIN COLLEGE",1,0,2004,"17770","90.980439","304","766","899",467,432,524,"245",279,0.5974,0.5671,0.5829,0.8521
"5277",169080,"Calvin College",1,0,2005,"18925","94.428657","309","866","1000",564,436,598,"232",366,0.6489,0.5321,0.598,0.866
"5278",169080,"Calvin College",1,0,2006,"20245","98.535849","315","867","1020",551,469,615,"268",347,0.6298,0.5714,0.6029,0.85
"5279",169080,"Calvin College",1,0,2007,"21460","103.618439","319","846","1034",556,478,590,"246",344,0.6187,0.5146,0.5706,0.8182
"5280",169080,"Calvin College",1,0,2008,"22940","115.707673","316","751","935",500,435,539,"235",304,0.608,0.5402,0.5765,0.8032
"5281",169080,"Calvin College",1,0,2009,"23810","118.632046","325","749","943",492,451,540,"244",296,0.6016,0.541,0.5726,0.7943
"5282",169080,"Calvin College",1,0,2010,"24645","120.02039","319","719","929",469,460,573,"250",323,0.6887,0.5435,0.6168,0.774
"5283",169798,"EASTERN MICHIGAN UNIVERSITY",1,0,1991,"2347","155.855483","733","1785","2232",1255,977,176,"65",111,0.0884,0.0665,0.0789,0.7997
"5284",169798,"EASTERN MICHIGAN UNIVERSITY",1,0,1992,"2471","151.00383","731","1681","2149",1200,949,174,"50",124,0.1033,0.0527,0.081,0.7822
"5285",169798,"EASTERN MICHIGAN UNIVERSITY",1,0,1993,"2804","170.263999","729","1675","2242",1217,1025,180,"67",113,0.0929,0.0654,0.0803,0.7471
"5286",169798,"EASTERN MICHIGAN UNIVERSITY",1,0,1995,"3314","180.382001","727","1642","2172",1230,942,198,"65",133,0.1081,0.069,0.0912,0.756
"5287",169798,"EASTERN MICHIGAN UNIVERSITY",1,0,1996,"3399","187.52678","741","1720","2298",1371,927,225,"77",148,0.108,0.0831,0.0979,0.7485
"5288",169798,"EASTERN MICHIGAN UNIVERSITY",1,0,1997,"3529","194.925539","730","1706","2314",1372,942,260,"80",180,0.1312,0.0849,0.1124,0.7373
"5289",169798,"EASTERN MICHIGAN UNIVERSITY",1,0,1998,"3645","206.595314","739","1749","2349",1426,923,244,"79",165,0.1157,0.0856,0.1039,0.7446
"5290",169798,"EASTERN MICHIGAN UNIVERSITY",1,0,1999,"3146","215.173665","767","1927","2767",1627,1140,298,"93",205,0.126,0.0816,0.1077,0.6964
"5291",169798,"EASTERN MICHIGAN UNIVERSITY",1,0,2000,"3097","227.720472","761.5","1885","2664",1619,1045,327,"109",218,0.1347,0.1043,0.1227,0.7076
"5292",169798,"EASTERN MICHIGAN UNIVERSITY",1,0,2001,"3622","241.904685","756","1855","2706",1627,1079,284,"92",192,0.118,0.0853,0.105,0.6855
"5293",169798,"EASTERN MICHIGAN UNIVERSITY",1,0,2002,"4047","248.377201","760","1785","2601",1564,1037,272,"91",181,0.1157,0.0878,0.1046,0.6863
"5294",169798,"EASTERN MICHIGAN UNIVERSITY",1,0,2003,"4594","270.421888","751","1676","2479",1510,969,295,"85",210,0.1391,0.0877,0.119,0.6761
"5295",169798,"EASTERN MICHIGAN UNIVERSITY",1,0,2004,"4707","269.060996","735","1508","2281",1329,952,280,"85",195,0.1467,0.0893,0.1228,0.6611
"5296",169798,"Eastern Michigan University",1,0,2005,"5463","276.087321","769","1544","2301",1416,885,297,"89",208,0.1469,0.1006,0.1291,0.671
"5297",169798,"Eastern Michigan University",1,0,2006,"5835","284.534921","764","1463","2272",1315,957,276,"97",179,0.1361,0.1014,0.1215,0.6439
"5298",169798,"Eastern Michigan University",1,0,2007,"6390","297.107857","756","1437","2365",1345,1020,294,"109",185,0.1375,0.1069,0.1243,0.6076
"5299",169798,"Eastern Michigan University",1,0,2008,"6885","305.924218","738","1176","2167",1283,884,269,"84",185,0.1442,0.095,0.1241,0.5427
"5300",169798,"Eastern Michigan University",1,0,2009,"7148","313.605547","755","1298","2196",1308,888,288,"84",204,0.156,0.0946,0.1311,0.5911
"5301",169798,"Eastern Michigan University",1,0,2010,"7148","338.567268","764","1080","1955",1152,803,254,"75",179,0.1554,0.0934,0.1299,0.5524
"5302",169910,"FERRIS STATE UNIVERSITY",0,1,1991,"2565","112.872211","512","1994","2377",889,1488,90,"47",43,0.0484,0.0316,0.0379,0.8389
"5303",169910,"FERRIS STATE UNIVERSITY",0,1,1992,"2970","120.641194","500","1617","2051",835,1216,57,"28",29,0.0347,0.023,0.0278,0.7884
"5304",169910,"FERRIS STATE UNIVERSITY",1,0,1993,"3222","123.114019","477","1681","2114",810,1304,51,"26",25,0.0309,0.0199,0.0241,0.7952
"5305",169910,"FERRIS STATE UNIVERSITY",1,0,1995,"3532","122.206355","445","1439","1893",752,1141,55,"28",27,0.0359,0.0245,0.0291,0.7602
"5306",169910,"FERRIS STATE UNIVERSITY",1,0,1996,"3630","124.787123","430","1413","1831",731,1100,48,"28",20,0.0274,0.0255,0.0262,0.7717
"5307",169910,"FERRIS STATE UNIVERSITY",1,0,1997,"3808","129.050426","429","1504","1906",763,1143,46,"21",25,0.0328,0.0184,0.0241,0.7891
"5308",169910,"FERRIS STATE UNIVERSITY",1,0,1998,"3998","137.228602","422","1472","1946",812,1134,53,"25",28,0.0345,0.022,0.0272,0.7564
"5309",169910,"FERRIS STATE UNIVERSITY",1,0,1999,"4118","141.585306","419","1511","1916",798,1118,78,"44",34,0.0426,0.0394,0.0407,0.7886
"5310",169910,"FERRIS STATE UNIVERSITY",1,0,2000,"4284","160.903334","430.5","1667","2147",883,1264,94,"47",47,0.0532,0.0372,0.0438,0.7764
"5311",169910,"FERRIS STATE UNIVERSITY",1,0,2001,"4670","172.260599","442","1671","2128",901,1227,123,"66",57,0.0633,0.0538,0.0578,0.7852
"5312",169910,"FERRIS STATE UNIVERSITY",1,0,2002,"5334","165.19156","446","1653","2035",882,1153,138,"67",71,0.0805,0.0581,0.0678,0.8123
"5313",169910,"FERRIS STATE UNIVERSITY",1,0,2003,"6044","175.681948","429","1821","2205",960,1245,137,"67",70,0.0729,0.0538,0.0621,0.8259
"5314",169910,"FERRIS STATE UNIVERSITY",1,0,2004,"6190","172.67964","463","1559","1924",834,1090,127,"60",67,0.0803,0.055,0.066,0.8103
"5315",169910,"Ferris State University",1,0,2005,"6740","178.076498","512","1744","2189",1003,1186,140,"59",81,0.0808,0.0497,0.064,0.7967
"5316",169910,"Ferris State University",1,0,2006,"7200","186.931008","537","1660","1895",860,1035,167,"82",85,0.0988,0.0792,0.0881,0.876
"5317",169910,"Ferris State University",1,0,2007,"8460","190.928205","540","1645","2035",933,1102,182,"79",103,0.1104,0.0717,0.0894,0.8084
"5318",169910,"Ferris State University",1,0,2008,"9000","204.278409","544","1680","2103",992,1111,169,"75",94,0.0948,0.0675,0.0804,0.7989
"5319",169910,"Ferris State University",1,0,2009,"9480","212.423236","586","1529","1958",980,978,152,"58",94,0.0959,0.0593,0.0776,0.7809
"5320",169910,"Ferris State University",1,0,2010,"9930","225.75306","525","1533","1960",976,984,143,"59",84,0.0861,0.06,0.073,0.7821
"5321",170082,"GRAND VALLEY STATE UNIVERSITY",1,0,1991,"2306","74.760095","303","1377","1545",941,604,240,"63",177,0.1881,0.1043,0.1553,0.8913
"5322",170082,"GRAND VALLEY STATE UNIVERSITY",1,0,1992,"2508","80.635812","317","1378","1557",982,575,289,"91",198,0.2016,0.1583,0.1856,0.885
"5323",170082,"GRAND VALLEY STATE UNIVERSITY",1,0,1993,"2742","86.989589","320","1341","1511",916,595,262,"79",183,0.1998,0.1328,0.1734,0.8875
"5324",170082,"GRAND VALLEY STATE UNIVERSITY",1,0,1995,"3140","105.253417","362","1575","1773",1087,686,287,"95",192,0.1766,0.1385,0.1619,0.8883
"5325",170082,"GRAND VALLEY STATE UNIVERSITY",1,0,1996,"3226","110.803842","380","1835","2039",1200,839,356,"112",244,0.2033,0.1335,0.1746,0.9
"5326",170082,"GRAND VALLEY STATE UNIVERSITY",1,0,1997,"3288","122.925528","400","2187","2406",1494,912,410,"120",290,0.1941,0.1316,0.1704,0.909
"5327",170082,"GRAND VALLEY STATE UNIVERSITY",1,0,1998,"3362","132.89411","435","2235","2482",1544,938,469,"153",316,0.2047,0.1631,0.189,0.9005
"5328",170082,"GRAND VALLEY STATE UNIVERSITY",1,0,1999,"4048","151.957909","475","2283","2528",1553,975,512,"163",349,0.2247,0.1672,0.2025,0.9031
"5329",170082,"GRAND VALLEY STATE UNIVERSITY",1,0,2000,"4230","190.395919","580","2577","2831",1732,1099,548,"166",382,0.2206,0.151,0.1936,0.9103
"5330",170082,"GRAND VALLEY STATE UNIVERSITY",1,0,2001,"4660","204.117494","685","2642","2977",1826,1151,569,"189",380,0.2081,0.1642,0.1911,0.8875
"5331",170082,"GRAND VALLEY STATE UNIVERSITY",1,0,2002,"5056","190.679605","748","2573","2868",1801,1067,634,"188",446,0.2476,0.1762,0.2211,0.8971
"5332",170082,"GRAND VALLEY STATE UNIVERSITY",1,0,2003,"5254","213.252626","827","2842","3270",2096,1174,851,"257",594,0.2834,0.2189,0.2602,0.8691
"5333",170082,"GRAND VALLEY STATE UNIVERSITY",1,0,2004,"5782","230.568891","880","2881","3324",2123,1201,875,"270",605,0.285,0.2248,0.2632,0.8667
"5334",170082,"Grand Valley State University",1,0,2005,"6220","249.252957","880","2864","3407",2220,1187,1011,"308",703,0.3167,0.2595,0.2967,0.8406
"5335",170082,"Grand Valley State University",1,0,2006,"6588","264.229881","904","2948","3556",2276,1280,1116,"346",770,0.3383,0.2703,0.3138,0.829
"5336",170082,"Grand Valley State University",1,0,2007,"7240","290.186527","923","2850","3446",2201,1245,1137,"346",791,0.3594,0.2779,0.3299,0.827
"5337",170082,"Grand Valley State University",1,0,2008,"8196","312.885486","981","3464","3879",2413,1466,1216,"403",813,0.3369,0.2749,0.3135,0.893
"5338",170082,"Grand Valley State University",1,0,2009,"8630","335.506736","1036","3271","3716",2278,1438,1363,"461",902,0.396,0.3206,0.3668,0.8802
"5339",170082,"Grand Valley State University",1,0,2010,"9088","353.288335","1048","2900","3414",2084,1330,1165,"413",752,0.3608,0.3105,0.3412,0.8494
"5340",170301,"HOPE COLLEGE",1,0,1991,"10086","45.112016","162","515","554",317,237,278,"99",179,0.5647,0.4177,0.5018,0.9296
"5341",170301,"HOPE COLLEGE",1,0,1992,"10792","46.139558","167","640","687",408,279,371,"134",237,0.5809,0.4803,0.54,0.9316
"5342",170301,"HOPE COLLEGE",1,0,1993,"11542","50.2482","159","599","657",360,297,360,"157",203,0.5639,0.5286,0.5479,0.9117
"5343",170301,"HOPE COLLEGE",1,0,1995,"13234","55.005","177","660","709",418,291,412,"143",269,0.6435,0.4914,0.5811,0.9309
"5344",170301,"HOPE COLLEGE",1,0,1996,"14310","57.068872","184","657","695",415,280,474,"166",308,0.7422,0.5929,0.682,0.9453
"5345",170301,"HOPE COLLEGE",1,0,1997,"14878","56.106591","186","673","721",432,289,450,"164",286,0.662,0.5675,0.6241,0.9334
"5346",170301,"HOPE COLLEGE",1,0,1998,"15470","59.869594","186","708","747",462,285,446,"148",298,0.645,0.5193,0.5971,0.9478
"5347",170301,"HOPE COLLEGE",1,0,1999,"15934","63.988858","200","709","755",455,300,485,"184",301,0.6615,0.6133,0.6424,0.9391
"5348",170301,"HOPE COLLEGE",1,0,2000,"16554","64.769089","199.5","683","754",468,286,480,"170",310,0.6624,0.5944,0.6366,0.9058
"5349",170301,"HOPE COLLEGE",1,0,2001,"17348","68.523209","199","718","763",468,295,474,"158",316,0.6752,0.5356,0.6212,0.941
"5350",170301,"HOPE COLLEGE",1,0,2002,"18158","69.067781","210","676","725",465,260,457,"139",318,0.6839,0.5346,0.6303,0.9324
"5351",170301,"HOPE COLLEGE",1,0,2003,"19212","72.257597","218","760","810",515,295,531,"167",364,0.7068,0.5661,0.6556,0.9383
"5352",170301,"HOPE COLLEGE",1,0,2004,"20300","75.655834","227","700","780",463,317,531,"194",337,0.7279,0.612,0.6808,0.8974
"5353",170301,"Hope College",1,0,2005,"21420","81.285588","232","713","774",463,311,531,"194",337,0.7279,0.6238,0.686,0.9212
"5354",170301,"Hope College",1,0,2006,"22430","84.258778","235","714","778",461,317,524,"189",335,0.7267,0.5962,0.6735,0.9177
"5355",170301,"Hope College",1,0,2007,"23660","91.301077","245","728","819",495,324,554,"199",355,0.7172,0.6142,0.6764,0.8889
"5356",170301,"Hope College",1,0,2008,"24780","94.648917","246","711","805",499,306,565,"189",376,0.7535,0.6176,0.7019,0.8832
"5357",170301,"Hope College",1,0,2009,"25500","94.226066","243","701","803",486,317,515,"186",329,0.677,0.5868,0.6413,0.873
"5358",170301,"Hope College",1,0,2010,"26350","92.894446","240","660","765",455,310,524,"185",339,0.7451,0.5968,0.685,0.8627
"5359",170532,"KALAMAZOO COLLEGE",0,1,1991,"12669","25.58918","89","294","336",179,157,192,"86",106,0.5922,0.5478,0.5714,0.875
"5360",170532,"KALAMAZOO COLLEGE",0,1,1992,"13785","27.90636","90","303","349",201,148,193,"77",116,0.5771,0.5203,0.553,0.8682
"5361",170532,"KALAMAZOO COLLEGE",0,1,1993,"15135","29.995183","92","298","338",198,140,217,"86",131,0.6616,0.6143,0.642,0.8817
"5362",170532,"KALAMAZOO COLLEGE",0,1,1995,"16713","32.25896","89","305","350",197,153,221,"90",131,0.665,0.5882,0.6314,0.8714
"5363",170532,"KALAMAZOO COLLEGE",0,1,1996,"17214","33.423345","82","313","360",202,158,239,"108",131,0.6485,0.6835,0.6639,0.8694
"5364",170532,"KALAMAZOO COLLEGE",0,1,1997,"17976","37.568783","84","247","290",170,120,201,"78",123,0.7235,0.65,0.6931,0.8517
"5365",170532,"KALAMAZOO COLLEGE",0,1,1998,"18630","39.66256","84","391","442",256,186,322,"126",196,0.7656,0.6774,0.7285,0.8846
"5366",170532,"KALAMAZOO COLLEGE",0,1,1999,"19188","42.255298","90","318","369",187,182,270,"128",142,0.7594,0.7033,0.7317,0.8618
"5367",170532,"KALAMAZOO COLLEGE",0,1,2000,"19764","42.817789","93.5","260","324",180,144,246,"103",143,0.7944,0.7153,0.7593,0.8025
"5368",170532,"KALAMAZOO COLLEGE",0,1,2001,"20652","45.7266","97","289","341",198,143,248,"100",148,0.7475,0.6993,0.7273,0.8475
"5369",170532,"KALAMAZOO COLLEGE",0,1,2002,"21603","47.253967","106","267","335",177,158,239,"105",134,0.7571,0.6646,0.7134,0.797
"5370",170532,"KALAMAZOO COLLEGE",0,1,2003,"22908","47.601502","106","309","382",220,162,275,"118",157,0.7136,0.7284,0.7199,0.8089
"5371",170532,"KALAMAZOO COLLEGE",0,1,2004,"24351","50.697444","102","239","310",188,122,240,"86",154,0.8191,0.7049,0.7742,0.771
"5372",170532,"Kalamazoo College",0,1,2005,"25644","50.617783","103","308","377",196,181,286,"134",152,0.7755,0.7403,0.7586,0.817
"5373",170532,"Kalamazoo College",0,1,2006,"27054","54.55414","106","277","379",211,168,279,"110",169,0.8009,0.6548,0.7361,0.7309
"5374",170532,"Kalamazoo College",0,1,2007,"28716","40.424349","99","259","363",213,150,263,"100",163,0.7653,0.6667,0.7245,0.7135
"5375",170532,"Kalamazoo College",0,1,2008,"30723","43.069996","98","274","364",200,164,279,"128",151,0.755,0.7805,0.7665,0.7527
"5376",170532,"Kalamazoo College",0,1,2009,"32643","44.70881","94","273","389",219,170,299,"121",178,0.8128,0.7118,0.7686,0.7018
"5377",170532,"Kalamazoo College",0,1,2010,"34017","44.867722","99","211","341",192,149,250,"106",144,0.75,0.7114,0.7331,0.6188
"5378",170639,"LAKE SUPERIOR STATE UNIVERSITY",1,0,1991,"2518","27.445674","107","413","492",221,271,60,"28",32,0.1448,0.1033,0.122,0.8394
"5379",170639,"LAKE SUPERIOR STATE UNIVERSITY",1,0,1992,"2694","32.356098","108","385","482",226,256,84,"35",49,0.2168,0.1367,0.1743,0.7988
"5380",170639,"LAKE SUPERIOR STATE UNIVERSITY",1,0,1993,"3200","32.331091","112","443","593",290,303,95,"35",60,0.2069,0.1155,0.1602,0.747
"5381",170639,"LAKE SUPERIOR STATE UNIVERSITY",1,0,1995,"3396","32.692414","111","480","593",281,312,80,"39",41,0.1459,0.125,0.1349,0.8094
"5382",170639,"LAKE SUPERIOR STATE UNIVERSITY",1,0,1996,"3534","35.883428","114","418","540",247,293,63,"27",36,0.1457,0.0922,0.1167,0.7741
"5383",170639,"LAKE SUPERIOR STATE UNIVERSITY",1,0,1997,"3642","36.62463","114","386","522",239,283,71,"34",37,0.1548,0.1201,0.136,0.7395
"5384",170639,"LAKE SUPERIOR STATE UNIVERSITY",1,0,1998,"3871","36.991188","115","453","575",250,325,67,"27",40,0.16,0.0831,0.1165,0.7878
"5385",170639,"LAKE SUPERIOR STATE UNIVERSITY",1,0,1999,"4030","39.252556","115","392","505",242,263,71,"30",41,0.1694,0.1141,0.1406,0.7762
"5386",170639,"LAKE SUPERIOR STATE UNIVERSITY",1,0,2000,"3818","41.837175","112.5","437","555",262,293,76,"35",41,0.1565,0.1195,0.1369,0.7874
"5387",170639,"LAKE SUPERIOR STATE UNIVERSITY",1,0,2001,"4128","40.163687","110","428","536",235,301,83,"42",41,0.1745,0.1395,0.1549,0.7985
"5388",170639,"LAKE SUPERIOR STATE UNIVERSITY",1,0,2002,"4548","44.040691","115","454","574",262,312,53,"29",24,0.0916,0.0929,0.0923,0.7909
"5389",170639,"LAKE SUPERIOR STATE UNIVERSITY",1,0,2003,"5136","45.170434","108","453","551",243,308,42,"17",25,0.1029,0.0552,0.0762,0.8221
"5390",170639,"LAKE SUPERIOR STATE UNIVERSITY",1,0,2004,"5418","43.581789","107","436","527",242,285,67,"27",40,0.1653,0.0947,0.1271,0.8273
"5391",170639,"Lake Superior State University",1,0,2005,"5988","41.132023","107","379","474",216,258,62,"31",31,0.1435,0.1202,0.1308,0.7996
"5392",170639,"Lake Superior State University",1,0,2006,"6558","43.238823","101","367","454",232,222,58,"23",35,0.1509,0.1036,0.1278,0.8084
"5393",170639,"Lake Superior State University",1,0,2007,"7176","44.504166","104","400","469",230,239,66,"35",31,0.1348,0.1464,0.1407,0.8529
"5394",170639,"Lake Superior State University",1,0,2008,"7824","45.797063","104","403","490",250,240,72,"32",40,0.16,0.1333,0.1469,0.8224
"5395",170639,"Lake Superior State University",1,0,2009,"8184","48.174706","115","358","437",209,228,65,"33",32,0.1531,0.1447,0.1487,0.8192
"5396",170639,"Lake Superior State University",1,0,2010,"8664","48.372773","113","399","501",229,272,91,"54",37,0.1616,0.1985,0.1816,0.7964
"5397",170976,"UNIVERSITY OF MICHIGAN-ANN ARBOR",0,1,1991,"4044","1759.239493","1929","3399","4908",2299,2609,2841,"1363",1478,0.6429,0.5224,0.5789,0.6925
"5398",170976,"UNIVERSITY OF MICHIGAN-ANN ARBOR",0,1,1992,"4583","1868.539629","1968","3411","5006",2342,2664,3058,"1490",1568,0.6695,0.5593,0.6109,0.6814
"5399",170976,"UNIVERSITY OF MICHIGAN-ANN ARBOR",0,1,1993,"5119","2031.412733","1968","3366","5016",2428,2588,3078,"1451",1627,0.6701,0.5607,0.6136,0.6711
"5400",170976,"UNIVERSITY OF MICHIGAN-ANN ARBOR",0,1,1995,"5842","2303.795271","1961","3375","5265",2658,2607,3223,"1428",1795,0.6753,0.5478,0.6122,0.641
"5401",170976,"UNIVERSITY OF MICHIGAN-ANN ARBOR",0,1,1996,"5710","2339.875327","1977","3338","5328",2710,2618,3399,"1533",1866,0.6886,0.5856,0.638,0.6265
"5402",170976,"UNIVERSITY OF MICHIGAN-ANN ARBOR",0,1,1997,"5878","2516.726576","1985","3616","5535",2763,2772,3619,"1656",1963,0.7105,0.5974,0.6538,0.6533
"5403",170976,"UNIVERSITY OF MICHIGAN-ANN ARBOR",0,1,1998,"6098","2662.642386","2020","3321","5258",2654,2604,3531,"1620",1911,0.72,0.6221,0.6715,0.6316
"5404",170976,"UNIVERSITY OF MICHIGAN-ANN ARBOR",0,1,1999,"6148","2714.324685","2113","3607","5563",2853,2710,3879,"1779",2100,0.7361,0.6565,0.6973,0.6484
"5405",170976,"UNIVERSITY OF MICHIGAN-ANN ARBOR",0,1,2000,"6328","3034.133252","2360.5","3447","5403",2860,2543,3803,"1697",2106,0.7364,0.6673,0.7039,0.638
"5406",170976,"UNIVERSITY OF MICHIGAN-ANN ARBOR",0,1,2001,"6750","3743.65508","2608","3618","5531",2884,2647,3896,"1752",2144,0.7434,0.6619,0.7044,0.6541
"5407",170976,"UNIVERSITY OF MICHIGAN-ANN ARBOR",0,1,2002,"7298","3405.581511","2651","3402","5180",2704,2476,3641,"1634",2007,0.7422,0.6599,0.7029,0.6568
"5408",170976,"UNIVERSITY OF MICHIGAN-ANN ARBOR",0,1,2003,"7788","3585.974","2645","3530","5538",2903,2635,4025,"1840",2185,0.7527,0.6983,0.7268,0.6374
"5409",170976,"UNIVERSITY OF MICHIGAN-ANN ARBOR",0,1,2004,"8014","3747.935","2662","3990","6016",3033,2983,4334,"1990",2344,0.7728,0.6671,0.7204,0.6632
"5410",170976,"University of Michigan-Ann Arbor",0,1,2005,"9024","3885.837","2495","3955","6080",3071,3009,4431,"2061",2370,0.7717,0.6849,0.7288,0.6505
"5411",170976,"University of Michigan-Ann Arbor",0,1,2006,"9534","4119.405","2572","3555","5356",2704,2652,4072,"1880",2192,0.8107,0.7089,0.7603,0.6637
"5412",170976,"University of Michigan-Ann Arbor",0,1,2007,"10258","4283.566","2998","3873","5955",3019,2936,4513,"2063",2450,0.8115,0.7027,0.7579,0.6504
"5413",170976,"University of Michigan-Ann Arbor",0,1,2008,"10848","5988.427","3079","3821","5738",2905,2833,4336,"1989",2347,0.8079,0.7021,0.7557,0.6659
"5414",170976,"University of Michigan-Ann Arbor",0,1,2009,"11470","4917.321","3228","4316","6019",2983,3036,4503,"2101",2402,0.8052,0.692,0.7481,0.7171
"5415",170976,"University of Michigan-Ann Arbor",0,1,2010,"11648","5098.288","3258","4480","6443",3217,3226,4929,"2317",2612,0.8119,0.7182,0.765,0.6953
"5416",171100,"MICHIGAN STATE UNIVERSITY",0,1,1991,"3474","765.330766","1927","5257","6314",3456,2858,1480,"535",945,0.2734,0.1872,0.2344,0.8326
"5417",171100,"MICHIGAN STATE UNIVERSITY",1,0,1992,"3876","820.176721","1876","5064","6086",3320,2766,1897,"669",1228,0.3699,0.2419,0.3117,0.8321
"5418",171100,"MICHIGAN STATE UNIVERSITY",1,0,1993,"4260","850.246503","1840","5016","6164",3372,2792,1851,"641",1210,0.3588,0.2296,0.3003,0.8138
"5419",171100,"MICHIGAN STATE UNIVERSITY",1,0,1995,"4521","896.4729","1848","5312","6396",3546,2850,2076,"693",1383,0.39,0.2432,0.3246,0.8305
"5420",171100,"MICHIGAN STATE UNIVERSITY",1,0,1996,"4655","925.605689","1861","5551","6708",3728,2980,2358,"809",1549,0.4155,0.2715,0.3515,0.8275
"5421",171100,"MICHIGAN STATE UNIVERSITY",1,0,1997,"4789","960.732056","1851","5567","6804",3723,3081,2232,"751",1481,0.3978,0.2438,0.328,0.8182
"5422",171100,"MICHIGAN STATE UNIVERSITY",1,0,1998,"4896","1020.842907","1847","5437","6724",3767,2957,2343,"757",1586,0.421,0.256,0.3485,0.8086
"5423",171100,"MICHIGAN STATE UNIVERSITY",1,0,1999,"5003","1066.25605","1838","5186","6499",3674,2825,2580,"833",1747,0.4755,0.2949,0.397,0.798
"5424",171100,"MICHIGAN STATE UNIVERSITY",1,0,2000,"4830","1129.112312","1889","5338","6790",3756,3034,2908,"1026",1882,0.5011,0.3382,0.4283,0.7862
"5425",171100,"MICHIGAN STATE UNIVERSITY",1,0,2001,"5257","1277.533579","1940","5224","6755",3808,2947,2878,"1041",1837,0.4824,0.3532,0.4261,0.7734
"5426",171100,"MICHIGAN STATE UNIVERSITY",1,0,2002,"5704","1248.13084","2068","5275","6829",3864,2965,3127,"1133",1994,0.516,0.3821,0.4579,0.7724
"5427",171100,"MICHIGAN STATE UNIVERSITY",1,0,2003,"6266","1299.315408","2091","5460","6938",3932,3006,3315,"1201",2114,0.5376,0.3995,0.4778,0.787
"5428",171100,"MICHIGAN STATE UNIVERSITY",1,0,2004,"6540","1303.075634","2075","5898","7426",4073,3353,3531,"1334",2197,0.5394,0.3979,0.4755,0.7942
"5429",171100,"Michigan State University",1,0,2005,"7161","1401.640386","2180","5712","7303",4147,3156,3470,"1232",2238,0.5397,0.3904,0.4751,0.7821
"5430",171100,"Michigan State University",1,0,2006,"7759","1498.644286","2268","5639","7306",4103,3203,3800,"1448",2352,0.5732,0.4521,0.5201,0.7718
"5431",171100,"Michigan State University",1,0,2007,"8672","1572.9961","2285","5678","7398",4099,3299,3666,"1372",2294,0.5596,0.4159,0.4955,0.7675
"5432",171100,"Michigan State University",1,0,2008,"9806","1714.075443","2340","5488","7385",4098,3287,3831,"1442",2389,0.583,0.4387,0.5188,0.7431
"5433",171100,"Michigan State University",1,0,2009,"10913","1798.712077","2346","5207","7249",3869,3380,3612,"1445",2167,0.5601,0.4275,0.4983,0.7183
"5434",171100,"Michigan State University",1,0,2010,"11670","1829.539938","2256","5213","7221",3821,3400,3685,"1516",2169,0.5677,0.4459,0.5103,0.7219
"5435",171128,"MICHIGAN TECHNOLOGICAL UNIVERSITY",0,1,1991,"2916","97.19","322","1191","1283",319,964,234,"145",89,0.279,0.1504,0.1824,0.9283
"5436",171128,"MICHIGAN TECHNOLOGICAL UNIVERSITY",0,1,1992,"3249","100.569","322","1143","1260",321,939,253,"169",84,0.2617,0.18,0.2008,0.9071
"5437",171128,"MICHIGAN TECHNOLOGICAL UNIVERSITY",0,1,1993,"3441","106.948","338","958","1026",262,764,215,"133",82,0.313,0.1741,0.2096,0.9337
"5438",171128,"MICHIGAN TECHNOLOGICAL UNIVERSITY",0,1,1995,"3843","120.25","368","971","1072",285,787,218,"134",84,0.2947,0.1703,0.2034,0.9058
"5439",171128,"MICHIGAN TECHNOLOGICAL UNIVERSITY",0,1,1996,"3948","126.234","374","963","1068",260,808,298,"199",99,0.3808,0.2463,0.279,0.9017
"5440",171128,"MICHIGAN TECHNOLOGICAL UNIVERSITY",0,1,1997,"4062","127.719","370","1131","1251",295,956,329,"224",105,0.3559,0.2343,0.263,0.9041
"5441",171128,"MICHIGAN TECHNOLOGICAL UNIVERSITY",0,1,1998,"4362","134.594","369","1056","1194",328,866,323,"202",121,0.3689,0.2333,0.2705,0.8844
"5442",171128,"MICHIGAN TECHNOLOGICAL UNIVERSITY",0,1,1999,"4365","138.36","366","1022","1137",276,861,259,"183",76,0.2754,0.2125,0.2278,0.8989
"5443",171128,"MICHIGAN TECHNOLOGICAL UNIVERSITY",1,0,2000,"4530","147.135","366.5","1115","1267",292,975,316,"223",93,0.3185,0.2287,0.2494,0.88
"5444",171128,"MICHIGAN TECHNOLOGICAL UNIVERSITY",1,0,2001,"5028","159.182","367","1021","1189",281,908,281,"181",100,0.3559,0.1993,0.2363,0.8587
"5445",171128,"MICHIGAN TECHNOLOGICAL UNIVERSITY",1,0,2002,"5782","156.146","366","1050","1186",267,919,306,"210",96,0.3596,0.2285,0.258,0.8853
"5446",171128,"MICHIGAN TECHNOLOGICAL UNIVERSITY",1,0,2003,"6810","159.87","346","1051","1168",238,930,251,"177",74,0.3109,0.1903,0.2149,0.8998
"5447",171128,"MICHIGAN TECHNOLOGICAL UNIVERSITY",1,0,2004,"6978","153.237","355","1102","1219",243,976,327,"221",106,0.4362,0.2264,0.2683,0.904
"5448",171128,"Michigan Technological University",1,0,2005,"7560","157.892","343","1152","1321",236,1085,327,"243",84,0.3559,0.224,0.2475,0.8721
"5449",171128,"Michigan Technological University",1,0,2006,"8271","167.705","349","1023","1163",283,880,328,"221",107,0.3781,0.2511,0.282,0.8796
"5450",171128,"Michigan Technological University",1,0,2007,"9180","184.741","367","1035","1215",287,928,275,"197",78,0.2718,0.2123,0.2263,0.8519
"5451",171128,"Michigan Technological University",1,0,2008,"9930","197.981","361","1200","1361",318,1043,333,"218",115,0.3616,0.209,0.2447,0.8817
"5452",171128,"Michigan Technological University",1,0,2009,"10500","208.172","378","1001","1155",301,854,260,"162",98,0.3256,0.1897,0.2251,0.8667
"5453",171128,"Michigan Technological University",1,0,2010,"11175","213.442","389","959","1110",273,837,308,"202",106,0.3883,0.2413,0.2775,0.864
"5454",171137,"UNIVERSITY OF MICHIGAN-DEARBORN",1,0,1991,"2766","45.19004","201","507","597",308,289,50,"22",28,0.0909,0.0761,0.0838,0.8492
"5455",171137,"UNIVERSITY OF MICHIGAN-DEARBORN",1,0,1992,"2886","44.964603","206","552","625",323,302,46,"18",28,0.0867,0.0596,0.0736,0.8832
"5456",171137,"UNIVERSITY OF MICHIGAN-DEARBORN",1,0,1993,"3160","48.026421","219","518","631",311,320,50,"21",29,0.0932,0.0656,0.0792,0.8209
"5457",171137,"UNIVERSITY OF MICHIGAN-DEARBORN",1,0,1995,"3736","54.339163","221","493","600",320,280,49,"23",26,0.0812,0.0821,0.0817,0.8217
"5458",171137,"UNIVERSITY OF MICHIGAN-DEARBORN",1,0,1996,"3970","58.922538","230","523","666",321,345,67,"23",44,0.1371,0.0667,0.1006,0.7853
"5459",171137,"UNIVERSITY OF MICHIGAN-DEARBORN",1,0,1997,"4087","64.062591","237","569","696",378,318,96,"29",67,0.1772,0.0912,0.1379,0.8175
"5460",171137,"UNIVERSITY OF MICHIGAN-DEARBORN",1,0,1998,"4274","66.137478","233","569","741",373,368,99,"41",58,0.1555,0.1114,0.1336,0.7679
"5461",171137,"UNIVERSITY OF MICHIGAN-DEARBORN",1,0,1999,"4077","67.041619","239","514","690",334,356,88,"30",58,0.1737,0.0843,0.1275,0.7449
"5462",171137,"UNIVERSITY OF MICHIGAN-DEARBORN",1,0,2000,"4492","74.935336","257.5","583","738",371,367,118,"52",66,0.1779,0.1417,0.1599,0.79
"5463",171137,"UNIVERSITY OF MICHIGAN-DEARBORN",1,0,2001,"4915","77.420159","276","497","658",330,328,90,"33",57,0.1727,0.1006,0.1368,0.7553
"5464",171137,"UNIVERSITY OF MICHIGAN-DEARBORN",1,0,2002,"5332","80.02988","283","573","735",342,393,105,"48",57,0.1667,0.1221,0.1429,0.7796
"5465",171137,"UNIVERSITY OF MICHIGAN-DEARBORN",1,0,2003,"5839","83.804","291","535","704",313,391,123,"62",61,0.1949,0.1586,0.1747,0.7599
"5466",171137,"UNIVERSITY OF MICHIGAN-DEARBORN",1,0,2004,"5491","91.66","295","460","656",311,345,106,"45",61,0.1961,0.1304,0.1616,0.7012
"5467",171137,"University of Michigan-Dearborn",1,0,2005,"6146","97.641","290","601","798",381,417,128,"47",81,0.2126,0.1127,0.1604,0.7531
"5468",171137,"University of Michigan-Dearborn",1,0,2006,"6641","99.898","288","563","761",394,367,136,"56",80,0.203,0.1526,0.1787,0.7398
"5469",171137,"University of Michigan-Dearborn",1,0,2007,"7165","104.992","292","611","859",420,439,128,"61",67,0.1595,0.139,0.149,0.7113
"5470",171137,"University of Michigan-Dearborn",1,0,2008,"7631","108.791","294","645","905",436,469,145,"60",85,0.195,0.1279,0.1602,0.7127
"5471",171137,"University of Michigan-Dearborn",1,0,2009,"8142","111.388","306","651","886",418,468,146,"60",86,0.2057,0.1282,0.1648,0.7348
"5472",171137,"University of Michigan-Dearborn",1,0,2010,"8460","116.002","305","650","883",429,454,149,"51",98,0.2284,0.1123,0.1687,0.7361
"5473",171146,"UNIVERSITY OF MICHIGAN-FLINT",1,0,1991,"2460","37.350657","176","411","485",286,199,32,"7",25,0.0874,0.0352,0.066,0.8474
"5474",171146,"UNIVERSITY OF MICHIGAN-FLINT",1,0,1992,"2700","37.966024","184","421","523",317,206,45,"8",37,0.1167,0.0388,0.086,0.805
"5475",171146,"UNIVERSITY OF MICHIGAN-FLINT",1,0,1993,"2916","40.132507","184","434","504",322,182,41,"12",29,0.0901,0.0659,0.0813,0.8611
"5476",171146,"UNIVERSITY OF MICHIGAN-FLINT",1,0,1995,"3304","42.845613","192","226","263",169,94,116,"45",71,0.4201,0.4787,0.4411,0.8593
"5477",171146,"UNIVERSITY OF MICHIGAN-FLINT",1,0,1996,"3433","45.23237","204","472","551",352,199,53,"15",38,0.108,0.0754,0.0962,0.8566
"5478",171146,"UNIVERSITY OF MICHIGAN-FLINT",1,0,1997,"3559","48.68374","206","450","552",337,215,30,"10",20,0.0593,0.0465,0.0543,0.8152
"5479",171146,"UNIVERSITY OF MICHIGAN-FLINT",1,0,1998,"3697","51.171769","198","524","613",372,241,60,"20",40,0.1075,0.083,0.0979,0.8548
"5480",171146,"UNIVERSITY OF MICHIGAN-FLINT",1,0,1999,"3640","52.363875","202","395","492",289,203,49,"15",34,0.1176,0.0739,0.0996,0.8028
"5481",171146,"UNIVERSITY OF MICHIGAN-FLINT",1,0,2000,"3712","60.99268","209","464","576",349,227,64,"18",46,0.1318,0.0793,0.1111,0.8056
"5482",171146,"UNIVERSITY OF MICHIGAN-FLINT",1,0,2001,"4135","59.874395","216","455","549",330,219,54,"17",37,0.1121,0.0776,0.0984,0.8288
"5483",171146,"UNIVERSITY OF MICHIGAN-FLINT",1,0,2002,"4494","63.628777","211","382","467",269,198,52,"16",36,0.1338,0.0808,0.1113,0.818
"5484",171146,"UNIVERSITY OF MICHIGAN-FLINT",1,0,2003,"5000","72.133","191","334","420",252,168,57,"17",40,0.1587,0.1012,0.1357,0.7952
"5485",171146,"UNIVERSITY OF MICHIGAN-FLINT",1,0,2004,"5126","71.684","191","393","474",293,181,53,"17",36,0.1229,0.0939,0.1118,0.8291
"5486",171146,"University of Michigan-Flint",1,0,2005,"5752","66.921","214","374","509",293,216,48,"18",30,0.1024,0.0833,0.0943,0.7348
"5487",171146,"University of Michigan-Flint",1,0,2006,"6214","75.783","222","347","483",274,209,46,"14",32,0.1168,0.067,0.0952,0.7184
"5488",171146,"University of Michigan-Flint",1,0,2007,"6618","77.683","220","407","594",346,248,56,"16",40,0.1156,0.0645,0.0943,0.6852
"5489",171146,"University of Michigan-Flint",1,0,2008,"7008","84.396","229","537","846",512,334,78,"31",47,0.0918,0.0928,0.0922,0.6348
"5490",171146,"University of Michigan-Flint",1,0,2009,"7474","92.22","231","471","713",401,312,77,"29",48,0.1197,0.0929,0.108,0.6606
"5491",171146,"University of Michigan-Flint",1,0,2010,"7809","95.772","242","506","724",398,326,94,"34",60,0.1508,0.1043,0.1298,0.6989
"5492",171599,"OLIVET COLLEGE",1,0,1991,"7890","9.734991","41","136","162",55,107,30,"18",12,0.2182,0.1682,0.1852,0.8395
"5493",171599,"OLIVET COLLEGE",1,0,1992,"8291","9.329928","40","120","139",39,100,14,"5",9,0.2308,0.05,0.1007,0.8633
"5494",171599,"OLIVET COLLEGE",1,0,1993,"10500","10.906425","44","210","234",78,156,53,"30",23,0.2949,0.1923,0.2265,0.8974
"5495",171599,"OLIVET COLLEGE",1,0,1995,"11580","12.875474","40","171","209",69,140,28,"20",8,0.1159,0.1429,0.134,0.8182
"5496",171599,"OLIVET COLLEGE",1,0,1996,"12160","13.40698","45","163","241",93,148,45,"21",24,0.2581,0.1419,0.1867,0.6763
"5497",171599,"OLIVET COLLEGE",1,0,1997,"12660","15.755119","43","159","228",73,155,2,"0",2,0.0274,0,0.0088,0.6974
"5498",171599,"OLIVET COLLEGE",1,0,1998,"12900","16.671485","36","117","198",85,113,42,"21",21,0.2471,0.1858,0.2121,0.5909
"5499",171599,"OLIVET COLLEGE",1,0,1999,"12948","16.677411","40","118","181",74,107,63,"32",31,0.4189,0.2991,0.3481,0.6519
"5500",171599,"OLIVET COLLEGE",1,0,2000,"13142","17.783726","38","94","183",66,117,36,"18",18,0.2727,0.1538,0.1967,0.5137
"5501",171599,"OLIVET COLLEGE",1,0,2001,"13982","20.192627","36","95","151",59,92,52,"26",26,0.4407,0.2826,0.3444,0.6291
"5502",171599,"OLIVET COLLEGE",1,0,2002,"14332","18.110863","31","174","238",85,153,82,"42",40,0.4706,0.2745,0.3445,0.7311
"5503",171599,"OLIVET COLLEGE",1,0,2003,"14762","13.749","33","175","271",99,172,101,"53",48,0.4848,0.3081,0.3727,0.6458
"5504",171599,"OLIVET COLLEGE",1,0,2004,"15500","15.044209","34","144","198",72,126,51,"26",25,0.3472,0.2063,0.2576,0.7273
"5505",171599,"Olivet College",1,0,2005,"15970","16.584669","33","198","257",103,154,77,"33",44,0.4272,0.2143,0.2996,0.7704
"5506",171599,"Olivet College",1,0,2006,"17584","15.865444","34","153","195",73,122,52,"28",24,0.3288,0.2295,0.2667,0.7846
"5507",171599,"Olivet College",1,0,2007,"17994","16.426342","37","137","182",67,115,48,"18",30,0.4478,0.1565,0.2637,0.7527
"5508",171599,"Olivet College",1,0,2008,"18580","17.050287","41","202","282",99,183,76,"34",42,0.4242,0.1858,0.2695,0.7163
"5509",171599,"Olivet College",1,0,2009,"19138","18.766385","42","212","258",141,117,68,"26",42,0.2979,0.2222,0.2636,0.8217
"5510",171599,"Olivet College",1,0,2010,"19710","16.973058","43","187","229",93,136,80,"35",45,0.4839,0.2574,0.3493,0.8166
"5511",172051,"SAGINAW VALLEY STATE UNIVERSITY",1,0,1991,"2426","39.990769","166","492","564",296,268,26,"6",20,0.0676,0.0224,0.0461,0.8723
"5512",172051,"SAGINAW VALLEY STATE UNIVERSITY",1,0,1992,"2620","47.171397","170","561","655",360,295,42,"8",34,0.0944,0.0271,0.0641,0.8565
"5513",172051,"SAGINAW VALLEY STATE UNIVERSITY",1,0,1993,"2891","42.882759","174","580","633",337,296,112,"36",76,0.2255,0.1216,0.1769,0.9163
"5514",172051,"SAGINAW VALLEY STATE UNIVERSITY",1,0,1995,"3259","45.03841","171","674","752",412,340,40,"14",26,0.0631,0.0412,0.0532,0.8963
"5515",172051,"SAGINAW VALLEY STATE UNIVERSITY",1,0,1996,"3350","47.272488","180","664","747",425,322,33,"8",25,0.0588,0.0248,0.0442,0.8889
"5516",172051,"SAGINAW VALLEY STATE UNIVERSITY",1,0,1997,"3447","51.748834","179","673","818",461,357,55,"12",43,0.0933,0.0336,0.0672,0.8227
"5517",172051,"SAGINAW VALLEY STATE UNIVERSITY",1,0,1998,"3526","55.046576","200","757","895",492,403,59,"20",39,0.0793,0.0496,0.0659,0.8458
"5518",172051,"SAGINAW VALLEY STATE UNIVERSITY",1,0,1999,"3351","58.87485","211","843","1015",549,466,81,"36",45,0.082,0.0773,0.0798,0.8305
"5519",172051,"SAGINAW VALLEY STATE UNIVERSITY",1,0,2000,"3290","65.957315","218.5","878","1049",559,490,68,"24",44,0.0787,0.049,0.0648,0.837
"5520",172051,"SAGINAW VALLEY STATE UNIVERSITY",1,0,2001,"3455","74.312351","226","865","1044",539,505,106,"39",67,0.1243,0.0772,0.1015,0.8285
"5521",172051,"SAGINAW VALLEY STATE UNIVERSITY",1,0,2002,"3824","77.712477","233","923","1109",654,455,97,"27",70,0.107,0.0593,0.0875,0.8323
"5522",172051,"SAGINAW VALLEY STATE UNIVERSITY",1,0,2003,"4188","82.640716","235","969","1156",667,489,104,"32",72,0.1079,0.0654,0.09,0.8382
"5523",172051,"SAGINAW VALLEY STATE UNIVERSITY",1,0,2004,"4271","84.670393","243","1044","1209",720,489,129,"32",97,0.1347,0.0654,0.1067,0.8635
"5524",172051,"Saginaw Valley State University",1,0,2005,"4877","90.392105","258","1014","1233",742,491,102,"26",76,0.1024,0.053,0.0827,0.8224
"5525",172051,"Saginaw Valley State University",1,0,2006,"5130","96.448567","266","1167","1434",840,594,123,"36",87,0.1036,0.0606,0.0858,0.8138
"5526",172051,"Saginaw Valley State University",1,0,2007,"5832","102.298409","279","1219","1533",883,650,155,"56",99,0.1121,0.0862,0.1011,0.7952
"5527",172051,"Saginaw Valley State University",1,0,2008,"6054","115.489779","286","1337","1647",949,698,144,"50",94,0.0991,0.0716,0.0874,0.8118
"5528",172051,"Saginaw Valley State University",1,0,2009,"6462","119.099817","288","1338","1728",1028,700,177,"59",118,0.1148,0.0843,0.1024,0.7743
"5529",172051,"Saginaw Valley State University",1,0,2010,"6870","126.548298","296","1284","1729",1013,716,196,"51",145,0.1431,0.0712,0.1134,0.7426
"5530",172699,"WESTERN MICHIGAN UNIVERSITY",0,1,1991,"2447","209.331","740","2379","2778",1543,1235,432,"162",270,0.175,0.1312,0.1555,0.8564
"5531",172699,"WESTERN MICHIGAN UNIVERSITY",0,1,1992,"2807","239.354528","709","2370","2863",1614,1249,484,"165",319,0.1976,0.1321,0.1691,0.8278
"5532",172699,"WESTERN MICHIGAN UNIVERSITY",0,1,1993,"2997","242.343577","731","2439","2810",1587,1223,538,"161",377,0.2376,0.1316,0.1915,0.868
"5533",172699,"WESTERN MICHIGAN UNIVERSITY",0,1,1995,"3242","264.856844","729","2704","3165",1851,1314,524,"148",376,0.2031,0.1126,0.1656,0.8543
"5534",172699,"WESTERN MICHIGAN UNIVERSITY",1,0,1996,"3332","272.930356","756","2672","3121",1801,1320,557,"177",380,0.211,0.1341,0.1785,0.8561
"5535",172699,"WESTERN MICHIGAN UNIVERSITY",1,0,1997,"3655","288.822945","751","2820","3213",1835,1378,592,"211",381,0.2076,0.1531,0.1843,0.8777
"5536",172699,"WESTERN MICHIGAN UNIVERSITY",1,0,1998,"3937","309.701311","808","3198","3621",1981,1640,699,"255",444,0.2241,0.1555,0.193,0.8832
"5537",172699,"WESTERN MICHIGAN UNIVERSITY",1,0,1999,"3453","328.430679","799","3916","4302",2288,2014,864,"306",558,0.2439,0.1519,0.2008,0.9103
"5538",172699,"WESTERN MICHIGAN UNIVERSITY",1,0,2000,"3492","359.342906","857.5","4012","4429",2349,2080,865,"323",542,0.2307,0.1553,0.1953,0.9058
"5539",172699,"WESTERN MICHIGAN UNIVERSITY",1,0,2001,"3897","384.849894","916","4113","4562",2306,2256,857,"334",523,0.2268,0.148,0.1879,0.9016
"5540",172699,"WESTERN MICHIGAN UNIVERSITY",1,0,2002,"4322","404.6729","962","4020","4442",2318,2124,941,"381",560,0.2416,0.1794,0.2118,0.905
"5541",172699,"WESTERN MICHIGAN UNIVERSITY",1,0,2003,"4933","421.860485","962","3743","4218",2191,2027,915,"388",527,0.2405,0.1914,0.2169,0.8874
"5542",172699,"WESTERN MICHIGAN UNIVERSITY",1,0,2004,"5066","416.497575","954","3246","3725",1872,1853,802,"301",501,0.2676,0.1624,0.2153,0.8714
"5543",172699,"Western Michigan University",1,0,2005,"5826","420.716541","890","3272","3702",1917,1785,919,"374",545,0.2843,0.2095,0.2482,0.8838
"5544",172699,"Western Michigan University",1,0,2006,"6176","437.342088","872","2977","3531",1800,1731,852,"359",493,0.2739,0.2074,0.2413,0.8431
"5545",172699,"Western Michigan University",1,0,2007,"6570","445.108703","867","2838","3473",1750,1723,842,"362",480,0.2743,0.2101,0.2424,0.8172
"5546",172699,"Western Michigan University",1,0,2008,"7220","476.889916","893","3067","3803",1934,1869,880,"381",499,0.258,0.2039,0.2314,0.8065
"5547",172699,"Western Michigan University",1,0,2009,"7654","491.667906","862","2453","3162",1591,1571,718,"279",439,0.2759,0.1776,0.2271,0.7758
"5548",172699,"Western Michigan University",1,0,2010,"8182","494.820389","865","2502","3346",1734,1612,721,"259",462,0.2664,0.1607,0.2155,0.7478
"5549",173160,"BETHEL COLLEGE",1,0,1991,"9950","28.025678","109","260","272",183,89,157,"49",108,0.5902,0.5506,0.5772,0.9559
"5550",173160,"BETHEL COLLEGE",1,0,1992,"10540","30.048773","105","225","236",143,93,153,"54",99,0.6923,0.5806,0.6483,0.9534
"5551",173160,"BETHEL COLLEGE",1,0,1993,"11050","31.861102","103","262","275",168,107,175,"64",111,0.6607,0.5981,0.6364,0.9527
"5552",173160,"BETHEL COLLEGE",1,0,1995,"12260","36.970428","116","450","475",303,172,282,"90",192,0.6337,0.5233,0.5937,0.9474
"5553",173160,"BETHEL COLLEGE",1,0,1996,"13180","40.177183","115","439","468",284,184,292,"103",189,0.6655,0.5598,0.6239,0.938
"5554",173160,"BETHEL COLLEGE",1,0,1997,"13840","34.968983","125","431","447",281,166,279,"98",181,0.6441,0.5904,0.6242,0.9642
"5555",173160,"BETHEL COLLEGE",1,0,1998,"14720","37.350111","132","485","513",314,199,314,"122",192,0.6115,0.6131,0.6121,0.9454
"5556",173160,"BETHEL COLLEGE",1,0,1999,"15300","43.043118","143","459","479",315,164,295,"98",197,0.6254,0.5976,0.6159,0.9582
"5557",173160,"BETHEL COLLEGE",1,0,2000,"15900","45.465678","153","568","591",357,234,364,"127",237,0.6639,0.5427,0.6159,0.9611
"5558",173160,"BETHEL COLLEGE",1,0,2001,"16780","48.034005","163","614","645",385,260,442,"173",269,0.6987,0.6654,0.6853,0.9519
"5559",173160,"BETHEL COLLEGE",1,0,2002,"17700","51.929821","171","540","567",348,219,370,"125",245,0.704,0.5708,0.6526,0.9524
"5560",173160,"BETHEL COLLEGE",1,0,2003,"18700","53.894137","178","650","690",419,271,427,"172",255,0.6086,0.6347,0.6188,0.942
"5561",173160,"BETHEL UNIVERSITY",1,0,2004,"19880","57.741104","189","615","669",386,283,385,"160",225,0.5829,0.5654,0.5755,0.9193
"5562",173160,"Bethel University",1,0,2005,"21130","63.055528","186","638","683",425,258,436,"149",287,0.6753,0.5775,0.6384,0.9341
"5563",173160,"Bethel University",1,0,2006,"22590","67.680245","198","575","629",351,278,392,"157",235,0.6695,0.5647,0.6232,0.9141
"5564",173160,"Bethel University",1,0,2007,"24400","75.419748","195","562","597",370,227,374,"126",248,0.6703,0.5551,0.6265,0.9414
"5565",173160,"Bethel University",1,0,2008,"25750","80.857426","207","578","632",377,255,408,"155",253,0.6711,0.6078,0.6456,0.9146
"5566",173160,"Bethel University",1,0,2009,"26900","95.215933","210","629","683",387,296,430,"169",261,0.6744,0.5709,0.6296,0.9209
"5567",173160,"Bethel University",1,0,2010,"27950","89.686795","195","557","604",366,238,408,"146",262,0.7158,0.6134,0.6755,0.9222
"5568",173258,"CARLETON COLLEGE",0,1,1991,"16296","48.589769","158","389","471",247,224,387,"175",212,0.8583,0.7812,0.8217,0.8259
"5569",173258,"CARLETON COLLEGE",0,1,1992,"17360","51.357248","154","399","494",249,245,402,"204",198,0.7952,0.8327,0.8138,0.8077
"5570",173258,"CARLETON COLLEGE",0,1,1993,"18405","55.255726","155","405","488",252,236,391,"185",206,0.8175,0.7839,0.8012,0.8299
"5571",173258,"CARLETON COLLEGE",0,1,1995,"20300","61.254524","163","379","463",232,231,393,"191",202,0.8707,0.8268,0.8488,0.8186
"5572",173258,"CARLETON COLLEGE",0,1,1996,"21117","64.966712","166","384","471",256,215,387,"164",223,0.8711,0.7628,0.8217,0.8153
"5573",173258,"CARLETON COLLEGE",0,1,1997,"21885","58.121251","169","405","484",255,229,412,"195",217,0.851,0.8515,0.8512,0.8368
"5574",173258,"CARLETON COLLEGE",0,1,1998,"22611","62.74325","166","421","520",279,241,450,"204",246,0.8817,0.8465,0.8654,0.8096
"5575",173258,"CARLETON COLLEGE",0,1,1999,"23325","65.037281","170","423","507",257,250,410,"199",211,0.821,0.796,0.8087,0.8343
"5576",173258,"CARLETON COLLEGE",0,1,2000,"24240","70.642815","170","385","471",247,224,415,"194",221,0.8947,0.8661,0.8811,0.8174
"5577",173258,"CARLETON COLLEGE",0,1,2001,"25371","79.512782","170","397","516",265,251,467,"222",245,0.9245,0.8845,0.905,0.7694
"5578",173258,"CARLETON COLLEGE",0,1,2002,"26745","89.419361","202","350","499",264,235,447,"203",244,0.9242,0.8638,0.8958,0.7014
"5579",173258,"CARLETON COLLEGE",0,1,2003,"28362","88.43374","212","359","488",241,247,435,"215",220,0.9129,0.8704,0.8914,0.7357
"5580",173258,"CARLETON COLLEGE",0,1,2004,"30501","86.962018","220","355","487",263,224,432,"195",237,0.9011,0.8705,0.8871,0.729
"5581",173258,"Carleton College",0,1,2005,"32460","89.240062","213","359","542",278,264,478,"226",252,0.9065,0.8561,0.8819,0.6624
"5582",173258,"Carleton College",0,1,2006,"34083","94.143273","212","368","504",272,232,458,"209",249,0.9154,0.9009,0.9087,0.7302
"5583",173258,"Carleton College",0,1,2007,"35958","98.497806","215","361","509",255,254,456,"221",235,0.9216,0.8701,0.8959,0.7092
"5584",173258,"Carleton College",0,1,2008,"37845","102.857333","216","335","488",244,244,444,"220",224,0.918,0.9016,0.9098,0.6865
"5585",173258,"Carleton College",0,1,2009,"39546","109.87919","222","352","528",272,256,480,"222",258,0.9485,0.8672,0.9091,0.6667
"5586",173258,"Carleton College",0,1,2010,"41076","111.542293","228","343","511",268,243,451,"209",242,0.903,0.8601,0.8826,0.6712
"5587",173328,"CONCORDIA COLLEGE",0,1,1991,"8268","14.718848","51","119","151",94,57,31,"10",21,0.2234,0.1754,0.2053,0.7881
"5588",173328,"CONCORDIA COLLEGE",0,1,1992,"9000","15.465618","54","118","149",90,59,39,"12",27,0.3,0.2034,0.2617,0.7919
"5589",173328,"CONCORDIA COLLEGE",0,1,1993,"9720","16.395231","53","116","138",77,61,39,"16",23,0.2987,0.2623,0.2826,0.8406
"5590",173328,"CONCORDIA COLLEGE",0,1,1995,"10815","17.36482","52","125","153",91,62,42,"13",29,0.3187,0.2097,0.2745,0.817
"5591",173328,"CONCORDIA COLLEGE",0,1,1996,"11355","17.710561","50","133","161",82,79,53,"25",28,0.3415,0.3165,0.3292,0.8261
"5592",173328,"CONCORDIA UNIVERSITY",0,1,1997,"11980","20.064776","49","178","222",132,90,86,"32",54,0.4091,0.3556,0.3874,0.8018
"5593",173328,"CONCORDIA UNIVERSITY",1,0,1998,"12658","22.681561","72","179","213",106,107,57,"24",33,0.3113,0.2243,0.2676,0.8404
"5594",173328,"CONCORDIA UNIVERSITY",1,0,1999,"13040","24.148429","68","187","258",142,116,76,"32",44,0.3099,0.2759,0.2946,0.7248
"5595",173328,"CONCORDIA UNIVERSITY",1,0,2000,"14752","25.765572","77","158","212",124,88,57,"15",42,0.3387,0.1705,0.2689,0.7453
"5596",173328,"CONCORDIA UNIVERSITY",1,0,2001,"15786","28.031731","86","138","200",87,113,57,"26",31,0.3563,0.2301,0.285,0.69
"5597",173328,"CONCORDIA UNIVERSITY",1,0,2002,"17326","30.431763","81","137","175",89,86,57,"19",38,0.427,0.2209,0.3257,0.7829
"5598",173328,"CONCORDIA UNIVERSITY-ST PAUL",1,0,2003,"18624","31.913342","86","123","167",83,84,59,"25",34,0.4096,0.2976,0.3533,0.7365
"5599",173328,"CONCORDIA UNIVERSITY-ST PAUL",1,0,2004,"19928","34.646886","81","127","176",102,74,64,"24",40,0.3922,0.3243,0.3636,0.7216
"5600",173328,"Concordia University-Saint Paul",1,0,2005,"21312","38.84248","84","113","163",84,79,53,"21",32,0.381,0.2658,0.3252,0.6933
"5601",173328,"Concordia University-Saint Paul",1,0,2006,"22378","37.49961","89","139","199",108,91,51,"19",32,0.2963,0.2088,0.2563,0.6985
"5602",173328,"Concordia University-Saint Paul",1,0,2007,"23496","39.546322","73","138","201",112,89,61,"20",41,0.3661,0.2247,0.3035,0.6866
"5603",173328,"Concordia University-Saint Paul",1,0,2008,"24900","33.181875","78","137","211",116,95,60,"25",35,0.3017,0.2632,0.2844,0.6493
"5604",173328,"Concordia University-Saint Paul",1,0,2009,"26400","35.244637","70","110","183",82,101,56,"22",34,0.4146,0.2178,0.306,0.6011
"5605",173328,"Concordia University-Saint Paul",1,0,2010,"27400","35.527528","69","132","217",126,91,81,"19",62,0.4921,0.2088,0.3733,0.6083
"5606",173647,"GUSTAVUS ADOLPHUS COLLEGE",1,0,1991,"11900","35.982606","142","595","624",336,288,464,"210",254,0.756,0.7292,0.7436,0.9535
"5607",173647,"GUSTAVUS ADOLPHUS COLLEGE",1,0,1992,"12600","38.214894","160","582","620",327,293,455,"224",231,0.7064,0.7645,0.7339,0.9387
"5608",173647,"GUSTAVUS ADOLPHUS COLLEGE",1,0,1993,"13400","40.744968","162","584","630",369,261,485,"191",294,0.7967,0.7318,0.7698,0.927
"5609",173647,"GUSTAVUS ADOLPHUS COLLEGE",1,0,1995,"14760","47.042417","164","659","690",380,310,478,"196",282,0.7421,0.6323,0.6928,0.9551
"5610",173647,"GUSTAVUS ADOLPHUS COLLEGE",1,0,1996,"15350","50.413003","164","585","633",375,258,504,"202",302,0.8053,0.7829,0.7962,0.9242
"5611",173647,"GUSTAVUS ADOLPHUS COLLEGE",1,0,1997,"15940","42.576637","165","592","625",353,272,438,"174",264,0.7479,0.6397,0.7008,0.9472
"5612",173647,"GUSTAVUS ADOLPHUS COLLEGE",1,0,1998,"16560","42.295564","166","663","695",391,304,477,"195",282,0.7212,0.6414,0.6863,0.954
"5613",173647,"GUSTAVUS ADOLPHUS COLLEGE",1,0,1999,"17200","47.299888","170","612","654",365,289,473,"207",266,0.7288,0.7163,0.7232,0.9358
"5614",173647,"GUSTAVUS ADOLPHUS COLLEGE",1,0,2000,"17970","53.715762","172","603","652",383,269,392,"169",223,0.5822,0.6283,0.6012,0.9248
"5615",173647,"GUSTAVUS ADOLPHUS COLLEGE",1,0,2001,"18940","55.239324","174","546","601",343,258,468,"196",272,0.793,0.7597,0.7787,0.9085
"5616",173647,"GUSTAVUS ADOLPHUS COLLEGE",1,0,2002,"19215","59.2698","185","601","645",383,262,521,"216",305,0.7963,0.8244,0.8078,0.9318
"5617",173647,"GUSTAVUS ADOLPHUS COLLEGE",1,0,2003,"20405","59.237998","178","571","623",331,292,514,"235",279,0.8429,0.8048,0.825,0.9165
"5618",173647,"GUSTAVUS ADOLPHUS COLLEGE",1,0,2004,"22625","59.664584","183","584","651",361,290,468,"221",247,0.6842,0.7621,0.7189,0.8971
"5619",173647,"Gustavus Adolphus College",1,0,2005,"25765","62.314416","204","673","739",439,300,588,"208",380,0.8656,0.6933,0.7957,0.9107
"5620",173647,"Gustavus Adolphus College",1,0,2006,"26310","67.073102","192","610","684",396,288,553,"226",327,0.8258,0.7847,0.8085,0.8918
"5621",173647,"Gustavus Adolphus College",1,0,2007,"28125","68.96525","193","573","666",374,292,542,"234",308,0.8235,0.8014,0.8138,0.8604
"5622",173647,"Gustavus Adolphus College",1,0,2008,"29990","72.279421","205","541","616",346,270,495,"211",284,0.8208,0.7815,0.8036,0.8782
"5623",173647,"Gustavus Adolphus College",1,0,2009,"31460","75.489096","215","514","611",372,239,495,"193",302,0.8118,0.8075,0.8101,0.8412
"5624",173647,"Gustavus Adolphus College",1,0,2010,"33100","76.023525","226","470","585",314,271,454,"208",246,0.7834,0.7675,0.7761,0.8034
"5625",173902,"MACALESTER COLLEGE",1,0,1991,"13331","36.380345","124","311","403",206,197,284,"126",158,0.767,0.6396,0.7047,0.7717
"5626",173902,"MACALESTER COLLEGE",1,0,1992,"14125","49.75804","126","358","475",258,217,332,"139",193,0.7481,0.6406,0.6989,0.7537
"5627",173902,"MACALESTER COLLEGE",1,0,1993,"15107","52.424604","120","346","452",252,200,318,"128",190,0.754,0.64,0.7035,0.7655
"5628",173902,"MACALESTER COLLEGE",1,0,1995,"16686","60.063089","138","353","437",231,206,322,"143",179,0.7749,0.6942,0.7368,0.8078
"5629",173902,"MACALESTER COLLEGE",1,0,1996,"17580","63.462308","141","387","491",293,198,377,"151",226,0.7713,0.7626,0.7678,0.7882
"5630",173902,"MACALESTER COLLEGE",1,0,1997,"18630","47.818","143","347","450",251,199,339,"140",199,0.7928,0.7035,0.7533,0.7711
"5631",173902,"MACALESTER COLLEGE",1,0,1998,"19673","52.119","147","352","465",260,205,339,"153",186,0.7154,0.7463,0.729,0.757
"5632",173902,"MACALESTER COLLEGE",1,0,1999,"20560","54.199","147","332","460",271,189,360,"147",213,0.786,0.7778,0.7826,0.7217
"5633",173902,"MACALESTER COLLEGE",1,0,2000,"21486","55.672","147.5","336","454",299,155,366,"126",240,0.8027,0.8129,0.8062,0.7401
"5634",173902,"MACALESTER COLLEGE",1,0,2001,"22480","60.574","148","379","505",265,240,415,"193",222,0.8377,0.8042,0.8218,0.7505
"5635",173902,"MACALESTER COLLEGE",1,0,2002,"23604","64.75","150","310","440",241,199,370,"169",201,0.834,0.8492,0.8409,0.7045
"5636",173902,"MACALESTER COLLEGE",1,0,2003,"24902","66.685","149","407","513",300,213,422,"168",254,0.8467,0.7887,0.8226,0.7934
"5637",173902,"MACALESTER COLLEGE",1,0,2004,"26638","68.219","151","321","485",284,201,410,"164",246,0.8662,0.8159,0.8454,0.6619
"5638",173902,"MacAlester College",1,0,2005,"28474","70.91","154","352","491",287,204,405,"158",247,0.8606,0.7745,0.8248,0.7169
"5639",173902,"Macalester College",1,0,2006,"30870","75.444","154","353","501",281,220,429,"181",248,0.8826,0.8227,0.8563,0.7046
"5640",173902,"Macalester College",1,0,2007,"33494","77.446","157","327","485",270,215,411,"176",235,0.8704,0.8186,0.8474,0.6742
"5641",173902,"Macalester College",1,0,2008,"36304","83.124","164","346","478",279,199,401,"161",240,0.8602,0.809,0.8389,0.7238
"5642",173902,"Macalester College",1,0,2009,"37974","90.85","163","391","564",329,235,481,"196",285,0.8663,0.834,0.8528,0.6933
"5643",173902,"Macalester College",1,0,2010,"39846","90.595","165","332","515",314,201,434,"158",276,0.879,0.7861,0.8427,0.6447
"5644",174066,"UNIVERSITY OF MINNESOTA TWIN CITIES",0,1,1991,"2829","1418.854913","1513","1618","1979",917,1062,318,"134",184,0.2007,0.1262,0.1607,0.8176
"5645",174066,"UNIVERSITY OF MINNESOTA TWIN CITIES",0,1,1992,"3158","1887.167894","1560","1634","1980",905,1075,329,"137",192,0.2122,0.1274,0.1662,0.8253
"5646",174066,"UNIVERSITY OF MINNESOTA TWIN CITIES",0,1,1993,"3266","1444.240089","1538","1848","2272",1080,1192,413,"171",242,0.2241,0.1435,0.1818,0.8134
"5647",174066,"UNIVERSITY OF MINNESOTA TWIN CITIES",0,1,1995,"3857","1616.218183","1499","3308","4128",2100,2028,984,"418",566,0.2695,0.2061,0.2384,0.8014
"5648",174066,"UNIVERSITY OF MINNESOTA TWIN CITIES",0,1,1996,"4320","1673.834954","1478","3300","4057",2049,2008,1050,"451",599,0.2923,0.2246,0.2588,0.8134
"5649",174066,"UNIVERSITY OF MINNESOTA-TWIN CITIES",0,1,1997,"4749","1594.815137","1446","3462","4371",2282,2089,1208,"467",741,0.3247,0.2236,0.2764,0.792
"5650",174066,"UNIVERSITY OF MINNESOTA-TWIN CITIES",0,1,1998,"4963","1487.690399","1440","3986","4992",2582,2410,1441,"573",868,0.3362,0.2378,0.2887,0.7985
"5651",174066,"UNIVERSITY OF MINNESOTA-TWIN CITIES",1,0,1999,"4171","1626.533218","1461","4033","5025",2636,2389,1604,"655",949,0.36,0.2742,0.3192,0.8026
"5652",174066,"UNIVERSITY OF MINNESOTA-TWIN CITIES",1,0,2000,"4401","1636.78481","1490","3853","4865",2577,2288,1581,"668",913,0.3543,0.292,0.325,0.792
"5653",174066,"UNIVERSITY OF MINNESOTA-TWIN CITIES",1,0,2001,"4852","1755.153055","1519","4248","5259",2677,2582,1939,"841",1098,0.4102,0.3257,0.3687,0.8078
"5654",174066,"UNIVERSITY OF MINNESOTA-TWIN CITIES",1,0,2002,"5420","1850.850897","1559","4109","5162",2762,2400,2118,"869",1249,0.4522,0.3621,0.4103,0.796
"5655",174066,"UNIVERSITY OF MINNESOTA-TWIN CITIES",1,0,2003,"5962","1964.920635","1626","3970","5160",2820,2340,2341,"902",1439,0.5103,0.3855,0.4537,0.7694
"5656",174066,"UNIVERSITY OF MINNESOTA-TWIN CITIES",1,0,2004,"6677","1936.203801","1669","4434","5562",3081,2481,2549,"994",1555,0.5047,0.4006,0.4583,0.7972
"5657",174066,"University of Minnesota-Twin Cities",1,0,2005,"7140","2037.771087","1677","4165","5274",2856,2418,2488,"1023",1465,0.513,0.4231,0.4717,0.7897
"5658",174066,"University of Minnesota-Twin Cities",1,0,2006,"7588","2182.280854","1710","4194","5418",2970,2448,2734,"1150",1584,0.5333,0.4698,0.5046,0.7741
"5659",174066,"University of Minnesota-Twin Cities",1,0,2007,"7950","2328.787414","2041","3990","5256",2927,2329,2863,"1182",1681,0.5743,0.5075,0.5447,0.7591
"5660",174066,"University of Minnesota-Twin Cities",1,0,2008,"8500","2610.0005","1933","3729","5089",2813,2276,2975,"1224",1751,0.6225,0.5378,0.5846,0.7328
"5661",174066,"University of Minnesota-Twin Cities",1,0,2009,"9120","2682.239235","1834","3986","5381",2849,2532,3188,"1380",1808,0.6346,0.545,0.5925,0.7408
"5662",174066,"University of Minnesota-Twin Cities",1,0,2010,"9794","2743.419751","1846","4074","5310",2810,2500,3251,"1428",1823,0.6488,0.5712,0.6122,0.7672
"5663",174233,"UNIVERSITY OF MINNESOTA DULUTH",0,1,1991,"2750","86.455891","281","975","1091",567,524,196,"69",127,0.224,0.1317,0.1797,0.8937
"5664",174233,"UNIVERSITY OF MINNESOTA DULUTH",0,1,1992,"3044","51.735719","290","1092","1163",566,597,221,"95",126,0.2226,0.1591,0.19,0.939
"5665",174233,"UNIVERSITY OF MINNESOTA-DULUTH",0,1,1993,"3137","96.151867","285","1164","1248",631,617,226,"88",138,0.2187,0.1426,0.1811,0.9327
"5666",174233,"UNIVERSITY OF MINNESOTA-DULUTH",0,1,1995,"3745","90.190058","327","1341","1462",688,774,361,"146",215,0.3125,0.1886,0.2469,0.9172
"5667",174233,"UNIVERSITY OF MINNESOTA-DULUTH",0,1,1996,"4187","93.908584","334","1614","1736",886,850,411,"156",255,0.2878,0.1835,0.2368,0.9297
"5668",174233,"UNIVERSITY OF MINNESOTA-DULUTH",0,1,1997,"4522","97.131186","335","1550","1679",843,836,363,"140",223,0.2645,0.1675,0.2162,0.9232
"5669",174233,"UNIVERSITY OF MINNESOTA-DULUTH",0,1,1998,"4725","103.299261","342","1623","1746",911,835,362,"138",224,0.2459,0.1653,0.2073,0.9296
"5670",174233,"UNIVERSITY OF MINNESOTA-DULUTH",1,0,1999,"4230","112.857132","356","1869","2000",1032,968,416,"168",248,0.2403,0.1736,0.208,0.9345
"5671",174233,"UNIVERSITY OF MINNESOTA-DULUTH",1,0,2000,"4463","117.652966","370.5","1947","2088",1107,981,508,"182",326,0.2945,0.1855,0.2433,0.9325
"5672",174233,"UNIVERSITY OF MINNESOTA-DULUTH",1,0,2001,"4920","128.042707","385","1970","2109",1094,1015,495,"180",315,0.2879,0.1773,0.2347,0.9341
"5673",174233,"UNIVERSITY OF MINNESOTA-DULUTH",1,0,2002,"5585","142.263521","410","1870","2025",1029,996,476,"183",293,0.2847,0.1837,0.2351,0.9235
"5674",174233,"UNIVERSITY OF MINNESOTA-DULUTH",1,0,2003,"6045","150.978139","378","1972","2155",1073,1082,514,"218",296,0.2759,0.2015,0.2385,0.9151
"5675",174233,"UNIVERSITY OF MINNESOTA-DULUTH",1,0,2004,"6710","150.407061","398","2021","2205",1153,1052,568,"208",360,0.3122,0.1977,0.2576,0.9166
"5676",174233,"University of Minnesota-Duluth",1,0,2005,"7157","164.492015","417","1969","2111",1025,1086,565,"243",322,0.3141,0.2238,0.2676,0.9327
"5677",174233,"University of Minnesota-Duluth",1,0,2006,"7605","177.224846","414","2122","2283",1105,1178,629,"270",359,0.3249,0.2292,0.2755,0.9295
"5678",174233,"University of Minnesota-Duluth",1,0,2007,"7700","190.765353","430","2006","2196",1100,1096,649,"244",405,0.3682,0.2226,0.2955,0.9135
"5679",174233,"University of Minnesota-Duluth",1,0,2008,"8230","214.156067","437","1999","2213",1110,1103,760,"306",454,0.409,0.2774,0.3434,0.9033
"5680",174233,"University of Minnesota-Duluth",1,0,2009,"8830","212.612148","431","1887","2079",1028,1051,728,"296",432,0.4202,0.2816,0.3502,0.9076
"5681",174233,"University of Minnesota-Duluth",1,0,2010,"9482","200.726345","439","2097","2316",1112,1204,819,"356",463,0.4164,0.2957,0.3536,0.9054
"5682",174251,"UNIVERSITY OF MINNESOTA MORRIS",0,1,1991,"2781","22.474314","116","384","462",272,190,155,"55",100,0.3676,0.2895,0.3355,0.8312
"5683",174251,"UNIVERSITY OF MINNESOTA MORRIS",0,1,1992,"3246","13.750651","113","435","497",291,206,187,"67",120,0.4124,0.3252,0.3763,0.8753
"5684",174251,"UNIVERSITY OF MINNESOTA-MORRIS",0,1,1993,"3417","23.969571","112","440","519",284,235,209,"88",121,0.4261,0.3745,0.4027,0.8478
"5685",174251,"UNIVERSITY OF MINNESOTA-MORRIS",0,1,1995,"4189","23.979072","113","430","503",297,206,202,"66",136,0.4579,0.3204,0.4016,0.8549
"5686",174251,"UNIVERSITY OF MINNESOTA-MORRIS",0,1,1996,"4554","25.829751","115","447","522",310,212,223,"71",152,0.4903,0.3349,0.4272,0.8563
"5687",174251,"UNIVERSITY OF MINNESOTA-MORRIS",0,1,1997,"4766","25.251903","111","387","461",271,190,161,"53",108,0.3985,0.2789,0.3492,0.8395
"5688",174251,"UNIVERSITY OF MINNESOTA-MORRIS",0,1,1998,"4956","26.902009","114","441","522",330,192,198,"62",136,0.4121,0.3229,0.3793,0.8448
"5689",174251,"UNIVERSITY OF MINNESOTA-MORRIS",0,1,1999,"4777","28.616813","112","386","453",270,183,174,"70",104,0.3852,0.3825,0.3841,0.8521
"5690",174251,"UNIVERSITY OF MINNESOTA-MORRIS",1,0,2000,"5033","30.489748","117.5","391","467",267,200,186,"66",120,0.4494,0.33,0.3983,0.8373
"5691",174251,"UNIVERSITY OF MINNESOTA-MORRIS",1,0,2001,"5549","32.665999","123","394","474",296,178,206,"74",132,0.4459,0.4157,0.4346,0.8312
"5692",174251,"UNIVERSITY OF MINNESOTA-MORRIS",1,0,2002,"6381","34.606504","123","404","475",309,166,219,"71",148,0.479,0.4277,0.4611,0.8505
"5693",174251,"UNIVERSITY OF MINNESOTA-MORRIS",1,0,2003,"6908","35.932721","120","349","412",249,163,179,"60",119,0.4779,0.3681,0.4345,0.8471
"5694",174251,"UNIVERSITY OF MINNESOTA-MORRIS",1,0,2004,"7668","35.553352","113","303","383",235,148,205,"73",132,0.5617,0.4932,0.5352,0.7911
"5695",174251,"University of Minnesota-Morris",1,0,2005,"8204","35.395599","118","275","353",207,146,171,"63",108,0.5217,0.4315,0.4844,0.779
"5696",174251,"University of Minnesota-Morris",1,0,2006,"8720","38.542525","113","283","377",214,163,179,"66",113,0.528,0.4049,0.4748,0.7507
"5697",174251,"University of Minnesota-Morris",1,0,2007,"7700","41.040507","123","281","358",205,153,180,"65",115,0.561,0.4248,0.5028,0.7849
"5698",174251,"University of Minnesota-Morris",1,0,2008,"8230","44.580929","112","286","373",209,164,200,"80",120,0.5742,0.4878,0.5362,0.7668
"5699",174251,"University of Minnesota-Morris",1,0,2009,"8830","41.137862","105","315","404",235,169,206,"74",132,0.5617,0.4379,0.5099,0.7797
"5700",174251,"University of Minnesota-Morris",1,0,2010,"9482","41.010201","110","295","418",242,176,211,"81",130,0.5372,0.4602,0.5048,0.7057
"5701",174491,"NORTHWESTERN COLLEGE",0,1,1991,"9096","23.855998","53","260","267",165,102,84,"24",60,0.3636,0.2353,0.3146,0.9738
"5702",174491,"NORTHWESTERN COLLEGE",0,1,1992,"9825","27.543032","57","297","308",183,125,106,"40",66,0.3607,0.32,0.3442,0.9643
"5703",174491,"NORTHWESTERN COLLEGE",0,1,1993,"10659","29.033744","57","314","329",209,120,107,"38",69,0.3301,0.3167,0.3252,0.9544
"5704",174491,"NORTHWESTERN COLLEGE",0,1,1995,"11985","31.392219","54","366","378",245,133,155,"43",112,0.4571,0.3233,0.4101,0.9683
"5705",174491,"NORTHWESTERN COLLEGE",0,1,1996,"12750","33.177934","57","336","358",223,135,140,"36",104,0.4664,0.2667,0.3911,0.9385
"5706",174491,"NORTHWESTERN COLLEGE",0,1,1997,"13125","25.478973","61","352","372",231,141,162,"61",101,0.4372,0.4326,0.4355,0.9462
"5707",174491,"NORTHWESTERN COLLEGE",0,1,1998,"13920","26.782161","58","375","393",242,151,155,"55",100,0.4132,0.3642,0.3944,0.9542
"5708",174491,"NORTHWESTERN COLLEGE",1,0,1999,"14336","29.348168","61","376","392",262,130,160,"42",118,0.4504,0.3231,0.4082,0.9592
"5709",174491,"NORTHWESTERN COLLEGE",1,0,2000,"14982","33.675919","63.5","409","430",279,151,178,"52",126,0.4516,0.3444,0.414,0.9512
"5710",174491,"NORTHWESTERN COLLEGE",1,0,2001,"15600","36.324268","66","373","400",262,138,184,"54",130,0.4962,0.3913,0.46,0.9325
"5711",174491,"NORTHWESTERN COLLEGE",1,0,2002,"16500","46.491912","78","410","431",267,164,183,"75",108,0.4045,0.4573,0.4246,0.9513
"5712",174491,"NORTHWESTERN COLLEGE",1,0,2003,"17400","41.862353","84","395","431",291,140,191,"55",136,0.4674,0.3929,0.4432,0.9165
"5713",174491,"NORTHWESTERN COLLEGE",1,0,2004,"18370","45.719547","89","378","409",245,164,194,"67",127,0.5184,0.4085,0.4743,0.9242
"5714",174491,"Northwestern College",1,0,2005,"19100","48.445044","89","424","476",295,181,221,"76",145,0.4915,0.4199,0.4643,0.8908
"5715",174491,"Northwestern College",1,0,2006,"19990","52.723763","95","459","498",302,196,256,"89",167,0.553,0.4541,0.5141,0.9217
"5716",174491,"Northwestern College",1,0,2007,"20990","56.202036","98","478","526",315,211,264,"99",165,0.5238,0.4692,0.5019,0.9087
"5717",174491,"Northwestern College",1,0,2008,"22250","59.255522","101","420","455",273,182,202,"62",140,0.5128,0.3407,0.444,0.9231
"5718",174491,"Northwestern College",1,0,2009,"22990","62.907927","101","404","450",258,192,240,"86",154,0.5969,0.4479,0.5333,0.8978
"5719",174491,"Northwestern College",1,0,2010,"24370","62.155464","103","378","451",247,204,219,"89",130,0.5263,0.4363,0.4856,0.8381
"5720",174792,"SAINT JOHN'S UNIVERSITY",1,0,1991,"10135","33.340558","129","380","415",0,415,247,"247",0,NA,0.5952,0.5952,0.9157
"5721",174792,"SAINT JOHN'S UNIVERSITY",1,0,1992,"10578","35.570705","129","399","435",0,435,236,"236",0,NA,0.5425,0.5425,0.9172
"5722",174792,"SAINT JOHNS UNIVERSITY",1,0,1993,"11428","37.273839","126","420","444",0,444,265,"265",0,NA,0.5968,0.5968,0.9459
"5723",174792,"SAINT JOHNS UNIVERSITY",1,0,1995,"13089","39.914869","127","409","430",0,430,286,"286",0,NA,0.6651,0.6651,0.9512
"5724",174792,"SAINT JOHNS UNIVERSITY",1,0,1996,"13996","42.88032","132","404","426",0,426,296,"296",0,NA,0.6948,0.6948,0.9484
"5725",174792,"SAINT JOHNS UNIVERSITY",1,0,1997,"14758","36.853478","128","434","450",0,450,335,"335",0,NA,0.7444,0.7444,0.9644
"5726",174792,"SAINT JOHNS UNIVERSITY",1,0,1998,"15574","38.903059","143","410","427",0,427,317,"317",0,NA,0.7424,0.7424,0.9602
"5727",174792,"SAINT JOHNS UNIVERSITY",1,0,1999,"16195","41.079895","145","457","475",0,475,335,"335",0,NA,0.7053,0.7053,0.9621
"5728",174792,"SAINT JOHNS UNIVERSITY",1,0,2000,"16995","45.83104","144","486","522",0,522,406,"406",0,NA,0.7778,0.7778,0.931
"5729",174792,"SAINT JOHNS UNIVERSITY",1,0,2001,"18015","48.461753","143","470","502",0,502,360,"360",0,NA,0.7171,0.7171,0.9363
"5730",174792,"SAINT JOHNS UNIVERSITY",1,0,2002,"18916","50.667033","142","435","468",0,468,340,"340",0,NA,0.7265,0.7265,0.9295
"5731",174792,"SAINT JOHNS UNIVERSITY",1,0,2003,"20335","53.230469","143","451","490",0,490,346,"346",0,NA,0.7061,0.7061,0.9204
"5732",174792,"SAINT JOHNS UNIVERSITY",1,0,2004,"21758","54.7461","136","480","512",0,512,338,"338",0,NA,0.6602,0.6602,0.9375
"5733",174792,"Saint Johns University",1,0,2005,"23064","57.460855","137","410","447",0,447,325,"325",0,NA,0.7271,0.7271,0.9172
"5734",174792,"Saint Johns University",1,0,2006,"24448","58.492638","137","461","506",0,506,347,"347",0,NA,0.6858,0.6858,0.9111
"5735",174792,"Saint Johns University",1,0,2007,"26038","60.901247","136","468","516",0,516,364,"364",0,NA,0.7054,0.7054,0.907
"5736",174792,"Saint Johns University",1,0,2008,"28122","64.421742","137","402","461",0,461,332,"332",0,NA,0.7202,0.7202,0.872
"5737",174792,"Saint Johns University",1,0,2009,"29388","65.590975","133","375","461",0,461,303,"303",0,NA,0.6573,0.6573,0.8134
"5738",174792,"Saint Johns University",1,0,2010,"31006","67.234614","136","427","503",0,503,360,"360",0,NA,0.7157,0.7157,0.8489
"5739",174844,"SAINT OLAF COLLEGE",1,0,1991,"12080","56.26779","253","674","733",391,342,534,"246",288,0.7366,0.7193,0.7285,0.9195
"5740",174844,"SAINT OLAF COLLEGE",1,0,1992,"12750","61.132224","230","641","701",409,292,501,"192",309,0.7555,0.6575,0.7147,0.9144
"5741",174844,"SAINT OLAF COLLEGE",1,0,1993,"13560","63.670717","235","687","737",413,324,515,"215",300,0.7264,0.6636,0.6988,0.9322
"5742",174844,"SAINT OLAF COLLEGE",1,0,1995,"15000","70.839384","244","692","742",431,311,557,"223",334,0.7749,0.717,0.7507,0.9326
"5743",174844,"SAINT OLAF COLLEGE",1,0,1996,"15700","75.781348","238","715","771",448,323,565,"228",337,0.7522,0.7059,0.7328,0.9274
"5744",174844,"SAINT OLAF COLLEGE",1,0,1997,"16500","60.441564","227","666","722",416,306,539,"227",312,0.75,0.7418,0.7465,0.9224
"5745",174844,"SAINT OLAF COLLEGE",1,0,1998,"17140","62.11998","218","692","756",431,325,594,"256",338,0.7842,0.7877,0.7857,0.9153
"5746",174844,"SAINT OLAF COLLEGE",1,0,1999,"18250","66.38279","210","661","761",451,310,594,"225",369,0.8182,0.7258,0.7806,0.8686
"5747",174844,"SAINT OLAF COLLEGE",1,0,2000,"19400","70.444718","202.5","675","753",441,312,600,"232",368,0.8345,0.7436,0.7968,0.8964
"5748",174844,"SAINT OLAF COLLEGE",1,0,2001,"21280","74.720528","195","639","744",432,312,608,"253",355,0.8218,0.8109,0.8172,0.8589
"5749",174844,"SAINT OLAF COLLEGE",1,0,2002,"22200","78.259795","200","689","777",479,298,645,"235",410,0.8559,0.7886,0.8301,0.8867
"5750",174844,"SAINT OLAF COLLEGE",1,0,2003,"23650","81.681464","211","606","719",422,297,593,"234",359,0.8507,0.7879,0.8248,0.8428
"5751",174844,"SAINT OLAF COLLEGE",1,0,2004,"25150","86.164958","198","632","777",446,331,631,"258",373,0.8363,0.7795,0.8121,0.8134
"5752",174844,"St. Olaf College",1,0,2005,"26500","87.241991","206","657","764",426,338,617,"270",347,0.8146,0.7988,0.8076,0.8599
"5753",174844,"St. Olaf College",1,0,2006,"28200","89.98818","199","688","792",436,356,660,"288",372,0.8532,0.809,0.8333,0.8687
"5754",174844,"St. Olaf College",1,0,2007,"30600","95.419909","207","652","751",406,345,624,"287",337,0.83,0.8319,0.8309,0.8682
"5755",174844,"St. Olaf College",1,0,2008,"34300","100.82131","216","688","813",454,359,698,"292",406,0.8943,0.8134,0.8585,0.8462
"5756",174844,"St. Olaf College",1,0,2009,"35500","104.863813","220","640","778",445,333,652,"267",385,0.8652,0.8018,0.838,0.8226
"5757",174844,"St Olaf College",1,0,2010,"36800","105.438807","229","690","844",434,410,719,"332",387,0.8917,0.8098,0.8519,0.8175
"5758",174899,"COLLEGE OF SAINT SCHOLASTICA",0,1,1991,"9861","26.340388","93","273","276",206,70,114,"28",86,0.4175,0.4,0.413,0.9891
"5759",174899,"COLLEGE OF SAINT SCHOLASTICA",0,1,1992,"10659","28.537586","101","318","325",240,85,126,"36",90,0.375,0.4235,0.3877,0.9785
"5760",174899,"COLLEGE OF SAINT SCHOLASTICA",0,1,1993,"11280","28.470336","108","222","254",193,61,120,"25",95,0.4922,0.4098,0.4724,0.874
"5761",174899,"COLLEGE OF SAINT SCHOLASTICA",0,1,1995,"12534","28.959317","128","238","270",201,69,142,"30",112,0.5572,0.4348,0.5259,0.8815
"5762",174899,"COLLEGE OF SAINT SCHOLASTICA",0,1,1996,"13131","31.469448","113","265","295",229,66,145,"36",109,0.476,0.5455,0.4915,0.8983
"5763",174899,"COLLEGE OF SAINT SCHOLASTICA",0,1,1997,"13995","25.459599","119","211","244",180,64,141,"32",109,0.6056,0.5,0.5779,0.8648
"5764",174899,"COLLEGE OF SAINT SCHOLASTICA",0,1,1998,"15060","27.729599","93","245","277",213,64,163,"30",133,0.6244,0.4688,0.5884,0.8845
"5765",174899,"THE COLLEGE OF SAINT SCHOLASTICA",1,0,1999,"15420","24.993909","101","275","305",230,75,156,"36",120,0.5217,0.48,0.5115,0.9016
"5766",174899,"THE COLLEGE OF SAINT SCHOLASTICA",1,0,2000,"16190","25.917913","101.5","287","315",226,89,173,"45",128,0.5664,0.5056,0.5492,0.9111
"5767",174899,"THE COLLEGE OF SAINT SCHOLASTICA",1,0,2001,"17080","26.714187","102","288","314",224,90,175,"48",127,0.567,0.5333,0.5573,0.9172
"5768",174899,"THE COLLEGE OF SAINT SCHOLASTICA",1,0,2002,"18106","30.670211","105","348","382",286,96,218,"43",175,0.6119,0.4479,0.5707,0.911
"5769",174899,"THE COLLEGE OF SAINT SCHOLASTICA",1,0,2003,"19192","34.610746","111","371","411",299,112,256,"75",181,0.6054,0.6696,0.6229,0.9027
"5770",174899,"THE COLLEGE OF SAINT SCHOLASTICA",1,0,2004,"20630","38.804151","124","382","437",300,137,227,"66",161,0.5367,0.4818,0.5195,0.8741
"5771",174899,"The College of Saint Scholastica",1,0,2005,"22110","43.846405","133","438","490",350,140,265,"70",195,0.5571,0.5,0.5408,0.8939
"5772",174899,"The College of Saint Scholastica",1,0,2006,"23434","46.591891","135","412","493",331,162,283,"79",204,0.6163,0.4877,0.574,0.8357
"5773",174899,"The College of Saint Scholastica",1,0,2007,"24840","49.598263","145","423","487",336,151,288,"76",212,0.631,0.5033,0.5914,0.8686
"5774",174899,"The College of Saint Scholastica",1,0,2008,"26324","54.777162","155","476","575",381,194,314,"93",221,0.5801,0.4794,0.5461,0.8278
"5775",174899,"The College of Saint Scholastica",1,0,2009,"27114","59.879134","166","476","540",359,181,337,"90",247,0.688,0.4972,0.6241,0.8815
"5776",174899,"The College of Saint Scholastica",1,0,2010,"28200","62.832902","175","489","575",358,217,328,"100",228,0.6369,0.4608,0.5704,0.8504
"5777",174914,"UNIVERSITY OF ST THOMAS",1,0,1991,"10564","92.109249","280","784","854",457,397,393,"174",219,0.4792,0.4383,0.4602,0.918
"5778",174914,"UNIVERSITY OF ST THOMAS",1,0,1992,"11204","106.792045","295","727","798",444,354,362,"141",221,0.4977,0.3983,0.4536,0.911
"5779",174914,"UNIVERSITY OF ST THOMAS",1,0,1993,"11748","111.392236","310","737","827",439,388,382,"155",227,0.5171,0.3995,0.4619,0.8912
"5780",174914,"UNIVERSITY OF ST THOMAS",1,0,1995,"13106","119.172391","298","769","852",454,398,430,"181",249,0.5485,0.4548,0.5047,0.9026
"5781",174914,"UNIVERSITY OF ST THOMAS",1,0,1996,"13778","126.734591","299","919","991",540,451,519,"204",315,0.5833,0.4523,0.5237,0.9273
"5782",174914,"UNIVERSITY OF ST THOMAS",1,0,1997,"14660","121.340728","317","869","955",514,441,595,"237",358,0.6965,0.5374,0.623,0.9099
"5783",174914,"UNIVERSITY OF ST THOMAS",1,0,1998,"15396","129.761217","321","942","1038",579,459,561,"230",331,0.5717,0.5011,0.5405,0.9075
"5784",174914,"UNIVERSITY OF ST THOMAS",1,0,1999,"16128","142.175307","338","993","1087",603,484,642,"255",387,0.6418,0.5269,0.5906,0.9135
"5785",174914,"UNIVERSITY OF ST THOMAS",1,0,2000,"17088","152.02921","357","971","1082",578,504,597,"244",353,0.6107,0.4841,0.5518,0.8974
"5786",174914,"UNIVERSITY OF ST THOMAS",1,0,2001,"18096","167.046458","376","943","1080",579,501,601,"253",348,0.601,0.505,0.5565,0.8731
"5787",174914,"UNIVERSITY OF ST THOMAS",1,0,2002,"19120","158.485882","387","992","1095",577,518,629,"280",349,0.6049,0.5405,0.5744,0.9059
"5788",174914,"UNIVERSITY OF ST THOMAS",1,0,2003,"20240","165.7374","387","952","1038",547,491,584,"244",340,0.6216,0.4969,0.5626,0.9171
"5789",174914,"UNIVERSITY OF ST THOMAS",1,0,2004,"21440","172.830393","395","970","1161",608,553,710,"312",398,0.6546,0.5642,0.6115,0.8355
"5790",174914,"University of St Thomas",1,0,2005,"22880","174.737021","384","1115","1325",706,619,812,"342",470,0.6657,0.5525,0.6128,0.8415
"5791",174914,"University of St Thomas",1,0,2006,"24368","183.004925","395","1129","1298",644,654,816,"392",424,0.6584,0.5994,0.6287,0.8698
"5792",174914,"University of St Thomas",1,0,2007,"25808","195.164593","394","1111","1313",672,641,822,"365",457,0.6801,0.5694,0.626,0.8462
"5793",174914,"University of St Thomas",1,0,2008,"27328","205.464084","410","1088","1321",638,683,792,"374",418,0.6552,0.5476,0.5995,0.8236
"5794",174914,"University of St Thomas",1,0,2009,"28944","218.086535","420","1106","1350",586,764,812,"439",373,0.6365,0.5746,0.6015,0.8193
"5795",174914,"University of St Thomas",1,0,2010,"29952","215.678653","433","1329","1518",762,756,941,"396",545,0.7152,0.5238,0.6199,0.8755
"5796",175342,"ALCORN STATE UNIVERSITY",1,0,1991,"2068","32.344724","160","16","899",520,379,108,"25",83,0.1596,0.066,0.1201,0.0178
"5797",175342,"ALCORN STATE UNIVERSITY",1,0,1992,"2376","32.608622","158","19","531",310,221,73,"16",57,0.1839,0.0724,0.1375,0.0358
"5798",175342,"ALCORN STATE UNIVERSITY",1,0,1993,"2376","36.265906","168","9","506",299,207,100,"24",76,0.2542,0.1159,0.1976,0.0178
"5799",175342,"ALCORN STATE UNIVERSITY",1,0,1995,"2389","40.229105","159","3","746",410,336,148,"38",110,0.2683,0.1131,0.1984,0.004
"5800",175342,"ALCORN STATE UNIVERSITY",1,0,1996,"2389","44.291552","162","4","621",384,237,175,"44",131,0.3411,0.1857,0.2818,0.0064
"5801",175342,"ALCORN STATE UNIVERSITY",1,0,1997,"2429","47.91417","159","7","532",299,233,138,"42",96,0.3211,0.1803,0.2594,0.0132
"5802",175342,"ALCORN STATE UNIVERSITY",1,0,1998,"2685","47.827648","172","3","556",306,250,140,"41",99,0.3235,0.164,0.2518,0.0054
"5803",175342,"ALCORN STATE UNIVERSITY",1,0,1999,"2685","52.717787","176","1","553",309,244,130,"41",89,0.288,0.168,0.2351,0.0018
"5804",175342,"ALCORN STATE UNIVERSITY",1,0,2000,"2585","63.164319","171.5","5","489",248,241,107,"28",79,0.3185,0.1162,0.2188,0.0102
"5805",175342,"ALCORN STATE UNIVERSITY",1,0,2001,"2294","61.126052","167","6","495",262,233,97,"36",61,0.2328,0.1545,0.196,0.0121
"5806",175342,"ALCORN STATE UNIVERSITY",1,0,2002,"2478","55.797976","171","8","423",249,174,86,"23",63,0.253,0.1322,0.2033,0.0189
"5807",175342,"ALCORN STATE UNIVERSITY",1,0,2003,"2478","60.418816","187","8","495",271,224,108,"32",76,0.2804,0.1429,0.2182,0.0162
"5808",175342,"ALCORN STATE UNIVERSITY",1,0,2004,"2999","60.926868","174","21","572",309,263,116,"33",83,0.2686,0.1255,0.2028,0.0367
"5809",175342,"Alcorn State University",1,0,2005,"2733","63.067523","186","17","526",274,252,100,"44",56,0.2044,0.1746,0.1901,0.0323
"5810",175342,"Alcorn State University",1,0,2006,"3300","64.746957","175","7","545",302,243,79,"34",45,0.149,0.1399,0.145,0.0128
"5811",175342,"Alcorn State University",1,0,2007,"3432","72.316166","172","3","514",305,209,94,"27",67,0.2197,0.1292,0.1829,0.0058
"5812",175342,"Alcorn State University",1,0,2008,"3571","79.277734","175","7","451",261,190,87,"36",51,0.1954,0.1895,0.1929,0.0155
"5813",175342,"Alcorn State University",1,0,2009,"3571","77.345135","183","12","463",277,186,77,"20",57,0.2058,0.1075,0.1663,0.0259
"5814",175342,"Alcorn State University",1,0,2010,"3931","80.838201","176","2","588",341,247,94,"25",69,0.2023,0.1012,0.1599,0.0034
"5815",175421,"BELHAVEN COLLEGE",1,0,1991,"5850","6.821353","28","29","43",27,16,5,"2",3,0.1111,0.125,0.1163,0.6744
"5816",175421,"BELHAVEN COLLEGE",1,0,1992,"6300","7.723106","30","70","89",52,37,22,"10",12,0.2308,0.2703,0.2472,0.7865
"5817",175421,"BELHAVEN COLLEGE",1,0,1993,"6980","8.856718","34","88","113",59,54,37,"16",21,0.3559,0.2963,0.3274,0.7788
"5818",175421,"BELHAVEN COLLEGE",1,0,1995,"7890","11.583651","36","90","112",67,45,39,"13",26,0.3881,0.2889,0.3482,0.8036
"5819",175421,"BELHAVEN COLLEGE",1,0,1996,"8390","11.50415","36","62","84",42,42,21,"11",10,0.2381,0.2619,0.25,0.7381
"5820",175421,"BELHAVEN COLLEGE",1,0,1997,"8990","10.899385","38","71","86",42,44,28,"11",17,0.4048,0.25,0.3256,0.8256
"5821",175421,"BELHAVEN COLLEGE",1,0,1998,"9870","11.940483","42","90","112",53,59,35,"12",23,0.434,0.2034,0.3125,0.8036
"5822",175421,"BELHAVEN COLLEGE",1,0,1999,"9960","11.263682","46","101","144",71,73,46,"25",21,0.2958,0.3425,0.3194,0.7014
"5823",175421,"BELHAVEN COLLEGE",1,0,2000,"10450","17.068076","47","137","182",95,87,50,"19",31,0.3263,0.2184,0.2747,0.7527
"5824",175421,"BELHAVEN COLLEGE",1,0,2001,"10990","19.105713","48","160","224",122,102,50,"22",28,0.2295,0.2157,0.2232,0.7143
"5825",175421,"BELHAVEN COLLEGE",1,0,2002,"11580","20.283821","51","187","266",150,116,68,"19",49,0.3267,0.1638,0.2556,0.703
"5826",175421,"BELHAVEN COLLEGE",1,0,2003,"12200","26.766951","56","127","170",96,74,53,"15",38,0.3958,0.2027,0.3118,0.7471
"5827",175421,"BELHAVEN COLLEGE",1,0,2004,"12800","24.642142","57","164","237",144,93,94,"28",66,0.4583,0.3011,0.3966,0.692
"5828",175421,"Belhaven College",1,0,2005,"13450","28.270905","56","155","201",105,96,68,"16",52,0.4952,0.1667,0.3383,0.7711
"5829",175421,"Belhaven College",1,0,2006,"14124","31.071503","69","166","248",133,115,76,"31",45,0.3383,0.2696,0.3065,0.6694
"5830",175421,"Belhaven College",1,0,2007,"15580","33.238874","68","146","241",134,107,60,"15",45,0.3358,0.1402,0.249,0.6058
"5831",175421,"Belhaven College",1,0,2008,"16360","35.950017","68","141","239",146,93,79,"27",52,0.3562,0.2903,0.3305,0.59
"5832",175421,"Belhaven University",1,0,2009,"16780","37.932467","68","123","208",116,92,67,"18",49,0.4224,0.1957,0.3221,0.5913
"5833",175421,"Belhaven University",1,0,2010,"17700","41.232928","69","117","234",126,108,65,"17",48,0.381,0.1574,0.2778,0.5
"5834",175616,"DELTA STATE UNIVERSITY",1,0,1991,"2000","28.315348","176","341","445",283,162,111,"33",78,0.2756,0.2037,0.2494,0.7663
"5835",175616,"DELTA STATE UNIVERSITY",1,0,1992,"2194","29.933286","172","345","443",247,196,98,"35",63,0.2551,0.1786,0.2212,0.7788
"5836",175616,"DELTA STATE UNIVERSITY",1,0,1993,"2194","30.660298","175","360","450",255,195,81,"28",53,0.2078,0.1436,0.18,0.8
"5837",175616,"DELTA STATE UNIVERSITY",1,0,1995,"2294","37.937062","185","333","464",301,163,102,"25",77,0.2558,0.1534,0.2198,0.7177
"5838",175616,"DELTA STATE UNIVERSITY",1,0,1996,"2294","38.458842","191","306","449",278,171,94,"27",67,0.241,0.1579,0.2094,0.6815
"5839",175616,"DELTA STATE UNIVERSITY",1,0,1997,"2354","39.444299","187","368","521",338,183,136,"40",96,0.284,0.2186,0.261,0.7063
"5840",175616,"DELTA STATE UNIVERSITY",1,0,1998,"2596","42.961917","184","298","427",265,162,100,"23",77,0.2906,0.142,0.2342,0.6979
"5841",175616,"DELTA STATE UNIVERSITY",1,0,1999,"2054","46.139328","191","334","458",275,183,107,"38",69,0.2509,0.2077,0.2336,0.7293
"5842",175616,"DELTA STATE UNIVERSITY",1,0,2000,"2145","49.007237","187.5","331","461",273,188,111,"24",87,0.3187,0.1277,0.2408,0.718
"5843",175616,"DELTA STATE UNIVERSITY",1,0,2001,"2549","49.461289","184","308","430",253,177,77,"21",56,0.2213,0.1186,0.1791,0.7163
"5844",175616,"DELTA STATE UNIVERSITY",1,0,2002,"2924","50.591007","166","236","336",200,136,58,"13",45,0.225,0.0956,0.1726,0.7024
"5845",175616,"DELTA STATE UNIVERSITY",1,0,2003,"2924","56.527401","146","198","327",191,136,55,"19",36,0.1885,0.1397,0.1682,0.6055
"5846",175616,"DELTA STATE UNIVERSITY",1,0,2004,"3092","65.012765","167","258","381",211,170,76,"24",52,0.2464,0.1412,0.1995,0.6772
"5847",175616,"Delta State University",1,0,2005,"3272","67.265216","165","236","393",222,171,67,"25",42,0.1892,0.1462,0.1705,0.6005
"5848",175616,"Delta State University",1,0,2006,"3518","64.708655","163","294","468",288,180,85,"33",52,0.1806,0.1833,0.1816,0.6282
"5849",175616,"Delta State University",1,0,2007,"3708","60.450363","179","268","477",293,184,78,"27",51,0.1741,0.1467,0.1635,0.5618
"5850",175616,"Delta State University",1,0,2008,"3946","63.111379","192","221","384",227,157,58,"19",39,0.1718,0.121,0.151,0.5755
"5851",175616,"Delta State University",1,0,2009,"3946","61.203253","193","189","367",230,137,62,"22",40,0.1739,0.1606,0.1689,0.515
"5852",175616,"Delta State University",1,0,2010,"4347","65.947181","186","219","370",208,162,61,"25",36,0.1731,0.1543,0.1649,0.5919
"5853",175856,"JACKSON STATE UNIVERSITY",1,0,1991,"2028","65.635869","302","2","1081",615,466,113,"34",79,0.1285,0.073,0.1045,0.0019
"5854",175856,"JACKSON STATE UNIVERSITY",1,0,1992,"2230","65.707997","314","4","906",477,429,89,"21",68,0.1426,0.049,0.0982,0.0044
"5855",175856,"JACKSON STATE UNIVERSITY",1,0,1993,"2230","67.473915","328","3","1105",596,509,124,"35",89,0.1493,0.0688,0.1122,0.0027
"5856",175856,"JACKSON STATE UNIVERSITY",1,0,1995,"2380","80.10917","325","2","1212",679,533,162,"39",123,0.1811,0.0732,0.1337,0.0017
"5857",175856,"JACKSON STATE UNIVERSITY",1,0,1996,"2380","85.385559","307","2","906",508,398,140,"33",107,0.2106,0.0829,0.1545,0.0022
"5858",175856,"JACKSON STATE UNIVERSITY",1,0,1997,"2380","74.80498","315","5","808",463,345,124,"28",96,0.2073,0.0812,0.1535,0.0062
"5859",175856,"JACKSON STATE UNIVERSITY",1,0,1998,"2688","79.310972","318","0","842",494,348,155,"43",112,0.2267,0.1236,0.1841,0
"5860",175856,"JACKSON STATE UNIVERSITY",1,0,1999,"2688","84.797084","327","1","845",527,318,128,"34",94,0.1784,0.1069,0.1515,0.0012
"5861",175856,"JACKSON STATE UNIVERSITY",1,0,2000,"2788","114.550474","335","2","936",547,389,134,"40",94,0.1718,0.1028,0.1432,0.0021
"5862",175856,"JACKSON STATE UNIVERSITY",1,0,2001,"3206","125.766623","343","4","930",540,390,154,"35",119,0.2204,0.0897,0.1656,0.0043
"5863",175856,"JACKSON STATE UNIVERSITY",1,0,2002,"3462","135.582534","339","5","1014",581,433,206,"49",157,0.2702,0.1132,0.2032,0.0049
"5864",175856,"JACKSON STATE UNIVERSITY",1,0,2003,"3612","149.111637","356","2","883",470,413,141,"43",98,0.2085,0.1041,0.1597,0.0023
"5865",175856,"JACKSON STATE UNIVERSITY",1,0,2004,"3842","166.182151","360","5","995",587,408,200,"50",150,0.2555,0.1225,0.201,0.005
"5866",175856,"Jackson State University",1,0,2005,"3964","172.60313","367","18","1131",690,441,221,"64",157,0.2275,0.1451,0.1954,0.0159
"5867",175856,"Jackson State University",1,0,2006,"4224","172.239711","354","19","889",513,376,191,"57",134,0.2612,0.1516,0.2148,0.0214
"5868",175856,"Jackson State University",1,0,2007,"4432","180.268934","384","18","919",541,378,153,"41",112,0.207,0.1085,0.1665,0.0196
"5869",175856,"Jackson State University",1,0,2008,"4634","183.260873","344","15","938",547,391,177,"48",129,0.2358,0.1228,0.1887,0.016
"5870",175856,"Jackson State University",1,0,2009,"4634","182.170291","406","14","841",507,334,157,"47",110,0.217,0.1407,0.1867,0.0166
"5871",175856,"Jackson State University",1,0,2010,"5050","177.530816","380","33","879",489,390,169,"52",117,0.2393,0.1333,0.1923,0.0375
"5872",175980,"MILLSAPS COLLEGE",1,0,1991,"9710","20.185577","83","256","273",140,133,170,"73",97,0.6929,0.5489,0.6227,0.9377
"5873",175980,"MILLSAPS COLLEGE",1,0,1992,"10280","20.910779","83","252","274",143,131,167,"75",92,0.6434,0.5725,0.6095,0.9197
"5874",175980,"MILLSAPS COLLEGE",1,0,1993,"11236","43.836456","85","304","319",161,158,189,"95",94,0.5839,0.6013,0.5925,0.953
"5875",175980,"MILLSAPS COLLEGE",1,0,1995,"12700","25.7173","89","237","261",128,133,180,"74",106,0.8281,0.5564,0.6897,0.908
"5876",175980,"MILLSAPS COLLEGE",1,0,1996,"13088","28.403654","91","262","292",163,129,166,"64",102,0.6258,0.4961,0.5685,0.8973
"5877",175980,"MILLSAPS COLLEGE",1,0,1997,"13612","23.812546","92","263","299",159,140,188,"84",104,0.6541,0.6,0.6288,0.8796
"5878",175980,"MILLSAPS COLLEGE",1,0,1998,"14424","24.295901","89","243","286",145,141,169,"79",90,0.6207,0.5603,0.5909,0.8497
"5879",175980,"MILLSAPS COLLEGE",1,0,1999,"14190","25.428521","89","244","284",158,126,177,"67",110,0.6962,0.5317,0.6232,0.8592
"5880",175980,"MILLSAPS COLLEGE",1,0,2000,"14900","28.042942","91","246","292",152,140,176,"82",94,0.6184,0.5857,0.6027,0.8425
"5881",175980,"MILLSAPS COLLEGE",1,0,2001,"15586","29.512767","93","273","324",178,146,208,"80",128,0.7191,0.5479,0.642,0.8426
"5882",175980,"MILLSAPS COLLEGE",1,0,2002,"16364","28.747081","93","204","251",125,126,159,"75",84,0.672,0.5952,0.6335,0.8127
"5883",175980,"MILLSAPS COLLEGE",1,0,2003,"17346","29.206057","93","218","259",141,118,152,"63",89,0.6312,0.5339,0.5869,0.8417
"5884",175980,"MILLSAPS COLLEGE",1,0,2004,"18386","29.394042","93","219","278",136,142,170,"83",87,0.6397,0.5845,0.6115,0.7878
"5885",175980,"Millsaps College",1,0,2005,"19490","30.709333","92","208","258",118,140,158,"76",82,0.6949,0.5429,0.6124,0.8062
"5886",175980,"Millsaps College",1,0,2006,"20660","31.936936","92","183","225",122,103,149,"63",86,0.7049,0.6117,0.6622,0.8133
"5887",175980,"Millsaps College",1,0,2007,"21900","32.784091","90","247","296",154,142,175,"75",100,0.6494,0.5282,0.5912,0.8345
"5888",175980,"Millsaps College",1,0,2008,"23214","35.689686","99","188","266",141,125,165,"66",99,0.7021,0.528,0.6203,0.7068
"5889",175980,"Millsaps College",1,0,2009,"24608","40.420429","95","205","281",116,165,166,"80",86,0.7414,0.4848,0.5907,0.7295
"5890",175980,"Millsaps College",1,0,2010,"26084","36.533571","101","149","211",106,105,145,"69",76,0.717,0.6571,0.6872,0.7062
"5891",176017,"UNIVERSITY OF MISSISSIPPI MAIN CAMPUS",1,0,1991,"2221","124.213934","430","1537","1690",892,798,484,"169",315,0.3531,0.2118,0.2864,0.9095
"5892",176017,"UNIVERSITY OF MISSISSIPPI MAIN CAMPUS",1,0,1992,"2435","125.451542","424","1448","1610",810,800,460,"175",285,0.3519,0.2188,0.2857,0.8994
"5893",176017,"UNIVERSITY OF MISSISSIPPI MAIN CAMPUS",1,0,1993,"2456","137.846296","439","1386","1538",796,742,461,"156",305,0.3832,0.2102,0.2997,0.9012
"5894",176017,"UNIVERSITY OF MISSISSIPPI MAIN CAMPUS",1,0,1995,"2546","160.830035","440","1363","1526",825,701,490,"180",310,0.3758,0.2568,0.3211,0.8932
"5895",176017,"UNIVERSITY OF MISSISSIPPI MAIN CAMPUS",1,0,1996,"2631","164.935919","474","1512","1736",909,827,580,"199",381,0.4191,0.2406,0.3341,0.871
"5896",176017,"UNIVERSITY OF MISSISSIPPI MAIN CAMPUS",1,0,1997,"2731","166.779311","456","1526","1770",948,822,578,"209",369,0.3892,0.2543,0.3266,0.8621
"5897",176017,"UNIVERSITY OF MISSISSIPPI MAIN CAMPUS",1,0,1998,"3053","172.368204","464","1577","1794",920,874,602,"213",389,0.4228,0.2437,0.3356,0.879
"5898",176017,"UNIVERSITY OF MISSISSIPPI MAIN CAMPUS",1,0,1999,"3053","192.764788","485","1537","1810",944,866,621,"218",403,0.4269,0.2517,0.3431,0.8492
"5899",176017,"UNIVERSITY OF MISSISSIPPI MAIN CAMPUS",1,0,2000,"3153","218.664205","498.5","1693","1981",1019,962,655,"248",407,0.3994,0.2578,0.3306,0.8546
"5900",176017,"UNIVERSITY OF MISSISSIPPI MAIN CAMPUS",1,0,2001,"3626","245.879051","512","1788","2126",1110,1016,402,"215",187,0.1685,0.2116,0.1891,0.841
"5901",176017,"UNIVERSITY OF MISSISSIPPI MAIN CAMPUS",1,0,2002,"3916","256.450111","575","1871","2230",1150,1080,724,"271",453,0.3939,0.2509,0.3247,0.839
"5902",176017,"UNIVERSITY OF MISSISSIPPI MAIN CAMPUS",1,0,2003,"3916","266.725135","587","1991","2377",1297,1080,851,"286",565,0.4356,0.2648,0.358,0.8376
"5903",176017,"UNIVERSITY OF MISSISSIPPI MAIN CAMPUS",1,0,2004,"4110","265.975736","591","1906","2248",1185,1063,761,"292",469,0.3958,0.2747,0.3385,0.8479
"5904",176017,"University of Mississippi Main Campus",1,0,2005,"4320","280.357681","622","1823","2131",1139,992,800,"280",520,0.4565,0.2823,0.3754,0.8555
"5905",176017,"University of Mississippi Main Campus",1,0,2006,"4602","303.00989","647","2061","2521",1320,1201,920,"352",568,0.4303,0.2931,0.3649,0.8175
"5906",176017,"University of Mississippi Main Campus",1,0,2007,"4932","327.579428","653","2002","2434",1293,1141,885,"328",557,0.4308,0.2875,0.3636,0.8225
"5907",176017,"University of Mississippi Main Campus",1,0,2008,"5106","350.271204","702","1846","2316",1272,1044,857,"301",556,0.4371,0.2883,0.37,0.7971
"5908",176017,"University of Mississippi Main Campus",1,0,2009,"5106","358.86996","711","2012","2547",1358,1189,996,"360",636,0.4683,0.3028,0.391,0.7899
"5909",176017,"University of Mississippi Main Campus",1,0,2010,"5436","369.532048","723","2321","3065",1580,1485,1135,"440",695,0.4399,0.2963,0.3703,0.7573
"5910",176035,"MISSISSIPPI UNIVERSITY FOR WOMEN",1,0,1991,"2043","19.567777","104","273","339",282,57,99,"10",89,0.3156,0.1754,0.292,0.8053
"5911",176035,"MISSISSIPPI UNIVERSITY FOR WOMEN",1,0,1992,"2239","21.161789","110","197","259",210,49,52,"6",46,0.219,0.1224,0.2008,0.7606
"5912",176035,"MISSISSIPPI UNIVERSITY FOR WOMEN",1,0,1993,"2239","22.807919","112","190","272",229,43,68,"5",63,0.2751,0.1163,0.25,0.6985
"5913",176035,"MISSISSIPPI UNIVERSITY FOR WOMEN",1,0,1995,"2244","27.642756","122","205","288",238,50,59,"7",52,0.2185,0.14,0.2049,0.7118
"5914",176035,"MISSISSIPPI UNIVERSITY FOR WOMEN",1,0,1996,"2284","29.274869","118","214","291",248,43,58,"2",56,0.2258,0.0465,0.1993,0.7354
"5915",176035,"MISSISSIPPI UNIVERSITY FOR WOMEN",1,0,1997,"2284","30.807207","129","171","231",193,38,71,"6",65,0.3368,0.1579,0.3074,0.7403
"5916",176035,"MISSISSIPPI UNIVERSITY FOR WOMEN",1,0,1998,"2556","33.003905","129","150","210",180,30,47,"4",43,0.2389,0.1333,0.2238,0.7143
"5917",176035,"MISSISSIPPI UNIVERSITY FOR WOMEN",1,0,1999,"2556","34.682022","132","128","202",177,25,59,"3",56,0.3164,0.12,0.2921,0.6337
"5918",176035,"MISSISSIPPI UNIVERSITY FOR WOMEN",1,0,2000,"2656","36.762493","133","132","205",190,15,57,"0",57,0.3,0,0.278,0.6439
"5919",176035,"MISSISSIPPI UNIVERSITY FOR WOMEN",1,0,2001,"3054","35.441124","134","129","189",163,26,44,"3",41,0.2515,0.1154,0.2328,0.6825
"5920",176035,"MISSISSIPPI UNIVERSITY FOR WOMEN",1,0,2002,"3298","35.037231","129","162","250",223,27,61,"2",59,0.2646,0.0741,0.244,0.648
"5921",176035,"MISSISSIPPI UNIVERSITY FOR WOMEN",1,0,2003,"3298","52.332047","134","136","202",178,24,48,"3",45,0.2528,0.125,0.2376,0.6733
"5922",176035,"MISSISSIPPI UNIVERSITY FOR WOMEN",1,0,2004,"3495","46.298044","135","161","242",207,35,55,"1",54,0.2609,0.0286,0.2273,0.6653
"5923",176035,"Mississippi University for Women",1,0,2005,"3690","47.138485","135","147","238",204,34,53,"5",48,0.2353,0.1471,0.2227,0.6176
"5924",176035,"Mississippi University for Women",1,0,2006,"3933","39.777932","131","145","256",243,13,53,"3",50,0.2058,0.2308,0.207,0.5664
"5925",176035,"Mississippi University for Women",1,0,2007,"4209","41.019856","135","123","235",213,22,46,"6",40,0.1878,0.2727,0.1957,0.5234
"5926",176035,"Mississippi University for Women",1,0,2008,"4423","42.111697","135","121","252",212,40,54,"7",47,0.2217,0.175,0.2143,0.4802
"5927",176035,"Mississippi University for Women",1,0,2009,"4423","42.186628","134","103","216",177,39,56,"10",46,0.2599,0.2564,0.2593,0.4769
"5928",176035,"Mississippi University for Women",1,0,2010,"4644","42.277972","130","105","199",154,45,50,"7",43,0.2792,0.1556,0.2513,0.5276
"5929",176044,"MISSISSIPPI VALLEY STATE UNIVERSITY",1,0,1991,"1952","21.924855","98","0","386",223,163,34,"7",27,0.1211,0.0429,0.0881,0
"5930",176044,"MISSISSIPPI VALLEY STATE UNIVERSITY",1,0,1992,"2164","23.277246","95","6","563",290,273,64,"26",38,0.131,0.0952,0.1137,0.0107
"5931",176044,"MISSISSIPPI VALLEY STATE UNIVERSITY",1,0,1993,"2164","24.453843","106","1","478",256,222,57,"19",38,0.1484,0.0856,0.1192,0.0021
"5932",176044,"MISSISSIPPI VALLEY STATE UNIVERSITY",1,0,1995,"2278","29.759189","111","2","448",244,204,87,"23",64,0.2623,0.1127,0.1942,0.0045
"5933",176044,"MISSISSIPPI VALLEY STATE UNIVERSITY",1,0,1996,"2278","29.359757","118","2","367",170,197,59,"26",33,0.1941,0.132,0.1608,0.0054
"5934",176044,"MISSISSIPPI VALLEY STATE UNIVERSITY",1,0,1997,"2353","32.128355","118","2","343",198,145,73,"23",50,0.2525,0.1586,0.2128,0.0058
"5935",176044,"MISSISSIPPI VALLEY STATE UNIVERSITY",1,0,1998,"2646","33.764934","110","4","321",182,139,68,"16",52,0.2857,0.1151,0.2118,0.0125
"5936",176044,"MISSISSIPPI VALLEY STATE UNIVERSITY",1,0,1999,"2646","37.6253","107","1","248",138,110,48,"18",30,0.2174,0.1636,0.1935,0.004
"5937",176044,"MISSISSIPPI VALLEY STATE UNIVERSITY",1,0,2000,"2746","39.142015","112","3","297",173,124,41,"13",28,0.1618,0.1048,0.138,0.0101
"5938",176044,"MISSISSIPPI VALLEY STATE UNIVERSITY",1,0,2001,"3158","42.872384","117","3","258",158,100,42,"9",33,0.2089,0.09,0.1628,0.0116
"5939",176044,"MISSISSIPPI VALLEY STATE UNIVERSITY",1,0,2002,"3411","53.211569","105","9","269",129,140,37,"14",23,0.1783,0.1,0.1375,0.0335
"5940",176044,"MISSISSIPPI VALLEY STATE UNIVERSITY",1,0,2003,"3411","50.900892","110","13","325",187,138,57,"16",41,0.2193,0.1159,0.1754,0.04
"5941",176044,"MISSISSIPPI VALLEY STATE UNIVERSITY",1,0,2004,"3832","54.195516","115","8","372",184,188,51,"15",36,0.1957,0.0798,0.1371,0.0215
"5942",176044,"Mississippi Valley State University",1,0,2005,"4024","66.343744","117","18","398",197,201,43,"13",30,0.1523,0.0647,0.108,0.0452
"5943",176044,"Mississippi Valley State University",1,0,2006,"4247","69.201947","121","25","443",216,227,55,"14",41,0.1898,0.0617,0.1242,0.0564
"5944",176044,"Mississippi Valley State University",1,0,2007,"4417","69.185027","136","15","485",256,229,51,"15",36,0.1406,0.0655,0.1052,0.0309
"5945",176044,"Mississippi Valley State University",1,0,2008,"4574","71.966142","138","15","446",203,243,57,"23",34,0.1675,0.0947,0.1278,0.0336
"5946",176044,"Mississippi Valley State University",1,0,2009,"4754","75.887539","133","18","413",222,191,43,"13",30,0.1351,0.0681,0.1041,0.0436
"5947",176044,"Mississippi Valley State University",1,0,2010,"4781","64.507937","126","12","382",192,190,68,"25",43,0.224,0.1316,0.178,0.0314
"5948",176080,"MISSISSIPPI STATE UNIVERSITY",1,0,1991,"2223","227.143668","761","1291","1569",715,854,320,"134",186,0.2601,0.1569,0.204,0.8228
"5949",176080,"MISSISSIPPI STATE UNIVERSITY",1,0,1992,"2474","228.007504","666","1338","1672",760,912,316,"130",186,0.2447,0.1425,0.189,0.8002
"5950",176080,"MISSISSIPPI STATE UNIVERSITY",1,0,1993,"2474","239.631266","669","1286","1633",777,856,330,"118",212,0.2728,0.1379,0.2021,0.7875
"5951",176080,"MISSISSIPPI STATE UNIVERSITY",1,0,1995,"2591","286.100399","779","1430","1826",845,981,382,"158",224,0.2651,0.1611,0.2092,0.7831
"5952",176080,"MISSISSIPPI STATE UNIVERSITY",1,0,1996,"2631","294.606909","828","1506","1864",869,995,463,"175",288,0.3314,0.1759,0.2484,0.8079
"5953",176080,"MISSISSIPPI STATE UNIVERSITY",1,0,1997,"2731","305.094967","822","1578","2016",965,1051,462,"162",300,0.3109,0.1541,0.2292,0.7827
"5954",176080,"MISSISSIPPI STATE UNIVERSITY",1,0,1998,"3017","330.742031","851","1450","1929",944,985,501,"178",323,0.3422,0.1807,0.2597,0.7517
"5955",176080,"MISSISSIPPI STATE UNIVERSITY",1,0,1999,"3017","371.044103","892","1511","2033",1003,1030,507,"177",330,0.329,0.1718,0.2494,0.7432
"5956",176080,"MISSISSIPPI STATE UNIVERSITY",1,0,2000,"3117","401.464503","887.5","1540","2055",1057,998,556,"204",352,0.333,0.2044,0.2706,0.7494
"5957",176080,"MISSISSIPPI STATE UNIVERSITY",1,0,2001,"3586","419.155207","883","1444","1826",909,917,483,"201",282,0.3102,0.2192,0.2645,0.7908
"5958",176080,"MISSISSIPPI STATE UNIVERSITY",1,0,2002,"3874","420.38698","1011","1373","1737",833,904,476,"181",295,0.3541,0.2002,0.274,0.7904
"5959",176080,"MISSISSIPPI STATE UNIVERSITY",1,0,2003,"3874","427.376219","1043","1303","1659",822,837,509,"185",324,0.3942,0.221,0.3068,0.7854
"5960",176080,"MISSISSIPPI STATE UNIVERSITY",1,0,2004,"4106","443.665291","1044","1291","1735",829,906,492,"193",299,0.3607,0.213,0.2836,0.7441
"5961",176080,"Mississippi State University",1,0,2005,"4312","466.374203","819","1408","1951",1010,941,585,"215",370,0.3663,0.2285,0.2998,0.7217
"5962",176080,"Mississippi State University",1,0,2006,"4596","483.177559","826","1396","1897",947,950,575,"233",342,0.3611,0.2453,0.3031,0.7359
"5963",176080,"Mississippi State University",1,0,2007,"4978","534.084801","824","1662","2262",1105,1157,699,"274",425,0.3846,0.2368,0.309,0.7347
"5964",176080,"Mississippi State University",1,0,2008,"5151","567.049288","854","1811","2474",1278,1196,746,"282",464,0.3631,0.2358,0.3015,0.732
"5965",176080,"Mississippi State University",1,0,2009,"5151","582.747476","897","1778","2447",1210,1237,755,"282",473,0.3909,0.228,0.3085,0.7266
"5966",176080,"Mississippi State University",1,0,2010,"5461","591.408843","850","1857","2688",1308,1380,847,"348",499,0.3815,0.2522,0.3151,0.6908
"5967",176406,"TOUGALOO COLLEGE",1,0,1991,"4395","10.644152","64","0","317",205,112,61,"16",45,0.2195,0.1429,0.1924,0
"5968",176406,"TOUGALOO COLLEGE",1,0,1992,"4835","12.487696","53","0","325",215,110,69,"15",54,0.2512,0.1364,0.2123,0
"5969",176406,"TOUGALOO COLLEGE",1,0,1993,"4795","13.750635","66","0","311",223,88,79,"17",62,0.278,0.1932,0.254,0
"5970",176406,"TOUGALOO COLLEGE",1,0,1995,"5440","15.680808","64","0","218",141,77,65,"19",46,0.3262,0.2468,0.2982,0
"5971",176406,"TOUGALOO COLLEGE",1,0,1996,"5712","15.332647","68","0","211",144,67,68,"11",57,0.3958,0.1642,0.3223,0
"5972",176406,"TOUGALOO COLLEGE",1,0,1997,"6160","14.150432","67","0","206",146,60,66,"11",55,0.3767,0.1833,0.3204,0
"5973",176406,"TOUGALOO COLLEGE",1,0,1998,"6610","14.510749","59","0","198",142,56,66,"12",54,0.3803,0.2143,0.3333,0
"5974",176406,"TOUGALOO COLLEGE",1,0,1999,"6400","15.624381","58","0","252",196,56,73,"11",62,0.3163,0.1964,0.2897,0
"5975",176406,"TOUGALOO COLLEGE",1,0,2000,"6600","17.030791","61","0","224",168,56,66,"15",51,0.3036,0.2679,0.2946,0
"5976",176406,"TOUGALOO COLLEGE",1,0,2001,"6900","19.435873","64","0","201",137,64,58,"13",45,0.3285,0.2031,0.2886,0
"5977",176406,"TOUGALOO COLLEGE",1,0,2002,"7245","22.670265","63","0","209",149,60,55,"12",43,0.2886,0.2,0.2632,0
"5978",176406,"TOUGALOO COLLEGE",1,0,2003,"7750","23.655489","64","1","221",166,55,53,"9",44,0.2651,0.1636,0.2398,0.0045
"5979",176406,"TOUGALOO COLLEGE",1,0,2004,"8140","24.744207","71","0","278",190,88,68,"16",52,0.2737,0.1818,0.2446,0
"5980",176406,"Tougaloo College",1,0,2005,"8800","24.922215","80","0","207",146,61,61,"15",46,0.3151,0.2459,0.2947,0
"5981",176406,"Tougaloo College",1,0,2006,"8800","30.715743","74","1","243",172,71,74,"15",59,0.343,0.2113,0.3045,0.0041
"5982",176406,"Tougaloo College",1,0,2007,"9240","27.308935","74","0","200",135,65,53,"9",44,0.3259,0.1385,0.265,0
"5983",176406,"Tougaloo College",1,0,2008,"9240","22.039203","76","1","237",158,79,68,"19",49,0.3101,0.2405,0.2869,0.0042
"5984",176406,"Tougaloo College",1,0,2009,"9240","24.604868","76","4","231",154,77,57,"12",45,0.2922,0.1558,0.2468,0.0173
"5985",176406,"Tougaloo College",1,0,2010,"9240","22.617005","76","4","198",126,72,50,"10",40,0.3175,0.1389,0.2525,0.0202
"5986",176628,"AVILA COLLEGE",1,0,1991,"7380","7.806649","59","73","88",53,35,27,"8",19,0.3585,0.2286,0.3068,0.8295
"5987",176628,"AVILA COLLEGE",1,0,1992,"7980","8.49764","50","83","91",50,41,21,"10",11,0.22,0.2439,0.2308,0.9121
"5988",176628,"AVILA COLLEGE",1,0,1993,"8490","9.252563","52","74","84",57,27,25,"3",22,0.386,0.1111,0.2976,0.881
"5989",176628,"AVILA COLLEGE",1,0,1995,"9600","10.770135","55","78","101",61,40,31,"11",20,0.3279,0.275,0.3069,0.7723
"5990",176628,"AVILA COLLEGE",1,0,1996,"10100","11.966248","55","83","91",56,35,20,"5",15,0.2679,0.1429,0.2198,0.9121
"5991",176628,"AVILA COLLEGE",1,0,1997,"10700","12.051153","54","68","96",57,39,29,"6",23,0.4035,0.1538,0.3021,0.7083
"5992",176628,"AVILA COLLEGE",1,0,1998,"11410","12.763725","54","95","113",64,49,39,"9",30,0.4688,0.1837,0.3451,0.8407
"5993",176628,"AVILA COLLEGE",1,0,1999,"11800","13.883114","56","91","113",81,32,45,"7",38,0.4691,0.2188,0.3982,0.8053
"5994",176628,"AVILA COLLEGE",1,0,2000,"12500","15.843829","57.5","127","162",91,71,36,"5",31,0.3407,0.0704,0.2222,0.784
"5995",176628,"AVILA COLLEGE",1,0,2001,"13150","16.783686","59","119","155",62,93,32,"7",25,0.4032,0.0753,0.2065,0.7677
"5996",176628,"AVILA UNIVERSITY",1,0,2002,"13900","18.820939","62","94","129",70,59,29,"5",24,0.3429,0.0847,0.2248,0.7287
"5997",176628,"AVILA UNIVERSITY",1,0,2003,"14700","16.596704","63","111","152",93,59,36,"5",31,0.3333,0.0847,0.2368,0.7303
"5998",176628,"AVILA UNIVERSITY",1,0,2004,"15500","17.772888","63","104","129",88,41,39,"3",36,0.4091,0.0732,0.3023,0.8062
"5999",176628,"Avila University",1,0,2005,"16300","18.251429","64","111","154",95,59,38,"11",27,0.2842,0.1864,0.2468,0.7208
"6000",176628,"Avila University",1,0,2006,"17300","19.239054","69","107","138",78,60,34,"11",23,0.2949,0.1833,0.2464,0.7754
"6001",176628,"Avila University",1,0,2007,"18300","19.985781","72","96","114",79,35,30,"5",25,0.3165,0.1429,0.2632,0.8421
"6002",176628,"Avila University",1,0,2008,"19500","21.15874","64","156","183",105,78,45,"9",36,0.3429,0.1154,0.2459,0.8525
"6003",176628,"Avila University",1,0,2009,"20250","22.954078","65","93","118",79,39,36,"9",27,0.3418,0.2308,0.3051,0.7881
"6004",176628,"Avila University",1,0,2010,"21050","22.889901","63","111","166",94,72,46,"11",35,0.3723,0.1528,0.2771,0.6687
"6005",176947,"CENTRAL METHODIST COLLEGE",1,0,1991,"6710","10.50416","60","210","240",109,131,52,"22",30,0.2752,0.1679,0.2167,0.875
"6006",176947,"CENTRAL METHODIST COLLEGE",1,0,1992,"7050","10.888047","53","178","209",79,130,42,"20",22,0.2785,0.1538,0.201,0.8517
"6007",176947,"CENTRAL METHODIST COLLEGE",1,0,1993,"7780","11.900811","56","207","238",108,130,62,"21",41,0.3796,0.1615,0.2605,0.8697
"6008",176947,"CENTRAL METHODIST COLLEGE",1,0,1995,"9160","13.235308","53","196","229",95,134,73,"36",37,0.3895,0.2687,0.3188,0.8559
"6009",176947,"CENTRAL METHODIST COLLEGE",1,0,1996,"9570","13.945466","55","189","212",82,130,48,"19",29,0.3537,0.1462,0.2264,0.8915
"6010",176947,"CENTRAL METHODIST COLLEGE",1,0,1997,"10220","10.332493","55","193","233",115,118,72,"25",47,0.4087,0.2119,0.309,0.8283
"6011",176947,"CENTRAL METHODIST COLLEGE",1,0,1998,"10620","11.134571","60","183","218",111,107,59,"19",40,0.3604,0.1776,0.2706,0.8394
"6012",176947,"CENTRAL METHODIST COLLEGE",1,0,1999,"10860","10.179421","60","205","228",108,120,62,"25",37,0.3426,0.2083,0.2719,0.8991
"6013",176947,"CENTRAL METHODIST COLLEGE",1,0,2000,"11390","12.416124","61.5","174","216",102,114,68,"17",51,0.5,0.1491,0.3148,0.8056
"6014",176947,"CENTRAL METHODIST COLLEGE",1,0,2001,"11950","13.578959","63","208","240",116,124,67,"23",44,0.3793,0.1855,0.2792,0.8667
"6015",176947,"CENTRAL METHODIST COLLEGE",1,0,2002,"12420","13.666994","53","196","232",100,132,61,"16",45,0.45,0.1212,0.2629,0.8448
"6016",176947,"CENTRAL METHODIST COLLEGE",1,0,2003,"13160","14.627296","52","183","223",93,130,64,"25",39,0.4194,0.1923,0.287,0.8206
"6017",176947,"CENTRAL METHODIST UNIV-COLL OF LIBERAL ARTS & SCIENCES",1,0,2004,"13800","14.152312","54","168","193",86,107,64,"21",43,0.5,0.1963,0.3316,0.8705
"6018",176947,"Central Methodist University-College of Liberal Arts & Sciences",1,0,2005,"14490","14.470584","51","198","223",96,127,73,"29",44,0.4583,0.2283,0.3274,0.8879
"6019",176947,"Central Methodist University-College of Liberal Arts & Sciences",1,0,2006,"15500","15.729449","57","190","207",111,96,81,"28",53,0.4775,0.2917,0.3913,0.9179
"6020",176947,"Central Methodist University-College of Liberal Arts & Sciences",1,0,2007,"16430","16.860972","55","228","270",123,147,69,"31",38,0.3089,0.2109,0.2556,0.8444
"6021",176947,"Central Methodist University-College of Liberal Arts & Sciences",1,0,2008,"17250","17.921025","59","254","300",141,159,110,"47",63,0.4468,0.2956,0.3667,0.8467
"6022",176947,"Central Methodist University-College of Liberal Arts & Sciences",1,0,2009,"17940","20.162093","59","221","260",129,131,106,"42",64,0.4961,0.3206,0.4077,0.85
"6023",176947,"Central Methodist University-College of Liberal Arts & Sciences",1,0,2010,"18660","21.446582","60","266","314",147,167,109,"33",76,0.517,0.1976,0.3471,0.8471
"6024",176965,"CENTRAL MISSOURI STATE UNIVERSITY",1,0,1991,"1860","91.332903","447","1691","1952",1038,914,273,"107",166,0.1599,0.1171,0.1399,0.8663
"6025",176965,"CENTRAL MISSOURI STATE UNIVERSITY",1,0,1992,"2040","92.277853","444","1564","1763",921,842,240,"105",135,0.1466,0.1247,0.1361,0.8871
"6026",176965,"CENTRAL MISSOURI STATE UNIVERSITY",1,0,1993,"2160","97.087651","454","1232","1433",757,676,213,"72",141,0.1863,0.1065,0.1486,0.8597
"6027",176965,"CENTRAL MISSOURI STATE UNIVERSITY",1,0,1995,"2460","99.180631","455","1259","1428",755,673,243,"79",164,0.2172,0.1174,0.1702,0.8817
"6028",176965,"CENTRAL MISSOURI STATE UNIVERSITY",1,0,1996,"2520","107.811935","433","1138","1252",655,597,221,"77",144,0.2198,0.129,0.1765,0.9089
"6029",176965,"CENTRAL MISSOURI STATE UNIVERSITY",1,0,1997,"2640","107.249098","432","1195","1323",718,605,298,"88",210,0.2925,0.1455,0.2252,0.9033
"6030",176965,"CENTRAL MISSOURI STATE UNIVERSITY",1,0,1998,"2730","117.273505","425","1250","1408",730,678,317,"107",210,0.2877,0.1578,0.2251,0.8878
"6031",176965,"CENTRAL MISSOURI STATE UNIVERSITY",1,0,1999,"2970","123.551092","446","1191","1329",725,604,300,"94",206,0.2841,0.1556,0.2257,0.8962
"6032",176965,"CENTRAL MISSOURI STATE UNIVERSITY",1,0,2000,"3210","126.653488","441.5","1274","1455",794,661,380,"146",234,0.2947,0.2209,0.2612,0.8756
"6033",176965,"CENTRAL MISSOURI STATE UNIVERSITY",1,0,2001,"3450","135.395398","437","1191","1437",789,648,275,"33",242,0.3067,0.0509,0.1914,0.8288
"6034",176965,"CENTRAL MISSOURI STATE UNIVERSITY",1,0,2002,"3240","127.522797","425","1041","1248",668,580,306,"106",200,0.2994,0.1828,0.2452,0.8341
"6035",176965,"CENTRAL MISSOURI STATE UNIVERSITY",1,0,2003,"3696","123.351662","428","1098","1355",737,618,323,"115",208,0.2822,0.1861,0.2384,0.8103
"6036",176965,"CENTRAL MISSOURI STATE UNIVERSITY",1,0,2004,"3936","127.349812","430","1232","1434",798,636,369,"120",249,0.312,0.1887,0.2573,0.8591
"6037",176965,"Central Missouri State University",1,0,2005,"4104","144.586582","448","1245","1484",810,674,410,"164",246,0.3037,0.2433,0.2763,0.8389
"6038",176965,"University of Central Missouri",1,0,2006,"5415","144.641174","457","1188","1505",871,634,416,"134",282,0.3238,0.2114,0.2764,0.7894
"6039",176965,"University of Central Missouri",1,0,2007,"4500","150.311208","453","1166","1426",786,640,428,"148",280,0.3562,0.2313,0.3001,0.8177
"6040",176965,"University of Central Missouri",1,0,2008,"4687","156.274442","456","1290","1583",854,729,463,"185",278,0.3255,0.2538,0.2925,0.8149
"6041",176965,"University of Central Missouri",1,0,2009,"5859","158.657083","460","1197","1478",822,656,452,"148",304,0.3698,0.2256,0.3058,0.8099
"6042",176965,"University of Central Missouri",1,0,2010,"5859","161.048459","459","1179","1546",862,684,496,"176",320,0.3712,0.2573,0.3208,0.7626
"6043",177418,"FONTBONNE COLLEGE",1,0,1991,"7390","6.909627","43","93","114",87,27,38,"9",29,0.3333,0.3333,0.3333,0.8158
"6044",177418,"FONTBONNE COLLEGE",1,0,1992,"7750","7.744583","44","118","144",110,34,56,"5",51,0.4636,0.1471,0.3889,0.8194
"6045",177418,"FONTBONNE COLLEGE",1,0,1993,"8140","9.533992","42","102","126",95,31,50,"7",43,0.4526,0.2258,0.3968,0.8095
"6046",177418,"FONTBONNE COLLEGE",1,0,1995,"8890","10.702188","40","120","143",110,33,51,"11",40,0.3636,0.3333,0.3566,0.8392
"6047",177418,"FONTBONNE COLLEGE",1,0,1996,"9660","11.508253","43","131","146",104,42,66,"13",53,0.5096,0.3095,0.4521,0.8973
"6048",177418,"FONTBONNE COLLEGE",1,0,1997,"10000","11.73589","45","143","171",124,47,50,"10",40,0.3226,0.2128,0.2924,0.8363
"6049",177418,"FONTBONNE COLLEGE",1,0,1998,"10810","12.756346","46","129","156",111,45,59,"11",48,0.4324,0.2444,0.3782,0.8269
"6050",177418,"FONTBONNE COLLEGE",1,0,1999,"11184","14.919941","48","115","144",94,50,60,"14",46,0.4894,0.28,0.4167,0.7986
"6051",177418,"FONTBONNE COLLEGE",1,0,2000,"11686","15.872982","53.5","129","164",124,40,57,"4",53,0.4274,0.1,0.3476,0.7866
"6052",177418,"FONTBONNE UNIVERSITY",1,0,2001,"12596","17.064389","59","129","153",111,42,50,"12",38,0.3423,0.2857,0.3268,0.8431
"6053",177418,"FONTBONNE UNIVERSITY",1,0,2002,"13414","21.707807","55","157","183",134,49,76,"16",60,0.4478,0.3265,0.4153,0.8579
"6054",177418,"FONTBONNE UNIVERSITY",1,0,2003,"14200","23.289494","59","152","194",143,51,61,"14",47,0.3287,0.2745,0.3144,0.7835
"6055",177418,"FONTBONNE UNIVERSITY",1,0,2004,"15100","24.715951","59","141","190",132,58,52,"16",36,0.2727,0.2759,0.2737,0.7421
"6056",177418,"Fontbonne University",1,0,2005,"16000","27.656099","66","141","187",136,51,44,"9",35,0.2574,0.1765,0.2353,0.754
"6057",177418,"Fontbonne University",1,0,2006,"17120","30.347366","65","140","187",98,89,30,"11",19,0.1939,0.1236,0.1604,0.7487
"6058",177418,"Fontbonne University",1,0,2007,"18000","32.929373","73","143","193",110,83,5,"1",4,0.0364,0.012,0.0259,0.7409
"6059",177418,"Fontbonne University",1,0,2008,"19000","35.669114","82","130","187",112,75,44,"12",32,0.2857,0.16,0.2353,0.6952
"6060",177418,"Fontbonne University",1,0,2009,"19475","38.560141","75","127","173",104,69,65,"19",46,0.4423,0.2754,0.3757,0.7341
"6061",177418,"Fontbonne University",1,0,2010,"20060","35.820237","82","119","151",77,74,53,"21",32,0.4156,0.2838,0.351,0.7881
"6062",178059,"MARYVILLE UNIVERSITY OF SAINT LOUIS",1,0,1991,"7800","16.664831","78","94","102",61,41,63,"22",41,0.6721,0.5366,0.6176,0.9216
"6063",178059,"MARYVILLE UNIVERSITY OF SAINT LOUIS",1,0,1992,"8200","19.733891","81","121","129",93,36,70,"19",51,0.5484,0.5278,0.5426,0.938
"6064",178059,"MARYVILLE UNIVERSITY OF SAINT LOUIS",1,0,1993,"8700","20.147305","78","149","165",109,56,73,"20",53,0.4862,0.3571,0.4424,0.903
"6065",178059,"MARYVILLE UNIVERSITY OF SAINT LOUIS",1,0,1995,"9800","22.87999","80","144","167",123,44,77,"16",61,0.4959,0.3636,0.4611,0.8623
"6066",178059,"MARYVILLE UNIVERSITY OF SAINT LOUIS",1,0,1996,"10280","24.022652","85","169","185",127,58,100,"28",72,0.5669,0.4828,0.5405,0.9135
"6067",178059,"MARYVILLE UNIVERSITY OF SAINT LOUIS",1,0,1997,"10850","21.649188","87","199","223",173,50,114,"26",88,0.5087,0.52,0.5112,0.8924
"6068",178059,"MARYVILLE UNIVERSITY OF SAINT LOUIS",1,0,1998,"11600","22.58019","86","214","225",158,67,100,"26",74,0.4684,0.3881,0.4444,0.9511
"6069",178059,"MARYVILLE UNIVERSITY OF SAINT LOUIS",1,0,1999,"12160","26.083695","91","164","198",133,65,101,"26",75,0.5639,0.4,0.5101,0.8283
"6070",178059,"MARYVILLE UNIVERSITY OF SAINT LOUIS",1,0,2000,"12880","27.230718","86.5","206","231",186,45,122,"18",104,0.5591,0.4,0.5281,0.8918
"6071",178059,"MARYVILLE UNIVERSITY OF SAINT LOUIS",1,0,2001,"13650","29.841536","82","206","247",183,64,141,"31",110,0.6011,0.4844,0.5709,0.834
"6072",178059,"MARYVILLE UNIVERSITY OF SAINT LOUIS",1,0,2002,"14400","29.651812","83","233","279",194,85,132,"46",86,0.4433,0.5412,0.4731,0.8351
"6073",178059,"MARYVILLE UNIVERSITY OF SAINT LOUIS",1,0,2003,"15200","31.817352","85","286","318",236,82,163,"39",124,0.5254,0.4756,0.5126,0.8994
"6074",178059,"MARYVILLE UNIVERSITY OF SAINT LOUIS",1,0,2004,"16000","34.787103","93","266","313",248,65,160,"29",131,0.5282,0.4462,0.5112,0.8498
"6075",178059,"Maryville University of Saint Louis",1,0,2005,"17000","37.496079","95","296","322",232,90,182,"42",140,0.6034,0.4667,0.5652,0.9193
"6076",178059,"Maryville University of Saint Louis",1,0,2006,"17800","39.586581","101","261","290",237,53,152,"26",126,0.5316,0.4906,0.5241,0.9
"6077",178059,"Maryville University of Saint Louis",1,0,2007,"18600","43.748658","107","257","294",211,83,149,"43",106,0.5024,0.5181,0.5068,0.8741
"6078",178059,"Maryville University of Saint Louis",1,0,2008,"19650","45.152529","110","283","318",236,82,149,"39",110,0.4661,0.4756,0.4686,0.8899
"6079",178059,"Maryville University of Saint Louis",1,0,2009,"20384","46.670811","107","278","340",233,107,190,"57",133,0.5708,0.5327,0.5588,0.8176
"6080",178059,"Maryville University of Saint Louis",1,0,2010,"21100","49.713711","113","271","338",242,96,192,"49",143,0.5909,0.5104,0.568,0.8018
"6081",178341,"MISSOURI SOUTHERN STATE COLLEGE",1,0,1991,"1272","25.918638","198","729","758",397,361,71,"24",47,0.1184,0.0665,0.0937,0.9617
"6082",178341,"MISSOURI SOUTHERN STATE COLLEGE",1,0,1992,"1598","26.431545","189","655","702",381,321,63,"24",39,0.1024,0.0748,0.0897,0.933
"6083",178341,"MISSOURI SOUTHERN STATE COLLEGE",1,0,1993,"2018","28.416787","187","665","701",362,339,51,"16",35,0.0967,0.0472,0.0728,0.9486
"6084",178341,"MISSOURI SOUTHERN STATE COLLEGE",1,0,1995,"2205","29.752573","190","672","720",359,361,77,"37",40,0.1114,0.1025,0.1069,0.9333
"6085",178341,"MISSOURI SOUTHERN STATE COLLEGE",1,0,1996,"2310","34.047345","196","644","685",373,312,77,"25",52,0.1394,0.0801,0.1124,0.9401
"6086",178341,"MISSOURI SOUTHERN STATE COLLEGE",1,0,1997,"2376","34.746438","205","632","675",368,307,61,"19",42,0.1141,0.0619,0.0904,0.9363
"6087",178341,"MISSOURI SOUTHERN STATE COLLEGE",1,0,1998,"2471","38.249381","202","794","857",469,388,95,"30",65,0.1386,0.0773,0.1109,0.9265
"6088",178341,"MISSOURI SOUTHERN STATE COLLEGE",1,0,1999,"2265","41.870527","204","738","804",434,370,104,"40",64,0.1475,0.1081,0.1294,0.9179
"6089",178341,"MISSOURI SOUTHERN STATE COLLEGE",1,0,2000,"2370","44.299716","204","713","771",427,344,129,"50",79,0.185,0.1453,0.1673,0.9248
"6090",178341,"MISSOURI SOUTHERN STATE COLLEGE",1,0,2001,"2700","47.658124","204","686","786",411,375,117,"47",70,0.1703,0.1253,0.1489,0.8728
"6091",178341,"MISSOURI SOUTHERN STATE COLLEGE",1,0,2002,"3720","43.955908","202","544","614",334,280,78,"27",51,0.1527,0.0964,0.127,0.886
"6092",178341,"MISSOURI SOUTHERN STATE UNIVERSITY",1,0,2003,"3810","46.285086","198","511","568",319,249,76,"25",51,0.1599,0.1004,0.1338,0.8996
"6093",178341,"MISSOURI SOUTHERN STATE UNIVERSITY",1,0,2004,"3810","46.756754","200","626","695",368,327,97,"33",64,0.1739,0.1009,0.1396,0.9007
"6094",178341,"Missouri Southern State University",1,0,2005,"3750","49.637878","203","709","836",466,370,106,"32",74,0.1588,0.0865,0.1268,0.8481
"6095",178341,"Missouri Southern State University",1,0,2006,"3900","53.887061","208","715","851",484,367,106,"40",66,0.1364,0.109,0.1246,0.8402
"6096",178341,"Missouri Southern State University",1,0,2007,"4050","59.180412","211","656","766",416,350,110,"29",81,0.1947,0.0829,0.1436,0.8564
"6097",178341,"Missouri Southern State University",1,0,2008,"4290","61.362912","215","621","727",398,329,106,"34",72,0.1809,0.1033,0.1458,0.8542
"6098",178341,"Missouri Southern State University",1,0,2009,"4290","55.899518","208","669","811",395,416,119,"53",66,0.1671,0.1274,0.1467,0.8249
"6099",178341,"Missouri Southern State University",1,0,2010,"4290","60.285521","207","687","844",439,405,88,"35",53,0.1207,0.0864,0.1043,0.814
"6100",178387,"MISSOURI WESTERN STATE COLLEGE",1,0,1991,"1648","24.730695","160","699","806",435,371,71,"27",44,0.1011,0.0728,0.0881,0.8672
"6101",178387,"MISSOURI WESTERN STATE COLLEGE",1,0,1992,"1822","26.111429","162","696","794",445,349,85,"22",63,0.1416,0.063,0.1071,0.8766
"6102",178387,"MISSOURI WESTERN STATE COLLEGE",1,0,1993,"1930","28.917039","161","784","928",514,414,86,"30",56,0.1089,0.0725,0.0927,0.8448
"6103",178387,"MISSOURI WESTERN STATE COLLEGE",1,0,1995,"2258","31.52932","165","801","923",530,393,92,"24",68,0.1283,0.0611,0.0997,0.8678
"6104",178387,"MISSOURI WESTERN STATE COLLEGE",1,0,1996,"2414","33.921534","176","836","963",564,399,113,"28",85,0.1507,0.0702,0.1173,0.8681
"6105",178387,"MISSOURI WESTERN STATE COLLEGE",1,0,1997,"2534","37.867187","181","846","985",572,413,135,"42",93,0.1626,0.1017,0.1371,0.8589
"6106",178387,"MISSOURI WESTERN STATE COLLEGE",1,0,1998,"2660","40.580774","185","827","983",577,406,127,"27",100,0.1733,0.0665,0.1292,0.8413
"6107",178387,"MISSOURI WESTERN STATE COLLEGE",1,0,1999,"2622","44.799531","188","832","980",575,405,113,"35",78,0.1357,0.0864,0.1153,0.849
"6108",178387,"MISSOURI WESTERN STATE COLLEGE",1,0,2000,"2754","47.070129","188","740","908",532,376,91,"20",71,0.1335,0.0532,0.1002,0.815
"6109",178387,"MISSOURI WESTERN STATE COLLEGE",1,0,2001,"2928","49.35054","188","903","1079",666,413,140,"44",96,0.1441,0.1065,0.1297,0.8369
"6110",178387,"MISSOURI WESTERN STATE COLLEGE",1,0,2002,"3768","46.282386","184","907","1131",655,476,134,"52",82,0.1252,0.1092,0.1185,0.8019
"6111",178387,"MISSOURI WESTERN STATE COLLEGE",1,0,2003,"4098","44.311719","180","783","994",572,422,111,"27",84,0.1469,0.064,0.1117,0.7877
"6112",178387,"MISSOURI WESTERN STATE COLLEGE",1,0,2004,"4380","44.486042","179","801","1021",573,448,109,"26",83,0.1449,0.058,0.1068,0.7845
"6113",178387,"Missouri Western State University",1,0,2005,"4380","47.762841","179","758","1005",557,448,111,"42",69,0.1239,0.0938,0.1104,0.7542
"6114",178387,"Missouri Western State University",1,0,2006,"4650","51.334924","178","723","936",516,420,102,"39",63,0.1221,0.0929,0.109,0.7724
"6115",178387,"Missouri Western State University",1,0,2007,"4800","52.18681","184","699","935",538,397,126,"36",90,0.1673,0.0907,0.1348,0.7476
"6116",178387,"Missouri Western State University",1,0,2008,"3994","54.492906","187","766","956",536,420,146,"44",102,0.1903,0.1048,0.1527,0.8013
"6117",178387,"Missouri Western State University",1,0,2009,"3994","58.709902","192","793","1004",572,432,127,"35",92,0.1608,0.081,0.1265,0.7898
"6118",178387,"Missouri Western State University",1,0,2010,"3994","59.160959","195","841","1083",559,524,145,"55",90,0.161,0.105,0.1339,0.7765
"6119",178396,"UNIVERSITY OF MISSOURI-COLUMBIA",1,0,1991,"2432","561.938061","899","2906","3368",1820,1548,959,"356",603,0.3313,0.23,0.2847,0.8628
"6120",178396,"UNIVERSITY OF MISSOURI-COLUMBIA",1,0,1992,"2812","594.756333","883","2493","2904",1600,1304,828,"305",523,0.3269,0.2339,0.2851,0.8585
"6121",178396,"UNIVERSITY OF MISSOURI-COLUMBIA",1,0,1993,"3125","638.392836","899","2499","2898",1511,1387,828,"320",508,0.3362,0.2307,0.2857,0.8623
"6122",178396,"UNIVERSITY OF MISSOURI-COLUMBIA",1,0,1995,"3771","741.631902","879","3232","3782",2099,1683,1210,"420",790,0.3764,0.2496,0.3199,0.8546
"6123",178396,"UNIVERSITY OF MISSOURI-COLUMBIA",1,0,1996,"4121","787.209426","910","3153","3687",2046,1641,1282,"462",820,0.4008,0.2815,0.3477,0.8552
"6124",178396,"UNIVERSITY OF MISSOURI-COLUMBIA",1,0,1997,"4280","820.647145","913","2952","3512",1935,1577,1290,"461",829,0.4284,0.2923,0.3673,0.8405
"6125",178396,"UNIVERSITY OF MISSOURI-COLUMBIA",1,0,1998,"4439","853.072658","899","3251","3785",2077,1708,1425,"500",925,0.4454,0.2927,0.3765,0.8589
"6126",178396,"UNIVERSITY OF MISSOURI-COLUMBIA",1,0,1999,"3978","883.038999","930","3350","3871",2138,1733,1468,"525",943,0.4411,0.3029,0.3792,0.8654
"6127",178396,"UNIVERSITY OF MISSOURI-COLUMBIA",1,0,2000,"4104","996.6778","968","3598","4170",2247,1923,1657,"609",1048,0.4664,0.3167,0.3974,0.8628
"6128",178396,"UNIVERSITY OF MISSOURI-COLUMBIA",1,0,2001,"4245","1083.580372","1006","3577","4112",2175,1937,1686,"643",1043,0.4795,0.332,0.41,0.8699
"6129",178396,"UNIVERSITY OF MISSOURI-COLUMBIA",1,0,2002,"4602","1073.08736","1219","3763","4379",2284,2095,1813,"669",1144,0.5009,0.3193,0.414,0.8593
"6130",178396,"UNIVERSITY OF MISSOURI-COLUMBIA",1,0,2003,"5838","1137.707886","1093","3951","4605",2443,2162,1985,"737",1248,0.5108,0.3409,0.4311,0.858
"6131",178396,"UNIVERSITY OF MISSOURI-COLUMBIA",1,0,2004,"6276","1183.806953","1544","3957","4625",2442,2183,1993,"765",1228,0.5029,0.3504,0.4309,0.8556
"6132",178396,"University of Missouri-Columbia",1,0,2005,"6062","1357.803723","1242","3954","4662",2513,2149,2087,"810",1277,0.5082,0.3769,0.4477,0.8481
"6133",178396,"University of Missouri-Columbia",1,0,2006,"6364","1437.990316","1276","3953","4783",2562,2221,2234,"835",1399,0.5461,0.376,0.4671,0.8265
"6134",178396,"University of Missouri-Columbia",1,0,2007,"7077","1513.270999","1292","4143","4897",2672,2225,2305,"829",1476,0.5524,0.3726,0.4707,0.846
"6135",178396,"University of Missouri-Columbia",1,0,2008,"7368","1607.479553","1295","4740","5698",3031,2667,2622,"1004",1618,0.5338,0.3765,0.4602,0.8319
"6136",178396,"University of Missouri-Columbia",1,0,2009,"7368","1641.980498","1284","4491","5492",2958,2534,2527,"907",1620,0.5477,0.3579,0.4601,0.8177
"6137",178396,"University of Missouri-Columbia",1,0,2010,"7368","1678.184727","1329","4904","5996",3175,2821,2641,"963",1678,0.5285,0.3414,0.4405,0.8179
"6138",178402,"UNIVERSITY OF MISSOURI-KANSAS CITY",1,0,1991,"2457","125.329762","454","345","494",270,224,55,"26",29,0.1074,0.1161,0.1113,0.6984
"6139",178402,"UNIVERSITY OF MISSOURI-KANSAS CITY",1,0,1992,"2841","132.473878","421","335","480",257,223,42,"13",29,0.1128,0.0583,0.0875,0.6979
"6140",178402,"UNIVERSITY OF MISSOURI-KANSAS CITY",1,0,1993,"3154","138.675318","434","353","515",266,249,53,"18",35,0.1316,0.0723,0.1029,0.6854
"6141",178402,"UNIVERSITY OF MISSOURI-KANSAS CITY",1,0,1995,"3799","151.880681","457","387","568",318,250,70,"25",45,0.1415,0.1,0.1232,0.6813
"6142",178402,"UNIVERSITY OF MISSOURI-KANSAS CITY",1,0,1996,"4121","173.00539","460","389","567",299,268,86,"33",53,0.1773,0.1231,0.1517,0.6861
"6143",178402,"UNIVERSITY OF MISSOURI-KANSAS CITY",1,0,1997,"4273","185.698934","468","433","588",321,267,79,"27",52,0.162,0.1011,0.1344,0.7364
"6144",178402,"UNIVERSITY OF MISSOURI-KANSAS CITY",1,0,1998,"4421","195.75608","469","418","618",336,282,114,"39",75,0.2232,0.1383,0.1845,0.6764
"6145",178402,"UNIVERSITY OF MISSOURI-KANSAS CITY",1,0,1999,"3978","207.48399","484","458","639",356,283,105,"46",59,0.1657,0.1625,0.1643,0.7167
"6146",178402,"UNIVERSITY OF MISSOURI-KANSAS CITY",1,0,2000,"4104","220.033678","504","453","688",391,297,120,"44",76,0.1944,0.1481,0.1744,0.6584
"6147",178402,"UNIVERSITY OF MISSOURI-KANSAS CITY",1,0,2001,"4245","231.693949","524","501","734",444,290,106,"36",70,0.1577,0.1241,0.1444,0.6826
"6148",178402,"UNIVERSITY OF MISSOURI-KANSAS CITY",1,0,2002,"4602","218.131001","593","481","747",454,293,128,"41",87,0.1916,0.1399,0.1714,0.6439
"6149",178402,"UNIVERSITY OF MISSOURI-KANSAS CITY",1,0,2003,"5838","250.788022","562","435","758",455,303,124,"38",86,0.189,0.1254,0.1636,0.5739
"6150",178402,"UNIVERSITY OF MISSOURI-KANSAS CITY",1,0,2004,"6276","260.595452","608","539","904",540,364,160,"50",110,0.2037,0.1374,0.177,0.5962
"6151",178402,"University of Missouri-Kansas City",1,0,2005,"6495","275.657824","662","611","1007",574,433,173,"61",112,0.1951,0.1409,0.1718,0.6068
"6152",178402,"University of Missouri-Kansas City",1,0,2006,"6819","287.614753","669","539","928",545,383,220,"86",134,0.2459,0.2245,0.2371,0.5808
"6153",178402,"University of Missouri-Kansas City",1,0,2007,"7077","288.775407","696","505","916",568,348,188,"59",129,0.2271,0.1695,0.2052,0.5513
"6154",178402,"University of Missouri-Kansas City",1,0,2008,"7368","305.487912","706","570","971",589,382,218,"68",150,0.2547,0.178,0.2245,0.587
"6155",178402,"University of Missouri-Kansas City",1,0,2009,"7368","319.769108","716","559","979",610,369,224,"62",162,0.2656,0.168,0.2288,0.571
"6156",178402,"University of Missouri-Kansas City",1,0,2010,"7368","331.875611","721","640","1109",673,436,246,"92",154,0.2288,0.211,0.2218,0.5771
"6157",178411,"UNIVERSITY OF MISSOURI-ROLLA",1,0,1991,"2543","70.273207","282","630","711",135,576,58,"43",15,0.1111,0.0747,0.0816,0.8861
"6158",178411,"UNIVERSITY OF MISSOURI-ROLLA",1,0,1992,"2932","72.133675","256","704","809",174,635,64,"40",24,0.1379,0.063,0.0791,0.8702
"6159",178411,"UNIVERSITY OF MISSOURI-ROLLA",1,0,1993,"3254","82.582543","253","707","786",190,596,78,"58",20,0.1053,0.0973,0.0992,0.8995
"6160",178411,"UNIVERSITY OF MISSOURI-ROLLA",1,0,1995,"3899","89.86291","263","704","804",190,614,121,"75",46,0.2421,0.1221,0.1505,0.8756
"6161",178411,"UNIVERSITY OF MISSOURI-ROLLA",1,0,1996,"4213","96.963938","272","684","777",179,598,121,"77",44,0.2458,0.1288,0.1557,0.8803
"6162",178411,"UNIVERSITY OF MISSOURI-ROLLA",1,0,1997,"4373","101.063257","267","631","692",168,524,99,"76",23,0.1369,0.145,0.1431,0.9118
"6163",178411,"UNIVERSITY OF MISSOURI-ROLLA",1,0,1998,"4522","105.399336","276","641","717",151,566,106,"81",25,0.1656,0.1431,0.1478,0.894
"6164",178411,"UNIVERSITY OF MISSOURI-ROLLA",1,0,1999,"3978","110.098689","272","588","679",140,539,112,"77",35,0.25,0.1429,0.1649,0.866
"6165",178411,"UNIVERSITY OF MISSOURI-ROLLA",1,0,2000,"4104","113.618519","271.5","583","672",146,526,143,"98",45,0.3082,0.1863,0.2128,0.8676
"6166",178411,"UNIVERSITY OF MISSOURI-ROLLA",1,0,2001,"4245","119.521426","271","586","691",126,565,144,"109",35,0.2778,0.1929,0.2084,0.848
"6167",178411,"UNIVERSITY OF MISSOURI-ROLLA",1,0,2002,"4602","109.077808","305","690","785",150,635,175,"128",47,0.3133,0.2016,0.2229,0.879
"6168",178411,"UNIVERSITY OF MISSOURI-ROLLA",1,0,2003,"5838","116.808518","296","752","870",181,689,217,"154",63,0.3481,0.2235,0.2494,0.8644
"6169",178411,"UNIVERSITY OF MISSOURI-ROLLA",1,0,2004,"6276","126.317731","318","721","836",169,667,211,"162",49,0.2899,0.2429,0.2524,0.8624
"6170",178411,"University of Missouri-Rolla",1,0,2005,"6495","135.55577","314","772","877",168,709,224,"154",70,0.4167,0.2172,0.2554,0.8803
"6171",178411,"University of Missouri-Rolla",1,0,2006,"6819","144.912767","323","802","929",216,713,258,"176",82,0.3796,0.2468,0.2777,0.8633
"6172",178411,"Missouri University of Science and Technology",1,0,2007,"7077","140.733961","330","885","1018",208,810,257,"180",77,0.3702,0.2222,0.2525,0.8694
"6173",178411,"Missouri University of Science and Technology",1,0,2008,"7368","154.944998","343","872","1036",234,802,253,"181",72,0.3077,0.2257,0.2442,0.8417
"6174",178411,"Missouri University of Science and Technology",1,0,2009,"7368","155.962145","333","904","1099",260,839,263,"180",83,0.3192,0.2145,0.2393,0.8226
"6175",178411,"Missouri University of Science and Technology",1,0,2010,"7368","160.634162","329","970","1138",250,888,246,"166",80,0.32,0.1869,0.2162,0.8524
"6176",178420,"UNIVERSITY OF MISSOURI-SAINT LOUIS",1,0,1991,"2379","77.270186","327","513","637",341,296,72,"28",44,0.129,0.0946,0.113,0.8053
"6177",178420,"UNIVERSITY OF MISSOURI-SAINT LOUIS",1,0,1992,"2740","78.000872","299","388","474",224,250,49,"18",31,0.1384,0.072,0.1034,0.8186
"6178",178420,"UNIVERSITY OF MISSOURI-ST LOUIS",1,0,1993,"3073","81.158641","304","361","458",231,227,52,"17",35,0.1515,0.0749,0.1135,0.7882
"6179",178420,"UNIVERSITY OF MISSOURI-ST LOUIS",1,0,1995,"3761","101.876381","332","436","552",315,237,85,"31",54,0.1714,0.1308,0.154,0.7899
"6180",178420,"UNIVERSITY OF MISSOURI-ST LOUIS",1,0,1996,"4145","111.864341","345","484","632",351,281,78,"20",58,0.1652,0.0712,0.1234,0.7658
"6181",178420,"UNIVERSITY OF MISSOURI-ST LOUIS",1,0,1997,"4323","116.942727","348","378","458",242,216,60,"12",48,0.1983,0.0556,0.131,0.8253
"6182",178420,"UNIVERSITY OF MISSOURI-ST LOUIS",1,0,1998,"4636","128.03058","330","443","528",274,254,114,"46",68,0.2482,0.1811,0.2159,0.839
"6183",178420,"UNIVERSITY OF MISSOURI-ST LOUIS",1,0,1999,"3978","135.699443","330","415","539",274,265,122,"43",79,0.2883,0.1623,0.2263,0.7699
"6184",178420,"UNIVERSITY OF MISSOURI-ST LOUIS",1,0,2000,"4104","146.900396","329","388","497",279,218,100,"35",65,0.233,0.1606,0.2012,0.7807
"6185",178420,"UNIVERSITY OF MISSOURI-ST LOUIS",1,0,2001,"4245","155.503124","328","376","515",313,202,96,"25",71,0.2268,0.1238,0.1864,0.7301
"6186",178420,"UNIVERSITY OF MISSOURI-ST LOUIS",1,0,2002,"4602","153.381894","415","324","426",234,192,96,"29",67,0.2863,0.151,0.2254,0.7606
"6187",178420,"UNIVERSITY OF MISSOURI-ST LOUIS",1,0,2003,"5838","149.677106","414","356","464",280,184,97,"26",71,0.2536,0.1413,0.2091,0.7672
"6188",178420,"UNIVERSITY OF MISSOURI-ST LOUIS",1,0,2004,"6276","164.827885","442","283","398",235,163,82,"25",57,0.2426,0.1534,0.206,0.7111
"6189",178420,"University of Missouri-St Louis",1,0,2005,"5196","173.602203","462","337","497",288,209,124,"41",83,0.2882,0.1962,0.2495,0.6781
"6190",178420,"University of Missouri-St Louis",1,0,2006,"6819","183.633869","497","297","476",273,203,106,"33",73,0.2674,0.1626,0.2227,0.6239
"6191",178420,"University of Missouri-St Louis",1,0,2007,"7077","192.582838","501","270","462",280,182,94,"25",69,0.2464,0.1374,0.2035,0.5844
"6192",178420,"University of Missouri-St Louis",1,0,2008,"7368","203.620957","504","279","437",244,193,92,"34",58,0.2377,0.1762,0.2105,0.6384
"6193",178420,"University of Missouri-St Louis",1,0,2009,"7368","203.59809","494","266","494",295,199,109,"34",75,0.2542,0.1709,0.2206,0.5385
"6194",178420,"University of Missouri-St Louis",1,0,2010,"7368","200.632476","493","298","479",282,197,141,"51",90,0.3191,0.2589,0.2944,0.6221
"6195",178615,"NORTHEAST MISSOURI STATE UNIVERSITY",1,0,1991,"1800","50.047944","337","1262","1375",784,591,459,"153",306,0.3903,0.2589,0.3338,0.9178
"6196",178615,"NORTHEAST MISSOURI STATE UNIVERSITY",1,0,1992,"2235","52.327113","337","1238","1384",786,598,539,"167",372,0.4733,0.2793,0.3895,0.8945
"6197",178615,"NORTHEAST MISSOURI STATE UNIVERSITY",1,0,1993,"2456","56.611946","328","1451","1614",962,652,597,"178",419,0.4356,0.273,0.3699,0.899
"6198",178615,"TRUMAN STATE UNIVERSITY",1,0,1995,"2872","64.820118","349","1021","1498",883,615,577,"183",394,0.4462,0.2976,0.3852,0.6816
"6199",178615,"TRUMAN STATE UNIVERSITY",1,0,1996,"3008","69.483811","347","1124","1480",868,612,592,"185",407,0.4689,0.3023,0.4,0.7595
"6200",178615,"TRUMAN STATE UNIVERSITY",1,0,1997,"3256","75.01615","356","1461","1654",1020,634,593,"175",418,0.4098,0.276,0.3585,0.8833
"6201",178615,"TRUMAN STATE UNIVERSITY",1,0,1998,"3408","88.683639","357","1304","1482",914,568,562,"181",381,0.4168,0.3187,0.3792,0.8799
"6202",178615,"TRUMAN STATE UNIVERSITY",1,0,1999,"3544","85.908302","363","1245","1446",884,562,594,"201",393,0.4446,0.3577,0.4108,0.861
"6203",178615,"TRUMAN STATE UNIVERSITY",1,0,2000,"3680","89.670827","366.5","1222","1396",840,556,537,"181",356,0.4238,0.3255,0.3847,0.8754
"6204",178615,"TRUMAN STATE UNIVERSITY",1,0,2001,"3800","92.019951","370","1249","1456",865,591,666,"232",434,0.5017,0.3926,0.4574,0.8578
"6205",178615,"TRUMAN STATE UNIVERSITY",1,0,2002,"4144","84.360164","366","1242","1441",872,569,654,"227",427,0.4897,0.3989,0.4539,0.8619
"6206",178615,"TRUMAN STATE UNIVERSITY",1,0,2003,"4700","79.215678","354","1113","1310",787,523,612,"198",414,0.526,0.3786,0.4672,0.8496
"6207",178615,"TRUMAN STATE UNIVERSITY",1,0,2004,"5410","80.147429","347","1310","1477",872,605,631,"228",403,0.4622,0.3769,0.4272,0.8869
"6208",178615,"Truman State University",1,0,2005,"5740","84.72657","353","1232","1441",830,611,626,"232",394,0.4747,0.3797,0.4344,0.855
"6209",178615,"Truman State University",1,0,2006,"5970","89.301579","339","1111","1365",826,539,781,"258",523,0.6332,0.4787,0.5722,0.8139
"6210",178615,"Truman State University",1,0,2007,"6210","88.830078","344","1146","1402",814,588,754,"248",506,0.6216,0.4218,0.5378,0.8174
"6211",178615,"Truman State University",1,0,2008,"6458","95.367415","357","1074","1334",779,555,757,"251",506,0.6496,0.4523,0.5675,0.8051
"6212",178615,"Truman State University",1,0,2009,"6458","98.137455","345","1006","1337",776,561,739,"263",476,0.6134,0.4688,0.5527,0.7524
"6213",178615,"Truman State University",1,0,2010,"6458","94.607524","338","1184","1416",881,535,800,"260",540,0.6129,0.486,0.565,0.8362
"6214",179043,"ROCKHURST COLLEGE",1,0,1991,"8200","19.772302","83","167","228",142,86,121,"44",77,0.5423,0.5116,0.5307,0.7325
"6215",179043,"ROCKHURST COLLEGE",1,0,1992,"8830","19.675633","96","156","198",121,77,92,"30",62,0.5124,0.3896,0.4646,0.7879
"6216",179043,"ROCKHURST COLLEGE",1,0,1993,"9090","21.008036","99","295","345",194,151,169,"74",95,0.4897,0.4901,0.4899,0.8551
"6217",179043,"ROCKHURST COLLEGE",1,0,1995,"10440","26.259141","105","255","288",161,127,174,"74",100,0.6211,0.5827,0.6042,0.8854
"6218",179043,"ROCKHURST COLLEGE",1,0,1996,"11270","29.579649","107","302","362",196,166,9,"3",6,0.0306,0.0181,0.0249,0.8343
"6219",179043,"ROCKHURST COLLEGE",1,0,1997,"11850","33.547313","108","268","319",175,144,181,"78",103,0.5886,0.5417,0.5674,0.8401
"6220",179043,"ROCKHURST COLLEGE",1,0,1998,"12240","34.857028","107","241","280",153,127,141,"50",91,0.5948,0.3937,0.5036,0.8607
"6221",179043,"ROCKHURST UNIVERSITY",1,0,1999,"12500","36.098379","114","250","303",177,126,152,"61",91,0.5141,0.4841,0.5017,0.8251
"6222",179043,"ROCKHURST UNIVERSITY",1,0,2000,"13500","31.221249","125.5","216","267",141,126,135,"61",74,0.5248,0.4841,0.5056,0.809
"6223",179043,"ROCKHURST UNIVERSITY",1,0,2001,"14800","61.919929","137","246","298",150,148,165,"76",89,0.5933,0.5135,0.5537,0.8255
"6224",179043,"ROCKHURST UNIVERSITY",1,0,2002,"15980","99.534135","126","179","214",133,81,119,"44",75,0.5639,0.5432,0.5561,0.8364
"6225",179043,"ROCKHURST UNIVERSITY",1,0,2003,"16950","135.941196","121","209","244",130,114,141,"60",81,0.6231,0.5263,0.5779,0.8566
"6226",179043,"ROCKHURST UNIVERSITY",1,0,2004,"17950","135.624051","125","267","305",176,129,184,"76",108,0.6136,0.5891,0.6033,0.8754
"6227",179043,"Rockhurst University",1,0,2005,"18900","150.649651","125","312","370",203,167,237,"110",127,0.6256,0.6587,0.6405,0.8432
"6228",179043,"Rockhurst University",1,0,2006,"20200","154.11923","129","345","396",260,136,237,"73",164,0.6308,0.5368,0.5985,0.8712
"6229",179043,"Rockhurst University",1,0,2007,"22000","141.635584","118","298","367",230,137,222,"81",141,0.613,0.5912,0.6049,0.812
"6230",179043,"Rockhurst University",1,0,2008,"23760","129.332095","124","270","358",237,121,223,"69",154,0.6498,0.5702,0.6229,0.7542
"6231",179043,"Rockhurst University",1,0,2009,"24950","112.819543","127","331","417",263,154,251,"84",167,0.635,0.5455,0.6019,0.7938
"6232",179043,"Rockhurst University",1,0,2010,"26450","87.040991","129","291","370",232,138,228,"79",149,0.6422,0.5725,0.6162,0.7865
"6233",179159,"SAINT LOUIS UNIVERSITY MAIN CAMPUS",1,0,1991,"9160","385.859209","360","720","914",479,435,355,"121",234,0.4885,0.2782,0.3884,0.7877
"6234",179159,"SAINT LOUIS UNIVERSITY MAIN CAMPUS",1,0,1992,"9880","436.077344","375","823","1051",546,505,473,"187",286,0.5238,0.3703,0.45,0.7831
"6235",179159,"SAINT LOUIS UNIVERSITY-MAIN CAMPUS",1,0,1993,"10820","467.77191","394","850","1066",578,488,500,"188",312,0.5398,0.3852,0.469,0.7974
"6236",179159,"SAINT LOUIS UNIVERSITY-MAIN CAMPUS",1,0,1995,"12800","528.878881","436","817","1055",604,451,501,"195",306,0.5066,0.4324,0.4749,0.7744
"6237",179159,"SAINT LOUIS UNIVERSITY-MAIN CAMPUS",1,0,1996,"13900","483.495043","454","803","1047",609,438,577,"202",375,0.6158,0.4612,0.5511,0.767
"6238",179159,"SAINT LOUIS UNIVERSITY-MAIN CAMPUS",1,0,1997,"14940","509.244147","511","802","1084",609,475,601,"246",355,0.5829,0.5179,0.5544,0.7399
"6239",179159,"SAINT LOUIS UNIVERSITY-MAIN CAMPUS",1,0,1998,"16100","494.836809","530","962","1239",694,545,684,"251",433,0.6239,0.4606,0.5521,0.7764
"6240",179159,"SAINT LOUIS UNIVERSITY-MAIN CAMPUS",1,0,1999,"17230","390.56619","547","974","1252",695,557,764,"314",450,0.6475,0.5637,0.6102,0.778
"6241",179159,"SAINT LOUIS UNIVERSITY-MAIN CAMPUS",1,0,2000,"18400","410.74239","559.5","1163","1405",748,657,886,"397",489,0.6537,0.6043,0.6306,0.8278
"6242",179159,"SAINT LOUIS UNIVERSITY-MAIN CAMPUS",1,0,2001,"19670","429.00106","572","1047","1329",695,634,827,"374",453,0.6518,0.5899,0.6223,0.7878
"6243",179159,"SAINT LOUIS UNIVERSITY-MAIN CAMPUS",1,0,2002,"20840","442.915023","591","1131","1409",762,647,867,"366",501,0.6575,0.5657,0.6153,0.8027
"6244",179159,"SAINT LOUIS UNIVERSITY-MAIN CAMPUS",1,0,2003,"22050","471.084885","629","1124","1377",752,625,832,"338",494,0.6569,0.5408,0.6042,0.8163
"6245",179159,"SAINT LOUIS UNIVERSITY-MAIN CAMPUS",1,0,2004,"23360","509.573132","620","1132","1456",864,592,892,"336",556,0.6435,0.5676,0.6126,0.7775
"6246",179159,"Saint Louis University-Main Campus",1,0,2005,"24760","517.205481","616","1180","1521",859,662,925,"377",548,0.638,0.5695,0.6082,0.7758
"6247",179159,"Saint Louis University-Main Campus",1,0,2006,"26250","546.394297","615","1218","1567",940,627,946,"358",588,0.6255,0.571,0.6037,0.7773
"6248",179159,"Saint Louis University-Main Campus",1,0,2007,"28480","555.219646","614","1234","1629",933,696,988,"380",608,0.6517,0.546,0.6065,0.7575
"6249",179159,"Saint Louis University-Main Campus",1,0,2008,"30330","591.622887","672","1138","1624",923,701,945,"365",580,0.6284,0.5207,0.5819,0.7007
"6250",179159,"Saint Louis University-Main Campus",1,0,2009,"30940","607.623525","639","1183","1714",966,748,1026,"393",633,0.6553,0.5254,0.5986,0.6902
"6251",179159,"Saint Louis University-Main Campus",1,0,2010,"32180","626.870988","707","1184","1724",1004,720,1063,"381",682,0.6793,0.5292,0.6166,0.6868
"6252",179557,"SOUTHEAST MISSOURI STATE UNIVERSITY",1,0,1991,"1716","66.227474","367","1319","1487",815,672,222,"70",152,0.1865,0.1042,0.1493,0.887
"6253",179557,"SOUTHEAST MISSOURI STATE UNIVERSITY",1,0,1992,"2113","68.136035","389","1259","1405",806,599,236,"67",169,0.2097,0.1119,0.168,0.8961
"6254",179557,"SOUTHEAST MISSOURI STATE UNIVERSITY",1,0,1993,"2434","71.8051","363","1119","1229",733,496,226,"58",168,0.2292,0.1169,0.1839,0.9105
"6255",179557,"SOUTHEAST MISSOURI STATE UNIVERSITY",1,0,1995,"2760","77.230371","376","1283","1385",824,561,334,"90",244,0.2961,0.1604,0.2412,0.9264
"6256",179557,"SOUTHEAST MISSOURI STATE UNIVERSITY",1,0,1996,"2874","84.157447","376","1117","1212",681,531,294,"82",212,0.3113,0.1544,0.2426,0.9216
"6257",179557,"SOUTHEAST MISSOURI STATE UNIVERSITY",1,0,1997,"3000","90.163836","378","1041","1124",713,411,248,"65",183,0.2567,0.1582,0.2206,0.9262
"6258",179557,"SOUTHEAST MISSOURI STATE UNIVERSITY",1,0,1998,"3105","92.561044","380","1132","1239",757,482,300,"75",225,0.2972,0.1556,0.2421,0.9136
"6259",179557,"SOUTHEAST MISSOURI STATE UNIVERSITY",1,0,1999,"2979","100.32825","369","1273","1391",816,575,320,"87",233,0.2855,0.1513,0.2301,0.9152
"6260",179557,"SOUTHEAST MISSOURI STATE UNIVERSITY",1,0,2000,"3099","109.579841","383.5","1244","1433",817,616,372,"103",269,0.3293,0.1672,0.2596,0.8681
"6261",179557,"SOUTHEAST MISSOURI STATE UNIVERSITY",1,0,2001,"3234","116.546998","398","1328","1502",910,592,356,"98",258,0.2835,0.1655,0.237,0.8842
"6262",179557,"SOUTHEAST MISSOURI STATE UNIVERSITY",1,0,2002,"3744","106.107538","404","1276","1457",858,599,361,"105",256,0.2984,0.1753,0.2478,0.8758
"6263",179557,"SOUTHEAST MISSOURI STATE UNIVERSITY",1,0,2003,"4254","110.410401","405","1215","1410",826,584,336,"98",238,0.2881,0.1678,0.2383,0.8617
"6264",179557,"SOUTHEAST MISSOURI STATE UNIVERSITY",1,0,2004,"4554","116.167813","406","1194","1386",823,563,334,"98",236,0.2868,0.1741,0.241,0.8615
"6265",179557,"Southeast Missouri State University",1,0,2005,"4764","124.153655","387","1267","1538",918,620,369,"102",267,0.2908,0.1645,0.2399,0.8238
"6266",179557,"Southeast Missouri State University",1,0,2006,"5034","131.633857","396","1087","1383",853,530,318,"92",226,0.2649,0.1736,0.2299,0.786
"6267",179557,"Southeast Missouri State University",1,0,2007,"5304","136.396299","401","1263","1650",946,704,438,"158",280,0.296,0.2244,0.2655,0.7655
"6268",179557,"Southeast Missouri State University",1,0,2008,"5544","147.23058","421","1423","1672",1054,618,492,"141",351,0.333,0.2282,0.2943,0.8511
"6269",179557,"Southeast Missouri State University",1,0,2009,"5544","153.991018","419","1392","1640",943,697,455,"165",290,0.3075,0.2367,0.2774,0.8488
"6270",179557,"Southeast Missouri State University",1,0,2010,"5544","159.237011","411","1482","1813",1097,716,526,"165",361,0.3291,0.2304,0.2901,0.8174
"6271",179566,"SOUTHWEST MISSOURI STATE UNIVERSITY",1,0,1991,"1594","110.898181","648","2658","2895",1571,1324,676,"241",435,0.2769,0.182,0.2335,0.9181
"6272",179566,"SOUTHWEST MISSOURI STATE UNIVERSITY",1,0,1992,"1752","113.88271","642","2636","2925",1621,1304,420,"110",310,0.1912,0.0844,0.1436,0.9012
"6273",179566,"SOUTHWEST MISSOURI STATE UNIVERSITY",1,0,1993,"1904","122.522961","671","2577","2800",1493,1307,376,"109",267,0.1788,0.0834,0.1343,0.9204
"6274",179566,"SOUTHWEST MISSOURI STATE UNIVERSITY",1,0,1995,"2758","129.705096","646","2297","2479",1394,1085,440,"156",284,0.2037,0.1438,0.1775,0.9266
"6275",179566,"SOUTHWEST MISSOURI STATE UNIVERSITY",1,0,1996,"2888","138.450647","661","2160","2447",1404,1043,433,"127",306,0.2179,0.1218,0.177,0.8827
"6276",179566,"SOUTHWEST MISSOURI STATE UNIVERSITY",1,0,1997,"3060","153.879549","673","2436","2704",1543,1161,522,"180",342,0.2216,0.155,0.193,0.9009
"6277",179566,"SOUTHWEST MISSOURI STATE UNIVERSITY",1,0,1998,"3214","160.073147","694","2446","2739",1545,1194,607,"192",415,0.2686,0.1608,0.2216,0.893
"6278",179566,"SOUTHWEST MISSOURI STATE UNIVERSITY",1,0,1999,"3030","168.088843","706","2310","2581",1439,1142,605,"223",382,0.2655,0.1953,0.2344,0.895
"6279",179566,"SOUTHWEST MISSOURI STATE UNIVERSITY",1,0,2000,"3180","179.800914","674","2243","2496",1477,1019,613,"204",409,0.2769,0.2002,0.2456,0.8986
"6280",179566,"SOUTHWEST MISSOURI STATE UNIVERSITY",1,0,2001,"3330","188.246019","642","2278","2508",1417,1091,672,"213",459,0.3239,0.1952,0.2679,0.9083
"6281",179566,"SOUTHWEST MISSOURI STATE UNIVERSITY",1,0,2002,"3840","190.812943","731","2474","2702",1609,1093,720,"205",515,0.3201,0.1876,0.2665,0.9156
"6282",179566,"SOUTHWEST MISSOURI STATE UNIVERSITY",1,0,2003,"4140","188.380406","725","2297","2645",1495,1150,1044,"382",662,0.4428,0.3322,0.3947,0.8684
"6283",179566,"SOUTHWEST MISSOURI STATE UNIVERSITY",1,0,2004,"4620","190.48531","726","2357","2663",1572,1091,755,"234",521,0.3314,0.2145,0.2835,0.8851
"6284",179566,"Missouri State University",1,0,2005,"4920","200.801081","728","2281","2575",1490,1085,822,"273",549,0.3685,0.2516,0.3192,0.8858
"6285",179566,"Missouri State University",1,0,2006,"5190","207.80739","716","2420","2732",1622,1110,854,"306",548,0.3379,0.2757,0.3126,0.8858
"6286",179566,"Missouri State University",1,0,2007,"5370","224.294407","698","2268","2610",1514,1096,796,"263",533,0.352,0.24,0.305,0.869
"6287",179566,"Missouri State University",1,0,2008,"5580","241.169867","724","2236","2532",1464,1068,785,"258",527,0.36,0.2416,0.31,0.8831
"6288",179566,"Missouri State University",1,0,2009,"5580","260.87541","721","2222","2625",1542,1083,768,"225",543,0.3521,0.2078,0.2926,0.8465
"6289",179566,"Missouri State University-Springfield",1,0,2010,"5580","269.904078","685","2256","2645",1574,1071,796,"266",530,0.3367,0.2484,0.3009,0.8529
"6290",179867,"WASHINGTON UNIVERSITY",1,0,1991,"16110","620.500232","610","834","1131",544,587,863,"417",446,0.8199,0.7104,0.763,0.7374
"6291",179867,"WASHINGTON UNIVERSITY",1,0,1992,"16918","682.980057","605","779","1070",513,557,831,"421",410,0.7992,0.7558,0.7766,0.728
"6292",179867,"WASHINGTON UNIVERSITY",1,0,1993,"17776","755.309145","620","937","1229",569,660,930,"460",470,0.826,0.697,0.7567,0.7624
"6293",179867,"WASHINGTON UNIVERSITY",1,0,1995,"19291","854.983785","642","820","1180",608,572,911,"411",500,0.8224,0.7185,0.772,0.6949
"6294",179867,"WASHINGTON UNIVERSITY",1,0,1996,"20200","925.644815","645","836","1275",642,633,1006,"463",543,0.8458,0.7314,0.789,0.6557
"6295",179867,"WASHINGTON UNIVERSITY",1,0,1997,"21210","826.991","666","778","1230",646,584,976,"424",552,0.8545,0.726,0.7935,0.6325
"6296",179867,"WASHINGTON UNIVERSITY",1,0,1998,"22422","865.54","589","1011","1465",770,695,1221,"570",651,0.8455,0.8201,0.8334,0.6901
"6297",179867,"WASHINGTON UNIVERSITY",1,0,1999,"23400","949.79","548","893","1369",684,685,1125,"548",577,0.8436,0.8,0.8218,0.6523
"6298",179867,"WASHINGTON UNIVERSITY",1,0,2000,"24500","1023.75","554","926","1392",761,631,1158,"498",660,0.8673,0.7892,0.8319,0.6652
"6299",179867,"WASHINGTON UNIVERSITY IN ST LOUIS",1,0,2001,"25700","1155.101","560","832","1262",637,625,1049,"494",555,0.8713,0.7904,0.8312,0.6593
"6300",179867,"WASHINGTON UNIVERSITY IN ST LOUIS",1,0,2002,"26900","1236.304","582","883","1329",699,630,1127,"513",614,0.8784,0.8143,0.848,0.6644
"6301",179867,"WASHINGTON UNIVERSITY IN ST LOUIS",1,0,2003,"28300","1354.222","572","880","1349",699,650,1138,"517",621,0.8884,0.7954,0.8436,0.6523
"6302",179867,"WASHINGTON UNIVERSITY IN ST LOUIS",1,0,2004,"29700","1418.897","698","868","1436",725,711,1233,"592",641,0.8841,0.8326,0.8586,0.6045
"6303",179867,"Washington University in St Louis",1,0,2005,"31100","1515.37","754","817","1372",715,657,1186,"544",642,0.8979,0.828,0.8644,0.5955
"6304",179867,"Washington University in St Louis",1,0,2006,"32800","1625.531","773","881","1456",714,742,1284,"628",656,0.9188,0.8464,0.8819,0.6051
"6305",179867,"Washington University in St Louis",1,0,2007,"34500","1720.965","783","776","1325",645,680,1169,"593",576,0.893,0.8721,0.8823,0.5857
"6306",179867,"Washington University in St Louis",1,0,2008,"36200","1793.958","794","817","1408",711,697,1270,"605",665,0.9353,0.868,0.902,0.5803
"6307",179867,"Washington University in St Louis",1,0,2009,"37800","1922.616","810","812","1481",720,761,1280,"622",658,0.9139,0.8173,0.8643,0.5483
"6308",179867,"Washington University in St Louis",1,0,2010,"39400","1981.401","817","929","1619",776,843,1430,"716",714,0.9201,0.8493,0.8833,0.5738
"6309",179894,"WEBSTER UNIVERSITY",1,0,1991,"7300","46.314629","105","149","187",110,77,65,"24",41,0.3727,0.3117,0.3476,0.7968
"6310",179894,"WEBSTER UNIVERSITY",1,0,1992,"8000","51.529136","107","165","201",114,87,68,"22",46,0.4035,0.2529,0.3383,0.8209
"6311",179894,"WEBSTER UNIVERSITY",1,0,1993,"8560","49.985192","115","201","227",132,95,81,"28",53,0.4015,0.2947,0.3568,0.8855
"6312",179894,"WEBSTER UNIVERSITY",1,0,1995,"9710","59.413269","125","153","227",105,122,90,"52",38,0.3619,0.4262,0.3965,0.674
"6313",179894,"WEBSTER UNIVERSITY",1,0,1996,"10292","65.228998","132","211","270",139,131,116,"50",66,0.4748,0.3817,0.4296,0.7815
"6314",179894,"WEBSTER UNIVERSITY",1,0,1997,"10860","72.064598","133","264","314",193,121,124,"41",83,0.4301,0.3388,0.3949,0.8408
"6315",179894,"WEBSTER UNIVERSITY",1,0,1998,"11460","79.592274","147","274","339",198,141,123,"50",73,0.3687,0.3546,0.3628,0.8083
"6316",179894,"WEBSTER UNIVERSITY",1,0,1999,"12150","87.345027","147","299","369",214,155,156,"52",104,0.486,0.3355,0.4228,0.8103
"6317",179894,"WEBSTER UNIVERSITY",1,0,2000,"12880","94.614164","149.5","327","412",242,170,168,"60",108,0.4463,0.3529,0.4078,0.7937
"6318",179894,"WEBSTER UNIVERSITY",1,0,2001,"13720","100.465325","152","330","399",250,149,179,"64",115,0.46,0.4295,0.4486,0.8271
"6319",179894,"WEBSTER UNIVERSITY",1,0,2002,"14600","111.365049","157","287","385",226,159,178,"67",111,0.4912,0.4214,0.4623,0.7455
"6320",179894,"WEBSTER UNIVERSITY",1,0,2003,"15480","124.895776","166","333","419",260,159,201,"62",139,0.5346,0.3899,0.4797,0.7947
"6321",179894,"WEBSTER UNIVERSITY",1,0,2004,"16250","140.052634","166","359","448",256,192,229,"89",140,0.5469,0.4635,0.5112,0.8013
"6322",179894,"Webster University",1,0,2005,"17210","146.586519","169","288","394",224,170,175,"76",99,0.442,0.4471,0.4442,0.731
"6323",179894,"Webster University",1,0,2006,"18240","147.328722","169","328","418",240,178,198,"69",129,0.5375,0.3876,0.4737,0.7847
"6324",179894,"Webster University",1,0,2007,"19330","157.048737","170","350","483",278,205,224,"80",144,0.518,0.3902,0.4638,0.7246
"6325",179894,"Webster University",1,0,2008,"20440","166.618378","175","290","407",250,157,173,"58",115,0.46,0.3694,0.4251,0.7125
"6326",179894,"Webster University",1,0,2009,"21056","169.668091","182","332","486",289,197,219,"78",141,0.4879,0.3959,0.4506,0.6831
"6327",179894,"Webster University",1,0,2010,"21688","178.297686","186","279","413",238,175,187,"67",120,0.5042,0.3829,0.4528,0.6755
"6328",179946,"WESTMINSTER COLLEGE",1,0,1991,"8400","9.746476","50","181","194",83,111,99,"56",43,0.5181,0.5045,0.5103,0.933
"6329",179946,"WESTMINSTER COLLEGE",1,0,1992,"8950","9.872169","50","191","203",89,114,75,"39",36,0.4045,0.3421,0.3695,0.9409
"6330",179946,"WESTMINSTER COLLEGE",1,0,1993,"9950","10.341443","50","168","180",71,109,73,"39",34,0.4789,0.3578,0.4056,0.9333
"6331",179946,"WESTMINSTER COLLEGE",1,0,1995,"11150","11.786444","46","174","190",88,102,91,"47",44,0.5,0.4608,0.4789,0.9158
"6332",179946,"WESTMINSTER COLLEGE",1,0,1996,"11700","12.058025","45","195","214",84,130,100,"62",38,0.4524,0.4769,0.4673,0.9112
"6333",179946,"WESTMINSTER COLLEGE",1,0,1997,"12300","10.424074","49","177","190",71,119,78,"40",38,0.5352,0.3361,0.4105,0.9316
"6334",179946,"WESTMINSTER COLLEGE",1,0,1998,"13205","11.78487","35","178","205",94,111,78,"40",38,0.4043,0.3604,0.3805,0.8683
"6335",179946,"WESTMINSTER COLLEGE",1,0,1999,"13490","13.269606","50","180","201",90,111,94,"41",53,0.5889,0.3694,0.4677,0.8955
"6336",179946,"WESTMINSTER COLLEGE",1,0,2000,"14060","14.029032","60","155","173",75,98,82,"37",45,0.6,0.3776,0.474,0.896
"6337",179946,"WESTMINSTER COLLEGE",1,0,2001,"14630","15.673522","70","218","248",102,146,97,"42",55,0.5392,0.2877,0.3911,0.879
"6338",179946,"WESTMINSTER COLLEGE",1,0,2002,"15360","16.954642","57","172","207",93,114,100,"48",52,0.5591,0.4211,0.4831,0.8309
"6339",179946,"WESTMINSTER COLLEGE",1,0,2003,"16128","17.256158","52","188","240",93,147,96,"56",40,0.4301,0.381,0.4,0.7833
"6340",179946,"WESTMINSTER COLLEGE",1,0,2004,"12990","17.876379","50","195","231",108,123,105,"54",51,0.4722,0.439,0.4545,0.8442
"6341",179946,"Westminster College",1,0,2005,"13750","17.8548","57","203","287",125,162,143,"65",78,0.624,0.4012,0.4983,0.7073
"6342",179946,"Westminster College",1,0,2006,"14120","19.508066","58","212","278",139,139,163,"73",90,0.6475,0.5252,0.5863,0.7626
"6343",179946,"Westminster College",1,0,2007,"15500","20.165342","54","169","223",95,128,115,"57",58,0.6105,0.4453,0.5157,0.7578
"6344",179946,"Westminster College",1,0,2008,"16650","20.618641","58","181","244",108,136,123,"67",56,0.5185,0.4926,0.5041,0.7418
"6345",179946,"Westminster College",1,0,2009,"17990","22.244471","61","217","311",152,159,149,"61",88,0.5789,0.3836,0.4791,0.6977
"6346",179946,"Westminster College",1,0,2010,"18990","23.61551","62","227","315",139,176,175,"75",100,0.7194,0.4261,0.5556,0.7206
"6347",180179,"EASTERN MONTANA COLLEGE",1,0,1991,"1524","25.712343","137","211","248",168,80,17,"4",13,0.0774,0.05,0.0685,0.8508
"6348",180179,"EASTERN MONTANA COLLEGE",1,0,1992,"1835","27.670253","138","253","285",200,85,27,"9",18,0.09,0.1059,0.0947,0.8877
"6349",180179,"EASTERN MONTANA COLLEGE",1,0,1993,"1916","27.672417","141","348","386",261,125,25,"3",22,0.0843,0.024,0.0648,0.9016
"6350",180179,"MONTANA STATE UNIVERSITY-BILLINGS",1,0,1995,"2304","28.578762","143","358","384",255,129,12,"2",10,0.0392,0.0155,0.0312,0.9323
"6351",180179,"MONTANA STATE UNIVERSITY-BILLINGS",1,0,1996,"2388","33.427778","142","466","520",332,188,79,"28",51,0.1536,0.1489,0.1519,0.8962
"6352",180179,"MONTANA STATE UNIVERSITY-BILLINGS",1,0,1997,"2517","34.649536","137","431","508",334,174,121,"28",93,0.2784,0.1609,0.2382,0.8484
"6353",180179,"MONTANA STATE UNIVERSITY-BILLINGS",1,0,1998,"2816","36.245837","139","450","539",325,214,52,"10",42,0.1292,0.0467,0.0965,0.8349
"6354",180179,"MONTANA STATE UNIVERSITY-BILLINGS",1,0,1999,"2922","38.583502","131","532","629",384,245,56,"15",41,0.1068,0.0612,0.089,0.8458
"6355",180179,"MONTANA STATE UNIVERSITY-BILLINGS",1,0,2000,"3052","40.867917","142","424","538",352,186,48,"10",38,0.108,0.0538,0.0892,0.7881
"6356",180179,"MONTANA STATE UNIVERSITY-BILLINGS",1,0,2001,"3429","45.121786","153","438","526",346,180,48,"15",33,0.0954,0.0833,0.0913,0.8327
"6357",180179,"MONTANA STATE UNIVERSITY-BILLINGS",1,0,2002,"3973","44.879453","148","458","542",357,185,48,"9",39,0.1092,0.0486,0.0886,0.845
"6358",180179,"MONTANA STATE UNIVERSITY-BILLINGS",1,0,2003,"4180","48.005299","154","513","588",380,208,54,"13",41,0.1079,0.0625,0.0918,0.8724
"6359",180179,"MONTANA STATE UNIVERSITY-BILLINGS",1,0,2004,"4550","52.418451","164","423","502",338,164,64,"18",46,0.1361,0.1098,0.1275,0.8426
"6360",180179,"Montana State University-Billings",1,0,2005,"3762","53.775165","157","677","796",463,333,79,"26",53,0.1145,0.0781,0.0992,0.8505
"6361",180179,"Montana State University-Billings",1,0,2006,"3951","55.908551","157","567","646",339,307,59,"17",42,0.1239,0.0554,0.0913,0.8777
"6362",180179,"Montana State University-Billings",1,0,2007,"3988","58.757416","155","615","724",393,331,60,"16",44,0.112,0.0483,0.0829,0.8494
"6363",180179,"Montana State University-Billings",1,0,2008,"3988","62.273244","154","577","692",402,290,47,"14",33,0.0821,0.0483,0.0679,0.8338
"6364",180179,"Montana State University-Billings",1,0,2009,"3988","62.554304","154","619","715",400,315,51,"19",32,0.08,0.0603,0.0713,0.8657
"6365",180179,"Montana State University-Billings",1,0,2010,"3988","63.418451","150","674","829",434,395,44,"11",33,0.076,0.0278,0.0531,0.813
"6366",180461,"MONTANA STATE UNIVERSITY",1,0,1991,"1550","106.431242","494","1227","1445",652,793,156,"60",96,0.1472,0.0757,0.108,0.8491
"6367",180461,"MONTANA STATE UNIVERSITY",1,0,1992,"1839","129.330347","483","1313","1530",646,884,155,"65",90,0.1393,0.0735,0.1013,0.8582
"6368",180461,"MONTANA STATE UNIVERSITY",1,0,1993,"2002","137.592702","468","1511","1716",756,960,195,"89",106,0.1402,0.0927,0.1136,0.8805
"6369",180461,"MONTANA STATE UNIVERSITY-BOZEMAN",1,0,1995,"2378","153.065178","460","1565","1744",714,1030,224,"101",123,0.1723,0.0981,0.1284,0.8974
"6370",180461,"MONTANA STATE UNIVERSITY-BOZEMAN",1,0,1996,"2504","157.734937","461","1531","1740",780,960,246,"120",126,0.1615,0.125,0.1414,0.8799
"6371",180461,"MONTANA STATE UNIVERSITY-BOZEMAN",1,0,1997,"2677","182.327007","442","1616","1819",784,1035,259,"116",143,0.1824,0.1121,0.1424,0.8884
"6372",180461,"MONTANA STATE UNIVERSITY-BOZEMAN",1,0,1998,"2869","170.400113","430","1666","1886",846,1040,299,"140",159,0.1879,0.1346,0.1585,0.8834
"6373",180461,"MONTANA STATE UNIVERSITY-BOZEMAN",1,0,1999,"2177","193.864945","464","1659","1894",891,1003,354,"164",190,0.2132,0.1635,0.1869,0.8759
"6374",180461,"MONTANA STATE UNIVERSITY-BOZEMAN",1,0,2000,"2272","218.829928","467.5","1698","1852",841,1011,357,"160",197,0.2342,0.1583,0.1928,0.9168
"6375",180461,"MONTANA STATE UNIVERSITY-BOZEMAN",1,0,2001,"2567","221.109025","471","1583","1720",731,989,292,"148",144,0.197,0.1496,0.1698,0.9203
"6376",180461,"MONTANA STATE UNIVERSITY-BOZEMAN",1,0,2002,"2900","232.756434","496","1765","1924",833,1091,307,"130",177,0.2125,0.1192,0.1596,0.9174
"6377",180461,"MONTANA STATE UNIVERSITY-BOZEMAN",1,0,2003,"3256","252.41398","496","1861","2004",837,1167,383,"193",190,0.227,0.1654,0.1911,0.9286
"6378",180461,"MONTANA STATE UNIVERSITY-BOZEMAN",1,0,2004,"3654","267.864013","483","1832","1998",836,1162,341,"159",182,0.2177,0.1368,0.1707,0.9169
"6379",180461,"Montana State University-Bozeman",1,0,2005,"4106","283.12704","538","1843","1980",843,1137,412,"198",214,0.2539,0.1741,0.2081,0.9308
"6380",180461,"Montana State University-Bozeman",1,0,2006,"4501","301.715158","545","1782","1940",814,1126,381,"173",208,0.2555,0.1536,0.1964,0.9186
"6381",180461,"Montana State University",1,0,2007,"4559","313.423037","540","1668","1852",791,1061,371,"162",209,0.2642,0.1527,0.2003,0.9006
"6382",180461,"Montana State University",1,0,2008,"4559","333.379547","541","1627","1805",765,1040,354,"154",200,0.2614,0.1481,0.1961,0.9014
"6383",180461,"Montana State University",1,0,2009,"4696","352.650932","559","1627","1795",728,1067,387,"190",197,0.2706,0.1781,0.2156,0.9064
"6384",180461,"Montana State University",1,0,2010,"4836","354.973063","579","1870","2115",877,1238,502,"219",283,0.3227,0.1769,0.2374,0.8842
"6385",180522,"NORTHERN MONTANA COLLEGE",0,1,1991,"1440","13.281672","79","151","188",86,102,27,"18",9,0.1047,0.1765,0.1436,0.8032
"6386",180522,"NORTHERN MONTANA COLLEGE",1,0,1992,"1732","14.271352","75","160","188",98,90,20,"13",7,0.0714,0.1444,0.1064,0.8511
"6387",180522,"NORTHERN MONTANA COLLEGE",1,0,1993,"1802","15.291383","79","182","223",106,117,20,"9",11,0.1038,0.0769,0.0897,0.8161
"6388",180522,"MONTANA STATE UNIVERSITY-NORTHERN",1,0,1995,"2221","16.035143","77","150","192",99,93,38,"16",22,0.2222,0.172,0.1979,0.7812
"6389",180522,"MONTANA STATE UNIVERSITY-NORTHERN",1,0,1996,"2350","16.487839","73","108","218",96,122,24,"13",11,0.1146,0.1066,0.1101,0.4954
"6390",180522,"MONTANA STATE UNIVERSITY-NORTHERN",1,0,1997,"2484","17.398322","70","182","235",89,146,28,"16",12,0.1348,0.1096,0.1191,0.7745
"6391",180522,"MONTANA STATE UNIVERSITY-NORTHERN",1,0,1998,"2692","17.971379","65","213","253",107,146,25,"15",10,0.0935,0.1027,0.0988,0.8419
"6392",180522,"MONTANA STATE UNIVERSITY-NORTHERN",1,0,1999,"1988","18.27533","64","210","261",112,149,30,"16",14,0.125,0.1074,0.1149,0.8046
"6393",180522,"MONTANA STATE UNIVERSITY-NORTHERN",1,0,2000,"1988","18.333848","63","152","187",85,102,28,"17",11,0.1294,0.1667,0.1497,0.8128
"6394",180522,"MONTANA STATE UNIVERSITY-NORTHERN",1,0,2001,"2436","19.094478","62","128","177",76,101,16,"10",6,0.0789,0.099,0.0904,0.7232
"6395",180522,"MONTANA STATE UNIVERSITY-NORTHERN",1,0,2002,"2796","19.605546","67","136","185",87,98,23,"13",10,0.1149,0.1327,0.1243,0.7351
"6396",180522,"MONTANA STATE UNIVERSITY-NORTHERN",1,0,2003,"2769","20.662917","63","177","214",108,106,36,"20",16,0.1481,0.1887,0.1682,0.8271
"6397",180522,"MONTANA STATE UNIVERSITY-NORTHERN",1,0,2004,"3101","20.670199","64","140","175",57,118,19,"12",7,0.1228,0.1017,0.1086,0.8
"6398",180522,"Montana State University-Northern",1,0,2005,"3335","19.870262","66","140","192",55,137,15,"10",5,0.0909,0.073,0.0781,0.7292
"6399",180522,"Montana State University-Northern",1,0,2006,"3586","22.032229","68","160","193",66,127,12,"5",7,0.1061,0.0394,0.0622,0.829
"6400",180522,"Montana State University-Northern",1,0,2007,"3586","21.339651","67","136","186",69,117,19,"12",7,0.1014,0.1026,0.1022,0.7312
"6401",180522,"Montana State University-Northern",1,0,2008,"3586","21.574333","63","153","199",70,129,14,"5",9,0.1286,0.0388,0.0704,0.7688
"6402",180522,"Montana State University-Northern",1,0,2009,"3586","21.62503","60","178","233",71,162,21,"13",8,0.1127,0.0802,0.0901,0.7639
"6403",180522,"Montana State University-Northern",1,0,2010,"3586","22.957323","62","160","226",78,148,16,"10",6,0.0769,0.0676,0.0708,0.708
"6404",180984,"CONCORDIA TEACHERS COLLEGE",1,0,1991,"7110","10.286791","57","194","204",117,87,58,"17",41,0.3504,0.1954,0.2843,0.951
"6405",180984,"CONCORDIA TEACHERS COLLEGE",1,0,1992,"8090","11.408214","59","189","202",114,88,73,"24",49,0.4298,0.2727,0.3614,0.9356
"6406",180984,"CONCORDIA TEACHERS COLLEGE",1,0,1993,"8506","12.42474","54","210","230",114,116,87,"31",56,0.4912,0.2672,0.3783,0.913
"6407",180984,"CONCORDIA TEACHERS COLLEGE",1,0,1995,"9480","14.489698","65","220","227",128,99,92,"37",55,0.4297,0.3737,0.4053,0.9692
"6408",180984,"CONCORDIA TEACHERS COLLEGE",1,0,1996,"10150","16.076739","59","214","247",133,114,67,"27",40,0.3008,0.2368,0.2713,0.8664
"6409",180984,"CONCORDIA TEACHERS COLLEGE",1,0,1997,"10750","12.662992","58","262","277",152,125,64,"22",42,0.2763,0.176,0.231,0.9458
"6410",180984,"CONCORDIA UNIVERSITY",1,0,1998,"11310","13.746239","55","273","294",172,122,90,"25",65,0.3779,0.2049,0.3061,0.9286
"6411",180984,"CONCORDIA UNIVERSITY",1,0,1999,"11876","15.265017","57","209","324",149,175,86,"41",45,0.302,0.2343,0.2654,0.6451
"6412",180984,"CONCORDIA UNIVERSITY",1,0,2000,"12470","15.815894","56.5","317","329",173,156,84,"42",42,0.2428,0.2692,0.2553,0.9635
"6413",180984,"CONCORDIA UNIVERSITY",1,0,2001,"13468","18.259049","56","245","265",163,102,71,"23",48,0.2945,0.2255,0.2679,0.9245
"6414",180984,"CONCORDIA UNIVERSITY",1,0,2002,"14546","18.401317","51","299","319",175,144,130,"41",89,0.5086,0.2847,0.4075,0.9373
"6415",180984,"CONCORDIA UNIVERSITY",1,0,2003,"16000","18.128441","52","200","222",138,84,77,"25",52,0.3768,0.2976,0.3468,0.9009
"6416",180984,"CONCORDIA UNIVERSITY",1,0,2004,"16880","18.821657","52","247","278",146,132,103,"28",75,0.5137,0.2121,0.3705,0.8885
"6417",180984,"Concordia University",1,0,2005,"17724","20.089695","54","199","289",146,143,113,"33",80,0.5479,0.2308,0.391,0.6886
"6418",180984,"Concordia University",1,0,2006,"18750","21.476806","57","265","302",153,149,114,"43",71,0.4641,0.2886,0.3775,0.8775
"6419",180984,"Concordia University",1,0,2007,"19670","23.018715","56","239","264",141,123,111,"41",70,0.4965,0.3333,0.4205,0.9053
"6420",180984,"Concordia University",1,0,2008,"20580","23.283767","58","245","273",129,144,125,"57",68,0.5271,0.3958,0.4579,0.8974
"6421",180984,"Concordia University",1,0,2009,"21100","23.950575","55","259","288",139,149,117,"47",70,0.5036,0.3154,0.4062,0.8993
"6422",180984,"Concordia University-Seward",1,0,2010,"21940","25.003792","58","254","276",139,137,138,"57",81,0.5827,0.4161,0.5,0.9203
"6423",181002,"CREIGHTON UNIVERSITY",1,0,1991,"8996","143.757323","334","648","750",445,305,430,"170",260,0.5843,0.5574,0.5733,0.864
"6424",181002,"CREIGHTON UNIVERSITY",1,0,1992,"9670","159.745528","344","728","843",517,326,509,"190",319,0.617,0.5828,0.6038,0.8636
"6425",181002,"CREIGHTON UNIVERSITY",1,0,1993,"10252","165.952","342","711","833",492,341,438,"164",274,0.5569,0.4809,0.5258,0.8535
"6426",181002,"CREIGHTON UNIVERSITY",1,0,1995,"11964","184.232714","370","608","746",441,305,421,"157",264,0.5986,0.5148,0.5643,0.815
"6427",181002,"CREIGHTON UNIVERSITY",1,0,1996,"12210","197.673913","373","642","832",494,338,489,"194",295,0.5972,0.574,0.5877,0.7716
"6428",181002,"CREIGHTON UNIVERSITY",1,0,1997,"12756","188.129167","373","627","798",457,341,466,"184",282,0.6171,0.5396,0.584,0.7857
"6429",181002,"CREIGHTON UNIVERSITY",1,0,1998,"13394","195.048159","394","627","794",462,332,481,"195",286,0.619,0.5873,0.6058,0.7897
"6430",181002,"CREIGHTON UNIVERSITY",1,0,1999,"13566","208.33758","374","677","822",499,323,516,"209",307,0.6152,0.6471,0.6277,0.8236
"6431",181002,"CREIGHTON UNIVERSITY",1,0,2000,"14312","217.954618","508.5","719","881",535,346,537,"197",340,0.6355,0.5694,0.6095,0.8161
"6432",181002,"CREIGHTON UNIVERSITY",1,0,2001,"16500","241.519322","643","643","760",440,320,454,"170",284,0.6455,0.5312,0.5974,0.8461
"6433",181002,"CREIGHTON UNIVERSITY",1,0,2002,"18200","253.675065","642","675","802",488,314,534,"191",343,0.7029,0.6083,0.6658,0.8416
"6434",181002,"CREIGHTON UNIVERSITY",1,0,2003,"19202","273.154099","424","792","933",567,366,601,"223",378,0.6667,0.6093,0.6442,0.8489
"6435",181002,"CREIGHTON UNIVERSITY",1,0,2004,"20354","291.447346","431","796","968",584,384,633,"246",387,0.6627,0.6406,0.6539,0.8223
"6436",181002,"Creighton University",1,0,2005,"21576","315.184207","432","789","970",562,408,640,"257",383,0.6815,0.6299,0.6598,0.8134
"6437",181002,"Creighton University",1,0,2006,"24166","333.307793","441","783","965",591,374,653,"257",396,0.6701,0.6872,0.6767,0.8114
"6438",181002,"Creighton University",1,0,2007,"25616","362.535","454","740","947",577,370,638,"254",384,0.6655,0.6865,0.6737,0.7814
"6439",181002,"Creighton University",1,0,2008,"27282","397.717","474","751","984",582,402,647,"257",390,0.6701,0.6393,0.6575,0.7632
"6440",181002,"Creighton University",1,0,2009,"28232","397.536","474","807","1052",635,417,709,"275",434,0.6835,0.6595,0.674,0.7671
"6441",181002,"Creighton University",1,0,2010,"29226","399.909","475","736","1010",606,404,676,"248",428,0.7063,0.6139,0.6693,0.7287
"6442",181020,"DOANE COLLEGE",1,0,1991,"8320","13.039821","54","216","230",116,114,117,"42",75,0.6466,0.3684,0.5087,0.9391
"6443",181020,"DOANE COLLEGE",1,0,1992,"8770","14.14552","55","223","241",125,116,136,"55",81,0.648,0.4741,0.5643,0.9253
"6444",181020,"DOANE COLLEGE",1,0,1993,"9390","15.732051","57","236","246",135,111,127,"52",75,0.5556,0.4685,0.5163,0.9593
"6445",181020,"DOANE COLLEGE",1,0,1995,"10410","18.162436","61","236","243",130,113,140,"56",84,0.6462,0.4956,0.5761,0.9712
"6446",181020,"DOANE COLLEGE",1,0,1996,"10950","19.431858","62","260","276",139,137,146,"62",84,0.6043,0.4526,0.529,0.942
"6447",181020,"DOANE COLLEGE",1,0,1997,"11450","20.472314","64","236","260",134,126,135,"55",80,0.597,0.4365,0.5192,0.9077
"6448",181020,"DOANE COLLEGE",1,0,1998,"11800","15.593151","63","256","266",123,143,156,"70",86,0.6992,0.4895,0.5865,0.9624
"6449",181020,"DOANE COLLEGE",1,0,1999,"12010","16.973116","63","257","278",141,137,174,"79",95,0.6738,0.5766,0.6259,0.9245
"6450",181020,"DOANE COLLEGE",1,0,2000,"12500","18.190459","69","282","300",160,140,174,"75",99,0.6188,0.5357,0.58,0.94
"6451",181020,"DOANE COLLEGE",1,0,2001,"13150","20.088405","75","202","218",118,100,128,"62",66,0.5593,0.62,0.5872,0.9266
"6452",181020,"DOANE COLLEGE",1,0,2002,"13960","21.123196","76","255","273",142,131,178,"84",94,0.662,0.6412,0.652,0.9341
"6453",181020,"DOANE COLLEGE",1,0,2003,"15080","22.324833","79","260","288",152,136,173,"75",98,0.6447,0.5515,0.6007,0.9028
"6454",181020,"DOANE COLLEGE",1,0,2004,"15620","24.150064","80","247","303",172,131,162,"67",95,0.5523,0.5115,0.5347,0.8152
"6455",181020,"Doane College",1,0,2005,"17186","24.80299","81","234","256",146,110,153,"56",97,0.6644,0.5091,0.5977,0.9141
"6456",181020,"Doane College",1,0,2006,"18420","21.816658","74","208","247",147,100,149,"54",95,0.6463,0.54,0.6032,0.8421
"6457",181020,"Doane College",1,0,2007,"18800","23.085298","73","204","259",115,144,132,"65",67,0.5826,0.4514,0.5097,0.7876
"6458",181020,"Doane College",1,0,2008,"19750","23.739208","73","205","247",105,142,135,"62",73,0.6952,0.4366,0.5466,0.83
"6459",181020,"Doane College",1,0,2009,"20540","24.708025","70","278","309",167,142,175,"65",110,0.6587,0.4577,0.5663,0.8997
"6460",181020,"Doane College-Crete",1,0,2010,"21570","24.736539","71","277","327",179,148,163,"52",111,0.6201,0.3514,0.4985,0.8471
"6461",181127,"HASTINGS COLLEGE",1,0,1991,"8090","11.331783","67","227","255",111,144,102,"55",47,0.4234,0.3819,0.4,0.8902
"6462",181127,"HASTINGS COLLEGE",1,0,1992,"8720","11.99066","67","235","254",124,130,112,"43",69,0.5565,0.3308,0.4409,0.9252
"6463",181127,"HASTINGS COLLEGE",1,0,1993,"9296","12.822125","66","250","266",147,119,119,"48",71,0.483,0.4034,0.4474,0.9398
"6464",181127,"HASTINGS COLLEGE",1,0,1995,"10164","14.456406","67","257","271",134,137,117,"44",73,0.5448,0.3212,0.4317,0.9483
"6465",181127,"HASTINGS COLLEGE",1,0,1996,"10724","15.1115","68","250","262",140,122,138,"51",87,0.6214,0.418,0.5267,0.9542
"6466",181127,"HASTINGS COLLEGE",1,0,1997,"11368","12.062364","68","272","282",145,137,145,"50",95,0.6552,0.365,0.5142,0.9645
"6467",181127,"HASTINGS COLLEGE",1,0,1998,"11940","12.781665","68","289","309",168,141,160,"57",103,0.6131,0.4043,0.5178,0.9353
"6468",181127,"HASTINGS COLLEGE",1,0,1999,"11916","14.211337","70","267","286",141,145,146,"54",92,0.6525,0.3724,0.5105,0.9336
"6469",181127,"HASTINGS COLLEGE",1,0,2000,"12396","14.70112","71.5","256","271",119,152,129,"61",68,0.5714,0.4013,0.476,0.9446
"6470",181127,"HASTINGS COLLEGE",1,0,2001,"13116","15.566798","73","235","252",125,127,130,"55",75,0.6,0.4331,0.5159,0.9325
"6471",181127,"HASTINGS COLLEGE",1,0,2002,"13972","16.087049","74","261","276",132,144,148,"57",91,0.6894,0.3958,0.5362,0.9457
"6472",181127,"HASTINGS COLLEGE",1,0,2003,"14782","17.140354","80","313","338",143,195,185,"87",98,0.6853,0.4462,0.5473,0.926
"6473",181127,"HASTINGS COLLEGE",1,0,2004,"15640","18.528913","81","265","289",140,149,152,"60",92,0.6571,0.4027,0.526,0.917
"6474",181127,"Hastings College",1,0,2005,"16578","20.190245","79","288","312",133,179,143,"69",74,0.5564,0.3855,0.4583,0.9231
"6475",181127,"Hastings College",1,0,2006,"17572","21.583446","84","242","262",111,151,122,"57",65,0.5856,0.3775,0.4656,0.9237
"6476",181127,"Hastings College",1,0,2007,"18822","22.614822","87","275","302",117,185,131,"70",61,0.5214,0.3784,0.4338,0.9106
"6477",181127,"Hastings College",1,0,2008,"19952","22.965026","86","282","320",151,169,153,"63",90,0.596,0.3728,0.4781,0.8812
"6478",181127,"Hastings College",1,0,2009,"20912","23.846967","86","252","290",150,140,132,"50",82,0.5467,0.3571,0.4552,0.869
"6479",181127,"Hastings College",1,0,2010,"21720","23.656297","81","277","312",150,162,144,"66",78,0.52,0.4074,0.4615,0.8878
"6480",181215,"UNIVERSITY OF NEBRASKA AT KEARNEY",1,0,1991,"1572","40.468921","296","1099","1230",665,565,141,"54",87,0.1308,0.0956,0.1146,0.8935
"6481",181215,"UNIVERSITY OF NEBRASKA AT KEARNEY",1,0,1992,"1720","44.011438","309","1151","1322",723,599,137,"38",99,0.1369,0.0634,0.1036,0.8707
"6482",181215,"UNIVERSITY OF NEBRASKA AT KEARNEY",1,0,1993,"1811","47.394372","309","844","936",501,435,124,"37",87,0.1737,0.0851,0.1325,0.9017
"6483",181215,"UNIVERSITY OF NEBRASKA AT KEARNEY",1,0,1995,"2061","48.439098","311","1154","1306",729,577,138,"46",92,0.1262,0.0797,0.1057,0.8836
"6484",181215,"UNIVERSITY OF NEBRASKA AT KEARNEY",1,0,1996,"2145","50.085079","317","1117","1279",707,572,174,"59",115,0.1627,0.1031,0.136,0.8733
"6485",181215,"UNIVERSITY OF NEBRASKA AT KEARNEY",1,0,1997,"2268","54.415376","314","885","1005",570,435,174,"60",114,0.2,0.1379,0.1731,0.8806
"6486",181215,"UNIVERSITY OF NEBRASKA AT KEARNEY",1,0,1998,"2508","53.665269","316","895","1022",598,424,204,"55",149,0.2492,0.1297,0.1996,0.8757
"6487",181215,"UNIVERSITY OF NEBRASKA AT KEARNEY",1,0,1999,"2122","57.681132","321","949","1035",579,456,212,"71",141,0.2435,0.1557,0.2048,0.9169
"6488",181215,"UNIVERSITY OF NEBRASKA AT KEARNEY",1,0,2000,"2243","58.561904","316.5","897","996",550,446,159,"48",111,0.2018,0.1076,0.1596,0.9006
"6489",181215,"UNIVERSITY OF NEBRASKA AT KEARNEY",1,0,2001,"2468","63.241473","312","896","1038",602,436,213,"62",151,0.2508,0.1422,0.2052,0.8632
"6490",181215,"UNIVERSITY OF NEBRASKA AT KEARNEY",1,0,2002,"2715","64.40106","307","865","1022",574,448,216,"69",147,0.2561,0.154,0.2114,0.8464
"6491",181215,"UNIVERSITY OF NEBRASKA AT KEARNEY",1,0,2003,"3120","67.975016","294","864","1012",588,424,229,"73",156,0.2653,0.1722,0.2263,0.8538
"6492",181215,"UNIVERSITY OF NEBRASKA AT KEARNEY",1,0,2004,"3495","67.738314","298","906","1061",589,472,238,"85",153,0.2598,0.1801,0.2243,0.8539
"6493",181215,"University of Nebraska at Kearney",1,0,2005,"3668","72.825848","306","848","1013",584,429,228,"71",157,0.2688,0.1655,0.2251,0.8371
"6494",181215,"University of Nebraska at Kearney",1,0,2006,"3885","75.743712","309","771","937",521,416,202,"80",122,0.2342,0.1923,0.2156,0.8228
"6495",181215,"University of Nebraska at Kearney",1,0,2007,"4118","79.638296","305","729","915",484,431,193,"74",119,0.2459,0.1717,0.2109,0.7967
"6496",181215,"University of Nebraska at Kearney",1,0,2008,"4365","81.018845","304","816","1019",530,489,232,"87",145,0.2736,0.1779,0.2277,0.8008
"6497",181215,"University of Nebraska at Kearney",1,0,2009,"4538","86.640085","305","764","974",548,426,231,"81",150,0.2737,0.1901,0.2372,0.7844
"6498",181215,"University of Nebraska at Kearney",1,0,2010,"4808","89.655008","306","922","1124",656,468,305,"96",209,0.3186,0.2051,0.2714,0.8203
"6499",181394,"UNIVERSITY OF NEBRASKA AT OMAHA",1,0,1991,"1242","82.800372","399","1049","1275",635,640,70,"31",39,0.0614,0.0484,0.0549,0.8227
"6500",181394,"UNIVERSITY OF NEBRASKA AT OMAHA",1,0,1992,"1467","90.009848","398","982","1256",630,626,54,"19",35,0.0556,0.0304,0.043,0.7818
"6501",181394,"UNIVERSITY OF NEBRASKA AT OMAHA",1,0,1993,"1535","91.560554","403","1025","1220",664,556,52,"14",38,0.0572,0.0252,0.0426,0.8402
"6502",181394,"UNIVERSITY OF NEBRASKA AT OMAHA",1,0,1995,"1790","90.728434","415","929","1123",607,516,64,"20",44,0.0725,0.0388,0.057,0.8272
"6503",181394,"UNIVERSITY OF NEBRASKA AT OMAHA",1,0,1996,"1848","97.266842","422","954","1129",588,541,87,"32",55,0.0935,0.0591,0.0771,0.845
"6504",181394,"UNIVERSITY OF NEBRASKA AT OMAHA",1,0,1997,"1926","102.97243","438","960","1185",615,570,95,"33",62,0.1008,0.0579,0.0802,0.8101
"6505",181394,"UNIVERSITY OF NEBRASKA AT OMAHA",1,0,1998,"2144","107.920237","434","1072","1296",701,595,120,"42",78,0.1113,0.0706,0.0926,0.8272
"6506",181394,"UNIVERSITY OF NEBRASKA AT OMAHA",1,0,1999,"2393","114.610928","423","1251","1477",762,715,151,"45",106,0.1391,0.0629,0.1022,0.847
"6507",181394,"UNIVERSITY OF NEBRASKA AT OMAHA",1,0,2000,"2528","119.99646","434","1273","1517",825,692,157,"55",102,0.1236,0.0795,0.1035,0.8392
"6508",181394,"UNIVERSITY OF NEBRASKA AT OMAHA",1,0,2001,"2226","129.097646","445","1338","1588",857,731,170,"62",108,0.126,0.0848,0.1071,0.8426
"6509",181394,"UNIVERSITY OF NEBRASKA AT OMAHA",1,0,2002,"3060","142.998354","467","1355","1601",851,750,199,"77",122,0.1434,0.1027,0.1243,0.8463
"6510",181394,"UNIVERSITY OF NEBRASKA AT OMAHA",1,0,2003,"3518","141.786214","452","1261","1465",787,678,189,"85",104,0.1321,0.1254,0.129,0.8608
"6511",181394,"UNIVERSITY OF NEBRASKA AT OMAHA",1,0,2004,"3938","143.621846","448","1366","1577",878,699,201,"78",123,0.1401,0.1116,0.1275,0.8662
"6512",181394,"University of Nebraska at Omaha",1,0,2005,"4133","151.900435","465","1402","1690",911,779,259,"105",154,0.169,0.1348,0.1533,0.8296
"6513",181394,"University of Nebraska at Omaha",1,0,2006,"4380","157.736019","472","1349","1637",864,773,231,"95",136,0.1574,0.1229,0.1411,0.8241
"6514",181394,"University of Nebraska at Omaha",1,0,2007,"4643","162.760139","474","1279","1596",834,762,228,"106",122,0.1463,0.1391,0.1429,0.8014
"6515",181394,"University of Nebraska at Omaha",1,0,2008,"4920","172.893965","479","1419","1755",920,835,286,"107",179,0.1946,0.1281,0.163,0.8085
"6516",181394,"University of Nebraska at Omaha",1,0,2009,"5115","186.648714","483","1393","1747",932,815,278,"93",185,0.1985,0.1141,0.1591,0.7974
"6517",181394,"University of Nebraska at Omaha",1,0,2010,"5423","192.040731","466","1281","1703",925,778,14,"8",6,0.0065,0.0103,0.0082,0.7522
"6518",181446,"NEBRASKA WESLEYAN UNIVERSITY",1,0,1991,"8226","17.034855","87","319","343",192,151,170,"72",98,0.5104,0.4768,0.4956,0.93
"6519",181446,"NEBRASKA WESLEYAN UNIVERSITY",1,0,1992,"8430","17.569952","86","348","366",212,154,174,"72",102,0.4811,0.4675,0.4754,0.9508
"6520",181446,"NEBRASKA WESLEYAN UNIVERSITY",1,0,1993,"8894","18.344613","87","363","382",218,164,153,"62",91,0.4174,0.378,0.4005,0.9503
"6521",181446,"NEBRASKA WESLEYAN UNIVERSITY",1,0,1995,"9890","19.622125","91","338","362",214,148,164,"57",107,0.5,0.3851,0.453,0.9337
"6522",181446,"NEBRASKA WESLEYAN UNIVERSITY",1,0,1996,"10284","20.199394","89","367","383",225,158,202,"79",123,0.5467,0.5,0.5274,0.9582
"6523",181446,"NEBRASKA WESLEYAN UNIVERSITY",1,0,1997,"11220","17.507521","86","422","437",250,187,205,"87",118,0.472,0.4652,0.4691,0.9657
"6524",181446,"NEBRASKA WESLEYAN UNIVERSITY",1,0,1998,"12004","18.854985","89","415","429",246,183,200,"76",124,0.5041,0.4153,0.4662,0.9674
"6525",181446,"NEBRASKA WESLEYAN UNIVERSITY",1,0,1999,"12584","19.457026","92","343","358",204,154,197,"84",113,0.5539,0.5455,0.5503,0.9581
"6526",181446,"NEBRASKA WESLEYAN UNIVERSITY",1,0,2000,"13452","21.626948","95.5","403","423",254,169,235,"87",148,0.5827,0.5148,0.5556,0.9527
"6527",181446,"NEBRASKA WESLEYAN UNIVERSITY",1,0,2001,"14380","23.536416","99","374","392",223,169,219,"84",135,0.6054,0.497,0.5587,0.9541
"6528",181446,"NEBRASKA WESLEYAN UNIVERSITY",1,0,2002,"15372","24.366841","95","316","336",187,149,157,"70",87,0.4652,0.4698,0.4673,0.9405
"6529",181446,"NEBRASKA WESLEYAN UNIVERSITY",1,0,2003,"16140","23.602744","101","396","417",241,176,216,"83",133,0.5519,0.4716,0.518,0.9496
"6530",181446,"NEBRASKA WESLEYAN UNIVERSITY",1,0,2004,"17090","25.706157","103","406","428",238,190,223,"101",122,0.5126,0.5316,0.521,0.9486
"6531",181446,"Nebraska Wesleyan University",1,0,2005,"18100","28.125978","105","394","406",237,169,236,"82",154,0.6498,0.4852,0.5813,0.9704
"6532",181446,"Nebraska Wesleyan University",1,0,2006,"18980","30.622","109","385","413",212,201,212,"94",118,0.5566,0.4677,0.5133,0.9322
"6533",181446,"Nebraska Wesleyan University",1,0,2007,"19930","31.192336","110","414","438",272,166,239,"74",165,0.6066,0.4458,0.5457,0.9452
"6534",181446,"Nebraska Wesleyan University",1,0,2008,"20950","32.964","115","352","383",212,171,211,"76",135,0.6368,0.4444,0.5509,0.9191
"6535",181446,"Nebraska Wesleyan University",1,0,2009,"21980","33.645","113","364","393",233,160,201,"63",138,0.5923,0.3938,0.5115,0.9262
"6536",181446,"Nebraska Wesleyan University",1,0,2010,"23124","34.671","118","376","427",237,190,256,"106",150,0.6329,0.5579,0.5995,0.8806
"6537",181464,"UNIVERSITY OF NEBRASKA AT LINCOLN",1,0,1991,"2040","337.727423","1127","3162","3386",1641,1745,379,"121",258,0.1572,0.0693,0.1119,0.9338
"6538",181464,"UNIVERSITY OF NEBRASKA AT LINCOLN",1,0,1992,"2187","351.232634","1126","3154","3392",1651,1741,330,"124",206,0.1248,0.0712,0.0973,0.9298
"6539",181464,"UNIVERSITY OF NEBRASKA AT LINCOLN",1,0,1993,"2283","374.848426","1127","3079","3325",1571,1754,449,"170",279,0.1776,0.0969,0.135,0.926
"6540",181464,"UNIVERSITY OF NEBRASKA AT LINCOLN",1,0,1995,"2555","402.380083","1115","3514","3891",1925,1966,620,"256",364,0.1891,0.1302,0.1593,0.9031
"6541",181464,"UNIVERSITY OF NEBRASKA AT LINCOLN",1,0,1996,"2638","426.433479","1100","3258","3625",1814,1811,654,"248",406,0.2238,0.1369,0.1804,0.8988
"6542",181464,"UNIVERSITY OF NEBRASKA AT LINCOLN",1,0,1997,"2829","438.946659","1127","2863","3195",1596,1599,681,"259",422,0.2644,0.162,0.2131,0.8961
"6543",181464,"UNIVERSITY OF NEBRASKA AT LINCOLN",1,0,1998,"3083","458.991962","1129","3026","3353",1619,1734,740,"275",465,0.2872,0.1586,0.2207,0.9025
"6544",181464,"UNIVERSITY OF NEBRASKA AT LINCOLN",1,0,1999,"2617","476.891263","1154","3259","3592",1778,1814,807,"317",490,0.2756,0.1748,0.2247,0.9073
"6545",181464,"UNIVERSITY OF NEBRASKA AT LINCOLN",1,0,2000,"2760","501.365402","1135","3123","3598",1783,1815,823,"326",497,0.2787,0.1796,0.2287,0.868
"6546",181464,"UNIVERSITY OF NEBRASKA AT LINCOLN",1,0,2001,"3038","528.298783","1116","3090","3480",1691,1789,788,"308",480,0.2839,0.1722,0.2264,0.8879
"6547",181464,"UNIVERSITY OF NEBRASKA AT LINCOLN",1,0,2002,"3345","568.031448","1088","3158","3615",1878,1737,919,"358",561,0.2987,0.2061,0.2542,0.8736
"6548",181464,"UNIVERSITY OF NEBRASKA AT LINCOLN",1,0,2003,"3847","597.065435","1035","3184","3639",1825,1814,904,"341",563,0.3085,0.188,0.2484,0.875
"6549",181464,"UNIVERSITY OF NEBRASKA AT LINCOLN",1,0,2004,"4312","598.279547","1038","2817","3236",1559,1677,950,"394",556,0.3566,0.2349,0.2936,0.8705
"6550",181464,"University of Nebraska at Lincoln",1,0,2005,"4530","636.364245","1129","3012","3533",1671,1862,1118,"505",613,0.3668,0.2712,0.3164,0.8525
"6551",181464,"University of Nebraska at Lincoln",1,0,2006,"4800","696.872283","1131","3245","3828",1805,2023,1126,"503",623,0.3452,0.2486,0.2941,0.8477
"6552",181464,"University of Nebraska-Lincoln",1,0,2007,"5085","718.615513","1164","3423","4214",2061,2153,1363,"555",808,0.392,0.2578,0.3234,0.8123
"6553",181464,"University of Nebraska-Lincoln",1,0,2008,"5392","768.039632","1166","3582","4164",2015,2149,1377,"566",811,0.4025,0.2634,0.3307,0.8602
"6554",181464,"University of Nebraska-Lincoln",1,0,2009,"5610","773.014038","1152","3409","3965",1870,2095,1308,"552",756,0.4043,0.2635,0.3299,0.8598
"6555",181464,"University of Nebraska-Lincoln",1,0,2010,"5948","810.080585","1180","3510","4039",1889,2150,1461,"647",814,0.4309,0.3009,0.3617,0.869
"6556",181534,"PERU STATE COLLEGE",1,0,1991,"1589","8.714263","49","211","235",129,106,24,"7",17,0.1318,0.066,0.1021,0.8979
"6557",181534,"PERU STATE COLLEGE",1,0,1992,"1671","9.312664","48","247","264",135,129,27,"9",18,0.1333,0.0698,0.1023,0.9356
"6558",181534,"PERU STATE COLLEGE",1,0,1993,"1687","9.188715","50","200","211",112,99,22,"4",18,0.1607,0.0404,0.1043,0.9479
"6559",181534,"PERU STATE COLLEGE",1,0,1995,"1848","10.458102","47","205","225",122,103,45,"19",26,0.2131,0.1845,0.2,0.9111
"6560",181534,"PERU STATE COLLEGE",1,0,1996,"1936","10.166059","46","199","223",97,126,38,"11",27,0.2784,0.0873,0.1704,0.8924
"6561",181534,"PERU STATE COLLEGE",1,0,1997,"2018","11.022961","43","222","258",107,151,38,"16",22,0.2056,0.106,0.1473,0.8605
"6562",181534,"PERU STATE COLLEGE",1,0,1998,"2161","12.232947","42","184","213",91,122,22,"3",19,0.2088,0.0246,0.1033,0.8638
"6563",181534,"PERU STATE COLLEGE",1,0,1999,"1875","11.681835","43","168","192",87,105,65,"31",34,0.3908,0.2952,0.3385,0.875
"6564",181534,"PERU STATE COLLEGE",1,0,2000,"1973","12.576754","41.5","170","201",93,108,26,"7",19,0.2043,0.0648,0.1294,0.8458
"6565",181534,"PERU STATE COLLEGE",1,0,2001,"2093","13.572083","40","164","186",85,101,16,"5",11,0.1294,0.0495,0.086,0.8817
"6566",181534,"PERU STATE COLLEGE",1,0,2002,"2288","12.767281","41","149","171",85,86,29,"10",19,0.2235,0.1163,0.1696,0.8713
"6567",181534,"PERU STATE COLLEGE",1,0,2003,"2610","12.214534","39","161","188",89,99,29,"9",20,0.2247,0.0909,0.1543,0.8564
"6568",181534,"PERU STATE COLLEGE",1,0,2004,"2850","12.469766","40","189","217",114,103,21,"5",16,0.1404,0.0485,0.0968,0.871
"6569",181534,"Peru State College",1,0,2005,"2932","13.664281","45","174","213",112,101,26,"7",19,0.1696,0.0693,0.1221,0.8169
"6570",181534,"Peru State College",1,0,2006,"3296","14.97906","47","166","204",95,109,37,"17",20,0.2105,0.156,0.1814,0.8137
"6571",181534,"Peru State College",1,0,2007,"3300","15.82754","45","159","197",89,108,38,"13",25,0.2809,0.1204,0.1929,0.8071
"6572",181534,"Peru State College",1,0,2008,"3495","16.306709","48","178","210",101,109,23,"10",13,0.1287,0.0917,0.1095,0.8476
"6573",181534,"Peru State College",1,0,2009,"3675","17.649246","46","190","227",113,114,35,"12",23,0.2035,0.1053,0.1542,0.837
"6574",181534,"Peru State College",1,0,2010,"3863","18.936703","46","209","243",117,126,32,"6",26,0.2222,0.0476,0.1317,0.8601
"6575",181783,"WAYNE STATE COLLEGE",1,0,1991,"1515","18.322659","120","649","681",357,324,103,"38",65,0.1821,0.1173,0.1512,0.953
"6576",181783,"WAYNE STATE COLLEGE",1,0,1992,"1599","20.530338","124","605","630",348,282,117,"39",78,0.2241,0.1383,0.1857,0.9603
"6577",181783,"WAYNE STATE COLLEGE",1,0,1993,"1690","22.240775","125","674","718",398,320,105,"25",80,0.201,0.0781,0.1462,0.9387
"6578",181783,"WAYNE STATE COLLEGE",1,0,1995,"1839","22.569584","131","666","722",382,340,146,"45",101,0.2644,0.1324,0.2022,0.9224
"6579",181783,"WAYNE STATE COLLEGE",1,0,1996,"1938","23.071494","132","636","690",397,293,147,"53",94,0.2368,0.1809,0.213,0.9217
"6580",181783,"WAYNE STATE COLLEGE",1,0,1997,"2080","25.384873","138","641","707",407,300,161,"42",119,0.2924,0.14,0.2277,0.9066
"6581",181783,"WAYNE STATE COLLEGE",1,0,1998,"2163","28.450133","138","636","700",402,298,177,"56",121,0.301,0.1879,0.2529,0.9086
"6582",181783,"WAYNE STATE COLLEGE",1,0,1999,"1875","28.738649","140","601","659",387,272,150,"41",109,0.2817,0.1507,0.2276,0.912
"6583",181783,"WAYNE STATE COLLEGE",1,0,2000,"1973","28.394852","134.5","573","623",366,257,168,"49",119,0.3251,0.1907,0.2697,0.9197
"6584",181783,"WAYNE STATE COLLEGE",1,0,2001,"2093","29.874686","129","524","583",359,224,138,"40",98,0.273,0.1786,0.2367,0.8988
"6585",181783,"WAYNE STATE COLLEGE",1,0,2002,"2288","28.458899","126","533","602",325,277,155,"66",89,0.2738,0.2383,0.2575,0.8854
"6586",181783,"WAYNE STATE COLLEGE",1,0,2003,"2610","30.177919","126","536","598",342,256,163,"59",104,0.3041,0.2305,0.2726,0.8963
"6587",181783,"WAYNE STATE COLLEGE",1,0,2004,"2850","29.469265","127","494","552",310,242,128,"39",89,0.2871,0.1612,0.2319,0.8949
"6588",181783,"Wayne State College",1,0,2005,"2346","32.263826","126","533","587",320,267,162,"71",91,0.2844,0.2659,0.276,0.908
"6589",181783,"Wayne State College",1,0,2006,"2460","34.403301","130","527","606",335,271,166,"53",113,0.3373,0.1956,0.2739,0.8696
"6590",181783,"Wayne State College",1,0,2007,"2640","36.975172","132","554","654",364,290,162,"48",114,0.3132,0.1655,0.2477,0.8471
"6591",181783,"Wayne State College",1,0,2008,"2796","38.256194","125","568","653",345,308,148,"52",96,0.2783,0.1688,0.2266,0.8698
"6592",181783,"Wayne State College",1,0,2009,"3675","40.006081","123","537","663",361,302,158,"56",102,0.2825,0.1854,0.2383,0.81
"6593",181783,"Wayne State College",1,0,2010,"3863","39.772973","125","537","677",366,311,172,"58",114,0.3115,0.1865,0.2541,0.7932
"6594",182281,"UNIVERSITY OF NEVADA-LAS VEGAS",1,0,1991,"1470","128.59707","598","796","1172",604,568,125,"47",78,0.1291,0.0827,0.1067,0.6792
"6595",182281,"UNIVERSITY OF NEVADA-LAS VEGAS",1,0,1992,"1665","136.56647","593","838","1213",641,572,128,"44",84,0.131,0.0769,0.1055,0.6908
"6596",182281,"UNIVERSITY OF NEVADA-LAS VEGAS",1,0,1993,"1665","132.663452","642","828","1281",669,612,127,"47",80,0.1196,0.0768,0.0991,0.6464
"6597",182281,"UNIVERSITY OF NEVADA-LAS VEGAS",1,0,1995,"1830","161.243842","612","837","1324",748,576,161,"54",107,0.143,0.0938,0.1216,0.6322
"6598",182281,"UNIVERSITY OF NEVADA-LAS VEGAS",1,0,1996,"1920","170.948752","607","911","1509",797,712,179,"49",130,0.1631,0.0688,0.1186,0.6037
"6599",182281,"UNIVERSITY OF NEVADA-LAS VEGAS",1,0,1997,"1995","185.518","612","903","1491",773,718,183,"54",129,0.1669,0.0752,0.1227,0.6056
"6600",182281,"UNIVERSITY OF NEVADA-LAS VEGAS",1,0,1998,"2070","201.028","632","910","1546",885,661,186,"58",128,0.1446,0.0877,0.1203,0.5886
"6601",182281,"UNIVERSITY OF NEVADA-LAS VEGAS",1,0,1999,"2145","221.58","676","886","1486",805,681,204,"73",131,0.1627,0.1072,0.1373,0.5962
"6602",182281,"UNIVERSITY OF NEVADA-LAS VEGAS",1,0,2000,"2340","238.686","698.5","1224","2126",1182,944,240,"70",170,0.1438,0.0742,0.1129,0.5757
"6603",182281,"UNIVERSITY OF NEVADA-LAS VEGAS",1,0,2001,"2415","258.243","721","1368","2424",1411,1013,324,"99",225,0.1595,0.0977,0.1337,0.5644
"6604",182281,"UNIVERSITY OF NEVADA-LAS VEGAS",1,0,2002,"2490","289.486","755","1292","2383",1373,1010,293,"80",213,0.1551,0.0792,0.123,0.5422
"6605",182281,"UNIVERSITY OF NEVADA-LAS VEGAS",1,0,2003,"2670","327.822","776","1496","2827",1596,1231,338,"107",231,0.1447,0.0869,0.1196,0.5292
"6606",182281,"UNIVERSITY OF NEVADA-LAS VEGAS",1,0,2004,"2850","361.73","810","1604","3108",1760,1348,428,"134",294,0.167,0.0994,0.1377,0.5161
"6607",182281,"University of Nevada-Las Vegas",1,0,2005,"3060","400.752","851","1140","2964",1694,1270,402,"134",268,0.1582,0.1055,0.1356,0.3846
"6608",182281,"University of Nevada-Las Vegas",1,0,2006,"3278","442.719","950","1225","2532",1410,1122,368,"130",238,0.1688,0.1159,0.1453,0.4838
"6609",182281,"University of Nevada-Las Vegas",1,0,2007,"3623","496.268","960","1305","2780",1596,1184,406,"117",289,0.1811,0.0988,0.146,0.4694
"6610",182281,"University of Nevada-Las Vegas",1,0,2008,"4005","506.07","904","1318","3020",1709,1311,422,"142",280,0.1638,0.1083,0.1397,0.4364
"6611",182281,"University of Nevada-Las Vegas",1,0,2009,"4485","535.183","897","1307","3083",1659,1424,397,"146",251,0.1513,0.1025,0.1288,0.4239
"6612",182281,"University of Nevada-Las Vegas",1,0,2010,"5196","528.454","842","1141","2923",1621,1302,341,"117",224,0.1382,0.0899,0.1167,0.3904
"6613",182290,"UNIVERSITY OF NEVADA-RENO",1,0,1991,"1104","154.949042","390","751","966",482,484,101,"43",58,0.1203,0.0888,0.1046,0.7774
"6614",182290,"UNIVERSITY OF NEVADA-RENO",1,0,1992,"1308","174.740001","404","855","1058",523,535,119,"41",78,0.1491,0.0766,0.1125,0.8081
"6615",182290,"UNIVERSITY OF NEVADA-RENO",1,0,1993,"1332","186.56419","403","915","1140",563,577,155,"49",106,0.1883,0.0849,0.136,0.8026
"6616",182290,"UNIVERSITY OF NEVADA-RENO",1,0,1995,"1464","211.175647","386","790","1035",591,444,170,"52",118,0.1997,0.1171,0.1643,0.7633
"6617",182290,"UNIVERSITY OF NEVADA-RENO",1,0,1996,"1650","236.116925","429","871","1123",605,518,163,"46",117,0.1934,0.0888,0.1451,0.7756
"6618",182290,"UNIVERSITY OF NEVADA-RENO",1,0,1997,"1710","249.917881","430","888","1165",654,511,171,"54",117,0.1789,0.1057,0.1468,0.7622
"6619",182290,"UNIVERSITY OF NEVADA-RENO",1,0,1998,"1770","266.116997","424","973","1260",675,585,181,"60",121,0.1793,0.1026,0.1437,0.7722
"6620",182290,"UNIVERSITY OF NEVADA-RENO",1,0,1999,"1704","278.997644","434","1116","1466",792,674,241,"78",163,0.2058,0.1157,0.1644,0.7613
"6621",182290,"UNIVERSITY OF NEVADA-RENO",1,0,2000,"2340","302.193675","447","1461","1930",1090,840,293,"95",198,0.1817,0.1131,0.1518,0.757
"6622",182290,"UNIVERSITY OF NEVADA-RENO",1,0,2001,"2415","325.222048","460","1504","1956",1125,831,268,"78",190,0.1689,0.0939,0.137,0.7689
"6623",182290,"UNIVERSITY OF NEVADA-RENO",1,0,2002,"2490","345.544002","750","1571","2066",1137,929,308,"102",206,0.1812,0.1098,0.1491,0.7604
"6624",182290,"UNIVERSITY OF NEVADA-RENO",1,0,2003,"2670","370.375597","712","1479","2047",1154,893,254,"76",178,0.1542,0.0851,0.1241,0.7225
"6625",182290,"UNIVERSITY OF NEVADA-RENO",1,0,2004,"2850","405.526548","639","1467","2132",1157,975,289,"104",185,0.1599,0.1067,0.1356,0.6881
"6626",182290,"University of Nevada-Reno",1,0,2005,"3060","430.31635","639","1598","2362",1300,1062,383,"136",247,0.19,0.1281,0.1622,0.6765
"6627",182290,"University of Nevada-Reno",1,0,2006,"3278","470.571744","656","1576","2358",1300,1058,407,"146",261,0.2008,0.138,0.1726,0.6684
"6628",182290,"University of Nevada-Reno",1,0,2007,"3623","494.500285","658","1498","2226",1166,1060,349,"131",218,0.187,0.1236,0.1568,0.673
"6629",182290,"University of Nevada-Reno",1,0,2008,"4005","518.632844","660","1513","2260",1211,1049,467,"179",288,0.2378,0.1706,0.2066,0.6695
"6630",182290,"University of Nevada-Reno",1,0,2009,"4485","530.395743","645","1484","2124",1144,980,467,"172",295,0.2579,0.1755,0.2199,0.6987
"6631",182290,"University of Nevada-Reno",1,0,2010,"5063","517.013048","631","1785","2693",1430,1263,610,"233",377,0.2636,0.1845,0.2265,0.6628
"6632",182634,"COLBY-SAWYER COLLEGE",1,0,1991,"11900","9.580816","34","213","215",137,78,99,"29",70,0.5109,0.3718,0.4605,0.9907
"6633",182634,"COLBY-SAWYER COLLEGE",1,0,1992,"12775","11.259958","34","158","160",106,54,73,"23",50,0.4717,0.4259,0.4562,0.9875
"6634",182634,"COLBY-SAWYER COLLEGE",1,0,1993,"13375","12.451295","38","173","179",115,64,72,"24",48,0.4174,0.375,0.4022,0.9665
"6635",182634,"COLBY-SAWYER COLLEGE",1,0,1995,"14720","15.371654","40","230","240",154,86,115,"46",69,0.4481,0.5349,0.4792,0.9583
"6636",182634,"COLBY-SAWYER COLLEGE",1,0,1996,"15530","20.331074","41","220","227",158,69,91,"31",60,0.3797,0.4493,0.4009,0.9692
"6637",182634,"COLBY-SAWYER COLLEGE",1,0,1997,"16310","14.952938","40","214","240",172,68,111,"29",82,0.4767,0.4265,0.4625,0.8917
"6638",182634,"COLBY-SAWYER COLLEGE",1,0,1998,"17270","16.330069","41","221","235",162,73,111,"29",82,0.5062,0.3973,0.4723,0.9404
"6639",182634,"COLBY-SAWYER COLLEGE",1,0,1999,"18060","16.479783","42","224","236",151,85,115,"47",68,0.4503,0.5529,0.4873,0.9492
"6640",182634,"COLBY-SAWYER COLLEGE",1,0,2000,"18960","18.05402","45","262","274",180,94,148,"47",101,0.5611,0.5,0.5401,0.9562
"6641",182634,"COLBY-SAWYER COLLEGE",1,0,2001,"20130","22.028442","48","254","285",184,101,140,"43",97,0.5272,0.4257,0.4912,0.8912
"6642",182634,"COLBY-SAWYER COLLEGE",1,0,2002,"21140","21.559013","50","261","270",172,98,133,"54",79,0.4593,0.551,0.4926,0.9667
"6643",182634,"COLBY-SAWYER COLLEGE",1,0,2003,"22200","23.947025","47","294","304",207,97,158,"34",124,0.599,0.3505,0.5197,0.9671
"6644",182634,"COLBY-SAWYER COLLEGE",1,0,2004,"23310","25.306955","53","255","263",179,84,140,"42",98,0.5475,0.5,0.5323,0.9696
"6645",182634,"Colby-Sawyer College",1,0,2005,"24700","25.791426","54","271","280",179,101,130,"42",88,0.4916,0.4158,0.4643,0.9679
"6646",182634,"Colby-Sawyer College",1,0,2006,"26350","26.888222","55","200","220",151,69,95,"22",73,0.4834,0.3188,0.4318,0.9091
"6647",182634,"Colby-Sawyer College",1,0,2007,"28010","27.909484","47","306","353",240,113,169,"44",125,0.5208,0.3894,0.4788,0.8669
"6648",182634,"Colby-Sawyer College",1,0,2008,"29620","28.21481","51","323","376",251,125,138,"44",94,0.3745,0.352,0.367,0.859
"6649",182634,"Colby-Sawyer College",1,0,2009,"31090","29.64645","60","357","432",313,119,190,"45",145,0.4633,0.3782,0.4398,0.8264
"6650",182634,"Colby-Sawyer College",1,0,2010,"32640","32.101843","64","271","393",266,127,185,"51",134,0.5038,0.4016,0.4707,0.6896
"6651",182795,"FRANKLIN PIERCE COLLEGE",1,0,1991,"11510","24.741925","73","337","429",192,237,124,"57",67,0.349,0.2405,0.289,0.7855
"6652",182795,"FRANKLIN PIERCE COLLEGE",1,0,1992,"12430","26.546376","75","340","469",236,233,178,"82",96,0.4068,0.3519,0.3795,0.7249
"6653",182795,"FRANKLIN PIERCE COLLEGE",1,0,1993,"12820","28.721347","76","377","410",186,224,117,"64",53,0.2849,0.2857,0.2854,0.9195
"6654",182795,"FRANKLIN PIERCE COLLEGE",1,0,1995,"14445","28.815591","61","383","464",220,244,174,"75",99,0.45,0.3074,0.375,0.8254
"6655",182795,"FRANKLIN PIERCE COLLEGE",1,0,1996,"15375","33.011747","67","313","438",210,228,181,"81",100,0.4762,0.3553,0.4132,0.7146
"6656",182795,"FRANKLIN PIERCE COLLEGE",1,0,1997,"16325","30.306025","69","398","489",257,232,178,"69",109,0.4241,0.2974,0.364,0.8139
"6657",182795,"FRANKLIN PIERCE COLLEGE",1,0,1998,"17022","29.927875","68","330","429",203,226,145,"59",86,0.4236,0.2611,0.338,0.7692
"6658",182795,"FRANKLIN PIERCE COLLEGE",1,0,1999,"17250","31.9021","67","363","429",184,245,189,"103",86,0.4674,0.4204,0.4406,0.8462
"6659",182795,"FRANKLIN PIERCE COLLEGE",1,0,2000,"18150","32.388557","66","442","530",262,268,227,"101",126,0.4809,0.3769,0.4283,0.834
"6660",182795,"FRANKLIN PIERCE COLLEGE",1,0,2001,"18900","34.227107","65","387","477",249,228,153,"67",86,0.3454,0.2939,0.3208,0.8113
"6661",182795,"FRANKLIN PIERCE COLLEGE",1,0,2002,"19560","36.375182","61","417","505",252,253,197,"88",109,0.4325,0.3478,0.3901,0.8257
"6662",182795,"FRANKLIN PIERCE COLLEGE",1,0,2003,"20790","38.063215","69","403","514",244,270,172,"74",98,0.4016,0.2741,0.3346,0.784
"6663",182795,"FRANKLIN PIERCE COLLEGE",1,0,2004,"21900","39.877689","70","452","568",285,283,232,"97",135,0.4737,0.3428,0.4085,0.7958
"6664",182795,"Franklin Pierce College",1,0,2005,"23100","43.667384","71","443","532",270,262,2,"0",2,0.0074,0,0.0038,0.8327
"6665",182795,"Franklin Pierce College",1,0,2006,"24300","44.933776","86","438","553",260,293,226,"103",123,0.4731,0.3515,0.4087,0.792
"6666",182795,"Franklin Pierce University",1,0,2007,"25516","47.40239","92","402","533",239,294,207,"100",107,0.4477,0.3401,0.3884,0.7542
"6667",182795,"Franklin Pierce University",1,0,2008,"27000","49.845665","97","360","474",205,269,185,"89",96,0.4683,0.3309,0.3903,0.7595
"6668",182795,"Franklin Pierce University",1,0,2009,"27700","50.101771","99","307","388",175,213,138,"62",76,0.4343,0.2911,0.3557,0.7912
"6669",182795,"Franklin Pierce University",1,0,2010,"27700","47.933533","99","295","399",179,220,142,"50",92,0.514,0.2273,0.3559,0.7393
"6670",183062,"KEENE STATE COLLEGE",1,0,1991,"2680","37.203863","191","630","731",444,287,159,"41",118,0.2658,0.1429,0.2175,0.8618
"6671",183062,"KEENE STATE COLLEGE",1,0,1992,"2845","39.20154","160","699","754",447,307,179,"50",129,0.2886,0.1629,0.2374,0.9271
"6672",183062,"KEENE STATE COLLEGE",1,0,1993,"3120","43.082617","180","765","809",488,321,170,"43",127,0.2602,0.134,0.2101,0.9456
"6673",183062,"KEENE STATE COLLEGE",1,0,1995,"3604","47.61022","179","941","988",588,400,251,"86",165,0.2806,0.215,0.254,0.9524
"6674",183062,"KEENE STATE COLLEGE",1,0,1996,"3794","52.026641","185","788","839",499,340,211,"68",143,0.2866,0.2,0.2515,0.9392
"6675",183062,"KEENE STATE COLLEGE",1,0,1997,"4320","52.826005","182","789","845",501,344,193,"71",122,0.2435,0.2064,0.2284,0.9337
"6676",183062,"KEENE STATE COLLEGE",1,0,1998,"4750","56.669779","175","716","773",470,303,178,"53",125,0.266,0.1749,0.2303,0.9263
"6677",183062,"KEENE STATE COLLEGE",1,0,1999,"3830","58.619855","181","964","1014",649,365,262,"70",192,0.2958,0.1918,0.2584,0.9507
"6678",183062,"KEENE STATE COLLEGE",1,0,2000,"4060","61.657106","188.5","909","935",576,359,243,"69",174,0.3021,0.1922,0.2599,0.9722
"6679",183062,"KEENE STATE COLLEGE",1,0,2001,"4220","65.149046","196","895","942",561,381,283,"94",189,0.3369,0.2467,0.3004,0.9501
"6680",183062,"KEENE STATE COLLEGE",1,0,2002,"4450","64.167278","199","1118","1170",668,502,333,"119",214,0.3204,0.2371,0.2846,0.9556
"6681",183062,"KEENE STATE COLLEGE",1,0,2003,"4750","71.640315","183","942","991",598,393,369,"126",243,0.4064,0.3206,0.3724,0.9506
"6682",183062,"KEENE STATE COLLEGE",1,0,2004,"5060","71.372831","183","1003","1068",649,419,425,"148",277,0.4268,0.3532,0.3979,0.9391
"6683",183062,"Keene State College",1,0,2005,"5410","76.830187","180","943","1001",565,436,434,"172",262,0.4637,0.3945,0.4336,0.9421
"6684",183062,"Keene State College",1,0,2006,"5780","83.192097","181","1083","1139",718,421,559,"194",365,0.5084,0.4608,0.4908,0.9508
"6685",183062,"Keene State College",1,0,2007,"6180","89.6953","185","1235","1295",762,533,666,"252",414,0.5433,0.4728,0.5143,0.9537
"6686",183062,"Keene State College",1,0,2008,"6600","96.352189","185","1226","1287",777,510,667,"238",429,0.5521,0.4667,0.5183,0.9526
"6687",183062,"Keene State College",1,0,2009,"7000","100.895909","194","1093","1171",712,459,616,"228",388,0.5449,0.4967,0.526,0.9334
"6688",183062,"Keene State College",1,0,2010,"7650","106.345869","197","976","1201",718,483,643,"252",391,0.5446,0.5217,0.5354,0.8127
"6689",183080,"PLYMOUTH STATE COLLEGE",1,0,1991,"2716","35.74347","164","655","729",377,352,219,"83",136,0.3607,0.2358,0.3004,0.8985
"6690",183080,"PLYMOUTH STATE COLLEGE",1,0,1992,"2926","38.268967","162","702","775",403,372,206,"79",127,0.3151,0.2124,0.2658,0.9058
"6691",183080,"PLYMOUTH STATE COLLEGE",1,0,1993,"3281","40.534131","164","688","748",364,384,163,"63",100,0.2747,0.1641,0.2179,0.9198
"6692",183080,"PLYMOUTH STATE COLLEGE",1,0,1995,"3754","43.480558","153","820","872",426,446,204,"80",124,0.2911,0.1794,0.2339,0.9404
"6693",183080,"PLYMOUTH STATE COLLEGE",1,0,1996,"3926","45.947525","159","837","894",433,461,196,"87",109,0.2517,0.1887,0.2192,0.9362
"6694",183080,"PLYMOUTH STATE COLLEGE",1,0,1997,"4342","47.63226","168","775","844",396,448,163,"75",88,0.2222,0.1674,0.1931,0.9182
"6695",183080,"PLYMOUTH STATE COLLEGE",1,0,1998,"4780","49.941728","164","715","784",375,409,190,"81",109,0.2907,0.198,0.2423,0.912
"6696",183080,"PLYMOUTH STATE COLLEGE",1,0,1999,"3830","50.716589","161","677","772",377,395,204,"75",129,0.3422,0.1899,0.2642,0.8769
"6697",183080,"PLYMOUTH STATE COLLEGE",1,0,2000,"4060","52.25032","163.5","836","902",454,448,241,"97",144,0.3172,0.2165,0.2672,0.9268
"6698",183080,"PLYMOUTH STATE COLLEGE",1,0,2001,"4220","54.478384","166","804","872",463,409,272,"89",183,0.3952,0.2176,0.3119,0.922
"6699",183080,"PLYMOUTH STATE COLLEGE",1,0,2002,"4450","55.426387","168","856","940",447,493,279,"120",159,0.3557,0.2434,0.2968,0.9106
"6700",183080,"PLYMOUTH STATE UNIVERSITY",1,0,2003,"4750","58.280243","171","811","900",469,431,310,"134",176,0.3753,0.3109,0.3444,0.9011
"6701",183080,"PLYMOUTH STATE UNIVERSITY",1,0,2004,"5060","62.579417","183","959","1052",524,528,356,"156",200,0.3817,0.2955,0.3384,0.9116
"6702",183080,"Plymouth State University",1,0,2005,"5410","67.493457","181","921","999",473,526,401,"193",208,0.4397,0.3669,0.4014,0.9219
"6703",183080,"Plymouth State University",1,0,2006,"5780","75.134403","185","870","1008",446,562,402,"191",211,0.4731,0.3399,0.3988,0.8631
"6704",183080,"Plymouth State University",1,0,2007,"6180","79.266392","187","788","1006",444,562,414,"206",208,0.4685,0.3665,0.4115,0.7833
"6705",183080,"Plymouth State University",1,0,2008,"6600","85.026804","188","889","1087",500,587,476,"214",262,0.524,0.3646,0.4379,0.8178
"6706",183080,"Plymouth State University",1,0,2009,"7000","88.008091","184","835","971",450,521,430,"196",234,0.52,0.3762,0.4428,0.8599
"6707",183080,"Plymouth State University",1,0,2010,"7650","90.421694","187","817","1056",520,536,456,"186",270,0.5192,0.347,0.4318,0.7737
"6708",183239,"SAINT ANSELM COLLEGE",1,0,1991,"10160","26.985758","114","535","545",303,242,365,"155",210,0.6931,0.6405,0.6697,0.9817
"6709",183239,"SAINT ANSELM COLLEGE",1,0,1992,"10870","31.031787","113","479","493",274,219,325,"141",184,0.6715,0.6438,0.6592,0.9716
"6710",183239,"SAINT ANSELM COLLEGE",1,0,1993,"11840","31.441468","109","496","510",284,226,323,"128",195,0.6866,0.5664,0.6333,0.9725
"6711",183239,"SAINT ANSELM COLLEGE",1,0,1995,"13720","34.987541","108","592","612",369,243,424,"163",261,0.7073,0.6708,0.6928,0.9673
"6712",183239,"SAINT ANSELM COLLEGE",1,0,1996,"14550","37.023711","113","527","549",301,248,397,"172",225,0.7475,0.6935,0.7231,0.9599
"6713",183239,"SAINT ANSELM COLLEGE",1,0,1997,"15430","28.366217","115","483","508",283,225,350,"134",216,0.7633,0.5956,0.689,0.9508
"6714",183239,"SAINT ANSELM COLLEGE",1,0,1998,"16370","30.086498","120","512","528",296,232,392,"159",233,0.7872,0.6853,0.7424,0.9697
"6715",183239,"SAINT ANSELM COLLEGE",1,0,1999,"17300","33.041413","113","509","534",280,254,376,"160",216,0.7714,0.6299,0.7041,0.9532
"6716",183239,"SAINT ANSELM COLLEGE",1,0,2000,"18350","34.734557","116.5","502","518",280,238,349,"142",207,0.7393,0.5966,0.6737,0.9691
"6717",183239,"SAINT ANSELM COLLEGE",1,0,2001,"19460","37.318927","120","502","535",286,249,363,"152",211,0.7378,0.6104,0.6785,0.9383
"6718",183239,"SAINT ANSELM COLLEGE",1,0,2002,"20390","40.416054","124","531","570",330,240,406,"148",258,0.7818,0.6167,0.7123,0.9316
"6719",183239,"SAINT ANSELM COLLEGE",1,0,2003,"21410","43.517344","126","497","587",336,251,418,"172",246,0.7321,0.6853,0.7121,0.8467
"6720",183239,"SAINT ANSELM COLLEGE",1,0,2004,"22700","45.996291","129","241","516",284,232,370,"149",221,0.7782,0.6422,0.7171,0.4671
"6721",183239,"Saint Anselm College",1,0,2005,"23990","48.09486","132","410","519",296,223,372,"145",227,0.7669,0.6502,0.7168,0.79
"6722",183239,"Saint Anselm College",1,0,2006,"25430","50.782202","135","471","568",343,225,410,"151",259,0.7551,0.6711,0.7218,0.8292
"6723",183239,"Saint Anselm College",1,0,2007,"26960","53.548968","136","515","568",300,268,404,"169",235,0.7833,0.6306,0.7113,0.9067
"6724",183239,"Saint Anselm College",1,0,2008,"28440","62.849204","136","454","500",286,214,351,"143",208,0.7273,0.6682,0.702,0.908
"6725",183239,"Saint Anselm College",1,0,2009,"29720","64.930081","143","448","528",285,243,372,"154",218,0.7649,0.6337,0.7045,0.8485
"6726",183239,"Saint Anselm College",1,0,2010,"30760","62.800103","141","455","535",295,240,369,"142",227,0.7695,0.5917,0.6897,0.8505
"6727",183822,"BLOOMFIELD COLLEGE",1,0,1991,"7450","16.447433","42","67","267",179,88,18,"6",12,0.067,0.0682,0.0674,0.2509
"6728",183822,"BLOOMFIELD COLLEGE",1,0,1992,"7750","18.766137","45","66","266",170,96,15,"6",9,0.0529,0.0625,0.0564,0.2481
"6729",183822,"BLOOMFIELD COLLEGE",1,0,1993,"8050","20.667201","46","78","270",192,78,20,"5",15,0.0781,0.0641,0.0741,0.2889
"6730",183822,"BLOOMFIELD COLLEGE",1,0,1995,"8850","19.259306","56","63","275",196,79,40,"11",29,0.148,0.1392,0.1455,0.2291
"6731",183822,"BLOOMFIELD COLLEGE",1,0,1996,"9100","20.104169","54","41","227",150,77,36,"6",30,0.2,0.0779,0.1586,0.1806
"6732",183822,"BLOOMFIELD COLLEGE",1,0,1997,"9500","19.394316","56","52","312",213,99,26,"8",18,0.0845,0.0808,0.0833,0.1667
"6733",183822,"BLOOMFIELD COLLEGE",1,0,1998,"9900","20.170978","62","20","247",170,77,25,"7",18,0.1059,0.0909,0.1012,0.081
"6734",183822,"BLOOMFIELD COLLEGE",1,0,1999,"10300","21.562216","64","28","242",155,87,13,"4",9,0.0581,0.046,0.0537,0.1157
"6735",183822,"BLOOMFIELD COLLEGE",1,0,2000,"10800","23.517672","62","25","236",135,101,13,"8",5,0.037,0.0792,0.0551,0.1059
"6736",183822,"BLOOMFIELD COLLEGE",1,0,2001,"11300","25.20845","60","47","250",150,100,41,"16",25,0.1667,0.16,0.164,0.188
"6737",183822,"BLOOMFIELD COLLEGE",1,0,2002,"12100","25.745856","60","42","339",216,123,57,"15",42,0.1944,0.122,0.1681,0.1239
"6738",183822,"BLOOMFIELD COLLEGE",1,0,2003,"12900","28.46491","62","44","341",215,126,39,"6",33,0.1535,0.0476,0.1144,0.129
"6739",183822,"BLOOMFIELD COLLEGE",1,0,2004,"13700","31.445083","66","53","361",233,128,32,"14",18,0.0773,0.1094,0.0886,0.1468
"6740",183822,"Bloomfield College",1,0,2005,"14850","29.148146","62","60","367",210,157,37,"15",22,0.1048,0.0955,0.1008,0.1635
"6741",183822,"Bloomfield College",1,0,2006,"16100","31.737045","69","49","316",183,133,47,"18",29,0.1585,0.1353,0.1487,0.1551
"6742",183822,"Bloomfield College",1,0,2007,"17500","32.695997","69","47","313",176,137,45,"24",21,0.1193,0.1752,0.1438,0.1502
"6743",183822,"Bloomfield College",1,0,2008,"19080","33.329673","69","46","392",237,155,23,"10",13,0.0549,0.0645,0.0587,0.1173
"6744",183822,"Bloomfield College",1,0,2009,"20000","36.004861","68","38","439",278,161,32,"16",16,0.0576,0.0994,0.0729,0.0866
"6745",183822,"Bloomfield College",1,0,2010,"21200","38.857628","66","33","379",225,154,44,"22",22,0.0978,0.1429,0.1161,0.0871
"6746",183974,"CENTENARY COLLEGE",1,0,1991,"10300","8.685361","31","52","89",66,23,22,"3",19,0.2879,0.1304,0.2472,0.5843
"6747",183974,"CENTENARY COLLEGE",1,0,1992,"10911","9.304396","35","68","113",86,27,19,"4",15,0.1744,0.1481,0.1681,0.6018
"6748",183974,"CENTENARY COLLEGE",1,0,1993,"11600","10.605854","36","50","95",77,18,20,"2",18,0.2338,0.1111,0.2105,0.5263
"6749",183974,"CENTENARY COLLEGE",1,0,1995,"12104","11.754957","38","46","73",53,20,19,"3",16,0.3019,0.15,0.2603,0.6301
"6750",183974,"CENTENARY COLLEGE",1,0,1996,"12608","12.983505","40","42","86",63,23,21,"0",21,0.3333,0,0.2442,0.4884
"6751",183974,"CENTENARY COLLEGE",1,0,1997,"13120","10.882727","41","24","104",65,39,24,"8",16,0.2462,0.2051,0.2308,0.2308
"6752",183974,"CENTENARY COLLEGE",1,0,1998,"13730","11.492408","37","41","124",77,47,26,"8",18,0.2338,0.1702,0.2097,0.3306
"6753",183974,"CENTENARY COLLEGE",1,0,1999,"13800","12.807669","44","69","136",98,38,58,"17",41,0.4184,0.4474,0.4265,0.5074
"6754",183974,"CENTENARY COLLEGE",1,0,2000,"14500","13.429021","45.5","96","145",114,31,56,"7",49,0.4298,0.2258,0.3862,0.6621
"6755",183974,"CENTENARY COLLEGE",1,0,2001,"15100","15.942563","47","120","195",141,54,57,"6",51,0.3617,0.1111,0.2923,0.6154
"6756",183974,"CENTENARY COLLEGE",1,0,2002,"15700","17.598123","49","165","236",147,89,97,"27",70,0.4762,0.3034,0.411,0.6992
"6757",183974,"CENTENARY COLLEGE",1,0,2003,"17100","21.360409","47","147","221",126,95,112,"47",65,0.5159,0.4947,0.5068,0.6652
"6758",183974,"CENTENARY COLLEGE",1,0,2004,"18450","25.088188","53","170","258",169,89,123,"38",85,0.503,0.427,0.4767,0.6589
"6759",183974,"Centenary College",1,0,2005,"19840","29.705","62","172","240",160,80,115,"35",80,0.5,0.4375,0.4792,0.7167
"6760",183974,"Centenary College",1,0,2006,"21230","34.646","64","211","303",211,92,147,"41",106,0.5024,0.4457,0.4851,0.6964
"6761",183974,"Centenary College",1,0,2007,"22930","38.759","67","204","275",175,100,154,"54",100,0.5714,0.54,0.56,0.7418
"6762",183974,"Centenary College",1,0,2008,"23900","42.024","68","227","310",196,114,188,"63",125,0.6378,0.5526,0.6065,0.7323
"6763",183974,"Centenary College",1,0,2009,"25334","45.444","69","186","270",165,105,156,"50",106,0.6424,0.4762,0.5778,0.6889
"6764",183974,"Centenary College",1,0,2010,"26854","44.067","72","161","252",144,108,115,"35",80,0.5556,0.3241,0.4563,0.6389
"6765",184348,"DREW UNIVERSITY",1,0,1991,"16424","46.449","119","184","269",166,103,188,"70",118,0.7108,0.6796,0.6989,0.684
"6766",184348,"DREW UNIVERSITY",1,0,1992,"17294","46.759","120","244","332",203,129,246,"92",154,0.7586,0.7132,0.741,0.7349
"6767",184348,"DREW UNIVERSITY",1,0,1993,"18058","47.33203","119","224","312",190,122,226,"84",142,0.7474,0.6885,0.7244,0.7179
"6768",184348,"DREW UNIVERSITY",1,0,1995,"19642","52.506","127","291","433",255,178,312,"122",190,0.7451,0.6854,0.7206,0.6721
"6769",184348,"DREW UNIVERSITY",1,0,1996,"20402","57.217355","130","240","371",203,168,265,"118",147,0.7241,0.7024,0.7143,0.6469
"6770",184348,"DREW UNIVERSITY",1,0,1997,"21396","48.617","131","300","418",243,175,294,"117",177,0.7284,0.6686,0.7033,0.7177
"6771",184348,"DREW UNIVERSITY",1,0,1998,"22232","51.439","145","224","337",213,124,226,"84",142,0.6667,0.6774,0.6706,0.6647
"6772",184348,"DREW UNIVERSITY",1,0,1999,"22462","52.63","141","249","407",225,182,279,"118",161,0.7156,0.6484,0.6855,0.6118
"6773",184348,"DREW UNIVERSITY",1,0,2000,"23472","70.612","143.5","283","419",265,154,291,"98",193,0.7283,0.6364,0.6945,0.6754
"6774",184348,"DREW UNIVERSITY",1,0,2001,"24576","74.467","146","251","395",254,141,261,"89",172,0.6772,0.6312,0.6608,0.6354
"6775",184348,"DREW UNIVERSITY",1,0,2002,"25800","95.9","147","248","396",231,165,281,"110",171,0.7403,0.6667,0.7096,0.6263
"6776",184348,"DREW UNIVERSITY",1,0,2003,"27360","63.661","146","276","419",247,172,289,"109",180,0.7287,0.6337,0.6897,0.6587
"6777",184348,"DREW UNIVERSITY",1,0,2004,"29000","65.576","146","290","418",243,175,264,"98",166,0.6831,0.56,0.6316,0.6938
"6778",184348,"Drew University",1,0,2005,"30740","69.644","154","279","391",218,173,240,"103",137,0.6284,0.5954,0.6138,0.7136
"6779",184348,"Drew University",1,0,2006,"32508","74.003","155","298","479",316,163,315,"103",212,0.6709,0.6319,0.6576,0.6221
"6780",184348,"Drew University",1,0,2007,"34230","77.213","160","266","452",268,184,293,"107",186,0.694,0.5815,0.6482,0.5885
"6781",184348,"Drew University",1,0,2008,"35910","81.378","160","229","390",256,134,222,"75",147,0.5742,0.5597,0.5692,0.5872
"6782",184348,"Drew University",1,0,2009,"37310","83.519","161","292","505",296,209,317,"114",203,0.6858,0.5455,0.6277,0.5782
"6783",184348,"Drew University",1,0,2010,"38766","84.488379","164","260","494",311,183,280,"96",184,0.5916,0.5246,0.5668,0.5263
"6784",184603,"FAIRLEIGH DICKINSON UNIVERSITY (ALL CAMPUSES)",1,0,1991,"10460","103.538907","326","445","908",436,472,78,"32",46,0.1055,0.0678,0.0859,0.4901
"6785",184603,"FAIRLEIGH DICKINSON UNIVERSITY (ALL CAMPUSES)",1,0,1992,"10483","103.871735","306","455","938",466,472,114,"53",61,0.1309,0.1123,0.1215,0.4851
"6786",184603,"FAIRLEIGH DICKINSON UNIVERSITY-ALL CAMPUSES",1,0,1993,"11091","112.132754","303","434","860",422,438,128,"46",82,0.1943,0.105,0.1488,0.5047
"6787",184603,"FAIRLEIGH DICKINSON UNIVERSITY-ALL CAMPUSES",1,0,1995,"12370","89.049141","285","452","781",396,385,128,"57",71,0.1793,0.1481,0.1639,0.5787
"6788",184603,"FAIRLEIGH DICKINSON UNIVERSITY-ALL CAMPUSES",1,0,1996,"13404","104.115","265","477","915",494,421,187,"76",111,0.2247,0.1805,0.2044,0.5213
"6789",184603,"FAIRLEIGH DICKINSON UNIVERSITY-ALL CAMPUSES",1,0,1997,"14126","87.871314","264","179","519",265,254,83,"27",56,0.2113,0.1063,0.1599,0.3449
"6790",184603,"FAIRLEIGH DICKINSON UNIVERSITY-ALL CAMPUSES",1,0,1998,"14836","89.465698","260","165","566",307,259,90,"30",60,0.1954,0.1158,0.159,0.2915
"6791",184603,"FAIRLEIGH DICKINSON UNIVERSITY-ALL CAMPUSES",1,0,1999,"14732","93.667823","262","161","526",281,245,96,"31",65,0.2313,0.1265,0.1825,0.3061
"6792",184603,"FAIRLEIGH DICKINSON UNIVERSITY-ALL CAMPUSES",1,0,2000,"16346","100.245345","268.5","154","535",300,235,79,"32",47,0.1567,0.1362,0.1477,0.2879
"6793",184603,"FAIRLEIGH DICKINSON UNIVERSITY-ALL CAMPUSES",1,0,2001,"17474","107.568414","275","116","448",260,188,80,"27",53,0.2038,0.1436,0.1786,0.2589
"6794",184603,"FAIRLEIGH DICKINSON UNIVERSITY-ALL CAMPUSES",1,0,2002,"18654","114.571209","277","159","474",281,193,87,"34",53,0.1886,0.1762,0.1835,0.3354
"6795",184603,"FAIRLEIGH DICKINSON UNIVERSITY-METROPOLITAN CAMPUS",1,0,2003,"19854","121.372151","160","189","540",303,237,105,"40",65,0.2145,0.1688,0.1944,0.35
"6796",184603,"FAIRLEIGH DICKINSON UNIVERSITY-METROPOLITAN CAMPUS",1,0,2004,"21224","131.064467","176","142","504",282,222,150,"61",89,0.3156,0.2748,0.2976,0.2817
"6797",184603,"Fairleigh Dickinson University-Metropolitan Campus",1,0,2005,"22604","140.349335","169","149","425",269,156,100,"31",69,0.2565,0.1987,0.2353,0.3506
"6798",184603,"Fairleigh Dickinson University-Metropolitan Campus",1,0,2006,"24072","151.611944","182","156","452",254,198,119,"37",82,0.3228,0.1869,0.2633,0.3451
"6799",184603,"Fairleigh Dickinson University-Metropolitan Campus",1,0,2007,"25624","165.695194","183","131","400",210,190,117,"30",87,0.4143,0.1579,0.2925,0.3275
"6800",184603,"Fairleigh Dickinson University-Metropolitan Campus",1,0,2008,"27136","168.425643","185","122","461",276,185,126,"39",87,0.3152,0.2108,0.2733,0.2646
"6801",184603,"Fairleigh Dickinson University-Metropolitan Campus",1,0,2009,"28194","174.017193","184","129","641",361,280,175,"57",118,0.3269,0.2036,0.273,0.2012
"6802",184603,"Fairleigh Dickinson University-Metropolitan Campus",1,0,2010,"30140","181.399474","186","131","694",400,294,133,"48",85,0.2125,0.1633,0.1916,0.1888
"6803",184612,"FELICIAN COLLEGE",1,0,1991,"6970","5.270013","38","49","93",79,14,9,"3",6,0.0759,0.2143,0.0968,0.5269
"6804",184612,"FELICIAN COLLEGE",1,0,1992,"7430","6.644367","39","78","116",103,13,16,"1",15,0.1456,0.0769,0.1379,0.6724
"6805",184612,"FELICIAN COLLEGE",1,0,1993,"7765","7.938826","44","82","129",105,24,10,"0",10,0.0952,0,0.0775,0.6357
"6806",184612,"FELICIAN COLLEGE",1,0,1995,"8790","8.812335","47","53","87",70,17,18,"9",9,0.1286,0.5294,0.2069,0.6092
"6807",184612,"FELICIAN COLLEGE",1,0,1996,"9502","10.41525","48","87","141",92,49,8,"3",5,0.0543,0.0612,0.0567,0.617
"6808",184612,"FELICIAN COLLEGE",1,0,1997,"10038","9.411961","51","65","112",94,18,9,"0",9,0.0957,0,0.0804,0.5804
"6809",184612,"FELICIAN COLLEGE",1,0,1998,"10542","11.459593","56","70","151",118,33,20,"3",17,0.1441,0.0909,0.1325,0.4636
"6810",184612,"FELICIAN COLLEGE",1,0,1999,"10560","14.413596","59","133","224",140,84,7,"7",0,0,0.0833,0.0312,0.5938
"6811",184612,"FELICIAN COLLEGE",1,0,2000,"11010","18.003612","63.5","129","219",173,46,46,"7",39,0.2254,0.1522,0.21,0.589
"6812",184612,"FELICIAN COLLEGE",1,0,2001,"11460","21.311917","68","134","272",188,84,46,"9",37,0.1968,0.1071,0.1691,0.4926
"6813",184612,"FELICIAN COLLEGE",1,0,2002,"12450","19.95","70","94","208",151,57,45,"8",37,0.245,0.1404,0.2163,0.4519
"6814",184612,"FELICIAN COLLEGE",1,0,2003,"14500","19.326725","70","111","218",158,60,33,"10",23,0.1456,0.1667,0.1514,0.5092
"6815",184612,"FELICIAN COLLEGE",1,0,2004,"15900","20.539201","73","114","232",170,62,38,"13",25,0.1471,0.2097,0.1638,0.4914
"6816",184612,"Felician College",1,0,2005,"17300","22.660946","83","101","236",163,73,38,"13",25,0.1534,0.1781,0.161,0.428
"6817",184612,"Felician College",1,0,2006,"18900","25.894277","81","93","251",172,79,58,"20",38,0.2209,0.2532,0.2311,0.3705
"6818",184612,"Felician College",1,0,2007,"20500","27.482225","95","106","294",213,81,72,"18",54,0.2535,0.2222,0.2449,0.3605
"6819",184612,"Felician College",1,0,2008,"22200","32.575787","102","90","245",170,75,42,"9",33,0.1941,0.12,0.1714,0.3673
"6820",184612,"Felician College",1,0,2009,"23650","36.615729","112","71","251",172,79,46,"17",29,0.1686,0.2152,0.1833,0.2829
"6821",184612,"Felician College",1,0,2010,"24950","37.707512","114","90","324",236,88,66,"21",45,0.1907,0.2386,0.2037,0.2778
"6822",184782,"GLASSBORO STATE COLLEGE",1,0,1991,"2715","75.055196","278","646","892",511,381,212,"77",135,0.2642,0.2021,0.2377,0.7242
"6823",184782,"ROWAN COLLEGE OF NEW JERSEY",1,0,1992,"2870","80.524902","286","568","771",453,318,154,"46",108,0.2384,0.1447,0.1997,0.7367
"6824",184782,"ROWAN COLLEGE OF NEW JERSEY",1,0,1993,"2843","83.717828","292","489","713",408,305,152,"43",109,0.2672,0.141,0.2132,0.6858
"6825",184782,"ROWAN COLLEGE OF NEW JERSEY",1,0,1995,"3393","90.648498","324","702","927",516,411,226,"69",157,0.3043,0.1679,0.2438,0.7573
"6826",184782,"ROWAN COLLEGE OF NEW JERSEY",1,0,1996,"3750","93.800961","320","931","1132",609,523,414,"173",241,0.3957,0.3308,0.3657,0.8224
"6827",184782,"ROWAN UNIVERSITY",1,0,1997,"4240","98.958292","336","814","1038",552,486,321,"119",202,0.3659,0.2449,0.3092,0.7842
"6828",184782,"ROWAN UNIVERSITY",1,0,1998,"4550","111.543814","364","868","1118",624,494,414,"160",254,0.4071,0.3239,0.3703,0.7764
"6829",184782,"ROWAN UNIVERSITY",1,0,1999,"3750","121.968222","360","910","1119",587,532,436,"183",253,0.431,0.344,0.3896,0.8132
"6830",184782,"ROWAN UNIVERSITY",1,0,2000,"4140","133.950554","372.5","819","1053",561,492,444,"173",271,0.4831,0.3516,0.4217,0.7778
"6831",184782,"ROWAN UNIVERSITY",1,0,2001,"4500","141.502198","385","1021","1276",680,596,498,"201",297,0.4368,0.3372,0.3903,0.8002
"6832",184782,"ROWAN UNIVERSITY",1,0,2002,"4950","135.116042","369","1019","1257",637,620,542,"224",318,0.4992,0.3613,0.4312,0.8107
"6833",184782,"ROWAN UNIVERSITY",1,0,2003,"5396","132.141705","403","1032","1243",600,643,588,"265",323,0.5383,0.4121,0.473,0.8302
"6834",184782,"ROWAN UNIVERSITY",1,0,2004,"5828","146.912281","434","970","1247",622,625,546,"255",291,0.4678,0.408,0.4379,0.7779
"6835",184782,"Rowan University",1,0,2005,"6294","161.577298","441","987","1239",607,632,554,"270",284,0.4679,0.4272,0.4471,0.7966
"6836",184782,"Rowan University",1,0,2006,"6798","175.350947","436","925","1216",602,614,593,"271",322,0.5349,0.4414,0.4877,0.7607
"6837",184782,"Rowan University",1,0,2007,"7308","188.136461","407","1053","1226",506,720,561,"301",260,0.5138,0.4181,0.4576,0.8589
"6838",184782,"Rowan University",1,0,2008,"7840","201.396211","407","965","1174",516,658,502,"269",233,0.4516,0.4088,0.4276,0.822
"6839",184782,"Rowan University",1,0,2009,"8074","218.443969","401","1209","1586",738,848,677,"344",333,0.4512,0.4057,0.4269,0.7623
"6840",184782,"Rowan University",1,0,2010,"8396","216.593002","395","1110","1485",715,770,713,"320",393,0.5497,0.4156,0.4801,0.7475
"6841",185129,"JERSEY CITY STATE COLLEGE",1,0,1991,"2422","55.322","245","264","618",322,296,34,"17",17,0.0528,0.0574,0.055,0.4272
"6842",185129,"JERSEY CITY STATE COLLEGE",1,0,1992,"2678","61.366","241","294","663",324,339,28,"16",12,0.037,0.0472,0.0422,0.4434
"6843",185129,"JERSEY CITY STATE COLLEGE",1,0,1993,"2798","61.479","237","254","514",276,238,27,"11",16,0.058,0.0462,0.0525,0.4942
"6844",185129,"JERSEY CITY STATE COLLEGE",1,0,1995,"3157","70.071","243","193","457",246,211,40,"11",29,0.1179,0.0521,0.0875,0.4223
"6845",185129,"JERSEY CITY STATE COLLEGE",1,0,1996,"3528","69.493572","248","196","531",283,248,32,"10",22,0.0777,0.0403,0.0603,0.3691
"6846",185129,"JERSEY CITY STATE COLLEGE",1,0,1997,"3828","75.856757","235","184","455",237,218,34,"13",21,0.0886,0.0596,0.0747,0.4044
"6847",185129,"NEW JERSEY CITY COLLEGE",1,0,1998,"4113","79.577972","237","203","549",305,244,40,"13",27,0.0885,0.0533,0.0729,0.3698
"6848",185129,"NEW JERSEY CITY UNIVERSITY",1,0,1999,"3330","85.541374","240","239","603",331,272,54,"18",36,0.1088,0.0662,0.0896,0.3964
"6849",185129,"NEW JERSEY CITY UNIVERSITY",1,0,2000,"3540","91.389483","242.5","271","661",357,304,46,"20",26,0.0728,0.0658,0.0696,0.41
"6850",185129,"NEW JERSEY CITY UNIVERSITY",1,0,2001,"3810","97.02307","245","176","540",304,236,43,"14",29,0.0954,0.0593,0.0796,0.3259
"6851",185129,"NEW JERSEY CITY UNIVERSITY",1,0,2002,"4185","94.890349","238","199","566",293,273,34,"9",25,0.0853,0.033,0.0601,0.3516
"6852",185129,"NEW JERSEY CITY UNIVERSITY",1,0,2003,"4560","93.23617","233","215","652",380,272,49,"15",34,0.0895,0.0551,0.0752,0.3298
"6853",185129,"NEW JERSEY CITY UNIVERSITY",1,0,2004,"4860","100.584012","241","145","512",300,212,40,"12",28,0.0933,0.0566,0.0781,0.2832
"6854",185129,"New Jersey City University",1,0,2005,"5190","107.492351","251","179","601",334,267,39,"17",22,0.0659,0.0637,0.0649,0.2978
"6855",185129,"New Jersey City University",1,0,2006,"5600","116.135129","242","156","646",379,267,45,"13",32,0.0844,0.0487,0.0697,0.2415
"6856",185129,"New Jersey City University",1,0,2007,"5936","119.830543","248","143","649",340,309,32,"16",16,0.0471,0.0518,0.0493,0.2203
"6857",185129,"New Jersey City University",1,0,2008,"6352","127.419559","238","113","563",306,257,42,"19",23,0.0752,0.0739,0.0746,0.2007
"6858",185129,"New Jersey City University",1,0,2009,"6542","132.502397","246","152","634",358,276,32,"12",20,0.0559,0.0435,0.0505,0.2397
"6859",185129,"New Jersey City University",1,0,2010,"6804","137.512799","242","145","681",380,301,45,"21",24,0.0632,0.0698,0.0661,0.2129
"6860",185572,"MONMOUTH COLLEGE",1,0,1991,"10700","43.839104","152","336","387",216,171,74,"23",51,0.2361,0.1345,0.1912,0.8682
"6861",185572,"MONMOUTH COLLEGE",1,0,1992,"11160","45.918452","142","360","436",230,206,94,"39",55,0.2391,0.1893,0.2156,0.8257
"6862",185572,"MONMOUTH COLLEGE",1,0,1993,"11820","46.970972","125","382","477",220,257,94,"43",51,0.2318,0.1673,0.1971,0.8008
"6863",185572,"MONMOUTH UNIVERSITY",1,0,1995,"13140","62.835727","157","634","764",412,352,234,"82",152,0.3689,0.233,0.3063,0.8298
"6864",185572,"MONMOUTH UNIVERSITY",1,0,1996,"13800","72.600781","173","653","799",411,388,261,"99",162,0.3942,0.2552,0.3267,0.8173
"6865",185572,"MONMOUTH UNIVERSITY",1,0,1997,"14442","59.541851","187","640","801",432,369,264,"87",177,0.4097,0.2358,0.3296,0.799
"6866",185572,"MONMOUTH UNIVERSITY",1,0,1998,"15068","65.294243","190","661","834",429,405,253,"98",155,0.3613,0.242,0.3034,0.7926
"6867",185572,"MONMOUTH UNIVERSITY",1,0,1999,"15138","69.368578","197","644","833",457,376,295,"99",196,0.4289,0.2633,0.3541,0.7731
"6868",185572,"MONMOUTH UNIVERSITY",1,0,2000,"15758","74.312782","204","863","1033",529,504,377,"142",235,0.4442,0.2817,0.365,0.8354
"6869",185572,"MONMOUTH UNIVERSITY",1,0,2001,"16506","80.893566","211","708","881",484,397,339,"125",214,0.4421,0.3149,0.3848,0.8036
"6870",185572,"MONMOUTH UNIVERSITY",1,0,2002,"17332","81.763337","229","788","948",521,427,351,"116",235,0.4511,0.2717,0.3703,0.8312
"6871",185572,"MONMOUTH UNIVERSITY",1,0,2003,"18198","90.000228","241","757","904",484,420,358,"125",233,0.4814,0.2976,0.396,0.8374
"6872",185572,"MONMOUTH UNIVERSITY",1,0,2004,"19108","97.353202","237","727","946",514,432,341,"120",221,0.43,0.2778,0.3605,0.7685
"6873",185572,"Monmouth University",1,0,2005,"20064","101.668061","254","738","942",503,439,436,"176",260,0.5169,0.4009,0.4628,0.7834
"6874",185572,"Monmouth University",1,0,2006,"21248","109.660183","244","747","959",535,424,425,"168",257,0.4804,0.3962,0.4432,0.7789
"6875",185572,"Monmouth University",1,0,2007,"22406","116.647221","251","753","944",538,406,393,"165",228,0.4238,0.4064,0.4163,0.7977
"6876",185572,"Monmouth University",1,0,2008,"23470","125.14237","247","795","960",549,411,473,"187",286,0.5209,0.455,0.4927,0.8281
"6877",185572,"Monmouth University",1,0,2009,"24386","130.7141","248","818","998",581,417,504,"191",313,0.5387,0.458,0.505,0.8196
"6878",185572,"Monmouth University",1,0,2010,"25728","136.952114","253","764","962",579,383,532,"196",336,0.5803,0.5117,0.553,0.7942
"6879",185590,"MONTCLAIR STATE COLLEGE",1,0,1991,"2612","89.154769","429","544","913",564,349,101,"31",70,0.1241,0.0888,0.1106,0.5958
"6880",185590,"MONTCLAIR STATE COLLEGE",1,0,1992,"2686","98.565652","420","560","913",530,383,106,"32",74,0.1396,0.0836,0.1161,0.6134
"6881",185590,"MONTCLAIR STATE COLLEGE",1,0,1993,"2844","99.014206","419","523","868",531,337,117,"34",83,0.1563,0.1009,0.1348,0.6025
"6882",185590,"MONTCLAIR STATE UNIVERSITY",1,0,1995,"3162","110.016841","421","662","1068",651,417,216,"69",147,0.2258,0.1655,0.2022,0.6199
"6883",185590,"MONTCLAIR STATE UNIVERSITY",1,0,1996,"3466","116.626708","444","746","1194",706,488,243,"64",179,0.2535,0.1311,0.2035,0.6248
"6884",185590,"MONTCLAIR STATE UNIVERSITY",1,0,1997,"3738","122.614618","472","648","1148",709,439,230,"62",168,0.237,0.1412,0.2003,0.5645
"6885",185590,"MONTCLAIR STATE UNIVERSITY",1,0,1998,"4120","129.617925","442","637","1106",660,446,252,"60",192,0.2909,0.1345,0.2278,0.5759
"6886",185590,"MONTCLAIR STATE UNIVERSITY",1,0,1999,"3154","136.441827","444","747","1319",823,496,308,"81",227,0.2758,0.1633,0.2335,0.5663
"6887",185590,"MONTCLAIR STATE UNIVERSITY",1,0,2000,"3470","147.141801","442.5","776","1324",827,497,351,"96",255,0.3083,0.1932,0.2651,0.5861
"6888",185590,"MONTCLAIR STATE UNIVERSITY",1,0,2001,"4071","159.732583","441","785","1378",826,552,371,"102",269,0.3257,0.1848,0.2692,0.5697
"6889",185590,"MONTCLAIR STATE UNIVERSITY",1,0,2002,"4390","152.729511","434","925","1470",881,589,410,"117",293,0.3326,0.1986,0.2789,0.6293
"6890",185590,"MONTCLAIR STATE UNIVERSITY",1,0,2003,"4785","158.655987","453","972","1594",934,660,471,"134",337,0.3608,0.203,0.2955,0.6098
"6891",185590,"MONTCLAIR STATE UNIVERSITY",1,0,2004,"5168","168.751328","462","1056","1737",1015,722,534,"164",370,0.3645,0.2271,0.3074,0.6079
"6892",185590,"Montclair State University",1,0,2005,"5581","197.185","474","1146","1868",1065,803,635,"188",447,0.4197,0.2341,0.3399,0.6135
"6893",185590,"Montclair State University",1,0,2006,"6028","232.445","491","1261","2018",1197,821,702,"214",488,0.4077,0.2607,0.3479,0.6249
"6894",185590,"Montclair State University",1,0,2007,"6390","240.676","509","1174","2068",1276,792,711,"205",506,0.3966,0.2588,0.3438,0.5677
"6895",185590,"Montclair State University",1,0,2008,"6836","263.488","524","1190","2257",1365,892,817,"230",587,0.43,0.2578,0.362,0.5272
"6896",185590,"Montclair State University",1,0,2009,"7042","272.629","553","1069","2100",1284,816,757,"219",538,0.419,0.2684,0.3605,0.509
"6897",185590,"Montclair State University",1,0,2010,"7324","288.712","569","1079","2169",1248,921,850,"304",546,0.4375,0.3301,0.3919,0.4975
"6898",185828,"NEW JERSEY INSTITUTE OF TECHNOLOGY",1,0,1991,"4288","105.11","319","236","541",96,445,30,"18",12,0.125,0.0404,0.0555,0.4362
"6899",185828,"NEW JERSEY INSTITUTE OF TECHNOLOGY",1,0,1992,"4524","108.124","327","247","501",75,426,34,"25",9,0.12,0.0587,0.0679,0.493
"6900",185828,"NEW JERSEY INSTITUTE OF TECHNOLOGY",1,0,1993,"4790","116.154","308","226","476",90,386,33,"22",11,0.1222,0.057,0.0693,0.4748
"6901",185828,"NEW JERSEY INSTITUTE OF TECHNOLOGY",1,0,1995,"5220","130.982","348","263","552",131,421,60,"35",25,0.1908,0.0831,0.1087,0.4764
"6902",185828,"NEW JERSEY INSTITUTE OF TECHNOLOGY",1,0,1996,"5466","144.24","354","295","599",116,483,60,"39",21,0.181,0.0807,0.1002,0.4925
"6903",185828,"NEW JERSEY INSTITUTE OF TECHNOLOGY",1,0,1997,"5802","146.382","358","276","568",105,463,88,"73",15,0.1429,0.1577,0.1549,0.4859
"6904",185828,"NEW JERSEY INSTITUTE OF TECHNOLOGY",1,0,1998,"6214","156.345","362","254","563",120,443,93,"64",29,0.2417,0.1445,0.1652,0.4512
"6905",185828,"NEW JERSEY INSTITUTE OF TECHNOLOGY",1,0,1999,"5508","163.074","380","261","649",114,535,116,"88",28,0.2456,0.1645,0.1787,0.4022
"6906",185828,"NEW JERSEY INSTITUTE OF TECHNOLOGY",1,0,2000,"5758","174.948","426.5","285","685",117,568,130,"98",32,0.2735,0.1725,0.1898,0.4161
"6907",185828,"NEW JERSEY INSTITUTE OF TECHNOLOGY",1,0,2001,"6158","190.815","473","297","706",129,577,102,"70",32,0.2481,0.1213,0.1445,0.4207
"6908",185828,"NEW JERSEY INSTITUTE OF TECHNOLOGY",1,0,2002,"6758","193.4","408","249","658",113,545,106,"81",25,0.2212,0.1486,0.1611,0.3784
"6909",185828,"NEW JERSEY INSTITUTE OF TECHNOLOGY",1,0,2003,"7332","195.04","458","283","685",119,566,118,"92",26,0.2185,0.1625,0.1723,0.4131
"6910",185828,"NEW JERSEY INSTITUTE OF TECHNOLOGY",1,0,2004,"7918","197.553","413","263","663",130,533,108,"74",34,0.2615,0.1388,0.1629,0.3967
"6911",185828,"New Jersey Institute of Technology",1,0,2005,"8472","209.857","403","295","746",129,617,126,"101",25,0.1938,0.1637,0.1689,0.3954
"6912",185828,"New Jersey Institute of Technology",1,0,2006,"9066","212.127","389","324","795",146,649,150,"102",48,0.3288,0.1572,0.1887,0.4075
"6913",185828,"New Jersey Institute of Technology",1,0,2007,"9700","224.519","382","300","730",148,582,171,"117",54,0.3649,0.201,0.2342,0.411
"6914",185828,"New Jersey Institute of Technology",1,0,2008,"10500","234.012","387","326","779",158,621,185,"136",49,0.3101,0.219,0.2375,0.4185
"6915",185828,"New Jersey Institute of Technology",1,0,2009,"10816","240.866","406","370","899",169,730,212,"151",61,0.3609,0.2068,0.2358,0.4116
"6916",185828,"New Jersey Institute of Technology",1,0,2010,"11248","238.208","398","200","828",187,641,209,"141",68,0.3636,0.22,0.2524,0.2415
"6917",186131,"PRINCETON UNIVERSITY",1,0,1991,"16570","451.601","704","794","1122",474,648,1002,"582",420,0.8861,0.8981,0.893,0.7077
"6918",186131,"PRINCETON UNIVERSITY",1,0,1992,"17750","496.8","709","842","1135",516,619,1023,"544",479,0.9283,0.8788,0.9013,0.7419
"6919",186131,"PRINCETON UNIVERSITY",1,0,1993,"18940","514.829","702","816","1152",514,638,1032,"563",469,0.9125,0.8824,0.8958,0.7083
"6920",186131,"PRINCETON UNIVERSITY",1,0,1995,"20960","509.39","712","800","1207",569,638,1105,"579",526,0.9244,0.9075,0.9155,0.6628
"6921",186131,"PRINCETON UNIVERSITY",1,0,1996,"22000","534.988352","691","747","1123",525,598,1032,"540",492,0.9371,0.903,0.919,0.6652
"6922",186131,"PRINCETON UNIVERSITY",1,0,1997,"22920","501.779","689","798","1129",511,618,1033,"562",471,0.9217,0.9094,0.915,0.7068
"6923",186131,"PRINCETON UNIVERSITY",1,0,1998,"23820","501.299","699","788","1167",560,607,1000,"495",505,0.9018,0.8155,0.8569,0.6752
"6924",186131,"PRINCETON UNIVERSITY",1,0,1999,"24630","536.994","717","790","1148",556,592,1030,"530",500,0.8993,0.8953,0.8972,0.6882
"6925",186131,"PRINCETON UNIVERSITY",1,0,2000,"25430","581.666","742.5","757","1159",569,590,1031,"503",528,0.9279,0.8525,0.8896,0.6531
"6926",186131,"PRINCETON UNIVERSITY",1,0,2001,"26160","639.664","768","757","1184",570,614,1051,"526",525,0.9211,0.8567,0.8877,0.6394
"6927",186131,"PRINCETON UNIVERSITY",1,0,2002,"27230","692.922","798","737","1164",557,607,1049,"542",507,0.9102,0.8929,0.9012,0.6332
"6928",186131,"PRINCETON UNIVERSITY",1,0,2003,"28540","725.705","797","734","1161",539,622,1044,"549",495,0.9184,0.8826,0.8992,0.6322
"6929",186131,"PRINCETON UNIVERSITY",1,0,2004,"29910","789.489","801","729","1170",548,622,1054,"549",505,0.9215,0.8826,0.9009,0.6231
"6930",186131,"Princeton University",1,0,2005,"31450","835.031","807","709","1224",558,666,1066,"562",504,0.9032,0.8438,0.8709,0.5792
"6931",186131,"Princeton University",1,0,2006,"33000","927.942","826","603","1228",576,652,1078,"561",517,0.8976,0.8604,0.8779,0.491
"6932",186131,"Princeton University",1,0,2007,"33000","981.281","824","592","1243",593,650,1091,"553",538,0.9073,0.8508,0.8777,0.4763
"6933",186131,"Princeton University",1,0,2008,"34290","1050.818","848","610","1243",620,623,1121,"545",576,0.929,0.8748,0.9019,0.4907
"6934",186131,"Princeton University",1,0,2009,"35340","1161.66","847","635","1297",643,654,1164,"568",596,0.9269,0.8685,0.8975,0.4896
"6935",186131,"Princeton University",1,0,2010,"36640","1235.024","844","653","1311",649,662,1169,"572",597,0.9199,0.864,0.8917,0.4981
"6936",186201,"RAMAPO COLLEGE OF NEW JERSEY",1,0,1991,"2893","37.032","130","279","423",205,218,55,"17",38,0.1854,0.078,0.13,0.6596
"6937",186201,"RAMAPO COLLEGE OF NEW JERSEY",1,0,1992,"3024","41.103","131","290","419",216,203,77,"25",52,0.2407,0.1232,0.1838,0.6921
"6938",186201,"RAMAPO COLLEGE OF NEW JERSEY",1,0,1993,"3226","45.83","131","235","361",199,162,62,"21",41,0.206,0.1296,0.1717,0.651
"6939",186201,"RAMAPO COLLEGE OF NEW JERSEY",1,0,1995,"3521","44.338","132","190","319",190,129,67,"20",47,0.2474,0.155,0.21,0.5956
"6940",186201,"RAMAPO COLLEGE OF NEW JERSEY",1,0,1996,"3872","49.687","138","273","413",240,173,101,"29",72,0.3,0.1676,0.2446,0.661
"6941",186201,"RAMAPO COLLEGE OF NEW JERSEY",1,0,1997,"4206","50.965","141","331","453",228,225,125,"53",72,0.3158,0.2356,0.2759,0.7307
"6942",186201,"RAMAPO COLLEGE OF NEW JERSEY",1,0,1998,"4616","53.692","142","343","472",271,201,169,"56",113,0.417,0.2786,0.3581,0.7267
"6943",186201,"RAMAPO COLLEGE OF NEW JERSEY",1,0,1999,"3822","61.225","142","380","527",293,234,201,"66",135,0.4608,0.2821,0.3814,0.7211
"6944",186201,"RAMAPO COLLEGE OF NEW JERSEY",1,0,2000,"4166","67.865","149.5","496","636",392,244,282,"87",195,0.4974,0.3566,0.4434,0.7799
"6945",186201,"RAMAPO COLLEGE OF NEW JERSEY",1,0,2001,"4416","71.504","157","474","628",382,246,303,"99",204,0.534,0.4024,0.4825,0.7548
"6946",186201,"RAMAPO COLLEGE OF NEW JERSEY",1,0,2002,"4836","74.112","170","522","684",420,264,363,"109",254,0.6048,0.4129,0.5307,0.7632
"6947",186201,"RAMAPO COLLEGE OF NEW JERSEY",1,0,2003,"5270","82.517","171","570","719",423,296,439,"165",274,0.6478,0.5574,0.6106,0.7928
"6948",186201,"RAMAPO COLLEGE OF NEW JERSEY",1,0,2004,"5640","89.619","179","580","746",451,295,486,"165",321,0.7118,0.5593,0.6515,0.7775
"6949",186201,"Ramapo College of New Jersey",1,0,2005,"6091","95.171","187","564","746",460,286,445,"137",308,0.6696,0.479,0.5965,0.756
"6950",186201,"Ramapo College of New Jersey",1,0,2006,"6579","103.455","192","591","811",475,336,488,"182",306,0.6442,0.5417,0.6017,0.7287
"6951",186201,"Ramapo College of New Jersey",1,0,2007,"6904","109.139","197","694","898",519,379,527,"181",346,0.6667,0.4776,0.5869,0.7728
"6952",186201,"Ramapo College of New Jersey",1,0,2008,"7459","120.284","199","662","877",513,364,511,"177",334,0.6511,0.4863,0.5827,0.7548
"6953",186201,"Ramapo College of New Jersey",1,0,2009,"7683","128.645","213","702","933",575,358,559,"165",394,0.6852,0.4609,0.5991,0.7524
"6954",186201,"Ramapo College of New Jersey",1,0,2010,"7805","127.432","216","674","893",522,371,547,"188",359,0.6877,0.5067,0.6125,0.7548
"6955",186283,"RIDER COLLEGE",1,0,1991,"11010","58.24102","207","516","653",351,302,259,"98",161,0.4587,0.3245,0.3966,0.7902
"6956",186283,"RIDER COLLEGE",1,0,1992,"12010","60.850079","207","577","731",402,329,305,"113",192,0.4776,0.3435,0.4172,0.7893
"6957",186283,"RIDER COLLEGE",1,0,1993,"12860","70.190666","208","515","663",376,287,267,"104",163,0.4335,0.3624,0.4027,0.7768
"6958",186283,"RIDER UNIVERSITY",1,0,1995,"13800","76.790175","222","465","612",329,283,242,"103",139,0.4225,0.364,0.3954,0.7598
"6959",186283,"RIDER UNIVERSITY",1,0,1996,"14400","78.222596","220","504","678",394,284,311,"113",198,0.5025,0.3979,0.4587,0.7434
"6960",186283,"RIDER UNIVERSITY",1,0,1997,"15120","64.64602","220","577","751",435,316,340,"135",205,0.4713,0.4272,0.4527,0.7683
"6961",186283,"RIDER UNIVERSITY",1,0,1998,"15880","67.190919","227","666","869",483,386,419,"161",258,0.5342,0.4171,0.4822,0.7664
"6962",186283,"RIDER UNIVERSITY",1,0,1999,"16520","71.197279","220","560","735",386,349,310,"128",182,0.4715,0.3668,0.4218,0.7619
"6963",186283,"RIDER UNIVERSITY",1,0,2000,"17180","75.508509","220","680","884",504,380,399,"152",247,0.4901,0.4,0.4514,0.7692
"6964",186283,"RIDER UNIVERSITY",1,0,2001,"17990","79.258535","220","600","839",472,367,361,"143",218,0.4619,0.3896,0.4303,0.7151
"6965",186283,"RIDER UNIVERSITY",1,0,2002,"19240","82.217194","229","754","958",542,416,439,"173",266,0.4908,0.4159,0.4582,0.7871
"6966",186283,"RIDER UNIVERSITY",1,0,2003,"20590","90.087516","232","735","944",575,369,443,"154",289,0.5026,0.4173,0.4693,0.7786
"6967",186283,"RIDER UNIVERSITY",1,0,2004,"21820","94.567689","235","663","890",514,376,456,"190",266,0.5175,0.5053,0.5124,0.7449
"6968",186283,"Rider University",1,0,2005,"22910","98.411326","231","727","934",526,408,482,"183",299,0.5684,0.4485,0.5161,0.7784
"6969",186283,"Rider University",1,0,2006,"24220","107.704031","235","799","1016",619,397,576,"206",370,0.5977,0.5189,0.5669,0.7864
"6970",186283,"Rider University",1,0,2007,"25650","116.077","241","750","990",569,421,547,"201",346,0.6081,0.4774,0.5525,0.7576
"6971",186283,"Rider University",1,0,2008,"27140","128.262","243","608","875",516,359,460,"167",293,0.5678,0.4652,0.5257,0.6949
"6972",186283,"Rider University",1,0,2009,"28470","135.221","242","678","1027",611,416,557,"216",341,0.5581,0.5192,0.5424,0.6602
"6973",186283,"Rider University",1,0,2010,"29870","145.318","249","744","1007",601,406,585,"227",358,0.5957,0.5591,0.5809,0.7388
"6974",186584,"SETON HALL UNIVERSITY",1,0,1991,"10450","112.822","336","668","984",474,510,429,"184",245,0.5169,0.3608,0.436,0.6789
"6975",186584,"SETON HALL UNIVERSITY",1,0,1992,"10960","123.61","348","649","985",484,501,384,"161",223,0.4607,0.3214,0.3898,0.6589
"6976",186584,"SETON HALL UNIVERSITY",1,0,1993,"11380","132.985","348","650","996",522,474,376,"142",234,0.4483,0.2996,0.3775,0.6526
"6977",186584,"SETON HALL UNIVERSITY",1,0,1995,"12250","138.778","341","561","955",527,428,371,"145",226,0.4288,0.3388,0.3885,0.5874
"6978",186584,"SETON HALL UNIVERSITY",1,0,1996,"12850","142.683","340","548","968",547,421,349,"112",237,0.4333,0.266,0.3605,0.5661
"6979",186584,"SETON HALL UNIVERSITY",1,0,1997,"13600","130.819","338","627","1056",547,509,409,"157",252,0.4607,0.3084,0.3873,0.5938
"6980",186584,"SETON HALL UNIVERSITY",1,0,1998,"15680","133.979","354","694","1221",657,564,486,"173",313,0.4764,0.3067,0.398,0.5684
"6981",186584,"SETON HALL UNIVERSITY",1,0,1999,"15480","148.616","376","588","1063",533,530,437,"190",247,0.4634,0.3585,0.4111,0.5532
"6982",186584,"SETON HALL UNIVERSITY",1,0,2000,"16410","162.143","377.5","537","1121",581,540,464,"186",278,0.4785,0.3444,0.4139,0.479
"6983",186584,"SETON HALL UNIVERSITY",1,0,2001,"17400","166.966","379","636","1182",601,581,495,"210",285,0.4742,0.3614,0.4188,0.5381
"6984",186584,"SETON HALL UNIVERSITY",1,0,2002,"18780","179.347","393","620","1157",607,550,523,"232",291,0.4794,0.4218,0.452,0.5359
"6985",186584,"SETON HALL UNIVERSITY",1,0,2003,"19530","184.11","404","716","1241",616,625,620,"301",319,0.5179,0.4816,0.4996,0.577
"6986",186584,"SETON HALL UNIVERSITY",1,0,2004,"20490","195.78","426","667","1234",672,562,626,"269",357,0.5312,0.4786,0.5073,0.5405
"6987",186584,"Seton Hall University",1,0,2005,"21510","202.06","441","626","1115",582,533,576,"236",340,0.5842,0.4428,0.5166,0.5614
"6988",186584,"Seton Hall University",1,0,2006,"22770","211.406","449","547","1054",602,452,574,"231",343,0.5698,0.5111,0.5446,0.519
"6989",186584,"Seton Hall University",1,0,2007,"25900","215.778","432","727","1256",664,592,631,"277",354,0.5331,0.4679,0.5024,0.5788
"6990",186584,"Seton Hall University",1,0,2008,"27680","239.05","452","705","1216",688,528,687,"282",405,0.5887,0.5341,0.565,0.5798
"6991",186584,"Seton Hall University",1,0,2009,"28520","244.242","460","580","1124",659,465,570,"232",338,0.5129,0.4989,0.5071,0.516
"6992",186584,"Seton Hall University",1,0,2010,"29940","247.765","446","704","1302",728,574,708,"288",420,0.5769,0.5017,0.5438,0.5407
"6993",186876,"STOCKTON STATE COLLEGE",1,0,1991,"2456","44.071393","175","526","683",364,319,194,"64",130,0.3571,0.2006,0.284,0.7701
"6994",186876,"STOCKTON STATE COLLEGE",1,0,1992,"2657","46.473435","174","598","720",401,319,174,"70",104,0.2594,0.2194,0.2417,0.8306
"6995",186876,"THE RICHARD STOCKTON COLLEGE OF NEW JERSEY",1,0,1993,"2880","48.400486","178","576","709",369,340,193,"77",116,0.3144,0.2265,0.2722,0.8124
"6996",186876,"THE RICHARD STOCKTON COLLEGE OF NEW JERSEY",1,0,1995,"3152","53.871504","176","605","726",438,288,258,"86",172,0.3927,0.2986,0.3554,0.8333
"6997",186876,"THE RICHARD STOCKTON COLLEGE OF NEW JERSEY",1,0,1996,"3472","60.26846","186","555","705",404,301,278,"110",168,0.4158,0.3654,0.3943,0.7872
"6998",186876,"THE RICHARD STOCKTON COLLEGE OF NEW JERSEY",1,0,1997,"3776","63.523319","193","555","700",415,285,283,"93",190,0.4578,0.3263,0.4043,0.7929
"6999",186876,"THE RICHARD STOCKTON COLLEGE OF NEW JERSEY",1,0,1998,"4144","67.258243","189","593","744",420,324,321,"116",205,0.4881,0.358,0.4315,0.797
"7000",186876,"THE RICHARD STOCKTON COLLEGE OF NEW JERSEY",1,0,1999,"3280","70.543865","199","547","705",409,296,254,"86",168,0.4108,0.2905,0.3603,0.7759
"7001",186876,"THE RICHARD STOCKTON COLLEGE OF NEW JERSEY",1,0,2000,"3600","79.180184","202","589","728",431,297,296,"96",200,0.464,0.3232,0.4066,0.8091
"7002",186876,"THE RICHARD STOCKTON COLLEGE OF NEW JERSEY",1,0,2001,"3952","85.82285","205","612","751",424,327,335,"122",213,0.5024,0.3731,0.4461,0.8149
"7003",186876,"THE RICHARD STOCKTON COLLEGE OF NEW JERSEY",1,0,2002,"4352","84.642597","216","674","794",436,358,338,"131",207,0.4748,0.3659,0.4257,0.8489
"7004",186876,"THE RICHARD STOCKTON COLLEGE OF NEW JERSEY",1,0,2003,"4736","97.062955","219","698","816",439,377,319,"119",200,0.4556,0.3156,0.3909,0.8554
"7005",186876,"THE RICHARD STOCKTON COLLEGE OF NEW JERSEY",1,0,2004,"5091","93.543934","227","686","819",435,384,331,"127",204,0.469,0.3307,0.4042,0.8376
"7006",186876,"The Richard Stockton College of New Jersey",1,0,2005,"5498","98.511959","242","653","808",460,348,346,"104",242,0.5261,0.2989,0.4282,0.8082
"7007",186876,"The Richard Stockton College of New Jersey",1,0,2006,"5938","116.058964","252","631","791",425,366,319,"123",196,0.4612,0.3361,0.4033,0.7977
"7008",186876,"The Richard Stockton College of New Jersey",1,0,2007,"6353","127.298074","259","613","794",480,314,335,"93",242,0.5042,0.2962,0.4219,0.772
"7009",186876,"The Richard Stockton College of New Jersey",1,0,2008,"6861","139.093432","264","641","840",458,382,425,"156",269,0.5873,0.4084,0.506,0.7631
"7010",186876,"The Richard Stockton College of New Jersey",1,0,2009,"7067","149.676376","263","646","865",483,382,459,"175",284,0.588,0.4581,0.5306,0.7468
"7011",186876,"The Richard Stockton College of New Jersey",1,0,2010,"7349","150.09236","271","651","858",518,340,433,"137",296,0.5714,0.4029,0.5047,0.7587
"7012",187134,"TRENTON STATE COLLEGE",1,0,1991,"3079","77.097","318","684","860",560,300,445,"108",337,0.6018,0.36,0.5174,0.7953
"7013",187134,"TRENTON STATE COLLEGE",1,0,1992,"3761","82.018","316","847","1068",712,356,628,"174",454,0.6376,0.4888,0.588,0.7931
"7014",187134,"TRENTON STATE COLLEGE",1,0,1993,"3857","87.404","313","792","1064",628,436,576,"186",390,0.621,0.4266,0.5414,0.7444
"7015",187134,"THE COLLEGE OF NEW JERSEY",1,0,1995,"4241","100.513","316","777","1087",670,417,638,"212",426,0.6358,0.5084,0.5869,0.7148
"7016",187134,"THE COLLEGE OF NEW JERSEY",1,0,1996,"4522","105.78","311","714","1009",675,334,648,"187",461,0.683,0.5599,0.6422,0.7076
"7017",187134,"THE COLLEGE OF NEW JERSEY",1,0,1997,"4843","107.317838","324","1037","1396",847,549,870,"305",565,0.6671,0.5556,0.6232,0.7428
"7018",187134,"THE COLLEGE OF NEW JERSEY",1,0,1998,"5318","115.151262","325","846","1206",714,492,760,"278",482,0.6751,0.565,0.6302,0.7015
"7019",187134,"THE COLLEGE OF NEW JERSEY",1,0,1999,"4445","122.724375","328","901","1207",697,510,776,"281",495,0.7102,0.551,0.6429,0.7465
"7020",187134,"THE COLLEGE OF NEW JERSEY",1,0,2000,"4654","126.771","331","927","1205",714,491,799,"287",512,0.7171,0.5845,0.6631,0.7693
"7021",187134,"THE COLLEGE OF NEW JERSEY",1,0,2001,"5022","138.194","334","988","1258",750,508,852,"302",550,0.7333,0.5945,0.6773,0.7854
"7022",187134,"THE COLLEGE OF NEW JERSEY",1,0,2002,"5625","121.141","324","914","1231",738,493,834,"288",546,0.7398,0.5842,0.6775,0.7425
"7023",187134,"THE COLLEGE OF NEW JERSEY",1,0,2003,"6131","129.397","325","898","1176",679,497,855,"327",528,0.7776,0.6579,0.727,0.7636
"7024",187134,"THE COLLEGE OF NEW JERSEY",1,0,2004,"6621","129.041","333","941","1230",681,549,876,"357",519,0.7621,0.6503,0.7122,0.765
"7025",187134,"The College of New Jersey",1,0,2005,"7051","138.828","341","917","1236",685,551,914,"383",531,0.7752,0.6951,0.7395,0.7419
"7026",187134,"The College of New Jersey",1,0,2006,"7615","156.239","332","817","1270",756,514,919,"339",580,0.7672,0.6595,0.7236,0.6433
"7027",187134,"The College of New Jersey",1,0,2007,"8072","156.117","335","852","1297",774,523,940,"334",606,0.7829,0.6386,0.7247,0.6569
"7028",187134,"The College of New Jersey",1,0,2008,"8718","164.098","343","815","1295",763,532,939,"356",583,0.7641,0.6692,0.7251,0.6293
"7029",187134,"The College of New Jersey",1,0,2009,"8980","174.066","348","828","1283",718,565,918,"366",552,0.7688,0.6478,0.7155,0.6454
"7030",187134,"The College of New Jersey",1,0,2010,"9340","184.098","348","944","1421",800,621,1065,"443",622,0.7775,0.7134,0.7495,0.6643
"7031",187444,"WILLIAM PATERSON COLLEGE OF NEW JERSEY",1,0,1991,"2544","65.297407","296","718","967",551,416,100,"19",81,0.147,0.0457,0.1034,0.7425
"7032",187444,"WILLIAM PATERSON COLLEGE OF NEW JERSEY",1,0,1992,"2832","72.383143","307","688","962",536,426,94,"24",70,0.1306,0.0563,0.0977,0.7152
"7033",187444,"WILLIAM PATERSON COLLEGE OF NEW JERSEY",1,0,1993,"2928","78.436691","311","755","1091",608,483,89,"14",75,0.1234,0.029,0.0816,0.692
"7034",187444,"WILLIAM PATERSON COLLEGE OF NEW JERSEY",1,0,1995,"3120","82.996375","314","518","831",476,355,87,"23",64,0.1345,0.0648,0.1047,0.6233
"7035",187444,"WILLIAM PATERSON COLLEGE OF NEW JERSEY",1,0,1996,"3380","85.528794","306","568","918",523,395,148,"41",107,0.2046,0.1038,0.1612,0.6187
"7036",187444,"WILLIAM PATERSON UNIVERSITY OF NEW JERSEY",1,0,1997,"3786","90.695463","323","610","1032",563,469,154,"51",103,0.1829,0.1087,0.1492,0.5911
"7037",187444,"WILLIAM PATERSON UNIVERSITY OF NEW JERSEY",1,0,1998,"4150","95.866146","340","696","1133",663,470,145,"39",106,0.1599,0.083,0.128,0.6143
"7038",187444,"WILLIAM PATERSON UNIVERSITY OF NEW JERSEY",1,0,1999,"3319","107.707397","352","678","1105",614,491,177,"56",121,0.1971,0.1141,0.1602,0.6136
"7039",187444,"WILLIAM PATERSON UNIVERSITY OF NEW JERSEY",1,0,2000,"3554","121.851914","357","675","1160",610,550,188,"73",115,0.1885,0.1327,0.1621,0.5819
"7040",187444,"WILLIAM PATERSON UNIVERSITY OF NEW JERSEY",1,0,2001,"3838","125.241164","362","799","1247",697,550,185,"59",126,0.1808,0.1073,0.1484,0.6407
"7041",187444,"WILLIAM PATERSON UNIVERSITY OF NEW JERSEY",1,0,2002,"4218","118.251474","359","747","1286",715,571,208,"59",149,0.2084,0.1033,0.1617,0.5809
"7042",187444,"WILLIAM PATERSON UNIVERSITY OF NEW JERSEY",1,0,2003,"4594","128.22501","354","741","1269",711,558,262,"86",176,0.2475,0.1541,0.2065,0.5839
"7043",187444,"WILLIAM PATERSON UNIVERSITY OF NEW JERSEY",1,0,2004,"4961","136.271126","371","813","1430",801,629,245,"85",160,0.1998,0.1351,0.1713,0.5685
"7044",187444,"William Paterson University of New Jersey",1,0,2005,"5358","147.088694","377","685","1296",652,644,235,"89",146,0.2239,0.1382,0.1813,0.5285
"7045",187444,"William Paterson University of New Jersey",1,0,2006,"5782","153.837574","366","613","1218",669,549,170,"62",108,0.1614,0.1129,0.1396,0.5033
"7046",187444,"William Paterson University of New Jersey",1,0,2007,"6072","155.335814","373","671","1299",642,657,211,"89",122,0.19,0.1355,0.1624,0.5166
"7047",187444,"William Paterson University of New Jersey",1,0,2008,"6375","172.209318","379","589","1204",617,587,215,"75",140,0.2269,0.1278,0.1786,0.4892
"7048",187444,"William Paterson University of New Jersey",1,0,2009,"6567","177.366046","371","726","1435",703,732,284,"129",155,0.2205,0.1762,0.1979,0.5059
"7049",187444,"William Paterson University of New Jersey",1,0,2010,"6830","182.390835","380","751","1509",774,735,443,"160",283,0.3656,0.2177,0.2936,0.4977
"7050",187985,"UNIVERSITY OF NEW MEXICO-MAIN CAMPUS",1,0,1991,"1554","486.597033","818","957","1716",915,801,147,"61",86,0.094,0.0762,0.0857,0.5577
"7051",187985,"UNIVERSITY OF NEW MEXICO-MAIN CAMPUS",1,0,1992,"1656","582.242613","817","917","1700",946,754,148,"53",95,0.1004,0.0703,0.0871,0.5394
"7052",187985,"UNIVERSITY OF NEW MEXICO-MAIN CAMPUS",1,0,1993,"1788","606.124815","837","1024","1910",1067,843,171,"52",119,0.1115,0.0617,0.0895,0.5361
"7053",187985,"UNIVERSITY OF NEW MEXICO-MAIN CAMPUS",1,0,1995,"1996","740.50541","861","897","1712",956,756,221,"76",145,0.1517,0.1005,0.1291,0.5239
"7054",187985,"UNIVERSITY OF NEW MEXICO-MAIN CAMPUS",1,0,1996,"2071","741.435636","839","813","1600",875,725,217,"67",150,0.1714,0.0924,0.1356,0.5081
"7055",187985,"UNIVERSITY OF NEW MEXICO-MAIN CAMPUS",1,0,1997,"2164","754.348789","854","1119","2047",1132,915,244,"71",173,0.1528,0.0776,0.1192,0.5467
"7056",187985,"UNIVERSITY OF NEW MEXICO-MAIN CAMPUS",1,0,1998,"2242","793.630623","862","1290","2617",1475,1142,281,"96",185,0.1254,0.0841,0.1074,0.4929
"7057",187985,"UNIVERSITY OF NEW MEXICO-MAIN CAMPUS",1,0,1999,"1942","820.468453","862","1397","2715",1517,1198,276,"85",191,0.1259,0.071,0.1017,0.5145
"7058",187985,"UNIVERSITY OF NEW MEXICO-MAIN CAMPUS",1,0,2000,"2259","892.510112","869.5","1286","2587",1474,1113,311,"106",205,0.1391,0.0952,0.1202,0.4971
"7059",187985,"UNIVERSITY OF NEW MEXICO-MAIN CAMPUS",1,0,2001,"2490","926.865168","877","1127","2364",1323,1041,280,"103",177,0.1338,0.0989,0.1184,0.4767
"7060",187985,"UNIVERSITY OF NEW MEXICO-MAIN CAMPUS",1,0,2002,"2621","1020.612047","870","1344","2758",1565,1193,314,"100",214,0.1367,0.0838,0.1139,0.4873
"7061",187985,"UNIVERSITY OF NEW MEXICO-MAIN CAMPUS",1,0,2003,"2740","1022.025261","884","1349","2940",1660,1280,300,"76",224,0.1349,0.0594,0.102,0.4588
"7062",187985,"UNIVERSITY OF NEW MEXICO-MAIN CAMPUS",1,0,2004,"3112","1103.634085","874","1352","3018",1720,1298,370,"98",272,0.1581,0.0755,0.1226,0.448
"7063",187985,"University of New Mexico-Main Campus",1,0,2005,"3360","1149.832937","905","1367","3010",1717,1293,372,"130",242,0.1409,0.1005,0.1236,0.4542
"7064",187985,"University of New Mexico-Main Campus",1,0,2006,"3475","1234.778012","889","1332","2955",1619,1336,356,"124",232,0.1433,0.0928,0.1205,0.4508
"7065",187985,"University of New Mexico-Main Campus",1,0,2007,"3640","1307.069816","918","1260","2850",1637,1213,415,"147",268,0.1637,0.1212,0.1456,0.4421
"7066",187985,"University of New Mexico-Main Campus",1,0,2008,"3817","1473.629341","933","1309","3148",1737,1411,459,"161",298,0.1716,0.1141,0.1458,0.4158
"7067",187985,"University of New Mexico-Main Campus",1,0,2009,"4007","1626.955425","958","1255","3344",1762,1582,516,"193",323,0.1833,0.122,0.1543,0.3753
"7068",187985,"University of New Mexico-Main Campus",1,0,2010,"4348","1699.009449","942","1274","3488",1951,1537,574,"204",370,0.1896,0.1327,0.1646,0.3653
"7069",188030,"NEW MEXICO STATE UNIVERSITY MAIN CAMPUS",1,0,1991,"1594","220.321269","575","945","1656",846,810,127,"45",82,0.0969,0.0556,0.0767,0.5707
"7070",188030,"NEW MEXICO STATE UNIVERSITY MAIN CAMPUS",1,0,1992,"1708","233.614598","586","871","1598",830,768,152,"58",94,0.1133,0.0755,0.0951,0.5451
"7071",188030,"NEW MEXICO STATE UNIVERSITY-MAIN CAMPUS",1,0,1993,"1824","242.900911","582","867","1602",780,822,153,"64",89,0.1141,0.0779,0.0955,0.5412
"7072",188030,"NEW MEXICO STATE UNIVERSITY-MAIN CAMPUS",1,0,1995,"2088","256.455238","597","743","1419",726,693,146,"51",95,0.1309,0.0736,0.1029,0.5236
"7073",188030,"NEW MEXICO STATE UNIVERSITY-MAIN CAMPUS",1,0,1996,"2196","253.68738","595","803","1510",807,703,188,"51",137,0.1698,0.0725,0.1245,0.5318
"7074",188030,"NEW MEXICO STATE UNIVERSITY-MAIN CAMPUS",1,0,1997,"2196","268.290129","583","843","1694",901,793,201,"70",131,0.1454,0.0883,0.1187,0.4976
"7075",188030,"NEW MEXICO STATE UNIVERSITY-MAIN CAMPUS",1,0,1998,"2346","271.359704","562","1074","2077",1070,1007,254,"77",177,0.1654,0.0765,0.1223,0.5171
"7076",188030,"NEW MEXICO STATE UNIVERSITY-MAIN CAMPUS",1,0,1999,"1740","288.514284","568","1081","2210",1223,987,272,"88",184,0.1504,0.0892,0.1231,0.4891
"7077",188030,"NEW MEXICO STATE UNIVERSITY-MAIN CAMPUS",1,0,2000,"1956","302.342955","562","160","1959",1082,877,238,"83",155,0.1433,0.0946,0.1215,0.0817
"7078",188030,"NEW MEXICO STATE UNIVERSITY-MAIN CAMPUS",1,0,2001,"2148","320.725706","556","769","2051",1075,976,250,"76",174,0.1619,0.0779,0.1219,0.3749
"7079",188030,"NEW MEXICO STATE UNIVERSITY-MAIN CAMPUS",1,0,2002,"2328","334.441101","575","826","1977",1111,866,257,"78",179,0.1611,0.0901,0.13,0.4178
"7080",188030,"NEW MEXICO STATE UNIVERSITY-MAIN CAMPUS",1,0,2003,"2418","349.360456","590","840","2016",1087,929,257,"90",167,0.1536,0.0969,0.1275,0.4167
"7081",188030,"NEW MEXICO STATE UNIVERSITY-MAIN CAMPUS",1,0,2004,"2828","359.544159","597","831","2061",1125,936,260,"92",168,0.1493,0.0983,0.1262,0.4032
"7082",188030,"New Mexico State University-Main Campus",1,0,2005,"2868","395.028075","657","785","1945",1092,853,289,"96",193,0.1767,0.1125,0.1486,0.4036
"7083",188030,"New Mexico State University-Main Campus",1,0,2006,"3124","424.762836","649","854","2073",1105,968,286,"80",206,0.1864,0.0826,0.138,0.412
"7084",188030,"New Mexico State University-Main Campus",1,0,2007,"3274","449.93654","679","802","2105",1123,982,329,"94",235,0.2093,0.0957,0.1563,0.381
"7085",188030,"New Mexico State University-Main Campus",1,0,2008,"3540","475.591153","690","794","2171",1175,996,337,"130",207,0.1762,0.1305,0.1552,0.3657
"7086",188030,"New Mexico State University-Main Campus",1,0,2009,"3720","496.522211","716","849","2446",1306,1140,328,"116",212,0.1623,0.1018,0.1341,0.3471
"7087",188030,"New Mexico State University-Main Campus",1,0,2010,"4128","491.012099","699","700","2255",1181,1074,381,"151",230,0.1948,0.1406,0.169,0.3104
"7088",188429,"ADELPHI UNIVERSITY",1,0,1991,"10420","75.924","280","352","658",417,241,259,"74",185,0.4436,0.3071,0.3936,0.535
"7089",188429,"ADELPHI UNIVERSITY",1,0,1992,"11420","79.381","267","291","591",356,235,153,"40",113,0.3174,0.1702,0.2589,0.4924
"7090",188429,"ADELPHI UNIVERSITY",1,0,1993,"12250","76.745","267","237","464",282,182,154,"48",106,0.3759,0.2637,0.3319,0.5108
"7091",188429,"ADELPHI UNIVERSITY",1,0,1995,"13350","83.6","220","207","370",212,158,140,"52",88,0.4151,0.3291,0.3784,0.5595
"7092",188429,"ADELPHI UNIVERSITY",1,0,1996,"14000","98.226185","176","182","316",204,112,128,"40",88,0.4314,0.3571,0.4051,0.5759
"7093",188429,"ADELPHI UNIVERSITY",1,0,1997,"14000","70.743613","204","150","289",174,115,130,"49",81,0.4655,0.4261,0.4498,0.519
"7094",188429,"ADELPHI UNIVERSITY",1,0,1998,"14250","67.847791","196","251","525",343,182,214,"67",147,0.4286,0.3681,0.4076,0.4781
"7095",188429,"ADELPHI UNIVERSITY",1,0,1999,"14920","70.61292","196","316","532",366,166,233,"64",169,0.4617,0.3855,0.438,0.594
"7096",188429,"ADELPHI UNIVERSITY",1,0,2000,"15520","75.267607","195.5","349","616",416,200,314,"82",232,0.5577,0.41,0.5097,0.5666
"7097",188429,"ADELPHI UNIVERSITY",1,0,2001,"16270","78.765539","195","373","664",469,195,367,"89",278,0.5928,0.4564,0.5527,0.5617
"7098",188429,"ADELPHI UNIVERSITY",1,0,2002,"16980","84.994862","215","365","666",463,203,373,"97",276,0.5961,0.4778,0.5601,0.548
"7099",188429,"ADELPHI UNIVERSITY",1,0,2003,"17800","91.865246","228","395","772",514,258,402,"117",285,0.5545,0.4535,0.5207,0.5117
"7100",188429,"ADELPHI UNIVERSITY",1,0,2004,"17700","103.633422","242","367","801",549,252,463,"119",344,0.6266,0.4722,0.578,0.4582
"7101",188429,"Adelphi University",1,0,2005,"18620","110.310195","257","327","754",505,249,416,"121",295,0.5842,0.4859,0.5517,0.4337
"7102",188429,"Adelphi University",1,0,2006,"19800","124.781305","280","488","826",587,239,446,"108",338,0.5758,0.4519,0.54,0.5908
"7103",188429,"Adelphi University",1,0,2007,"21000","135.054647","283","517","883",603,280,464,"134",330,0.5473,0.4786,0.5255,0.5855
"7104",188429,"Adelphi University",1,0,2008,"22725","142.491238","295","554","944",614,330,510,"146",364,0.5928,0.4424,0.5403,0.5869
"7105",188429,"Adelphi University",1,0,2009,"24100","155.968446","308","577","985",690,295,539,"131",408,0.5913,0.4441,0.5472,0.5858
"7106",188429,"Adelphi University",1,0,2010,"25465","162.805964","311","499","909",634,275,521,"133",388,0.612,0.4836,0.5732,0.549
"7107",188641,"ALFRED UNIVERSITY",1,0,1991,"14110","39.197","119","231","256",110,146,132,"67",65,0.5909,0.4589,0.5156,0.9023
"7108",188641,"ALFRED UNIVERSITY",1,0,1992,"14998","43.178","111","269","300",136,164,151,"73",78,0.5735,0.4451,0.5033,0.8967
"7109",188641,"ALFRED UNIVERSITY",1,0,1993,"15648","48.08","113","273","314",148,166,165,"74",91,0.6149,0.4458,0.5255,0.8694
"7110",188641,"ALFRED UNIVERSITY",1,0,1995,"17948","53.187","114","287","326",158,168,153,"56",97,0.6139,0.3333,0.4693,0.8804
"7111",188641,"ALFRED UNIVERSITY",1,0,1996,"18972","56.328512","117","295","330",166,164,178,"76",102,0.6145,0.4634,0.5394,0.8939
"7112",188641,"ALFRED UNIVERSITY",1,0,1997,"19916","45.089644","114","424","467",205,262,204,"99",105,0.5122,0.3779,0.4368,0.9079
"7113",188641,"ALFRED UNIVERSITY",1,0,1998,"20212","50.122371","111","492","554",275,279,272,"118",154,0.56,0.4229,0.491,0.8881
"7114",188641,"ALFRED UNIVERSITY",1,0,1999,"18498","54.485007","115","478","549",277,272,242,"98",144,0.5199,0.3603,0.4408,0.8707
"7115",188641,"ALFRED UNIVERSITY",1,0,2000,"18498","57.310586","115","386","504",280,224,246,"81",165,0.5893,0.3616,0.4881,0.7659
"7116",188641,"ALFRED UNIVERSITY",1,0,2001,"18498","62.753887","115","369","500",243,257,232,"97",135,0.5556,0.3774,0.464,0.738
"7117",188641,"ALFRED UNIVERSITY",1,0,2002,"19918","69.221443","125","348","474",223,251,247,"111",136,0.6099,0.4422,0.5211,0.7342
"7118",188641,"ALFRED UNIVERSITY",1,0,2003,"19918","70.054818","188","364","472",250,222,237,"89",148,0.592,0.4009,0.5021,0.7712
"7119",188641,"ALFRED UNIVERSITY",1,0,2004,"20106","68.906595","172","367","505",226,279,218,"99",119,0.5265,0.3548,0.4317,0.7267
"7120",188641,"Alfred University",1,0,2005,"20515","72.253138","213","306","429",188,241,186,"85",101,0.5372,0.3527,0.4336,0.7133
"7121",188641,"Alfred University",1,0,2006,"21284","66.328151","177","332","490",257,233,229,"86",143,0.5564,0.3691,0.4673,0.6776
"7122",188641,"Alfred University",1,0,2007,"22312","65.761283","167","345","518",239,279,231,"107",124,0.5188,0.3835,0.4459,0.666
"7123",188641,"Alfred University",1,0,2008,"23428","68.898126","158","344","502",219,283,193,"99",94,0.4292,0.3498,0.3845,0.6853
"7124",188641,"Alfred University",1,0,2009,"24366","68.538198","160","313","465",234,231,204,"85",119,0.5085,0.368,0.4387,0.6731
"7125",188641,"Alfred University",1,0,2010,"25096","65.48167","156","372","526",240,286,225,"91",134,0.5583,0.3182,0.4278,0.7072
"7126",190044,"CLARKSON UNIVERSITY",1,0,1991,"13675","67.037","182","554","634",134,500,338,"266",72,0.5373,0.532,0.5331,0.8738
"7127",190044,"CLARKSON UNIVERSITY",1,0,1992,"14510","69.274","179","479","549",138,411,294,"210",84,0.6087,0.5109,0.5355,0.8725
"7128",190044,"CLARKSON UNIVERSITY",1,0,1993,"15060","65.486","161","502","557",120,437,285,"221",64,0.5333,0.5057,0.5117,0.9013
"7129",190044,"CLARKSON UNIVERSITY",1,0,1995,"17113","65.702","148","573","645",170,475,305,"221",84,0.4941,0.4653,0.4729,0.8884
"7130",190044,"CLARKSON UNIVERSITY",1,0,1996,"17500","68.701","144","577","664",176,488,349,"253",96,0.5455,0.5184,0.5256,0.869
"7131",190044,"CLARKSON UNIVERSITY",1,0,1997,"18593","56.026987","154","546","612",136,476,378,"297",81,0.5956,0.6239,0.6176,0.8922
"7132",190044,"CLARKSON UNIVERSITY",1,0,1998,"19418","58.545298","156","553","616",138,478,292,"216",76,0.5507,0.4519,0.474,0.8977
"7133",190044,"CLARKSON UNIVERSITY",1,0,1999,"19825","60.133041","149","645","706",225,481,407,"264",143,0.6356,0.5489,0.5765,0.9136
"7134",190044,"CLARKSON UNIVERSITY",1,0,2000,"20600","63.850587","156.5","568","638",149,489,325,"242",83,0.557,0.4949,0.5094,0.8903
"7135",190044,"CLARKSON UNIVERSITY",1,0,2001,"21400","70.544364","164","631","722",164,558,382,"290",92,0.561,0.5197,0.5291,0.874
"7136",190044,"CLARKSON UNIVERSITY",1,0,2002,"22235","70.399912","154","673","723",164,559,391,"296",95,0.5793,0.5295,0.5408,0.9308
"7137",190044,"CLARKSON UNIVERSITY",1,0,2003,"23100","76.509276","169","641","720",193,527,372,"257",115,0.5959,0.4877,0.5167,0.8903
"7138",190044,"CLARKSON UNIVERSITY",1,0,2004,"24100","83.615616","169","610","658",142,516,364,"275",89,0.6268,0.5329,0.5532,0.9271
"7139",190044,"Clarkson University",1,0,2005,"25185","83.095692","175","579","630",173,457,380,"274",106,0.6127,0.5996,0.6032,0.919
"7140",190044,"Clarkson University",1,0,2006,"26650","84.30388","174","556","646",176,470,354,"246",108,0.6136,0.5234,0.548,0.8607
"7141",190044,"Clarkson University",1,0,2007,"28470","87.29039","183","582","682",189,493,418,"289",129,0.6825,0.5862,0.6129,0.8534
"7142",190044,"Clarkson University",1,0,2008,"30320","87.827012","186","615","734",204,530,407,"274",133,0.652,0.517,0.5545,0.8379
"7143",190044,"Clarkson University",1,0,2009,"32220","93.645098","194","645","774",220,554,405,"262",143,0.65,0.4729,0.5233,0.8333
"7144",190044,"Clarkson University",1,0,2010,"34070","98.421572","201","612","712",182,530,399,"279",120,0.6593,0.5264,0.5604,0.8596
"7145",190099,"COLGATE UNIVERSITY",1,0,1991,"16150","65.024","194","587","694",330,364,554,"265",289,0.8758,0.728,0.7983,0.8458
"7146",190099,"COLGATE UNIVERSITY",1,0,1992,"17415","67.819","200","586","690",368,322,589,"257",332,0.9022,0.7981,0.8536,0.8493
"7147",190099,"COLGATE UNIVERSITY",1,0,1993,"18620","74.803","198","625","726",378,348,603,"269",334,0.8836,0.773,0.8306,0.8609
"7148",190099,"COLGATE UNIVERSITY",1,0,1995,"20650","85.618","192","632","722",361,361,604,"290",314,0.8698,0.8033,0.8366,0.8753
"7149",190099,"COLGATE UNIVERSITY",1,0,1996,"21675","92.364","190","600","718",351,367,592,"282",310,0.8832,0.7684,0.8245,0.8357
"7150",190099,"COLGATE UNIVERSITY",1,0,1997,"22765","78.859","188","593","711",364,347,599,"276",323,0.8874,0.7954,0.8425,0.834
"7151",190099,"COLGATE UNIVERSITY",1,0,1998,"23880","80.956","193","620","751",407,344,641,"283",358,0.8796,0.8227,0.8535,0.8256
"7152",190099,"COLGATE UNIVERSITY",1,0,1999,"24575","84.735","230","619","750",397,353,662,"306",356,0.8967,0.8669,0.8827,0.8253
"7153",190099,"COLGATE UNIVERSITY",1,0,2000,"25565","92.565","241.5","601","711",339,372,600,"308",292,0.8614,0.828,0.8439,0.8453
"7154",190099,"COLGATE UNIVERSITY",1,0,2001,"26845","97.437213","253","597","740",392,348,631,"282",349,0.8903,0.8103,0.8527,0.8068
"7155",190099,"COLGATE UNIVERSITY",1,0,2002,"28165","104.48299","247","565","728",386,342,629,"292",337,0.8731,0.8538,0.864,0.7761
"7156",190099,"COLGATE UNIVERSITY",1,0,2003,"29740","111.672","246","562","725",355,370,615,"301",314,0.8845,0.8135,0.8483,0.7752
"7157",190099,"COLGATE UNIVERSITY",1,0,2004,"31230","119.044","246","544","738",396,342,616,"277",339,0.8561,0.8099,0.8347,0.7371
"7158",190099,"Colgate University",1,0,2005,"32885","123.247068","250","571","729",368,361,640,"311",329,0.894,0.8615,0.8779,0.7833
"7159",190099,"Colgate University",1,0,2006,"34795","130.352","264","552","743",417,326,630,"278",352,0.8441,0.8528,0.8479,0.7429
"7160",190099,"Colgate University",1,0,2007,"37405","139.308","257","552","744",382,362,644,"297",347,0.9084,0.8204,0.8656,0.7419
"7161",190099,"Colgate University",1,0,2008,"39275","146.206","267","553","737",386,351,661,"307",354,0.9171,0.8746,0.8969,0.7503
"7162",190099,"Colgate University",1,0,2009,"40690","150.045095","269","556","750",400,350,644,"299",345,0.8625,0.8543,0.8587,0.7413
"7163",190099,"Colgate University",1,0,2010,"41585","155.231541","280","568","849",466,383,721,"312",409,0.8777,0.8146,0.8492,0.669
"7164",190150,"COLUMBIA UNIVERSITY IN THE CITY OF NEW YORK",1,0,1991,"16318","891.381","888","572","1085",464,621,851,"481",370,0.7974,0.7746,0.7843,0.5272
"7165",190150,"COLUMBIA UNIVERSITY IN THE CITY OF NEW YORK",1,0,1992,"16918","984.855","2240","478","1113",458,655,880,"511",369,0.8057,0.7802,0.7907,0.4295
"7166",190150,"COLUMBIA UNIVERSITY IN THE CITY OF NEW YORK",1,0,1993,"17948","1019.384","2240","848","1626",997,629,1243,"482",761,0.7633,0.7663,0.7645,0.5215
"7167",190150,"COLUMBIA UNIVERSITY IN THE CITY OF NEW YORK",1,0,1995,"20292","1152.441","2438","561","1157",505,652,918,"501",417,0.8257,0.7684,0.7934,0.4849
"7168",190150,"COLUMBIA UNIVERSITY IN THE CITY OF NEW YORK",1,0,1996,"21444","1207.329","2461","595","1260",576,684,1041,"542",499,0.8663,0.7924,0.8262,0.4722
"7169",190150,"COLUMBIA UNIVERSITY IN THE CITY OF NEW YORK",1,0,1997,"22652","1216.485","1130","583","1271",583,688,1036,"547",489,0.8388,0.7951,0.8151,0.4587
"7170",190150,"COLUMBIA UNIVERSITY IN THE CITY OF NEW YORK",1,0,1998,"23244","1281.94","1163","589","1283",619,664,1061,"545",516,0.8336,0.8208,0.827,0.4591
"7171",190150,"COLUMBIA UNIVERSITY IN THE CITY OF NEW YORK",1,0,1999,"24150","1418.056","1217","625","1298",573,725,1068,"586",482,0.8412,0.8083,0.8228,0.4815
"7172",190150,"COLUMBIA UNIVERSITY IN THE CITY OF NEW YORK",1,0,2000,"25044","1573.457","1290.5","630","1339",610,729,1136,"602",534,0.8754,0.8258,0.8484,0.4705
"7173",190150,"COLUMBIA UNIVERSITY IN THE CITY OF NEW YORK",1,0,2001,"25790","1722.173","1364","661","1330",607,723,1108,"612",496,0.8171,0.8465,0.8331,0.497
"7174",190150,"COLUMBIA UNIVERSITY IN THE CITY OF NEW YORK",1,0,2002,"27190","1895.116","1466","678","1386",636,750,1168,"630",538,0.8459,0.84,0.8427,0.4892
"7175",190150,"COLUMBIA UNIVERSITY IN THE CITY OF NEW YORK",1,0,2003,"28686","2037.8","1508","611","1355",626,729,1131,"606",525,0.8387,0.8313,0.8347,0.4509
"7176",190150,"COLUMBIA UNIVERSITY IN THE CITY OF NEW YORK",1,0,2004,"30260","2190.773","1521","604","1366",632,734,1133,"604",529,0.837,0.8229,0.8294,0.4422
"7177",190150,"Columbia University in the City of New York",1,0,2005,"31924","2409.267","1289","644","1403",660,743,1189,"621",568,0.8606,0.8358,0.8475,0.459
"7178",190150,"Columbia University in the City of New York",1,0,2006,"33664","2540.033","1317","564","1353",646,707,1191,"604",587,0.9087,0.8543,0.8803,0.4169
"7179",190150,"Columbia University in the City of New York",1,0,2007,"35516","2688.355","1388","567","1371",671,700,1173,"586",587,0.8748,0.8371,0.8556,0.4136
"7180",190150,"Columbia University in the City of New York",1,0,2008,"37470","2894.809","1425","549","1374",653,721,1208,"613",595,0.9112,0.8502,0.8792,0.3996
"7181",190150,"Columbia University in the City of New York",1,0,2009,"39296","3061.281","1422","491","1432",701,731,1260,"629",631,0.9001,0.8605,0.8799,0.3429
"7182",190150,"Columbia University in the City of New York",1,0,2010,"41160","3158.488","1439","495","1392",676,716,1188,"595",593,0.8772,0.831,0.8534,0.3556
"7183",190248,"CONCORDIA COLLEGE",1,0,1991,"8370","7.844","38","73","85",43,42,29,"10",19,0.4419,0.2381,0.3412,0.8588
"7184",190248,"CONCORDIA COLLEGE",1,0,1992,"9370","8.67","33","79","106",62,44,28,"8",20,0.3226,0.1818,0.2642,0.7453
"7185",190248,"CONCORDIA COLLEGE",1,0,1993,"9990","9.877","32","61","81",40,41,27,"12",15,0.375,0.2927,0.3333,0.7531
"7186",190248,"CONCORDIA COLLEGE",1,0,1995,"10696","10.069","32","81","118",63,55,29,"13",16,0.254,0.2364,0.2458,0.6864
"7187",190248,"CONCORDIA COLLEGE",1,0,1996,"11400","10.742769","32","69","94",43,51,19,"7",12,0.2791,0.1373,0.2021,0.734
"7188",190248,"CONCORDIA COLLEGE",1,0,1997,"11990","9.255695","30","90","113",71,42,41,"13",28,0.3944,0.3095,0.3628,0.7965
"7189",190248,"CONCORDIA COLLEGE",1,0,1998,"12650","9.881446","29","75","114",68,46,40,"17",23,0.3382,0.3696,0.3509,0.6579
"7190",190248,"CONCORDIA COLLEGE",1,0,1999,"13350","10.026951","28","66","111",72,39,33,"6",27,0.375,0.1538,0.2973,0.5946
"7191",190248,"CONCORDIA COLLEGE",1,0,2000,"14350","10.623364","26","82","122",68,54,55,"23",32,0.4706,0.4259,0.4508,0.6721
"7192",190248,"CONCORDIA COLLEGE",1,0,2001,"15550","11.505552","24","97","132",88,44,50,"9",41,0.4659,0.2045,0.3788,0.7348
"7193",190248,"CONCORDIA COLLEGE",1,0,2002,"16800","11.793391","26","86","135",75,60,43,"16",27,0.36,0.2667,0.3185,0.637
"7194",190248,"CONCORDIA COLLEGE",1,0,2003,"17640","12.120198","25","80","137",85,52,37,"12",25,0.2941,0.2308,0.2701,0.5839
"7195",190248,"CONCORDIA COLLEGE",1,0,2004,"18700","12.630133","24","84","143",61,82,38,"13",25,0.4098,0.1585,0.2657,0.5874
"7196",190248,"Concordia College",1,0,2005,"19800","13.054063","26","92","140",83,57,49,"12",37,0.4458,0.2105,0.35,0.6571
"7197",190248,"Concordia College",1,0,2006,"20700","13.917298","26","109","171",90,81,57,"26",31,0.3444,0.321,0.3333,0.6374
"7198",190248,"Concordia College",1,0,2007,"21950","15.151711","28","68","127",76,51,35,"9",26,0.3421,0.1765,0.2756,0.5354
"7199",190248,"Concordia College",1,0,2008,"22930","16.818875","34","51","104",58,46,40,"12",28,0.4828,0.2609,0.3846,0.4904
"7200",190248,"Concordia College-New York",1,0,2009,"23950","17.049572","33","45","101",54,47,27,"7",20,0.3704,0.1489,0.2673,0.4455
"7201",190248,"Concordia College-New York",1,0,2010,"24670","17.11909","35","67","138",76,62,62,"22",40,0.5263,0.3548,0.4493,0.4855
"7202",190415,"CORNELL UNIVERSITY-ENDOWED COLLEGES",1,0,1991,"16214","510.106","923","1705","2949",1345,1604,2336,"1218",1118,0.8312,0.7594,0.7921,0.5782
"7203",190415,"CORNELL UNIVERSITY-ENDOWED COLLEGES",1,0,1992,"17276","523.596","940","1597","2893",1382,1511,2354,"1179",1175,0.8502,0.7803,0.8137,0.552
"7204",190415,"CORNELL UNIVERSITY-ENDOWED COLLEGES",1,0,1993,"18226","547.401","914","1802","3172",1423,1749,2612,"1400",1212,0.8517,0.8005,0.8235,0.5681
"7205",190415,"CORNELL UNIVERSITY-ENDOWED COLLEGES",1,0,1995,"20066","634.6262","911","1196","2070",842,1228,1625,"931",694,0.8242,0.7581,0.785,0.5778
"7206",190415,"CORNELL UNIVERSITY-ENDOWED COLLEGES",1,0,1996,"20974","664.084684","891","1108","2001",870,1131,1570,"872",698,0.8023,0.771,0.7846,0.5537
"7207",190415,"CORNELL UNIVERSITY-ENDOWED COLLEGES",1,0,1997,"21914","582.713993","906","1750","2998",1405,1593,2551,"1307",1244,0.8854,0.8205,0.8509,0.5837
"7208",190415,"CORNELL UNIVERSITY-ENDOWED COLLEGES",1,0,1998,"22868","619.783529","911","1920","3084",1452,1632,2633,"1358",1275,0.8781,0.8321,0.8538,0.6226
"7209",190415,"CORNELL UNIVERSITY-ENDOWED COLLEGES",1,0,1999,"23760","653.253359","897","1939","3158",1497,1661,2660,"1341",1319,0.8811,0.8073,0.8423,0.614
"7210",190415,"CORNELL UNIVERSITY-ENDOWED COLLEGES",1,0,2000,"24760","705.050594","911","1814","3047",1438,1609,2569,"1308",1261,0.8769,0.8129,0.8431,0.5953
"7211",190415,"CORNELL UNIVERSITY-ENDOWED COLLEGES",1,0,2001,"25970","705.925173","925","1815","2984",1471,1513,2524,"1246",1278,0.8688,0.8235,0.8458,0.6082
"7212",190415,"CORNELL UNIVERSITY-ENDOWED COLLEGES",1,0,2002,"27270","763.619653","933","1878","2999",1530,1469,2605,"1253",1352,0.8837,0.853,0.8686,0.6262
"7213",190415,"CORNELL UNIVERSITY-ENDOWED COLLEGES",1,0,2003,"28630","1263.190041","1692","1782","3131",1533,1598,2672,"1322",1350,0.8806,0.8273,0.8534,0.5691
"7214",190415,"CORNELL UNIVERSITY-ENDOWED COLLEGES",1,0,2004,"30000","1333.276293","1748","1724","3051",1494,1557,2621,"1289",1332,0.8916,0.8279,0.8591,0.5651
"7215",190415,"Cornell University",1,0,2005,"31300","1409.323705","1742","1838","3071",1541,1530,2664,"1286",1378,0.8942,0.8405,0.8675,0.5985
"7216",190415,"Cornell University",1,0,2006,"32800","1520.874737","1787","1576","3186",1538,1648,2779,"1375",1404,0.9129,0.8343,0.8723,0.4947
"7217",190415,"Cornell University",1,0,2007,"34600","1547.174284","1799","1363","3005",1454,1551,2601,"1285",1316,0.9051,0.8285,0.8656,0.4536
"7218",190415,"Cornell University",1,0,2008,"36300","1680.283612","1819","1514","3132",1573,1559,2718,"1307",1411,0.897,0.8384,0.8678,0.4834
"7219",190415,"Cornell University",1,0,2009,"37750","1689.355056","1775","1471","3174",1597,1577,2742,"1327",1415,0.886,0.8415,0.8639,0.4635
"7220",190415,"Cornell University",1,0,2010,"39450","1616.047278","1737","1467","3172",1579,1593,2763,"1325",1438,0.9107,0.8318,0.8711,0.4625
"7221",190512,"CUNY BERNARD BARUCH COLLEGE",1,0,1991,"1950","97.225","433","194","1170",746,424,56,"19",37,0.0496,0.0448,0.0479,0.1658
"7222",190512,"CUNY BERNARD BARUCH COLLEGE",1,0,1992,"2552","104.246","398","260","1359",830,529,52,"20",32,0.0386,0.0378,0.0383,0.1913
"7223",190512,"CUNY BERNARD M BARUCH COLLEGE",1,0,1993,"2562","111.04","438","284","1300",798,502,63,"25",38,0.0476,0.0498,0.0485,0.2185
"7224",190512,"CUNY BERNARD M BARUCH COLLEGE",1,0,1995,"3320","123.213","413","323","1445",839,606,149,"55",94,0.112,0.0908,0.1031,0.2235
"7225",190512,"CUNY BERNARD M BARUCH COLLEGE",1,0,1996,"3320","119.799","404","349","1365",797,568,196,"82",114,0.143,0.1444,0.1436,0.2557
"7226",190512,"CUNY BERNARD M BARUCH COLLEGE",1,0,1997,"3330","126.145","396","261","1109",608,501,202,"75",127,0.2089,0.1497,0.1821,0.2353
"7227",190512,"CUNY BERNARD M BARUCH COLLEGE",1,0,1998,"3330","127.914","409","276","946",493,453,231,"83",148,0.3002,0.1832,0.2442,0.2918
"7228",190512,"CUNY BERNARD M BARUCH COLLEGE",1,0,1999,"3200","107.984","405","358","1133",593,540,312,"124",188,0.317,0.2296,0.2754,0.316
"7229",190512,"CUNY BERNARD M BARUCH COLLEGE",1,0,2000,"3200","144.349","441","417","1295",701,594,351,"137",214,0.3053,0.2306,0.271,0.322
"7230",190512,"CUNY BERNARD M BARUCH COLLEGE",1,0,2001,"3200","143.226666","477","571","1688",921,767,554,"231",323,0.3507,0.3012,0.3282,0.3383
"7231",190512,"CUNY BERNARD M BARUCH COLLEGE",1,0,2002,"3200","126.450823","424","615","1654",830,824,554,"217",337,0.406,0.2633,0.3349,0.3718
"7232",190512,"CUNY BERNARD M BARUCH COLLEGE",1,0,2003,"4000","138.961812","473","564","1659",819,840,544,"214",330,0.4029,0.2548,0.3279,0.34
"7233",190512,"CUNY BERNARD M BARUCH COLLEGE",1,0,2004,"4000","143.882276","486","575","1693",865,828,569,"233",336,0.3884,0.2814,0.3361,0.3396
"7234",190512,"CUNY Bernard M Baruch College",1,0,2005,"4000","150.775661","473","513","1625",784,841,577,"266",311,0.3967,0.3163,0.3551,0.3157
"7235",190512,"CUNY Bernard M Baruch College",1,0,2006,"4000","163.871933","486","448","1493",650,843,497,"248",249,0.3831,0.2942,0.3329,0.3001
"7236",190512,"CUNY Bernard M Baruch College",1,0,2007,"4000","180.941993","501","492","1470",695,775,578,"259",319,0.459,0.3342,0.3932,0.3347
"7237",190512,"CUNY Bernard M Baruch College",1,0,2008,"4000","195.106835","509","469","1497",693,804,530,"250",280,0.404,0.3109,0.354,0.3133
"7238",190512,"CUNY Bernard M Baruch College",1,0,2009,"4600","238.762269","498","444","1430",619,811,598,"294",304,0.4911,0.3625,0.4182,0.3105
"7239",190512,"CUNY Bernard M Baruch College",1,0,2010,"4600","249.853079","522","378","1255",527,728,483,"242",241,0.4573,0.3324,0.3849,0.3012
"7240",190549,"CUNY BROOKLYN COLLEGE",1,0,1991,"2005","100.495","551","828","1475",843,632,135,"42",93,0.1103,0.0665,0.0915,0.5614
"7241",190549,"CUNY BROOKLYN COLLEGE",1,0,1992,"2607","108.249","534","728","1341",765,576,122,"40",82,0.1072,0.0694,0.091,0.5429
"7242",190549,"CUNY BROOKLYN COLLEGE",1,0,1993,"2629","113.471","557","646","1269",748,521,143,"40",103,0.1377,0.0768,0.1127,0.5091
"7243",190549,"CUNY BROOKLYN COLLEGE",1,0,1995,"3387","125.761","490","549","1167",685,482,182,"60",122,0.1781,0.1245,0.156,0.4704
"7244",190549,"CUNY BROOKLYN COLLEGE",1,0,1996,"3387","121.964","479","591","1211",739,472,183,"49",134,0.1813,0.1038,0.1511,0.488
"7245",190549,"CUNY BROOKLYN COLLEGE",1,0,1997,"3393","120.625","473","636","1344",774,570,194,"75",119,0.1537,0.1316,0.1443,0.4732
"7246",190549,"CUNY BROOKLYN COLLEGE",1,0,1998,"3393","126.403","461","521","1029",615,414,184,"56",128,0.2081,0.1353,0.1788,0.5063
"7247",190549,"CUNY BROOKLYN COLLEGE",1,0,1999,"3200","131.319","465","504","982",591,391,166,"55",111,0.1878,0.1407,0.169,0.5132
"7248",190549,"CUNY BROOKLYN COLLEGE",1,0,2000,"3200","130.273","491","589","1238",717,521,218,"79",139,0.1939,0.1516,0.1761,0.4758
"7249",190549,"CUNY BROOKLYN COLLEGE",1,0,2001,"3200","141.961431","517","528","1017",591,426,209,"64",145,0.2453,0.1502,0.2055,0.5192
"7250",190549,"CUNY BROOKLYN COLLEGE",1,0,2002,"3200","141.589859","466","579","1194",679,515,235,"78",157,0.2312,0.1515,0.1968,0.4849
"7251",190549,"CUNY BROOKLYN COLLEGE",1,0,2003,"4000","146.890475","509","653","1296",679,617,220,"73",147,0.2165,0.1183,0.1698,0.5039
"7252",190549,"CUNY BROOKLYN COLLEGE",1,0,2004,"4000","150.3747","514","545","1170",653,517,268,"90",178,0.2726,0.1741,0.2291,0.4658
"7253",190549,"CUNY Brooklyn College",1,0,2005,"4000","153.125648","510","588","1372",757,615,294,"109",185,0.2444,0.1772,0.2143,0.4286
"7254",190549,"CUNY Brooklyn College",1,0,2006,"4000","171.503478","515","579","1354",766,588,355,"120",235,0.3068,0.2041,0.2622,0.4276
"7255",190549,"CUNY Brooklyn College",1,0,2007,"4000","196.047484","530","531","1300",743,557,305,"103",202,0.2719,0.1849,0.2346,0.4085
"7256",190549,"CUNY Brooklyn College",1,0,2008,"4000","201.310228","533","522","1330",792,538,319,"107",212,0.2677,0.1989,0.2398,0.3925
"7257",190549,"CUNY Brooklyn College",1,0,2009,"4600","228.891655","557","388","952",541,411,223,"94",129,0.2384,0.2287,0.2342,0.4076
"7258",190549,"CUNY Brooklyn College",1,0,2010,"4600","250.795151","519","505","1143",661,482,284,"95",189,0.2859,0.1971,0.2485,0.4418
"7259",190558,"CUNY COLLEGE OF STATEN ISLAND",1,0,1991,"1949","59.232","257","843","1153",599,554,16,"4",12,0.02,0.0072,0.0139,0.7311
"7260",190558,"CUNY COLLEGE OF STATEN ISLAND",1,0,1992,"2558","64.091","237","811","1126",593,533,17,"3",14,0.0236,0.0056,0.0151,0.7202
"7261",190558,"CUNY COLLEGE OF STATEN ISLAND",1,0,1993,"2558","70.753","293","784","1100",579,521,23,"9",14,0.0242,0.0173,0.0209,0.7127
"7262",190558,"CUNY COLLEGE OF STATEN ISLAND",1,0,1995,"3316","80.571","264","1007","1426",728,698,33,"17",16,0.022,0.0244,0.0231,0.7062
"7263",190558,"CUNY COLLEGE OF STATEN ISLAND",1,0,1996,"3316","77.472","265","956","1434",727,707,32,"9",23,0.0316,0.0127,0.0223,0.6667
"7264",190558,"CUNY COLLEGE OF STATEN ISLAND",1,0,1997,"3316","81.077","274","944","1418",729,689,32,"7",25,0.0343,0.0102,0.0226,0.6657
"7265",190558,"CUNY COLLEGE OF STATEN ISLAND",1,0,1998,"3316","86.405","273","956","1510",786,724,36,"14",22,0.028,0.0193,0.0238,0.6331
"7266",190558,"CUNY COLLEGE OF STATEN ISLAND",1,0,1999,"3200","90.482","288","942","1532",782,750,63,"21",42,0.0537,0.028,0.0411,0.6149
"7267",190558,"CUNY COLLEGE OF STATEN ISLAND",1,0,2000,"3200","91.068","309.5","982","1488",796,692,44,"10",34,0.0427,0.0145,0.0296,0.6599
"7268",190558,"CUNY COLLEGE OF STATEN ISLAND",1,0,2001,"3200","96.955847","331","1045","1600",817,783,57,"22",35,0.0428,0.0281,0.0356,0.6531
"7269",190558,"CUNY COLLEGE OF STATEN ISLAND",1,0,2002,"3200","97.125572","290","1131","1743",905,838,66,"25",41,0.0453,0.0298,0.0379,0.6489
"7270",190558,"CUNY COLLEGE OF STATEN ISLAND",1,0,2003,"4000","103.647861","334","1210","1885",1013,872,67,"17",50,0.0494,0.0195,0.0355,0.6419
"7271",190558,"CUNY COLLEGE OF STATEN ISLAND",1,0,2004,"4000","107.511209","343","1243","2020",1147,873,67,"12",55,0.048,0.0137,0.0332,0.6153
"7272",190558,"CUNY College of Staten Island",1,0,2005,"4000","113.418185","333","1120","1888",1048,840,62,"31",31,0.0296,0.0369,0.0328,0.5932
"7273",190558,"CUNY College of Staten Island",1,0,2006,"4000","123.595096","328","1265","2072",1124,948,108,"41",67,0.0596,0.0432,0.0521,0.6105
"7274",190558,"CUNY College of Staten Island",1,0,2007,"4000","133.177113","345","1342","2273",1272,1001,122,"48",74,0.0582,0.048,0.0537,0.5904
"7275",190558,"CUNY College of Staten Island",1,0,2008,"4000","144.727339","347","1340","2282",1209,1073,112,"47",65,0.0538,0.0438,0.0491,0.5872
"7276",190558,"CUNY College of Staten Island",1,0,2009,"4600","172.030388","350","1430","2407",1245,1162,127,"52",75,0.0602,0.0448,0.0528,0.5941
"7277",190558,"CUNY College of Staten Island",1,0,2010,"4600","192.637032","366","1299","2237",1184,1053,146,"52",94,0.0794,0.0494,0.0653,0.5807
"7278",190567,"CUNY CITY COLLEGE",1,0,1991,"1945","123.231","623","68","1126",505,621,19,"11",8,0.0158,0.0177,0.0169,0.0604
"7279",190567,"CUNY CITY COLLEGE",1,0,1992,"2547","131.323","541","53","1071",454,617,18,"12",6,0.0132,0.0194,0.0168,0.0495
"7280",190567,"CUNY CITY COLLEGE",1,0,1993,"2547","136.487","587","94","1167",507,660,25,"13",12,0.0237,0.0197,0.0214,0.0805
"7281",190567,"CUNY CITY COLLEGE",1,0,1995,"3304","139.833","530","55","865",449,416,31,"18",13,0.029,0.0433,0.0358,0.0636
"7282",190567,"CUNY CITY COLLEGE",1,0,1996,"3309","126.892","501","39","768",352,416,28,"14",14,0.0398,0.0337,0.0365,0.0508
"7283",190567,"CUNY CITY COLLEGE",1,0,1997,"3309","123.996","474","49","947",464,483,44,"17",27,0.0582,0.0352,0.0465,0.0517
"7284",190567,"CUNY CITY COLLEGE",1,0,1998,"3309","129.472","453","51","901",462,439,31,"11",20,0.0433,0.0251,0.0344,0.0566
"7285",190567,"CUNY CITY COLLEGE",1,0,1999,"3200","133.348","456","64","773",341,432,45,"16",29,0.085,0.037,0.0582,0.0828
"7286",190567,"CUNY CITY COLLEGE",1,0,2000,"3200","88.684","474","69","852",399,453,27,"8",19,0.0476,0.0177,0.0317,0.081
"7287",190567,"CUNY CITY COLLEGE",1,0,2001,"3200","168.117701","492","72","705",310,395,54,"17",37,0.1194,0.043,0.0766,0.1021
"7288",190567,"CUNY CITY COLLEGE",1,0,2002,"3200","172.28601","478","134","961",435,526,65,"28",37,0.0851,0.0532,0.0676,0.1394
"7289",190567,"CUNY CITY COLLEGE",1,0,2003,"4000","185.546397","512","138","1124",547,577,62,"20",42,0.0768,0.0347,0.0552,0.1228
"7290",190567,"CUNY CITY COLLEGE",1,0,2004,"4000","189.397559","532","137","1168",531,637,106,"45",61,0.1149,0.0706,0.0908,0.1173
"7291",190567,"CUNY City College",1,0,2005,"4000","202.021948","530","164","1278",592,686,78,"39",39,0.0659,0.0569,0.061,0.1283
"7292",190567,"CUNY City College",1,0,2006,"4000","209.580386","521","224","1529",760,769,114,"43",71,0.0934,0.0559,0.0746,0.1465
"7293",190567,"CUNY City College",1,0,2007,"4000","225.734945","530","270","1771",916,855,166,"65",101,0.1103,0.076,0.0937,0.1525
"7294",190567,"CUNY City College",1,0,2008,"4000","257.804128","567","271","1744",919,825,182,"67",115,0.1251,0.0812,0.1044,0.1554
"7295",190567,"CUNY City College",1,0,2009,"4600","324.855615","574","323","1753",909,844,195,"75",120,0.132,0.0889,0.1112,0.1843
"7296",190567,"CUNY City College",1,0,2010,"4600","343.398478","588","241","1368",685,683,171,"58",113,0.165,0.0849,0.125,0.1762
"7297",190594,"CUNY HUNTER COLLEGE",1,0,1991,"1953","126.457","548","163","808",617,191,30,"3",27,0.0438,0.0157,0.0371,0.2017
"7298",190594,"CUNY HUNTER COLLEGE",1,0,1992,"2555","127.911","529","200","936",710,226,35,"10",25,0.0352,0.0442,0.0374,0.2137
"7299",190594,"CUNY HUNTER COLLEGE",1,0,1993,"2555","140.589","572","284","1308",1011,297,62,"7",55,0.0544,0.0236,0.0474,0.2171
"7300",190594,"CUNY HUNTER COLLEGE",1,0,1995,"3313","149.692","544","356","1091",807,284,82,"13",69,0.0855,0.0458,0.0752,0.3263
"7301",190594,"CUNY HUNTER COLLEGE",1,0,1996,"3323","130.246","525","456","1456",1008,448,127,"28",99,0.0982,0.0625,0.0872,0.3132
"7302",190594,"CUNY HUNTER COLLEGE",1,0,1997,"3329","130.188","512","551","1630",1137,493,136,"26",110,0.0967,0.0527,0.0834,0.338
"7303",190594,"CUNY HUNTER COLLEGE",1,0,1998,"3329","142.264","526","486","1468",1026,442,134,"29",105,0.1023,0.0656,0.0913,0.3311
"7304",190594,"CUNY HUNTER COLLEGE",1,0,1999,"3200","146.032","522","585","1806",1281,525,176,"36",140,0.1093,0.0686,0.0975,0.3239
"7305",190594,"CUNY HUNTER COLLEGE",1,0,2000,"3200","149.154","556.5","619","1741",1227,514,188,"43",145,0.1182,0.0837,0.108,0.3555
"7306",190594,"CUNY HUNTER COLLEGE",1,0,2001,"3200","172.66616","591","670","1877",1284,593,234,"41",193,0.1503,0.0691,0.1247,0.357
"7307",190594,"CUNY HUNTER COLLEGE",1,0,2002,"3200","173.932373","632","573","1445",1010,435,256,"50",206,0.204,0.1149,0.1772,0.3965
"7308",190594,"CUNY HUNTER COLLEGE",1,0,2003,"4000","191.641448","612","641","1661",1113,548,280,"63",217,0.195,0.115,0.1686,0.3859
"7309",190594,"CUNY HUNTER COLLEGE",1,0,2004,"4000","192.571801","641","683","1824",1235,589,312,"81",231,0.187,0.1375,0.1711,0.3745
"7310",190594,"CUNY Hunter College",1,0,2005,"4000","205.200317","633","692","1776",1199,577,356,"97",259,0.216,0.1681,0.2005,0.3896
"7311",190594,"CUNY Hunter College",1,0,2006,"4000","239.299961","632","658","1813",1202,611,349,"86",263,0.2188,0.1408,0.1925,0.3629
"7312",190594,"CUNY Hunter College",1,0,2007,"4000","244.094353","668","699","1854",1226,628,402,"89",313,0.2553,0.1417,0.2168,0.377
"7313",190594,"CUNY Hunter College",1,0,2008,"4000","268.289341","686","698","1988",1273,715,445,"108",337,0.2647,0.151,0.2238,0.3511
"7314",190594,"CUNY Hunter College",1,0,2009,"4600","307.532835","694","708","1983",1241,742,487,"115",372,0.2998,0.155,0.2456,0.357
"7315",190594,"CUNY Hunter College",1,0,2010,"4600","337.285306","705","661","1740",1141,599,413,"100",313,0.2743,0.1669,0.2374,0.3799
"7316",190637,"CUNY LEHMAN COLLEGE",1,0,1991,"1960","61.092","330","74","711",470,241,15,"8",7,0.0149,0.0332,0.0211,0.1041
"7317",190637,"CUNY LEHMAN COLLEGE",1,0,1992,"2562","65.997","305","60","692",468,224,21,"6",15,0.0321,0.0268,0.0303,0.0867
"7318",190637,"CUNY LEHMAN COLLEGE",1,0,1993,"2562","72.599","324","56","663",455,208,15,"1",14,0.0308,0.0048,0.0226,0.0845
"7319",190637,"CUNY LEHMAN COLLEGE",1,0,1995,"3320","79.9","286","43","506",345,161,32,"7",25,0.0725,0.0435,0.0632,0.085
"7320",190637,"CUNY LEHMAN COLLEGE",1,0,1996,"3320","74.376","272","47","605",422,183,45,"8",37,0.0877,0.0437,0.0744,0.0777
"7321",190637,"CUNY LEHMAN COLLEGE",1,0,1997,"3320","78.651","276","56","736",519,217,45,"11",34,0.0655,0.0507,0.0611,0.0761
"7322",190637,"CUNY LEHMAN COLLEGE",1,0,1998,"3320","81.258","280","48","581",398,183,28,"8",20,0.0503,0.0437,0.0482,0.0826
"7323",190637,"CUNY LEHMAN COLLEGE",1,0,1999,"3200","82.003","281","51","604",416,188,44,"19",25,0.0601,0.1011,0.0728,0.0844
"7324",190637,"CUNY LEHMAN COLLEGE",1,0,2000,"3200","86.904","287.5","41","542",367,175,45,"11",34,0.0926,0.0629,0.083,0.0756
"7325",190637,"CUNY LEHMAN COLLEGE",1,0,2001,"3200","94.805891","294","39","642",441,201,77,"18",59,0.1338,0.0896,0.1199,0.0607
"7326",190637,"CUNY LEHMAN COLLEGE",1,0,2002,"3200","98.91151","287","49","729",485,244,73,"21",52,0.1072,0.0861,0.1001,0.0672
"7327",190637,"CUNY LEHMAN COLLEGE",1,0,2003,"4000","104.747517","308","59","790",529,261,85,"20",65,0.1229,0.0766,0.1076,0.0747
"7328",190637,"CUNY LEHMAN COLLEGE",1,0,2004,"4000","108.776887","337","64","852",571,281,100,"27",73,0.1278,0.0961,0.1174,0.0751
"7329",190637,"CUNY Lehman College",1,0,2005,"4000","117.662015","330","52","788",551,237,110,"33",77,0.1397,0.1392,0.1396,0.066
"7330",190637,"CUNY Lehman College",1,0,2006,"4000","125.418775","344","64","911",674,237,131,"24",107,0.1588,0.1013,0.1438,0.0703
"7331",190637,"CUNY Lehman College",1,0,2007,"4000","137.153411","363","59","874",610,264,129,"35",94,0.1541,0.1326,0.1476,0.0675
"7332",190637,"CUNY Lehman College",1,0,2008,"4000","148.529721","373","63","987",654,333,139,"40",99,0.1514,0.1201,0.1408,0.0638
"7333",190637,"CUNY Lehman College",1,0,2009,"4600","172.500984","374","55","754",461,293,111,"34",77,0.167,0.116,0.1472,0.0729
"7334",190637,"CUNY Lehman College",1,0,2010,"4600","186.047708","384","45","619",386,233,116,"33",83,0.215,0.1416,0.1874,0.0727
"7335",190664,"CUNY QUEENS COLLEGE",1,0,1991,"2033","111.748","579","848","1603",889,714,165,"49",116,0.1305,0.0686,0.1029,0.529
"7336",190664,"QUEENS COLLEGE",1,0,1992,"2635","117.168","551","808","1448",819,629,146,"35",111,0.1355,0.0556,0.1008,0.558
"7337",190664,"QUEENS COLLEGE",1,0,1993,"2635","130.371","631","809","1526",831,695,180,"55",125,0.1504,0.0791,0.118,0.5301
"7338",190664,"QUEENS COLLEGE",1,0,1995,"3392","143.312","541","777","1444",805,639,228,"81",147,0.1826,0.1268,0.1579,0.5381
"7339",190664,"QUEENS COLLEGE",1,0,1996,"3393","123.337","516","547","1040",621,419,225,"56",169,0.2721,0.1337,0.2163,0.526
"7340",190664,"CUNY QUEENS COLLEGE",1,0,1997,"3393","125.431","521","578","1153",675,478,227,"65",162,0.24,0.136,0.1969,0.5013
"7341",190664,"CUNY QUEENS COLLEGE",1,0,1998,"3393","133.744","514","558","1133",711,422,235,"59",176,0.2475,0.1398,0.2074,0.4925
"7342",190664,"CUNY QUEENS COLLEGE",1,0,1999,"3200","138.109","516","448","876",528,348,200,"50",150,0.2841,0.1437,0.2283,0.5114
"7343",190664,"CUNY QUEENS COLLEGE",1,0,2000,"3200","139.729","551.5","496","1085",639,446,254,"65",189,0.2958,0.1457,0.2341,0.4571
"7344",190664,"CUNY QUEENS COLLEGE",1,0,2001,"3200","139.187206","587","557","1204",704,500,325,"100",225,0.3196,0.2,0.2699,0.4626
"7345",190664,"CUNY QUEENS COLLEGE",1,0,2002,"3200","151.502552","545","596","1178",693,485,325,"90",235,0.3391,0.1856,0.2759,0.5059
"7346",190664,"CUNY QUEENS COLLEGE",1,0,2003,"4000","161.385056","566","626","1290",790,500,327,"88",239,0.3025,0.176,0.2535,0.4853
"7347",190664,"CUNY QUEENS COLLEGE",1,0,2004,"4000","165.085754","593","629","1352",815,537,352,"102",250,0.3067,0.1899,0.2604,0.4652
"7348",190664,"CUNY Queens College",1,0,2005,"4000","178.501824","577","708","1470",884,586,381,"101",280,0.3167,0.1724,0.2592,0.4816
"7349",190664,"CUNY Queens College",1,0,2006,"4000","188.581177","582","762","1627",991,636,418,"113",305,0.3078,0.1777,0.2569,0.4683
"7350",190664,"CUNY Queens College",1,0,2007,"4000","207.070248","628","776","1755",1064,691,440,"112",328,0.3083,0.1621,0.2507,0.4422
"7351",190664,"CUNY Queens College",1,0,2008,"4000","227.056377","630","667","1642",961,681,445,"125",320,0.333,0.1836,0.271,0.4062
"7352",190664,"CUNY Queens College",1,0,2009,"4600","270.206915","636","781","1684",944,740,473,"153",320,0.339,0.2068,0.2809,0.4638
"7353",190664,"CUNY Queens College",1,0,2010,"4600","296.991061","641","679","1471",821,650,452,"133",319,0.3886,0.2046,0.3073,0.4616
"7354",190691,"CUNY YORK COLLEGE",1,0,1991,"1932","33.556","131","17","431",276,155,22,"10",12,0.0435,0.0645,0.051,0.0394
"7355",190691,"CUNY YORK COLLEGE",1,0,1992,"2534","36.897","117","27","640",392,248,22,"12",10,0.0255,0.0484,0.0344,0.0422
"7356",190691,"CUNY YORK COLLEGE",1,0,1993,"2534","41.324","147","28","607",359,248,29,"13",16,0.0446,0.0524,0.0478,0.0461
"7357",190691,"CUNY YORK COLLEGE",1,0,1995,"3291","48.485","141","27","486",294,192,22,"7",15,0.051,0.0365,0.0453,0.0556
"7358",190691,"CUNY YORK COLLEGE",1,0,1996,"3292","45.548","130","29","543",368,175,47,"16",31,0.0842,0.0914,0.0866,0.0534
"7359",190691,"CUNY YORK COLLEGE",1,0,1997,"3292","46.42","139","26","500",323,177,38,"12",26,0.0805,0.0678,0.076,0.052
"7360",190691,"CUNY YORK COLLEGE",1,0,1998,"3292","48.096","142","27","383",235,148,22,"8",14,0.0596,0.0541,0.0574,0.0705
"7361",190691,"CUNY YORK COLLEGE",1,0,1999,"3200","49.413","147","23","425",261,164,31,"11",20,0.0766,0.0671,0.0729,0.0541
"7362",190691,"CUNY YORK COLLEGE",1,0,2000,"3200","51.049","157.5","30","458",314,144,29,"6",23,0.0732,0.0417,0.0633,0.0655
"7363",190691,"CUNY YORK COLLEGE",1,0,2001,"3200","56.38398","168","28","464",320,144,35,"11",24,0.075,0.0764,0.0754,0.0603
"7364",190691,"CUNY YORK COLLEGE",1,0,2002,"3200","58.908985","154","27","563",385,178,34,"8",26,0.0675,0.0449,0.0604,0.048
"7365",190691,"CUNY YORK COLLEGE",1,0,2003,"4000","62.347352","164","37","565",366,199,30,"8",22,0.0601,0.0402,0.0531,0.0655
"7366",190691,"CUNY YORK COLLEGE",1,0,2004,"4000","59.851695","172","45","727",453,274,27,"8",19,0.0419,0.0292,0.0371,0.0619
"7367",190691,"CUNY York College",1,0,2005,"4000","63.254305","180","40","746",481,265,27,"5",22,0.0457,0.0189,0.0362,0.0536
"7368",190691,"CUNY York College",1,0,2006,"4000","70.946666","174","46","668",428,240,27,"10",17,0.0397,0.0417,0.0404,0.0689
"7369",190691,"CUNY York College",1,0,2007,"4000","78.454277","183","53","983",636,347,50,"11",39,0.0613,0.0317,0.0509,0.0539
"7370",190691,"CUNY York College",1,0,2008,"4000","82.118355","205","77","1024",673,351,80,"26",54,0.0802,0.0741,0.0781,0.0752
"7371",190691,"CUNY York College",1,0,2009,"4600","102.53853","220","88","1028",627,401,50,"12",38,0.0606,0.0299,0.0486,0.0856
"7372",190691,"CUNY York College",1,0,2010,"4600","115.641365","233","82","1085",652,433,71,"16",55,0.0844,0.037,0.0654,0.0756
"7373",190725,"DAEMEN COLLEGE",1,0,1991,"7980","17.49","65","207","244",164,80,40,"14",26,0.1585,0.175,0.1639,0.8484
"7374",190725,"DAEMEN COLLEGE",1,0,1992,"8330","20.202","66","244","302",205,97,45,"9",36,0.1756,0.0928,0.149,0.8079
"7375",190725,"DAEMEN COLLEGE",1,0,1993,"8730","18.698","69","358","405",271,134,58,"19",39,0.1439,0.1418,0.1432,0.884
"7376",190725,"DAEMEN COLLEGE",1,0,1995,"9780","18.765","75","362","398",269,129,77,"20",57,0.2119,0.155,0.1935,0.9095
"7377",190725,"DAEMEN COLLEGE",1,0,1996,"10330","21.981728","74","336","372",259,113,69,"11",58,0.2239,0.0973,0.1855,0.9032
"7378",190725,"DAEMEN COLLEGE",1,0,1997,"10980","17.996555","77","360","416",313,103,87,"22",65,0.2077,0.2136,0.2091,0.8654
"7379",190725,"DAEMEN COLLEGE",1,0,1998,"11100","18.437453","72","293","345",262,83,80,"20",60,0.229,0.241,0.2319,0.8493
"7380",190725,"DAEMEN COLLEGE",1,0,1999,"11800","19.023785","72","222","293",230,63,70,"17",53,0.2304,0.2698,0.2389,0.7577
"7381",190725,"DAEMEN COLLEGE",1,0,2000,"12500","18.789563","72.5","247","317",254,63,77,"13",64,0.252,0.2063,0.2429,0.7792
"7382",190725,"DAEMEN COLLEGE",1,0,2001,"13200","19.61283","73","243","340",278,62,88,"12",76,0.2734,0.1935,0.2588,0.7147
"7383",190725,"DAEMEN COLLEGE",1,0,2002,"13850","21.139124","77","254","316",246,70,84,"16",68,0.2764,0.2286,0.2658,0.8038
"7384",190725,"DAEMEN COLLEGE",1,0,2003,"14700","23.486605","77","269","356",252,104,108,"23",85,0.3373,0.2212,0.3034,0.7556
"7385",190725,"DAEMEN COLLEGE",1,0,2004,"15570","26.080671","80","191","264",198,66,62,"11",51,0.2576,0.1667,0.2348,0.7235
"7386",190725,"Daemen College",1,0,2005,"16350","27.964942","83","300","366",288,78,91,"12",79,0.2743,0.1538,0.2486,0.8197
"7387",190725,"Daemen College",1,0,2006,"17240","29.298153","85","315","368",284,84,100,"22",78,0.2746,0.2619,0.2717,0.856
"7388",190725,"Daemen College",1,0,2007,"18300","30.823761","89","299","361",268,93,99,"19",80,0.2985,0.2043,0.2742,0.8283
"7389",190725,"Daemen College",1,0,2008,"19400","32.242711","99","324","405",309,96,110,"24",86,0.2783,0.25,0.2716,0.8
"7390",190725,"Daemen College",1,0,2009,"20250","34.123141","105","320","400",306,94,103,"29",74,0.2418,0.3085,0.2575,0.8
"7391",190725,"Daemen College",1,0,2010,"20950","36.637022","110","314","441",325,116,148,"36",112,0.3446,0.3103,0.3356,0.712
"7392",191241,"FORDHAM UNIVERSITY",1,0,1991,"11100","149.933","521","677","952",507,445,641,"292",349,0.6884,0.6562,0.6733,0.7111
"7393",191241,"FORDHAM UNIVERSITY",1,0,1992,"12170","160.253","513","693","1039",546,493,623,"294",329,0.6026,0.5963,0.5996,0.667
"7394",191241,"FORDHAM UNIVERSITY",1,0,1993,"13375","164.827","498","629","989",532,457,587,"271",316,0.594,0.593,0.5935,0.636
"7395",191241,"FORDHAM UNIVERSITY",1,0,1995,"14900","186.481","508","777","1120",620,500,794,"323",471,0.7597,0.646,0.7089,0.6938
"7396",191241,"FORDHAM UNIVERSITY",1,0,1996,"15800","201.893879","525","789","1206",694,512,822,"338",484,0.6974,0.6602,0.6816,0.6542
"7397",191241,"FORDHAM UNIVERSITY",1,0,1997,"16800","171.144146","569","971","1459",849,610,1075,"445",630,0.742,0.7295,0.7368,0.6655
"7398",191241,"FORDHAM UNIVERSITY",1,0,1998,"18435","185.874422","603","992","1532",912,620,1111,"422",689,0.7555,0.6806,0.7252,0.6475
"7399",191241,"FORDHAM UNIVERSITY",1,0,1999,"19200","205.199136","594","1008","1538",891,647,1105,"443",662,0.743,0.6847,0.7185,0.6554
"7400",191241,"FORDHAM UNIVERSITY",1,0,2000,"20200","215.63861","597.5","1008","1632",975,657,1183,"468",715,0.7333,0.7123,0.7249,0.6176
"7401",191241,"FORDHAM UNIVERSITY",1,0,2001,"21210","235.567518","601","1022","1610",950,660,1218,"470",748,0.7874,0.7121,0.7565,0.6348
"7402",191241,"FORDHAM UNIVERSITY",1,0,2002,"22913","248.190323","595","1042","1694",1020,674,1263,"478",785,0.7696,0.7092,0.7456,0.6151
"7403",191241,"FORDHAM UNIVERSITY",1,0,2003,"24001","288.352132","625","1045","1687",961,726,1265,"547",718,0.7471,0.7534,0.7499,0.6194
"7404",191241,"FORDHAM UNIVERSITY",1,0,2004,"26085","302.635389","645","986","1674",997,677,1269,"486",783,0.7854,0.7179,0.7581,0.589
"7405",191241,"Fordham University",1,0,2005,"27769","324.647303","654","1069","1734",983,751,1282,"548",734,0.7467,0.7297,0.7393,0.6165
"7406",191241,"Fordham University",1,0,2006,"29715","347.774862","667","1083","1697",929,768,1300,"578",722,0.7772,0.7526,0.7661,0.6382
"7407",191241,"Fordham University",1,0,2007,"31375","369.164541","686","1056","1760",910,850,1338,"645",693,0.7615,0.7588,0.7602,0.6
"7408",191241,"Fordham University",1,0,2008,"34099","396.050047","723","1078","1852",991,861,1385,"629",756,0.7629,0.7305,0.7478,0.5821
"7409",191241,"Fordham University",1,0,2009,"35717","421.538132","699","1169","1811",926,885,1358,"647",711,0.7678,0.7311,0.7499,0.6455
"7410",191241,"Fordham University",1,0,2010,"37050","433.047012","703","1223","1865",1021,844,1388,"607",781,0.7649,0.7192,0.7442,0.6558
"7411",191515,"HAMILTON COLLEGE",1,0,1991,"16650","45.428","135","391","462",207,255,384,"204",180,0.8696,0.8,0.8312,0.8463
"7412",191515,"HAMILTON COLLEGE",1,0,1992,"17650","48.432","148","385","461",223,238,373,"178",195,0.8744,0.7479,0.8091,0.8351
"7413",191515,"HAMILTON COLLEGE",1,0,1993,"18650","50.536","149","378","452",195,257,361,"192",169,0.8667,0.7471,0.7987,0.8363
"7414",191515,"HAMILTON COLLEGE",1,0,1995,"20700","57.538","152","435","488",237,251,392,"194",198,0.8354,0.7729,0.8033,0.8914
"7415",191515,"HAMILTON COLLEGE",1,0,1996,"21700","62.291","147","446","497",239,258,392,"196",196,0.8201,0.7597,0.7887,0.8974
"7416",191515,"HAMILTON COLLEGE",1,0,1997,"22700","53.96","138","400","457",239,218,381,"172",209,0.8745,0.789,0.8337,0.8753
"7417",191515,"HAMILTON COLLEGE",1,0,1998,"23600","56.649139","148","396","464",238,226,372,"170",202,0.8487,0.7522,0.8017,0.8534
"7418",191515,"HAMILTON COLLEGE",1,0,1999,"25000","61.135493","151","418","500",254,246,408,"190",218,0.8583,0.7724,0.816,0.836
"7419",191515,"HAMILTON COLLEGE",1,0,2000,"26000","64.8984","159.5","383","467",251,216,386,"172",214,0.8526,0.7963,0.8266,0.8201
"7420",191515,"HAMILTON COLLEGE",1,0,2001,"27250","70.236","168","389","465",233,232,386,"185",201,0.8627,0.7974,0.8301,0.8366
"7421",191515,"HAMILTON COLLEGE",1,0,2002,"28610","70.794","196","403","492",252,240,418,"195",223,0.8849,0.8125,0.8496,0.8191
"7422",191515,"HAMILTON COLLEGE",1,0,2003,"30000","85.742","202","370","464",234,230,383,"185",198,0.8462,0.8043,0.8254,0.7974
"7423",191515,"HAMILTON COLLEGE",1,0,2004,"31500","86.709","202","281","457",236,221,385,"180",205,0.8686,0.8145,0.8425,0.6149
"7424",191515,"Hamilton College",1,0,2005,"33150","93.993","191","342","496",248,248,417,"198",219,0.8831,0.7984,0.8407,0.6895
"7425",191515,"Hamilton College",1,0,2006,"34780","96.447","200","360","501",267,234,424,"195",229,0.8577,0.8333,0.8463,0.7186
"7426",191515,"Hamilton College",1,0,2007,"36500","102.362","194","338","468",247,221,419,"193",226,0.915,0.8733,0.8953,0.7222
"7427",191515,"Hamilton College",1,0,2008,"38220","107.606","200","309","461",257,204,396,"164",232,0.9027,0.8039,0.859,0.6703
"7428",191515,"Hamilton College",1,0,2009,"39370","111.681","191","291","466",241,225,407,"180",227,0.9419,0.8,0.8734,0.6245
"7429",191515,"Hamilton College",1,0,2010,"40870","114.247","194","279","467",252,215,414,"185",229,0.9087,0.8605,0.8865,0.5974
"7430",191533,"HARTWICK COLLEGE",1,0,1991,"13350","31.397","122","341","370",217,153,201,"74",127,0.5853,0.4837,0.5432,0.9216
"7431",191533,"HARTWICK COLLEGE",1,0,1992,"14350","31.8","117","410","446",228,218,248,"108",140,0.614,0.4954,0.5561,0.9193
"7432",191533,"HARTWICK COLLEGE",1,0,1993,"16400","33.578","123","383","429",217,212,201,"80",121,0.5576,0.3774,0.4685,0.8928
"7433",191533,"HARTWICK COLLEGE",1,0,1995,"19300","37.595","103","396","453",229,224,227,"88",139,0.607,0.3929,0.5011,0.8742
"7434",191533,"HARTWICK COLLEGE",1,0,1996,"20805","42.219","112","411","482",257,225,228,"93",135,0.5253,0.4133,0.473,0.8527
"7435",191533,"HARTWICK COLLEGE",1,0,1997,"21065","50.188511","109","283","388",197,191,209,"94",115,0.5838,0.4921,0.5387,0.7294
"7436",191533,"HARTWICK COLLEGE",1,0,1998,"23090","39.081887","104","305","440",227,213,204,"82",122,0.5374,0.385,0.4636,0.6932
"7437",191533,"HARTWICK COLLEGE",1,0,1999,"23745","40.572223","108","287","407",210,197,192,"75",117,0.5571,0.3807,0.4717,0.7052
"7438",191533,"HARTWICK COLLEGE",1,0,2000,"24760","43.272251","106.5","290","425",245,180,188,"61",127,0.5184,0.3389,0.4424,0.6824
"7439",191533,"HARTWICK COLLEGE",1,0,2001,"25715","43.175222","105","272","433",232,201,200,"73",127,0.5474,0.3632,0.4619,0.6282
"7440",191533,"HARTWICK COLLEGE",1,0,2002,"26615","42.47382","104","255","375",224,151,165,"56",109,0.4866,0.3709,0.44,0.68
"7441",191533,"HARTWICK COLLEGE",1,0,2003,"27400","41.100072","101","279","447",236,211,210,"77",133,0.5636,0.3649,0.4698,0.6242
"7442",191533,"HARTWICK COLLEGE",1,0,2004,"25830","40.610119","105","254","409",219,190,189,"80",109,0.4977,0.4211,0.4621,0.621
"7443",191533,"Hartwick College",1,0,2005,"26480","41.668361","108","256","405",212,193,182,"77",105,0.4953,0.399,0.4494,0.6321
"7444",191533,"Hartwick College",1,0,2006,"27450","43.216964","112","302","464",270,194,235,"88",147,0.5444,0.4536,0.5065,0.6509
"7445",191533,"Hartwick College",1,0,2007,"30125","43.961101","107","290","452",256,196,243,"92",151,0.5898,0.4694,0.5376,0.6416
"7446",191533,"Hartwick College",1,0,2008,"31330","46.149136","108","292","444",250,194,224,"91",133,0.532,0.4691,0.5045,0.6577
"7447",191533,"Hartwick College",1,0,2009,"32550","46.250176","103","253","402",239,163,202,"66",136,0.569,0.4049,0.5025,0.6294
"7448",191533,"Hartwick College",1,0,2010,"33850","42.979694","104","344","487",270,217,241,"104",137,0.5074,0.4793,0.4949,0.7064
"7449",191630,"HOBART WILLIAM SMITH COLLEGES",0,1,1991,"16396","42.752","130","419","503",211,292,334,"174",160,0.7583,0.5959,0.664,0.833
"7450",191630,"HOBART WILLIAM SMITH COLLEGES",0,1,1992,"17291","46.524","141","481","564",261,303,349,"167",182,0.6973,0.5512,0.6188,0.8528
"7451",191630,"HOBART WILLIAM SMITH COLLEGES",0,1,1993,"18309","49.645","134","435","493",236,257,325,"146",179,0.7585,0.5681,0.6592,0.8824
"7452",191630,"HOBART WILLIAM SMITH COLLEGES",0,1,1995,"20393","52.237","132","399","458",244,214,318,"137",181,0.7418,0.6402,0.6943,0.8712
"7453",191630,"HOBART WILLIAM SMITH COLLEGES",0,1,1996,"21381","54.865397","131","445","530",267,263,356,"161",195,0.7303,0.6122,0.6717,0.8396
"7454",191630,"HOBART WILLIAM SMITH COLLEGES",0,1,1997,"22380","40.770377","132","448","549",284,265,354,"174",180,0.6338,0.6566,0.6448,0.816
"7455",191630,"HOBART WILLIAM SMITH COLLEGES",0,1,1998,"23448","43.578882","132","416","488",280,208,347,"129",218,0.7786,0.6202,0.7111,0.8525
"7456",191630,"HOBART WILLIAM SMITH COLLEGES",0,1,1999,"23865","44.232505","135","440","502",255,247,307,"133",174,0.6824,0.5385,0.6116,0.8765
"7457",191630,"HOBART WILLIAM SMITH COLLEGES",1,0,2000,"24700","46.125384","142","445","521",282,239,353,"144",209,0.7411,0.6025,0.6775,0.8541
"7458",191630,"HOBART WILLIAM SMITH COLLEGES",1,0,2001,"25664","49.084972","149","473","548",313,235,368,"137",231,0.738,0.583,0.6715,0.8631
"7459",191630,"HOBART WILLIAM SMITH COLLEGES",1,0,2002,"26818","52.982146","152","457","532",283,249,367,"151",216,0.7633,0.6064,0.6898,0.859
"7460",191630,"HOBART WILLIAM SMITH COLLEGES",1,0,2003,"28400","55.51774","169","448","516",267,249,383,"176",207,0.7753,0.7068,0.7422,0.8682
"7461",191630,"HOBART WILLIAM SMITH COLLEGES",1,0,2004,"30076","59.529332","172","428","482",255,227,337,"142",195,0.7647,0.6256,0.6992,0.888
"7462",191630,"Hobart William Smith Colleges",1,0,2005,"31850","62.876776","174","475","545",283,262,377,"159",218,0.7703,0.6069,0.6917,0.8716
"7463",191630,"Hobart William Smith Colleges",1,0,2006,"33730","67.130881","183","534","597",319,278,428,"182",246,0.7712,0.6547,0.7169,0.8945
"7464",191630,"Hobart William Smith Colleges",1,0,2007,"35720","72.855663","173","419","600",338,262,444,"172",272,0.8047,0.6565,0.74,0.6983
"7465",191630,"Hobart William Smith Colleges",1,0,2008,"37820","78.032865","176","262","544",288,256,404,"179",225,0.7812,0.6992,0.7426,0.4816
"7466",191630,"Hobart William Smith Colleges",1,0,2009,"39144","88.645249","181","311","545",315,230,416,"161",255,0.8095,0.7,0.7633,0.5706
"7467",191630,"Hobart William Smith Colleges",1,0,2010,"40592","85.629075","179","442","618",339,279,448,"182",266,0.7847,0.6523,0.7249,0.7152
"7468",191649,"HOFSTRA UNIVERSITY",1,0,1991,"9790","157.144","420","628","1338",747,591,567,"190",377,0.5047,0.3215,0.4238,0.4694
"7469",191649,"HOFSTRA UNIVERSITY",1,0,1992,"10490","162.586","418","656","1403",769,634,571,"196",375,0.4876,0.3091,0.407,0.4676
"7470",191649,"HOFSTRA UNIVERSITY",1,0,1993,"11080","168.822","418","902","1349",705,644,524,"191",333,0.4723,0.2966,0.3884,0.6686
"7471",191649,"HOFSTRA UNIVERSITY",1,0,1995,"12360","181.681","429","970","1518",830,688,559,"201",358,0.4313,0.2922,0.3682,0.639
"7472",191649,"HOFSTRA UNIVERSITY",1,0,1996,"12966","191.933915","432","664","1735",996,739,653,"217",436,0.4378,0.2936,0.3764,0.3827
"7473",191649,"HOFSTRA UNIVERSITY",1,0,1997,"13544","186.545437","448","924","1743",928,815,648,"221",427,0.4601,0.2712,0.3718,0.5301
"7474",191649,"HOFSTRA UNIVERSITY",1,0,1998,"14000","200.213107","462","972","1749",907,842,593,"217",376,0.4146,0.2577,0.3391,0.5557
"7475",191649,"HOFSTRA UNIVERSITY",1,0,1999,"13750","204.309908","473","1105","1876",1015,861,675,"242",433,0.4266,0.2811,0.3598,0.589
"7476",191649,"HOFSTRA UNIVERSITY",1,0,2000,"14280","218.860155","468.5","1101","1937",1036,901,703,"266",437,0.4218,0.2952,0.3629,0.5684
"7477",191649,"HOFSTRA UNIVERSITY",1,0,2001,"14920","236.50102","464","1232","1974",1037,937,685,"248",437,0.4214,0.2647,0.347,0.6241
"7478",191649,"HOFSTRA UNIVERSITY",1,0,2002,"15740","230.876493","489","1181","1764",912,852,693,"254",439,0.4814,0.2981,0.3929,0.6695
"7479",191649,"HOFSTRA UNIVERSITY",1,0,2003,"17410","248.545077","508","1181","1855",979,876,768,"290",478,0.4883,0.3311,0.414,0.6367
"7480",191649,"HOFSTRA UNIVERSITY",1,0,2004,"19010","251.334791","518","1102","1713",885,828,750,"303",447,0.5051,0.3659,0.4378,0.6433
"7481",191649,"Hofstra University",1,0,2005,"20500","262.914991","527","1065","1759",961,798,763,"281",482,0.5016,0.3521,0.4338,0.6055
"7482",191649,"Hofstra University",1,0,2006,"22200","286.913354","532","1067","1706",865,841,768,"335",433,0.5006,0.3983,0.4502,0.6254
"7483",191649,"Hofstra University",1,0,2007,"25700","297.783242","544","1131","1716",907,809,850,"344",506,0.5579,0.4252,0.4953,0.6591
"7484",191649,"Hofstra University",1,0,2008,"27600","314.16511","551","1137","1637",864,773,816,"344",472,0.5463,0.445,0.4985,0.6946
"7485",191649,"Hofstra University",1,0,2009,"29080","333.226886","544","1045","1554",834,720,755,"297",458,0.5492,0.4125,0.4858,0.6725
"7486",191649,"Hofstra University",1,0,2010,"30750","333.079206","533","884","1435",819,616,764,"289",475,0.58,0.4692,0.5324,0.616
"7487",191676,"HOUGHTON COLLEGE",1,0,1991,"8676","16.477","75","219","244",152,92,119,"46",73,0.4803,0.5,0.4877,0.8975
"7488",191676,"HOUGHTON COLLEGE",1,0,1992,"9230","18.434","74","264","296",195,101,141,"44",97,0.4974,0.4356,0.4764,0.8919
"7489",191676,"HOUGHTON COLLEGE",1,0,1993,"9720","19.575","77","254","287",182,105,147,"50",97,0.533,0.4762,0.5122,0.885
"7490",191676,"HOUGHTON COLLEGE",1,0,1995,"10890","23.892","77","263","293",213,80,171,"52",119,0.5587,0.65,0.5836,0.8976
"7491",191676,"HOUGHTON COLLEGE",1,0,1996,"12060","24.940536","77","252","288",194,94,164,"47",117,0.6031,0.5,0.5694,0.875
"7492",191676,"HOUGHTON COLLEGE",1,0,1997,"12764","19.900034","78","277","310",198,112,179,"65",114,0.5758,0.5804,0.5774,0.8935
"7493",191676,"HOUGHTON COLLEGE",1,0,1998,"12776","20.931244","78","272","309",204,105,180,"50",130,0.6373,0.4762,0.5825,0.8803
"7494",191676,"HOUGHTON COLLEGE",1,0,1999,"14590","20.791241","78","273","294",186,108,166,"56",110,0.5914,0.5185,0.5646,0.9286
"7495",191676,"HOUGHTON COLLEGE",1,0,2000,"15180","23.913301","83","330","358",226,132,217,"75",142,0.6283,0.5682,0.6061,0.9218
"7496",191676,"HOUGHTON COLLEGE",1,0,2001,"16290","26.544476","88","328","355",229,126,222,"77",145,0.6332,0.6111,0.6254,0.9239
"7497",191676,"HOUGHTON COLLEGE",1,0,2002,"17160","27.942515","86","262","289",201,88,187,"54",133,0.6617,0.6136,0.6471,0.9066
"7498",191676,"HOUGHTON COLLEGE",1,0,2003,"17984","29.836957","85","272","299",203,96,179,"53",126,0.6207,0.5521,0.5987,0.9097
"7499",191676,"HOUGHTON COLLEGE",1,0,2004,"18660","31.043225","89","290","320",212,108,186,"56",130,0.6132,0.5185,0.5812,0.9062
"7500",191676,"Houghton College",1,0,2005,"19420","32.245849","89","299","321",211,110,180,"57",123,0.5829,0.5182,0.5607,0.9315
"7501",191676,"Houghton College",1,0,2006,"20400","32.974439","92","276","306",195,111,177,"58",119,0.6103,0.5225,0.5784,0.902
"7502",191676,"Houghton College",1,0,2007,"21620","33.794008","92","239","264",174,90,171,"54",117,0.6724,0.6,0.6477,0.9053
"7503",191676,"Houghton College",1,0,2008,"22990","35.536672","94","284","327",211,116,193,"56",137,0.6493,0.4828,0.5902,0.8685
"7504",191676,"Houghton College",1,0,2009,"24440","35.474724","88","245","282",199,83,186,"53",133,0.6683,0.6386,0.6596,0.8688
"7505",191676,"Houghton College",1,0,2010,"25360","34.29269","91","221","253",178,75,154,"46",108,0.6067,0.6133,0.6087,0.8735
"7506",191931,"IONA COLLEGE",1,0,1991,"9000","59.491","207","646","1046",526,520,290,"122",168,0.3194,0.2346,0.2772,0.6176
"7507",191931,"IONA COLLEGE",1,0,1992,"9500","70.058","204","663","1012",522,490,322,"136",186,0.3563,0.2776,0.3182,0.6551
"7508",191931,"IONA COLLEGE",1,0,1993,"10210","65.425","192","641","951",455,496,260,"117",143,0.3143,0.2359,0.2734,0.674
"7509",191931,"IONA COLLEGE",1,0,1995,"11330","61.201","175","369","609",288,321,203,"73",130,0.4514,0.2274,0.3333,0.6059
"7510",191931,"IONA COLLEGE",1,0,1996,"12200","56.151","167","422","662",320,342,260,"100",160,0.5,0.2924,0.3927,0.6375
"7511",191931,"IONA COLLEGE",1,0,1997,"13420","48.733759","170","439","695",312,383,263,"98",165,0.5288,0.2559,0.3784,0.6317
"7512",191931,"IONA COLLEGE",1,0,1998,"14000","48.28087","170","501","696",302,394,279,"117",162,0.5364,0.297,0.4009,0.7198
"7513",191931,"IONA COLLEGE",1,0,1999,"14700","52.640739","169","540","790",349,441,335,"147",188,0.5387,0.3333,0.4241,0.6835
"7514",191931,"IONA COLLEGE",1,0,2000,"15500","58.611235","164.5","518","723",351,372,337,"132",205,0.584,0.3548,0.4661,0.7165
"7515",191931,"IONA COLLEGE",1,0,2001,"16500","55.015895","160","503","768",376,392,360,"144",216,0.5745,0.3673,0.4688,0.6549
"7516",191931,"IONA COLLEGE",1,0,2002,"17326","55.584304","168","492","731",379,352,337,"123",214,0.5646,0.3494,0.461,0.6731
"7517",191931,"IONA COLLEGE",1,0,2003,"17750","60.083051","171","553","811",434,377,409,"152",257,0.5922,0.4032,0.5043,0.6819
"7518",191931,"IONA COLLEGE",1,0,2004,"18990","64.086805","178","617","854",458,396,448,"175",273,0.5961,0.4419,0.5246,0.7225
"7519",191931,"Iona College",1,0,2005,"20110","67.743728","173","537","776",419,357,375,"150",225,0.537,0.4202,0.4832,0.692
"7520",191931,"Iona College",1,0,2006,"21518","73.160339","175","622","903",504,399,506,"181",325,0.6448,0.4536,0.5604,0.6888
"7521",191931,"Iona College",1,0,2007,"23024","79.60026","174","623","906",486,420,476,"195",281,0.5782,0.4643,0.5254,0.6876
"7522",191931,"Iona College",1,0,2008,"24406","79.788089","176","620","921",498,423,469,"167",302,0.6064,0.3948,0.5092,0.6732
"7523",191931,"Iona College",1,0,2009,"25600","82.901529","181","518","792",480,312,448,"150",298,0.6208,0.4808,0.5657,0.654
"7524",191931,"Iona College",1,0,2010,"26850","86.413807","185","556","871",504,367,525,"202",323,0.6409,0.5504,0.6028,0.6383
"7525",191968,"ITHACA COLLEGE",1,0,1991,"11946","108.044","399","1519","1638",831,807,1036,"477",559,0.6727,0.5911,0.6325,0.9274
"7526",191968,"ITHACA COLLEGE",1,0,1992,"12870","117.098","414","1455","1566",832,734,978,"425",553,0.6647,0.579,0.6245,0.9291
"7527",191968,"ITHACA COLLEGE",1,0,1993,"13642","120.785","414","1266","1365",721,644,813,"345",468,0.6491,0.5357,0.5956,0.9275
"7528",191968,"ITHACA COLLEGE",1,0,1995,"15250","124.189","391","1472","1625",878,747,1052,"440",612,0.697,0.589,0.6474,0.9058
"7529",191968,"ITHACA COLLEGE",1,0,1996,"16130","130.634","371","1302","1426",820,606,908,"355",553,0.6744,0.5858,0.6367,0.913
"7530",191968,"ITHACA COLLEGE",1,0,1997,"16900","101.374","374","1286","1417",801,616,909,"362",547,0.6829,0.5877,0.6415,0.9076
"7531",191968,"ITHACA COLLEGE",1,0,1998,"17662","109.034","385","1232","1337",759,578,909,"379",530,0.6983,0.6557,0.6799,0.9215
"7532",191968,"ITHACA COLLEGE",1,0,1999,"18410","111.395","393","1411","1586",885,701,1022,"418",604,0.6825,0.5963,0.6444,0.8897
"7533",191968,"ITHACA COLLEGE",1,0,2000,"19192","118.918","406","1468","1675",940,735,1149,"474",675,0.7181,0.6449,0.686,0.8764
"7534",191968,"ITHACA COLLEGE",1,0,2001,"20104","125.060394","419","1569","1755",1002,753,1230,"501",729,0.7275,0.6653,0.7009,0.894
"7535",191968,"ITHACA COLLEGE",1,0,2002,"21102","133.64435","446","1354","1515",896,619,1083,"441",642,0.7165,0.7124,0.7149,0.8937
"7536",191968,"ITHACA COLLEGE",1,0,2003,"22264","142.199117","467","1332","1581",912,669,1118,"456",662,0.7259,0.6816,0.7071,0.8425
"7537",191968,"ITHACA COLLEGE",1,0,2004,"23690","149.698904","451","1242","1458",831,627,1013,"411",602,0.7244,0.6555,0.6948,0.8519
"7538",191968,"Ithaca College",1,0,2005,"25194","156.079639","454","1436","1679",885,794,1117,"521",596,0.6734,0.6562,0.6653,0.8553
"7539",191968,"Ithaca College",1,0,2006,"26832","163.861973","474","1180","1519",819,700,1059,"466",593,0.7241,0.6657,0.6972,0.7768
"7540",191968,"Ithaca College",1,0,2007,"28670","174.51284","468","1422","1794",1055,739,1241,"488",753,0.7137,0.6604,0.6918,0.7926
"7541",191968,"Ithaca College",1,0,2008,"30606","187.737637","472","972","1441",862,579,1017,"397",620,0.7193,0.6857,0.7058,0.6745
"7542",191968,"Ithaca College",1,0,2009,"32060","188.197281","465","1452","2024",1144,880,1390,"571",819,0.7159,0.6489,0.6868,0.7174
"7543",191968,"Ithaca College",1,0,2010,"33630","192.668966","481","1132","1614",869,745,1071,"442",629,0.7238,0.5933,0.6636,0.7014
"7544",192192,"KEUKA COLLEGE",1,0,1991,"7900","9.594","41","128","139",112,27,65,"15",50,0.4464,0.5556,0.4676,0.9209
"7545",192192,"KEUKA COLLEGE",1,0,1992,"8770","11.286","40","154","160",121,39,53,"12",41,0.3388,0.3077,0.3312,0.9625
"7546",192192,"KEUKA COLLEGE",1,0,1993,"9100","11.707","44","155","172",124,48,47,"13",34,0.2742,0.2708,0.2733,0.9012
"7547",192192,"KEUKA COLLEGE",1,0,1995,"9960","14.988","52","189","200",154,46,69,"10",59,0.3831,0.2174,0.345,0.945
"7548",192192,"KEUKA COLLEGE",1,0,1996,"10490","15.968518","46","217","234",168,66,61,"17",44,0.2619,0.2576,0.2607,0.9274
"7549",192192,"KEUKA COLLEGE",1,0,1997,"11040","13.142134","48","139","141",112,29,69,"12",57,0.5089,0.4138,0.4894,0.9858
"7550",192192,"KEUKA COLLEGE",1,0,1998,"12185","15.37009","46","214","226",180,46,75,"15",60,0.3333,0.3261,0.3319,0.9469
"7551",192192,"KEUKA COLLEGE",1,0,1999,"12730","14.132694","48","236","268",192,76,90,"23",67,0.349,0.3026,0.3358,0.8806
"7552",192192,"KEUKA COLLEGE",1,0,2000,"13490","15.016096","49.5","218","281",183,98,83,"28",55,0.3005,0.2857,0.2954,0.7758
"7553",192192,"KEUKA COLLEGE",1,0,2001,"14050","15.5977","51","225","253",188,65,88,"14",74,0.3936,0.2154,0.3478,0.8893
"7554",192192,"KEUKA COLLEGE",1,0,2002,"14890","17.774984","52","167","195",138,57,81,"21",60,0.4348,0.3684,0.4154,0.8564
"7555",192192,"KEUKA COLLEGE",1,0,2003,"15790","18.537419","48","209","239",168,71,107,"29",78,0.4643,0.4085,0.4477,0.8745
"7556",192192,"KEUKA COLLEGE",1,0,2004,"16820","19.154844","50","208","245",170,75,120,"29",91,0.5353,0.3867,0.4898,0.849
"7557",192192,"Keuka College",1,0,2005,"17800","20.598143","52","229","268",179,89,111,"31",80,0.4469,0.3483,0.4142,0.8545
"7558",192192,"Keuka College",1,0,2006,"18850","23.902375","51","195","232",147,85,106,"44",62,0.4218,0.5176,0.4569,0.8405
"7559",192192,"Keuka College",1,0,2007,"19960","26.334013","53","217","274",192,82,98,"28",70,0.3646,0.3415,0.3577,0.792
"7560",192192,"Keuka College",1,0,2008,"21140","29.077387","55","220","270",200,70,98,"21",77,0.385,0.3,0.363,0.8148
"7561",192192,"Keuka College",1,0,2009,"22040","30.249063","62","210","254",175,79,57,"24",33,0.1886,0.3038,0.2244,0.8268
"7562",192192,"Keuka College",1,0,2010,"23130","31.732877","75","210","270",196,74,141,"32",109,0.5561,0.4324,0.5222,0.7778
"7563",192323,"LE MOYNE COLLEGE",1,0,1991,"9290","27.841","122","354","404",212,192,261,"118",143,0.6745,0.6146,0.646,0.8762
"7564",192323,"LE MOYNE COLLEGE",1,0,1992,"9620","31.056","117","328","371",215,156,254,"105",149,0.693,0.6731,0.6846,0.8841
"7565",192323,"LE MOYNE COLLEGE",1,0,1993,"10640","31.943","119","362","415",213,202,254,"107",147,0.6901,0.5297,0.612,0.8723
"7566",192323,"LE MOYNE COLLEGE",1,0,1995,"12015","36.43","126","329","397",236,161,258,"98",160,0.678,0.6087,0.6499,0.8287
"7567",192323,"LE MOYNE COLLEGE",1,0,1996,"12750","37.338555","122","395","434",255,179,305,"115",190,0.7451,0.6425,0.7028,0.9101
"7568",192323,"LE MOYNE COLLEGE",1,0,1997,"13520","31.349413","125","389","453",292,161,299,"101",198,0.6781,0.6273,0.66,0.8587
"7569",192323,"LE MOYNE COLLEGE",1,0,1998,"14230","33.303955","121","406","471",279,192,309,"114",195,0.6989,0.5938,0.6561,0.862
"7570",192323,"LE MOYNE COLLEGE",1,0,1999,"14580","34.783365","126","389","471",264,207,304,"121",183,0.6932,0.5845,0.6454,0.8259
"7571",192323,"LE MOYNE COLLEGE",1,0,2000,"15370","37.398463","129","413","510",291,219,298,"119",179,0.6151,0.5434,0.5843,0.8098
"7572",192323,"LE MOYNE COLLEGE",1,0,2001,"16350","40.313605","132","428","502",292,210,311,"122",189,0.6473,0.581,0.6195,0.8526
"7573",192323,"LE MOYNE COLLEGE",1,0,2002,"17410","42.375425","142","458","561",333,228,388,"144",244,0.7327,0.6316,0.6916,0.8164
"7574",192323,"LE MOYNE COLLEGE",1,0,2003,"18440","46.235556","153","422","503",310,193,323,"115",208,0.671,0.5959,0.6421,0.839
"7575",192323,"LE MOYNE COLLEGE",1,0,2004,"19640","48.094798","152","384","473",277,196,305,"115",190,0.6859,0.5867,0.6448,0.8118
"7576",192323,"Le Moyne College",1,0,2005,"20770","49.726785","154","425","519",308,211,320,"123",197,0.6396,0.5829,0.6166,0.8189
"7577",192323,"Le Moyne College",1,0,2006,"21860","53.958393","161","451","544",330,214,329,"120",209,0.6333,0.5607,0.6048,0.829
"7578",192323,"Le Moyne College",1,0,2007,"23040","56.977765","157","483","577",348,229,362,"125",237,0.681,0.5459,0.6274,0.8371
"7579",192323,"Le Moyne College",1,0,2008,"24280","59.019709","157","456","541",335,206,331,"114",217,0.6478,0.5534,0.6118,0.8429
"7580",192323,"Le Moyne College",1,0,2009,"25110","60.639931","156","495","605",394,211,344,"102",242,0.6142,0.4834,0.5686,0.8182
"7581",192323,"Le Moyne College",1,0,2010,"26350","61.146475","155","511","615",372,243,355,"130",225,0.6048,0.535,0.5772,0.8309
"7582",192439,"LONG ISLAND UNIVERSITY BROOKLYN CAMPUS",1,0,1991,"9280","57.632","554","91","665",436,229,30,"12",18,0.0413,0.0524,0.0451,0.1368
"7583",192439,"LONG ISLAND UNIVERSITY BROOKLYN CAMPUS",1,0,1992,"10670","71.595","547","156","837",552,285,34,"15",19,0.0344,0.0526,0.0406,0.1864
"7584",192439,"LONG ISLAND UNIVERSITY-BROOKLYN CAMPUS",1,0,1993,"10670","84.877","561","158","918",633,285,36,"13",23,0.0363,0.0456,0.0392,0.1721
"7585",192439,"LONG ISLAND UNIVERSITY-BROOKLYN CAMPUS",1,0,1995,"12215","100.563","568","185","1043",700,343,55,"17",38,0.0543,0.0496,0.0527,0.1774
"7586",192439,"LONG ISLAND UNIVERSITY-BROOKLYN CAMPUS",1,0,1996,"12840","96.215266","574","165","956",654,302,51,"17",34,0.052,0.0563,0.0533,0.1726
"7587",192439,"LONG ISLAND UNIVERSITY-BROOKLYN CAMPUS",1,0,1997,"13570","78.848847","261","147","915",595,320,33,"13",20,0.0336,0.0406,0.0361,0.1607
"7588",192439,"LONG ISLAND UNIVERSITY-BROOKLYN CAMPUS",1,0,1998,"14310","85.650341","292","130","1061",689,372,44,"8",36,0.0522,0.0215,0.0415,0.1225
"7589",192439,"LONG ISLAND UNIVERSITY-BROOKLYN CAMPUS",1,0,1999,"14340","88.468827","290","152","1010",719,291,38,"12",26,0.0362,0.0412,0.0376,0.1505
"7590",192439,"LONG ISLAND UNIVERSITY-BROOKLYN CAMPUS",1,0,2000,"16100","93.802629","283","112","863",578,285,36,"9",27,0.0467,0.0316,0.0417,0.1298
"7591",192439,"LONG ISLAND UNIVERSITY-BROOKLYN CAMPUS",1,0,2001,"17220","103.464869","276","97","825",574,251,55,"20",35,0.061,0.0797,0.0667,0.1176
"7592",192439,"LONG ISLAND UNIVERSITY-BROOKLYN CAMPUS",1,0,2002,"18250","113.725688","295","85","776",561,215,48,"9",39,0.0695,0.0419,0.0619,0.1095
"7593",192439,"LONG ISLAND UNIVERSITY-BROOKLYN CAMPUS",1,0,2003,"19510","121.224408","304","89","680",480,200,45,"10",35,0.0729,0.05,0.0662,0.1309
"7594",192439,"LONG ISLAND UNIVERSITY-BROOKLYN CAMPUS",1,0,2004,"21150","127.288959","305","152","912",629,283,39,"12",27,0.0429,0.0424,0.0428,0.1667
"7595",192439,"Long Island University-Brooklyn Campus",1,0,2005,"22048","135.756132","308","175","959",643,316,51,"10",41,0.0638,0.0316,0.0532,0.1825
"7596",192439,"Long Island University-Brooklyn Campus",1,0,2006,"23328","146.157662","311","200","1079",730,349,56,"14",42,0.0575,0.0401,0.0519,0.1854
"7597",192439,"Long Island University-Brooklyn Campus",1,0,2007,"24672","165.624586","314","166","1021",721,300,61,"16",45,0.0624,0.0533,0.0597,0.1626
"7598",192439,"Long Island University-Brooklyn Campus",1,0,2008,"26048","174.755757","304","187","992",706,286,73,"18",55,0.0779,0.0629,0.0736,0.1885
"7599",192439,"Long Island University-Brooklyn Campus",1,0,2009,"27328","167.827957","307","179","1005",692,313,81,"19",62,0.0896,0.0607,0.0806,0.1781
"7600",192439,"Long Island University-Brooklyn Campus",1,0,2010,"25088","174.184627","310","154","883",618,265,58,"13",45,0.0728,0.0491,0.0657,0.1744
"7601",192703,"MANHATTAN COLLEGE",1,0,1991,"11100","48.717","174","406","548",258,290,298,"137",161,0.624,0.4724,0.5438,0.7409
"7602",192703,"MANHATTAN COLLEGE",1,0,1992,"11900","56.152","170","429","577",250,327,244,"120",124,0.496,0.367,0.4229,0.7435
"7603",192703,"MANHATTAN COLLEGE",1,0,1993,"12700","57.412","172","385","546",254,292,307,"152",155,0.6102,0.5205,0.5623,0.7051
"7604",192703,"MANHATTAN COLLEGE",1,0,1995,"14220","54.686","163","396","572",256,316,321,"160",161,0.6289,0.5063,0.5612,0.6923
"7605",192703,"MANHATTAN COLLEGE",1,0,1996,"14900","54.239","156","372","557",258,299,313,"143",170,0.6589,0.4783,0.5619,0.6679
"7606",192703,"MANHATTAN COLLEGE",1,0,1997,"15500","57.461049","158","363","527",235,292,269,"134",135,0.5745,0.4589,0.5104,0.6888
"7607",192703,"MANHATTAN COLLEGE",1,0,1998,"16100","46.606636","160","358","547",274,273,328,"159",169,0.6168,0.5824,0.5996,0.6545
"7608",192703,"MANHATTAN COLLEGE",1,0,1999,"15500","49.403836","161","473","645",289,356,386,"195",191,0.6609,0.5478,0.5984,0.7333
"7609",192703,"MANHATTAN COLLEGE",1,0,2000,"16000","51.780693","164.5","442","623",315,308,361,"153",208,0.6603,0.4968,0.5795,0.7095
"7610",192703,"MANHATTAN COLLEGE",1,0,2001,"16500","55.276847","168","441","597",276,321,344,"162",182,0.6594,0.5047,0.5762,0.7387
"7611",192703,"MANHATTAN COLLEGE",1,0,2002,"17100","58.18096","162","549","769",401,368,501,"228",273,0.6808,0.6196,0.6515,0.7139
"7612",192703,"MANHATTAN COLLEGE",1,0,2003,"17800","63.591048","167","502","638",342,296,400,"173",227,0.6637,0.5845,0.627,0.7868
"7613",192703,"MANHATTAN COLLEGE",1,0,2004,"18600","65.945202","169","521","657",343,314,420,"182",238,0.6939,0.5796,0.6393,0.793
"7614",192703,"Manhattan College",1,0,2005,"19400","67.462622","172","555","700",368,332,456,"198",258,0.7011,0.5964,0.6514,0.7929
"7615",192703,"Manhattan College",1,0,2006,"20350","72.187651","171","562","710",353,357,466,"234",232,0.6572,0.6555,0.6563,0.7915
"7616",192703,"Manhattan College",1,0,2007,"21640","75.006168","170","571","708",356,352,427,"201",226,0.6348,0.571,0.6031,0.8065
"7617",192703,"Manhattan College",1,0,2008,"22940","79.183843","180","524","726",351,375,475,"226",249,0.7094,0.6027,0.6543,0.7218
"7618",192703,"Manhattan College",1,0,2009,"25100","86.860726","176","493","693",343,350,412,"183",229,0.6676,0.5229,0.5945,0.7114
"7619",192703,"Manhattan College",1,0,2010,"25335","89.683677","201","465","658",300,358,375,"190",185,0.6167,0.5307,0.5699,0.7067
"7620",192749,"MANHATTANVILLE COLLEGE",1,0,1991,"12760","24.769","81","123","192",143,49,96,"22",74,0.5175,0.449,0.5,0.6406
"7621",192749,"MANHATTANVILLE COLLEGE",1,0,1992,"13605","28.72","77","103","183",139,44,106,"23",83,0.5971,0.5227,0.5792,0.5628
"7622",192749,"MANHATTANVILLE COLLEGE",1,0,1993,"14450","29.087","65","132","214",133,81,86,"30",56,0.4211,0.3704,0.4019,0.6168
"7623",192749,"MANHATTANVILLE COLLEGE",1,0,1995,"15500","25.829","58","89","161",115,46,87,"18",69,0.6,0.3913,0.5404,0.5528
"7624",192749,"MANHATTANVILLE COLLEGE",1,0,1996,"16120","26.189","56","148","271",181,90,117,"33",84,0.4641,0.3667,0.4317,0.5461
"7625",192749,"MANHATTANVILLE COLLEGE",1,0,1997,"17300","22.412","56","146","294",202,92,148,"40",108,0.5347,0.4348,0.5034,0.4966
"7626",192749,"MANHATTANVILLE COLLEGE",1,0,1998,"18130","24.32","58","184","338",225,113,126,"35",91,0.4044,0.3097,0.3728,0.5444
"7627",192749,"MANHATTANVILLE COLLEGE",1,0,1999,"18130","27.735111","63","230","387",266,121,195,"57",138,0.5188,0.4711,0.5039,0.5943
"7628",192749,"MANHATTANVILLE COLLEGE",1,0,2000,"18860","32.269382","67","241","403",277,126,213,"58",155,0.5596,0.4603,0.5285,0.598
"7629",192749,"MANHATTANVILLE COLLEGE",1,0,2001,"19620","36.678786","71","243","404",277,127,226,"65",161,0.5812,0.5118,0.5594,0.6015
"7630",192749,"MANHATTANVILLE COLLEGE",1,0,2002,"20600","37.288091","82","249","420",287,133,212,"50",162,0.5645,0.3759,0.5048,0.5929
"7631",192749,"MANHATTANVILLE COLLEGE",1,0,2003,"22150","38.805211","88","240","422",295,127,223,"68",155,0.5254,0.5354,0.5284,0.5687
"7632",192749,"MANHATTANVILLE COLLEGE",1,0,2004,"23620","41.224663","88","259","450",312,138,261,"78",183,0.5865,0.5652,0.58,0.5756
"7633",192749,"Manhattanville College",1,0,2005,"24920","46.060476","88","316","506",327,179,264,"73",191,0.5841,0.4078,0.5217,0.6245
"7634",192749,"Manhattanville College",1,0,2006,"26920","48.861292","92","289","507",329,178,274,"91",183,0.5562,0.5112,0.5404,0.57
"7635",192749,"Manhattanville College",1,0,2007,"28540","56.273116","99","229","463",315,148,249,"59",190,0.6032,0.3986,0.5378,0.4946
"7636",192749,"Manhattanville College",1,0,2008,"30400","62.490591","100","223","476",326,150,270,"82",188,0.5767,0.5467,0.5672,0.4685
"7637",192749,"Manhattanville College",1,0,2009,"31490","62.972888","101","202","490",298,192,250,"86",164,0.5503,0.4479,0.5102,0.4122
"7638",192749,"Manhattanville College",1,0,2010,"33030","62.936093","103","199","428",274,154,181,"57",124,0.4526,0.3701,0.4229,0.465
"7639",192819,"MARIST COLLEGE",1,0,1991,"9205","53.275","142","806","881",489,392,441,"166",275,0.5624,0.4235,0.5006,0.9149
"7640",192819,"MARIST COLLEGE",1,0,1992,"9826","61.193","143","697","820",451,369,514,"201",313,0.694,0.5447,0.6268,0.85
"7641",192819,"MARIST COLLEGE",1,0,1993,"10397","65.864","151","692","806",460,346,371,"134",237,0.5152,0.3873,0.4603,0.8586
"7642",192819,"MARIST COLLEGE",1,0,1995,"11590","73.01","157","513","926",527,399,472,"181",291,0.5522,0.4536,0.5097,0.554
"7643",192819,"MARIST COLLEGE",1,0,1996,"12450","65.71838","159","706","839",482,357,510,"187",323,0.6701,0.5238,0.6079,0.8415
"7644",192819,"MARIST COLLEGE",1,0,1997,"13098","55.385408","162","755","973",532,441,570,"232",338,0.6353,0.5261,0.5858,0.776
"7645",192819,"MARIST COLLEGE",1,0,1998,"13818","58.817363","157","691","834",430,404,547,"240",307,0.714,0.5941,0.6559,0.8285
"7646",192819,"MARIST COLLEGE",1,0,1999,"14374","63.622317","162","803","975",548,427,665,"260",405,0.7391,0.6089,0.6821,0.8236
"7647",192819,"MARIST COLLEGE",1,0,2000,"15366","69.478802","170","860","993",589,404,690,"272",418,0.7097,0.6733,0.6949,0.8661
"7648",192819,"MARIST COLLEGE",1,0,2001,"16364","77.135771","178","764","908",484,424,632,"281",351,0.7252,0.6627,0.696,0.8414
"7649",192819,"MARIST COLLEGE",1,0,2002,"17444","83.309358","182","781","956",576,380,693,"252",441,0.7656,0.6632,0.7249,0.8169
"7650",192819,"MARIST COLLEGE",1,0,2003,"18432","89.959651","197","807","961",528,433,732,"310",422,0.7992,0.7159,0.7617,0.8398
"7651",192819,"MARIST COLLEGE",1,0,2004,"19540","91.8623","199","728","955",536,419,699,"282",417,0.778,0.673,0.7319,0.7623
"7652",192819,"Marist College",1,0,2005,"20712","93.114065","201","810","1017",585,432,697,"258",439,0.7504,0.5972,0.6853,0.7965
"7653",192819,"Marist College",1,0,2006,"22066","101.564196","204","852","1038",573,465,737,"309",428,0.7469,0.6645,0.71,0.8208
"7654",192819,"Marist College",1,0,2007,"23560","108.622176","218","754","1019",561,458,713,"295",418,0.7451,0.6441,0.6997,0.7399
"7655",192819,"Marist College",1,0,2008,"25100","121.962613","222","781","1018",611,407,697,"249",448,0.7332,0.6118,0.6847,0.7672
"7656",192819,"Marist College",1,0,2009,"26105","127.498898","219","836","1041",577,464,708,"279",429,0.7435,0.6013,0.6801,0.8031
"7657",192819,"Marist College",1,0,2010,"27150","130.092857","228","886","1088",612,476,814,"331",483,0.7892,0.6954,0.7482,0.8143
"7658",192925,"MEDAILLE COLLEGE",1,0,1991,"7180","9.285","41","82","143",79,64,23,"6",17,0.2152,0.0938,0.1608,0.5734
"7659",192925,"MEDAILLE COLLEGE",1,0,1992,"7750","12.182","40","110","185",86,99,21,"4",17,0.1977,0.0404,0.1135,0.5946
"7660",192925,"MEDAILLE COLLEGE",1,0,1993,"8350","13.393","43","124","202",94,108,38,"16",22,0.234,0.1481,0.1881,0.6139
"7661",192925,"MEDAILLE COLLEGE",1,0,1995,"9560","12.112","41","60","78",50,28,15,"5",10,0.2,0.1786,0.1923,0.7692
"7662",192925,"MEDAILLE COLLEGE",1,0,1996,"9990","11.054402","41","55","81",58,23,6,"2",4,0.069,0.087,0.0741,0.679
"7663",192925,"MEDAILLE COLLEGE",1,0,1997,"10470","9.289133","38","121","164",102,62,19,"6",13,0.1275,0.0968,0.1159,0.7378
"7664",192925,"MEDAILLE COLLEGE",1,0,1998,"10950","10.248888","43","101","153",113,40,45,"15",30,0.2655,0.375,0.2941,0.6601
"7665",192925,"MEDAILLE COLLEGE",1,0,1999,"11190","11.320326","43","115","143",104,39,31,"6",25,0.2404,0.1538,0.2168,0.8042
"7666",192925,"MEDAILLE COLLEGE",1,0,2000,"11700","12.479738","52","148","208",153,55,36,"10",26,0.1699,0.1818,0.1731,0.7115
"7667",192925,"MEDAILLE COLLEGE",1,0,2001,"12240","14.65307","61","161","208",166,42,53,"12",41,0.247,0.2857,0.2548,0.774
"7668",192925,"MEDAILLE COLLEGE",1,0,2002,"12720","17.100197","63","199","308",204,104,69,"25",44,0.2157,0.2404,0.224,0.6461
"7669",192925,"MEDAILLE COLLEGE",1,0,2003,"13350","20.056923","70","184","241",146,95,100,"42",58,0.3973,0.4421,0.4149,0.7635
"7670",192925,"MEDAILLE COLLEGE",1,0,2004,"14010","24.346179","76","233","296",179,117,85,"36",49,0.2737,0.3077,0.2872,0.7872
"7671",192925,"Medaille College",1,0,2005,"15030","30.717105","90","165","203",126,77,62,"27",35,0.2778,0.3506,0.3054,0.8128
"7672",192925,"Medaille College",1,0,2006,"15780","38.242052","97","239","320",198,122,87,"38",49,0.2475,0.3115,0.2719,0.7469
"7673",192925,"Medaille College",1,0,2007,"16590","40.385677","91","308","409",255,154,131,"56",75,0.2941,0.3636,0.3203,0.7531
"7674",192925,"Medaille College",1,0,2008,"17420","40.479884","90","283","408",253,155,105,"49",56,0.2213,0.3161,0.2574,0.6936
"7675",192925,"Medaille College",1,0,2009,"19590","39.892666","81","272","402",257,145,104,"35",69,0.2685,0.2414,0.2587,0.6766
"7676",192925,"Medaille College",1,0,2010,"20570","38.179561","73","259","377",234,143,112,"46",66,0.2821,0.3217,0.2971,0.687
"7677",193016,"MERCY COLLEGE - MAIN CAMPUS",1,0,1991,"6990","31.39","150","153","619",329,290,19,"5",14,0.0426,0.0172,0.0307,0.2472
"7678",193016,"MERCY COLLEGE-MAIN CAMPUS",1,0,1992,"7200","41.948","147","230","867",534,333,19,"7",12,0.0225,0.021,0.0219,0.2653
"7679",193016,"MERCY COLLEGE-MAIN CAMPUS",1,0,1993,"7380","40.599","149","124","733",403,330,16,"6",10,0.0248,0.0182,0.0218,0.1692
"7680",193016,"MERCY COLLEGE-MAIN CAMPUS",1,0,1995,"6600","49.375","146","429","1002",623,379,4,"2",2,0.0032,0.0053,0.004,0.4281
"7681",193016,"MERCY COLLEGE-MAIN CAMPUS",1,0,1996,"7200","50.974959","150","143","551",336,215,62,"12",50,0.1488,0.0558,0.1125,0.2595
"7682",193016,"MERCY COLLEGE-MAIN CAMPUS",1,0,1997,"7600","53.696881","153","271","1052",692,360,46,"16",30,0.0434,0.0444,0.0437,0.2576
"7683",193016,"MERCY COLLEGE-MAIN CAMPUS",1,0,1998,"7800","59.408453","178","161","907",582,325,53,"14",39,0.067,0.0431,0.0584,0.1775
"7684",193016,"MERCY COLLEGE-MAIN CAMPUS",1,0,1999,"7950","58.838862","181","115","953",630,323,68,"18",50,0.0794,0.0557,0.0714,0.1207
"7685",193016,"MERCY COLLEGE-MAIN CAMPUS",1,0,2000,"8500","62.7","195","94","637",421,216,69,"10",59,0.1401,0.0463,0.1083,0.1476
"7686",193016,"MERCY COLLEGE-MAIN CAMPUS",1,0,2001,"8950","70.290636","209","95","618",412,206,61,"10",51,0.1238,0.0485,0.0987,0.1537
"7687",193016,"MERCY COLLEGE-MAIN CAMPUS",1,0,2002,"10000","76.711202","230","140","680",425,255,69,"14",55,0.1294,0.0549,0.1015,0.2059
"7688",193016,"MERCY COLLEGE-MAIN CAMPUS",1,0,2003,"10700","83.590978","228","132","611",379,232,58,"10",48,0.1266,0.0431,0.0949,0.216
"7689",193016,"MERCY COLLEGE-MAIN CAMPUS",1,0,2004,"11230","91.202841","223","165","649",421,228,79,"18",61,0.1449,0.0789,0.1217,0.2542
"7690",193016,"Mercy College-Main Campus",1,0,2005,"11792","89.769018","175","102","485",324,161,53,"11",42,0.1296,0.0683,0.1093,0.2103
"7691",193016,"Mercy College-Main Campus",1,0,2006,"12370","94.313313","183","152","614",390,224,79,"22",57,0.1462,0.0982,0.1287,0.2476
"7692",193016,"Mercy College-Main Campus",1,0,2007,"13730","94.614235","180","185","532",343,189,111,"21",90,0.2624,0.1111,0.2086,0.3477
"7693",193016,"Mercy College",1,0,2008,"14990","95.906723","169","178","677",441,236,92,"14",78,0.1769,0.0593,0.1359,0.2629
"7694",193016,"Mercy College",1,0,2009,"15990","94.553369","193","248","880",552,328,157,"39",118,0.2138,0.1189,0.1784,0.2818
"7695",193016,"Mercy College",1,0,2010,"16490","103.788228","199","247","1086",708,378,212,"45",167,0.2359,0.119,0.1952,0.2274
"7696",193292,"MOLLOY COLLEGE",1,0,1991,"7800","13.299","89","102","123",100,23,55,"6",49,0.49,0.2609,0.4472,0.8293
"7697",193292,"MOLLOY COLLEGE",1,0,1992,"8390","23.149","102","929","1417",1055,362,65,"7",58,0.055,0.0193,0.0459,0.6556
"7698",193292,"MOLLOY COLLEGE",1,0,1993,"8700","24.389","116","138","175",139,36,74,"8",66,0.4748,0.2222,0.4229,0.7886
"7699",193292,"MOLLOY COLLEGE",1,0,1995,"9700","21.12","136","109","135",108,27,30,"5",25,0.2315,0.1852,0.2222,0.8074
"7700",193292,"MOLLOY COLLEGE",1,0,1996,"10000","22.63878","147","139","183",125,58,21,"5",16,0.128,0.0862,0.1148,0.7596
"7701",193292,"MOLLOY COLLEGE",1,0,1997,"10400","24.238847","70","127","156",112,44,46,"6",40,0.3571,0.1364,0.2949,0.8141
"7702",193292,"MOLLOY COLLEGE",1,0,1998,"11270","25.709963","148","146","180",117,63,72,"21",51,0.4359,0.3333,0.4,0.8111
"7703",193292,"MOLLOY COLLEGE",1,0,1999,"11900","26.864678","137","159","209",156,53,84,"11",73,0.4679,0.2075,0.4019,0.7608
"7704",193292,"MOLLOY COLLEGE",1,0,2000,"12500","22.085094","132.5","140","195",133,62,56,"13",43,0.3233,0.2097,0.2872,0.7179
"7705",193292,"MOLLOY COLLEGE",1,0,2001,"13190","22.36509","128","153","210",145,65,66,"16",50,0.3448,0.2462,0.3143,0.7286
"7706",193292,"MOLLOY COLLEGE",1,0,2002,"13940","24.001739","134","151","229",168,61,77,"19",58,0.3452,0.3115,0.3362,0.6594
"7707",193292,"MOLLOY COLLEGE",1,0,2003,"14430","27.925925","137","181","262",185,77,89,"29",60,0.3243,0.3766,0.3397,0.6908
"7708",193292,"MOLLOY COLLEGE",1,0,2004,"15150","30.684869","142","206","311",231,80,105,"17",88,0.381,0.2125,0.3376,0.6624
"7709",193292,"Molloy College",1,0,2005,"15760","39.798715","147","194","274",190,84,109,"31",78,0.4105,0.369,0.3978,0.708
"7710",193292,"Molloy College",1,0,2006,"16560","44.378879","158","172","269",196,73,90,"22",68,0.3469,0.3014,0.3346,0.6394
"7711",193292,"Molloy College",1,0,2007,"17640","50.146444","162","246","370",282,88,140,"31",109,0.3865,0.3523,0.3784,0.6649
"7712",193292,"Molloy College",1,0,2008,"18700","53.858655","163","271","393",288,105,156,"32",124,0.4306,0.3048,0.3969,0.6896
"7713",193292,"Molloy College",1,0,2009,"19970","58.480258","169","269","414",307,107,189,"42",147,0.4788,0.3925,0.4565,0.6498
"7714",193292,"Molloy College",1,0,2010,"21170","63.9427","173","271","387",257,130,180,"59",121,0.4708,0.4538,0.4651,0.7003
"7715",193353,"MOUNT SAINT MARY COLLEGE",1,0,1991,"7020","13.007","48","208","248",188,60,96,"16",80,0.4255,0.2667,0.3871,0.8387
"7716",193353,"MOUNT SAINT MARY COLLEGE",1,0,1992,"7810","15.835","48","218","254",180,74,97,"25",72,0.4,0.3378,0.3819,0.8583
"7717",193353,"MOUNT SAINT MARY COLLEGE",1,0,1993,"8110","18.287","51","195","239",164,75,90,"29",61,0.372,0.3867,0.3766,0.8159
"7718",193353,"MOUNT SAINT MARY COLLEGE",1,0,1995,"8955","19.488","53","207","258",196,62,114,"24",90,0.4592,0.3871,0.4419,0.8023
"7719",193353,"MOUNT SAINT MARY COLLEGE",1,0,1996,"9495","20.158","54","226","266",199,67,105,"20",85,0.4271,0.2985,0.3947,0.8496
"7720",193353,"MOUNT SAINT MARY COLLEGE",1,0,1997,"10215","17.820253","53","202","260",177,83,121,"43",78,0.4407,0.5181,0.4654,0.7769
"7721",193353,"MOUNT SAINT MARY COLLEGE",1,0,1998,"10855","18.628183","52","239","304",230,74,122,"27",95,0.413,0.3649,0.4013,0.7862
"7722",193353,"MOUNT SAINT MARY COLLEGE",1,0,1999,"11100","19.875577","53","253","323",247,76,156,"25",131,0.5304,0.3289,0.483,0.7833
"7723",193353,"MOUNT SAINT MARY COLLEGE",1,0,2000,"11580","21.661178","56","266","328",251,77,124,"15",109,0.4343,0.1948,0.378,0.811
"7724",193353,"MOUNT SAINT MARY COLLEGE",1,0,2001,"12270","23.925125","59","282","343",239,104,143,"33",110,0.4603,0.3173,0.4169,0.8222
"7725",193353,"MOUNT SAINT MARY COLLEGE",1,0,2002,"12930","26.53162","62","291","361",261,100,151,"33",118,0.4521,0.33,0.4183,0.8061
"7726",193353,"MOUNT SAINT MARY COLLEGE",1,0,2003,"13830","29.25515","67","285","347",246,101,137,"31",106,0.4309,0.3069,0.3948,0.8213
"7727",193353,"MOUNT SAINT MARY COLLEGE",1,0,2004,"15180","31.410683","67","345","419",314,105,180,"45",135,0.4299,0.4286,0.4296,0.8234
"7728",193353,"Mount Saint Mary College",1,0,2005,"16410","35.011941","71","285","356",247,109,154,"45",109,0.4413,0.4128,0.4326,0.8006
"7729",193353,"Mount Saint Mary College",1,0,2006,"17730","36.938639","73","308","400",295,105,162,"41",121,0.4102,0.3905,0.405,0.77
"7730",193353,"Mount Saint Mary College",1,0,2007,"18900","38.533854","74","307","364",252,112,150,"31",119,0.4722,0.2768,0.4121,0.8434
"7731",193353,"Mount Saint Mary College",1,0,2008,"20040","43.034314","76","334","432",318,114,191,"50",141,0.4434,0.4386,0.4421,0.7731
"7732",193353,"Mount Saint Mary College",1,0,2009,"21210","45.630418","81","383","474",362,112,217,"42",175,0.4834,0.375,0.4578,0.808
"7733",193353,"Mount Saint Mary College",1,0,2010,"22350","48.62418","85","340","443",301,142,187,"60",127,0.4219,0.4225,0.4221,0.7675
"7734",193399,"COLLEGE OF MOUNT SAINT VINCENT",1,0,1991,"9810","12.7","50","107","188",147,41,91,"20",71,0.483,0.4878,0.484,0.5691
"7735",193399,"COLLEGE OF MOUNT SAINT VINCENT",1,0,1992,"10460","14.776","51","100","185",153,32,88,"12",76,0.4967,0.375,0.4757,0.5405
"7736",193399,"COLLEGE OF MOUNT SAINT VINCENT",1,0,1993,"11190","14.313","49","104","174",136,38,71,"9",62,0.4559,0.2368,0.408,0.5977
"7737",193399,"COLLEGE OF MOUNT SAINT VINCENT",1,0,1995,"12450","19.242","71","115","217",164,53,107,"27",80,0.4878,0.5094,0.4931,0.53
"7738",193399,"COLLEGE OF MOUNT SAINT VINCENT",1,0,1996,"13060","19.012035","56","95","208",162,46,111,"26",85,0.5247,0.5652,0.5337,0.4567
"7739",193399,"COLLEGE OF MOUNT SAINT VINCENT",1,0,1997,"13580","21.133765","61","97","225",168,57,95,"18",77,0.4583,0.3158,0.4222,0.4311
"7740",193399,"COLLEGE OF MOUNT SAINT VINCENT",1,0,1998,"14360","21.853637","61","92","266",200,66,124,"26",98,0.49,0.3939,0.4662,0.3459
"7741",193399,"COLLEGE OF MOUNT SAINT VINCENT",1,0,1999,"14910","19.041988","65","82","240",167,73,76,"18",58,0.3473,0.2466,0.3167,0.3417
"7742",193399,"COLLEGE OF MOUNT SAINT VINCENT",1,0,2000,"16030","19.986282","68.5","77","236",174,62,83,"16",67,0.3851,0.2581,0.3517,0.3263
"7743",193399,"COLLEGE OF MOUNT SAINT VINCENT",1,0,2001,"17030","21.387771","72","101","286",214,72,111,"21",90,0.4206,0.2917,0.3881,0.3531
"7744",193399,"COLLEGE OF MOUNT SAINT VINCENT",1,0,2002,"17880","21.046471","69","140","326",239,87,128,"21",107,0.4477,0.2414,0.3926,0.4294
"7745",193399,"COLLEGE OF MOUNT SAINT VINCENT",1,0,2003,"18600","22.191859","70","155","336",272,64,136,"13",123,0.4522,0.2031,0.4048,0.4613
"7746",193399,"COLLEGE OF MOUNT SAINT VINCENT",1,0,2004,"19100","25.139795","73","177","355",229,126,166,"53",113,0.4934,0.4206,0.4676,0.4986
"7747",193399,"College of Mount Saint Vincent",1,0,2005,"19950","26.562034","74","168","343",247,96,136,"32",104,0.4211,0.3333,0.3965,0.4898
"7748",193399,"College of Mount Saint Vincent",1,0,2006,"21000","27.107423","72","153","390",294,96,159,"37",122,0.415,0.3854,0.4077,0.3923
"7749",193399,"College of Mount Saint Vincent",1,0,2007,"22150","29.326666","73","152","394",272,122,144,"39",105,0.386,0.3197,0.3655,0.3858
"7750",193399,"College of Mount Saint Vincent",1,0,2008,"23270","33.309221","74","151","374",267,107,146,"34",112,0.4195,0.3178,0.3904,0.4037
"7751",193399,"College of Mount Saint Vincent",1,0,2009,"24400","34.317228","73","132","390",275,115,131,"30",101,0.3673,0.2609,0.3359,0.3385
"7752",193399,"College of Mount Saint Vincent",1,0,2010,"25600","35.882114","73","115","377",249,128,147,"41",106,0.4257,0.3203,0.3899,0.305
"7753",193584,"NAZARETH COLLEGE OF ROCHESTER",1,0,1991,"8940","23.455","102","228","246",177,69,124,"27",97,0.548,0.3913,0.5041,0.9268
"7754",193584,"NAZARETH COLLEGE OF ROCHESTER",1,0,1992,"9790","27.769","105","195","211",159,52,129,"24",105,0.6604,0.4615,0.6114,0.9242
"7755",193584,"NAZARETH COLLEGE OF ROCHESTER",1,0,1993,"10390","27.309","105","252","266",192,74,142,"29",113,0.5885,0.3919,0.5338,0.9474
"7756",193584,"NAZARETH COLLEGE OF ROCHESTER",1,0,1995,"11380","31.494","104","284","302",227,75,182,"36",146,0.6432,0.48,0.6026,0.9404
"7757",193584,"NAZARETH COLLEGE OF ROCHESTER",1,0,1996,"12130","33.066","106","310","337",242,95,208,"55",153,0.6322,0.5789,0.6172,0.9199
"7758",193584,"NAZARETH COLLEGE OF ROCHESTER",1,0,1997,"12966","28.188299","111","327","351",257,94,214,"59",155,0.6031,0.6277,0.6097,0.9316
"7759",193584,"NAZARETH COLLEGE OF ROCHESTER",1,0,1998,"13526","30.581874","111","296","321",246,75,199,"38",161,0.6545,0.5067,0.6199,0.9221
"7760",193584,"NAZARETH COLLEGE OF ROCHESTER",1,0,1999,"13620","32.032458","120","304","334",244,90,205,"51",154,0.6311,0.5667,0.6138,0.9102
"7761",193584,"NAZARETH COLLEGE OF ROCHESTER",1,0,2000,"14230","34.334188","126","368","402",304,98,244,"56",188,0.6184,0.5714,0.607,0.9154
"7762",193584,"NAZARETH COLLEGE OF ROCHESTER",1,0,2001,"14940","37.057916","132","329","358",274,84,239,"50",189,0.6898,0.5952,0.6676,0.919
"7763",193584,"NAZARETH COLLEGE OF ROCHESTER",1,0,2002,"15910","40.613223","134","335","385",292,93,230,"49",181,0.6199,0.5269,0.5974,0.8701
"7764",193584,"NAZARETH COLLEGE OF ROCHESTER",1,0,2003,"17020","44.051923","137","325","383",284,99,236,"54",182,0.6408,0.5455,0.6162,0.8486
"7765",193584,"NAZARETH COLLEGE OF ROCHESTER",1,0,2004,"18040","46.301921","136","377","449",335,114,285,"60",225,0.6716,0.5263,0.6347,0.8396
"7766",193584,"Nazareth College of Rochester",1,0,2005,"19214","49.524956","135","392","451",342,109,303,"56",247,0.7222,0.5138,0.6718,0.8692
"7767",193584,"Nazareth College of Rochester",1,0,2006,"20656","52.763669","144","419","481",364,117,293,"62",231,0.6346,0.5299,0.6091,0.8711
"7768",193584,"Nazareth College of Rochester",1,0,2007,"21844","56.115746","152","374","456",335,121,268,"60",208,0.6209,0.4959,0.5877,0.8202
"7769",193584,"Nazareth College",1,0,2008,"23046","60.935177","156","381","471",361,110,306,"62",244,0.6759,0.5636,0.6497,0.8089
"7770",193584,"Nazareth College",1,0,2009,"24082","64.521709","156","386","491",387,104,315,"68",247,0.6382,0.6538,0.6415,0.7862
"7771",193584,"Nazareth College",1,0,2010,"25046","68.457857","160","331","467",353,114,273,"60",213,0.6034,0.5263,0.5846,0.7088
"7772",193645,"COLLEGE OF NEW ROCHELLE",1,0,1991,"10050","34.034","75","86","645",563,82,93,"2",91,0.1616,0.0244,0.1442,0.1333
"7773",193645,"COLLEGE OF NEW ROCHELLE",1,0,1992,"10200","41.83","71","72","935",777,158,85,"7",78,0.1004,0.0443,0.0909,0.077
"7774",193645,"COLLEGE OF NEW ROCHELLE",1,0,1993,"10600","37.947","67","88","821",677,144,89,"14",75,0.1108,0.0972,0.1084,0.1072
"7775",193645,"COLLEGE OF NEW ROCHELLE",1,0,1995,"12200","45.93","67","65","718",595,123,120,"13",107,0.1798,0.1057,0.1671,0.0905
"7776",193645,"COLLEGE OF NEW ROCHELLE",1,0,1996,"11000","48.833216","68","41","931",787,144,129,"13",116,0.1474,0.0903,0.1386,0.044
"7777",193645,"COLLEGE OF NEW ROCHELLE",1,0,1997,"11000","38.370499","72","53","758",643,115,165,"18",147,0.2286,0.1565,0.2177,0.0699
"7778",193645,"COLLEGE OF NEW ROCHELLE",1,0,1998,"11300","42.188015","79","58","852",738,114,161,"11",150,0.2033,0.0965,0.189,0.0681
"7779",193645,"COLLEGE OF NEW ROCHELLE",1,0,1999,"11600","41.262313","74","58","814",670,144,152,"16",136,0.203,0.1111,0.1867,0.0713
"7780",193645,"THE COLLEGE OF NEW ROCHELLE",1,0,2000,"11900","44.521908","90.5","48","755",662,93,159,"13",146,0.2205,0.1398,0.2106,0.0636
"7781",193645,"THE COLLEGE OF NEW ROCHELLE",1,0,2001,"12320","45.469372","107","39","774",650,124,169,"13",156,0.24,0.1048,0.2183,0.0504
"7782",193645,"THE COLLEGE OF NEW ROCHELLE",1,0,2002,"13000","47.77261","112","16","850",733,117,151,"12",139,0.1896,0.1026,0.1776,0.0188
"7783",193645,"THE COLLEGE OF NEW ROCHELLE",1,0,2003,"14400","48.428271","117","39","769",668,101,121,"5",116,0.1737,0.0495,0.1573,0.0507
"7784",193645,"THE COLLEGE OF NEW ROCHELLE",1,0,2004,"16500","53.251598","122","32","952",815,137,152,"11",141,0.173,0.0803,0.1597,0.0336
"7785",193645,"The College of New Rochelle",1,0,2005,"17950","54.67618","107","32","943",883,60,168,"1",167,0.1891,0.0167,0.1782,0.0339
"7786",193645,"The College of New Rochelle",1,0,2006,"20800","56.16467","106","33","821",757,64,133,"6",127,0.1678,0.0938,0.162,0.0402
"7787",193645,"The College of New Rochelle",1,0,2007,"23200","57.09635","110","25","805",733,72,126,"2",124,0.1692,0.0278,0.1565,0.0311
"7788",193645,"The College of New Rochelle",1,0,2008,"24592","59.088616","108","26","504",461,43,86,"2",84,0.1822,0.0465,0.1706,0.0516
"7789",193645,"The College of New Rochelle",1,0,2009,"25576","60.011204","102","15","530",465,65,86,"8",78,0.1677,0.1231,0.1623,0.0283
"7790",193645,"The College of New Rochelle",1,0,2010,"27110","56.409378","108","19","635",566,69,140,"10",130,0.2297,0.1449,0.2205,0.0299
"7791",193654,"NEW SCHOOL FOR SOCIAL RESEARCH",1,0,1991,"12200","74.897","117","105","265",182,83,81,"25",56,0.3077,0.3012,0.3057,0.3962
"7792",193654,"NEW SCHOOL FOR SOCIAL RESEARCH",1,0,1992,"12600","80.607","114","171","423",275,148,155,"41",114,0.4145,0.277,0.3664,0.4043
"7793",193654,"NEW SCHOOL FOR SOCIAL RESEARCH",1,0,1993,"14210","86.412","123","174","441",282,159,142,"50",92,0.3262,0.3145,0.322,0.3946
"7794",193654,"NEW SCHOOL FOR SOCIAL RESEARCH",1,0,1995,"16070","104.188","148","161","445",275,170,178,"54",124,0.4509,0.3176,0.4,0.3618
"7795",193654,"NEW SCHOOL FOR SOCIAL RESEARCH",1,0,1996,"17660","109.598","140","159","401",272,129,132,"27",105,0.386,0.2093,0.3292,0.3965
"7796",193654,"NEW SCHOOL FOR SOCIAL RESEARCH",1,0,1997,"18200","105.187534","131","182","465",308,157,205,"56",149,0.4838,0.3567,0.4409,0.3914
"7797",193654,"NEW SCHOOL FOR SOCIAL RESEARCH",1,0,1998,"19370","112.709817","133","213","581",394,187,240,"51",189,0.4797,0.2727,0.4131,0.3666
"7798",193654,"NEW SCHOOL UNIVERSITY",1,0,1999,"20410","122.945044","144","219","573",399,174,234,"55",179,0.4486,0.3161,0.4084,0.3822
"7799",193654,"NEW SCHOOL UNIVERSITY",1,0,2000,"20600","128.858177","150","245","595",402,193,245,"69",176,0.4378,0.3575,0.4118,0.4118
"7800",193654,"NEW SCHOOL UNIVERSITY",1,0,2001,"22630","140.730149","156","263","617",422,195,269,"74",195,0.4621,0.3795,0.436,0.4263
"7801",193654,"NEW SCHOOL UNIVERSITY",1,0,2002,"23900","152.792198","145","255","605",415,190,328,"89",239,0.5759,0.4684,0.5421,0.4215
"7802",193654,"NEW SCHOOL UNIVERSITY",1,0,2003,"25330","167.868731","159","248","581",409,172,288,"81",207,0.5061,0.4709,0.4957,0.4269
"7803",193654,"NEW SCHOOL UNIVERSITY",1,0,2004,"26820","182.399275","196","339","815",612,203,371,"86",285,0.4657,0.4236,0.4552,0.416
"7804",193654,"The New School",1,0,2005,"28560","196.78965","226","336","789",558,231,355,"86",269,0.4821,0.3723,0.4499,0.4259
"7805",193654,"The New School",1,0,2006,"28853","219.488144","269","375","883",622,261,409,"110",299,0.4807,0.4215,0.4632,0.4247
"7806",193654,"The New School",1,0,2007,"30550","232.646423","306","416","999",740,259,482,"118",364,0.4919,0.4556,0.4825,0.4164
"7807",193654,"The New School",1,0,2008,"32695","256.779411","334","400","1058",746,312,482,"113",369,0.4946,0.3622,0.4556,0.3781
"7808",193654,"The New School",1,0,2009,"34081","265.704","370","422","1136",836,300,533,"113",420,0.5024,0.3767,0.4692,0.3715
"7809",193654,"The New School",1,0,2010,"35607","281.458","415","441","1166",859,307,603,"139",464,0.5402,0.4528,0.5172,0.3782
"7810",193900,"NEW YORK UNIVERSITY",1,0,1991,"15620","1175.857","1225","1303","2338",1279,1059,1173,"508",665,0.5199,0.4797,0.5017,0.5573
"7811",193900,"NEW YORK UNIVERSITY",1,0,1992,"16650","1277.671","1222","1278","2669",1511,1158,1355,"571",784,0.5189,0.4931,0.5077,0.4788
"7812",193900,"NEW YORK UNIVERSITY",1,0,1993,"17640","1339.25","1231","1423","2752",1592,1160,1395,"546",849,0.5333,0.4707,0.5069,0.5171
"7813",193900,"NEW YORK UNIVERSITY",1,0,1995,"19748","1539.077","2346","1569","3156",1851,1305,1652,"681",971,0.5246,0.5218,0.5234,0.4971
"7814",193900,"NEW YORK UNIVERSITY",1,0,1996,"20756","1637.866787","2238","1489","3393",2002,1391,1838,"770",1068,0.5335,0.5536,0.5417,0.4388
"7815",193900,"NEW YORK UNIVERSITY",1,0,1997,"21730","1599.177","2353","1409","3557",2054,1503,1963,"775",1188,0.5784,0.5156,0.5519,0.3961
"7816",193900,"NEW YORK UNIVERSITY",1,0,1998,"22586","1297.066","2808","1432","3722",2224,1498,2028,"805",1223,0.5499,0.5374,0.5449,0.3847
"7817",193900,"NEW YORK UNIVERSITY",1,0,1999,"22256","1402.433","2414","1535","3845",2323,1522,2245,"868",1377,0.5928,0.5703,0.5839,0.3992
"7818",193900,"NEW YORK UNIVERSITY",1,0,2000,"23090","1498.255","2596","1571","3966",2424,1542,2416,"966",1450,0.5982,0.6265,0.6092,0.3961
"7819",193900,"NEW YORK UNIVERSITY",1,0,2001,"23986","1687.731","2778","1844","4136",2525,1611,2574,"1016",1558,0.617,0.6307,0.6223,0.4458
"7820",193900,"NEW YORK UNIVERSITY",1,0,2002,"24950","1849.378","1790","2160","4126",2577,1549,2564,"963",1601,0.6213,0.6217,0.6214,0.5235
"7821",193900,"NEW YORK UNIVERSITY",1,0,2003,"26766","2021.253","1906","1867","4203",2563,1640,2664,"1069",1595,0.6223,0.6518,0.6338,0.4442
"7822",193900,"NEW YORK UNIVERSITY",1,0,2004,"28328","2049.478","2010","2331","4568",2792,1776,2860,"1121",1739,0.6229,0.6312,0.6261,0.5103
"7823",193900,"New York University",1,0,2005,"29890","2236.615","2043","2439","4639",2853,1786,2941,"1168",1773,0.6215,0.654,0.634,0.5258
"7824",193900,"New York University",1,0,2006,"31534","2402.387","2152","2445","4704",2895,1809,2879,"1141",1738,0.6003,0.6307,0.612,0.5198
"7825",193900,"New York University",1,0,2007,"33268","2603.313","2231","2462","4884",3064,1820,2973,"1082",1891,0.6172,0.5945,0.6087,0.5041
"7826",193900,"New York University",1,0,2008,"35230","2841.168","2311","2182","4786",2738,2048,2740,"1134",1606,0.5866,0.5537,0.5725,0.4559
"7827",193900,"New York University",1,0,2009,"36586","3050.744","2377","2245","5367",3037,2330,3359,"1449",1910,0.6289,0.6219,0.6259,0.4183
"7828",193900,"New York University",1,0,2010,"37866","3196.919","2462","2301","5434",3100,2334,3417,"1477",1940,0.6258,0.6328,0.6288,0.4234
"7829",193973,"NIAGARA UNIVERSITY",1,0,1991,"9030","31.019","116","367","447",272,175,176,"53",123,0.4522,0.3029,0.3937,0.821
"7830",193973,"NIAGARA UNIVERSITY",1,0,1992,"9523","34.745","110","445","517",334,183,184,"60",124,0.3713,0.3279,0.3559,0.8607
"7831",193973,"NIAGARA UNIVERSITY",1,0,1993,"10070","34.285","108","359","432",259,173,202,"68",134,0.5174,0.3931,0.4676,0.831
"7832",193973,"NIAGARA UNIVERSITY",1,0,1995,"11560","37.19","116","327","424",264,160,204,"67",137,0.5189,0.4188,0.4811,0.7712
"7833",193973,"NIAGARA UNIVERSITY",1,0,1996,"12256","41.919696","118","458","552",314,238,253,"107",146,0.465,0.4496,0.4583,0.8297
"7834",193973,"NIAGARA UNIVERSITY",1,0,1997,"12890","34.127167","118","576","705",417,288,299,"102",197,0.4724,0.3542,0.4241,0.817
"7835",193973,"NIAGARA UNIVERSITY",1,0,1998,"13406","35.322797","119","449","543",332,211,271,"93",178,0.5361,0.4408,0.4991,0.8269
"7836",193973,"NIAGARA UNIVERSITY",1,0,1999,"13400","37.334147","120","500","575",345,230,315,"127",188,0.5449,0.5522,0.5478,0.8696
"7837",193973,"NIAGARA UNIVERSITY",1,0,2000,"14000","38.18303","124","527","628",371,257,350,"122",228,0.6146,0.4747,0.5573,0.8392
"7838",193973,"NIAGARA UNIVERSITY",1,0,2001,"14700","40.690229","128","497","598",362,236,322,"117",205,0.5663,0.4958,0.5385,0.8311
"7839",193973,"NIAGARA UNIVERSITY",1,0,2002,"15900","45.343666","134","604","735",440,295,409,"148",261,0.5932,0.5017,0.5565,0.8218
"7840",193973,"NIAGARA UNIVERSITY",1,0,2003,"16700","51.113073","131","568","686",417,269,403,"152",251,0.6019,0.5651,0.5875,0.828
"7841",193973,"NIAGARA UNIVERSITY",1,0,2004,"17700","53.323746","131","604","725",467,258,443,"141",302,0.6467,0.5465,0.611,0.8331
"7842",193973,"Niagara University",1,0,2005,"19000","57.625504","136","626","730",444,286,435,"160",275,0.6194,0.5594,0.5959,0.8575
"7843",193973,"Niagara University",1,0,2006,"20400","61.264266","142","606","705",421,284,437,"169",268,0.6366,0.5951,0.6199,0.8596
"7844",193973,"Niagara University",1,0,2007,"21400","63.955173","149","476","737",435,302,440,"164",276,0.6345,0.543,0.597,0.6459
"7845",193973,"Niagara University",1,0,2008,"22500","69.118418","153","582","738",454,284,435,"146",289,0.6366,0.5141,0.5894,0.7886
"7846",193973,"Niagara University",1,0,2009,"23700","72.596608","148","547","671",404,267,378,"141",237,0.5866,0.5281,0.5633,0.8152
"7847",193973,"Niagara University",1,0,2010,"24600","71.468929","156","521","668",377,291,397,"163",234,0.6207,0.5601,0.5943,0.7799
"7848",194161,"NYACK COLLEGE",1,0,1991,"7100","9.611","48","61","108",77,31,26,"4",22,0.2857,0.129,0.2407,0.5648
"7849",194161,"NYACK COLLEGE",1,0,1992,"7910","11.69","47","60","104",60,44,37,"14",23,0.3833,0.3182,0.3558,0.5769
"7850",194161,"NYACK COLLEGE",1,0,1993,"8400","13.156","44","72","109",69,40,30,"8",22,0.3188,0.2,0.2752,0.6606
"7851",194161,"NYACK COLLEGE",1,0,1995,"9450","15.114","43","72","160",92,68,56,"21",35,0.3804,0.3088,0.35,0.45
"7852",194161,"NYACK COLLEGE",1,0,1996,"10360","15.572045","43","143","208",129,79,69,"23",46,0.3566,0.2911,0.3317,0.6875
"7853",194161,"NYACK COLLEGE",1,0,1997,"11100","15.712213","50","126","208",114,94,46,"17",29,0.2544,0.1809,0.2212,0.6058
"7854",194161,"NYACK COLLEGE",1,0,1998,"11650","17.094823","56","133","258",159,99,73,"20",53,0.3333,0.202,0.2829,0.5155
"7855",194161,"NYACK COLLEGE",1,0,1999,"11440","18.133831","61","149","322",182,140,107,"39",68,0.3736,0.2786,0.3323,0.4627
"7856",194161,"NYACK COLLEGE",1,0,2000,"11990","21.793498","69.5","141","373",233,140,105,"35",70,0.3004,0.25,0.2815,0.378
"7857",194161,"NYACK COLLEGE",1,0,2001,"12480","26.088142","78","131","320",206,114,103,"35",68,0.3301,0.307,0.3219,0.4094
"7858",194161,"NYACK COLLEGE",1,0,2002,"12990","29.607759","84","133","295",183,112,109,"40",69,0.377,0.3571,0.3695,0.4508
"7859",194161,"NYACK COLLEGE",1,0,2003,"13500","31.541033","86","122","267",166,101,79,"26",53,0.3193,0.2574,0.2959,0.4569
"7860",194161,"NYACK COLLEGE",1,0,2004,"13990","33.54503","91","96","260",162,98,78,"29",49,0.3025,0.2959,0.3,0.3692
"7861",194161,"Nyack College",1,0,2005,"14750","37.585237","102","105","256",137,119,60,"21",39,0.2847,0.1765,0.2344,0.4102
"7862",194161,"Nyack College",1,0,2006,"15400","39.172925","102","113","308",178,130,85,"30",55,0.309,0.2308,0.276,0.3669
"7863",194161,"Nyack College",1,0,2007,"15800","41.190549","97","99","304",172,132,74,"22",52,0.3023,0.1667,0.2434,0.3257
"7864",194161,"Nyack College",1,0,2008,"17500","43.289706","90","83","253",140,113,61,"22",39,0.2786,0.1947,0.2411,0.3281
"7865",194161,"Nyack College",1,0,2009,"18500","42.39777","100","69","260",151,109,68,"26",42,0.2781,0.2385,0.2615,0.2654
"7866",194161,"Nyack College",1,0,2010,"19500","43.826242","110","82","314",181,133,67,"28",39,0.2155,0.2105,0.2134,0.2611
"7867",194310,"PACE UNIVERSITY-NEW YORK",1,0,1991,"9494","140.605","449","366","510",290,220,178,"56",122,0.4207,0.2545,0.349,0.7176
"7868",194310,"PACE UNIVERSITY-NEW YORK",1,0,1992,"10100","152.454","431","192","543",357,186,151,"42",109,0.3053,0.2258,0.2781,0.3536
"7869",194310,"PACE UNIVERSITY-NEW YORK",1,0,1993,"10780","155.715","437","256","659",430,229,228,"64",164,0.3814,0.2795,0.346,0.3885
"7870",194310,"PACE UNIVERSITY-NEW YORK",1,0,1995,"12120","180.515729","451","498","1139",681,458,420,"139",281,0.4126,0.3035,0.3687,0.4372
"7871",194310,"PACE UNIVERSITY-NEW YORK",1,0,1996,"13080","192.752917","210","670","1388",788,600,487,"180",307,0.3896,0.3,0.3509,0.4827
"7872",194310,"PACE UNIVERSITY-NEW YORK",1,0,1997,"13820","70.743613","200","723","1476",859,617,588,"203",385,0.4482,0.329,0.3984,0.4898
"7873",194310,"PACE UNIVERSITY-NEW YORK",1,0,1998,"14690","168.813403","200","697","1536",911,625,602,"220",382,0.4193,0.352,0.3919,0.4538
"7874",194310,"PACE UNIVERSITY-NEW YORK",1,0,1999,"15130","179.30546","209","646","1500",895,605,604,"205",399,0.4458,0.3388,0.4027,0.4307
"7875",194310,"PACE UNIVERSITY-NEW YORK",1,0,2000,"15870","175.948979","319","713","1602",976,626,612,"204",408,0.418,0.3259,0.382,0.4451
"7876",194310,"PACE UNIVERSITY-NEW YORK",1,0,2001,"16650","204.308279","429","607","1573",948,625,567,"192",375,0.3956,0.3072,0.3605,0.3859
"7877",194310,"PACE UNIVERSITY-NEW YORK",1,0,2002,"17800","211.649686","432","686","1508",916,592,592,"190",402,0.4389,0.3209,0.3926,0.4549
"7878",194310,"PACE UNIVERSITY-NEW YORK",1,0,2003,"20540","225.870373","426","783","1553",997,556,653,"214",439,0.4403,0.3849,0.4205,0.5042
"7879",194310,"PACE UNIVERSITY-NEW YORK",1,0,2004,"22100","239.227855","448","663","1437",900,537,577,"194",383,0.4256,0.3613,0.4015,0.4614
"7880",194310,"Pace University-New York",1,0,2005,"24752","258.300075","474","741","1474",954,520,584,"186",398,0.4172,0.3577,0.3962,0.5027
"7881",194310,"Pace University-New York",1,0,2006,"29454","274.182103","460","589","1131",738,393,441,"126",315,0.4268,0.3206,0.3899,0.5208
"7882",194310,"Pace University-New York",1,0,2007,"29454","280.345295","416","696","1537",937,600,528,"183",345,0.3682,0.305,0.3435,0.4528
"7883",194310,"Pace University-New York",1,0,2008,"30632","266.823445","415","717","1616",1002,614,589,"208",381,0.3802,0.3388,0.3645,0.4437
"7884",194310,"Pace University-New York",1,0,2009,"31860","280.257716","416","768","1637",1036,601,603,"194",409,0.3948,0.3228,0.3684,0.4692
"7885",194310,"Pace University-New York",1,0,2010,"32656","277.047402","414","491","1766",1089,677,696,"240",456,0.4187,0.3545,0.3941,0.278
"7886",194824,"RENSSELAER POLYTECHNIC INSTITUTE",1,0,1991,"15633","174.196","374","669","971",193,778,428,"334",94,0.487,0.4293,0.4408,0.689
"7887",194824,"RENSSELAER POLYTECHNIC INSTITUTE",1,0,1992,"16402","186.741","369","762","1083",216,867,483,"368",115,0.5324,0.4245,0.446,0.7036
"7888",194824,"RENSSELAER POLYTECHNIC INSTITUTE",1,0,1993,"17335","186.785","369","638","936",168,768,408,"303",105,0.625,0.3945,0.4359,0.6816
"7889",194824,"RENSSELAER POLYTECHNIC INSTITUTE",1,0,1995,"18656","184.644","333","725","962",243,719,425,"296",129,0.5309,0.4117,0.4418,0.7536
"7890",194824,"RENSSELAER POLYTECHNIC INSTITUTE",1,0,1996,"19685","185.548","336","654","898",225,673,454,"318",136,0.6044,0.4725,0.5056,0.7283
"7891",194824,"RENSSELAER POLYTECHNIC INSTITUTE",1,0,1997,"20960","178.164","326","719","1069",267,802,584,"414",170,0.6367,0.5162,0.5463,0.6726
"7892",194824,"RENSSELAER POLYTECHNIC INSTITUTE",1,0,1998,"21655","179.431","340","765","1138",258,880,654,"483",171,0.6628,0.5489,0.5747,0.6722
"7893",194824,"RENSSELAER POLYTECHNIC INSTITUTE",1,0,1999,"22300","194.992","343","928","1323",295,1028,812,"611",201,0.6814,0.5944,0.6138,0.7014
"7894",194824,"RENSSELAER POLYTECHNIC INSTITUTE",1,0,2000,"23525","217.559","386","871","1303",334,969,833,"603",230,0.6886,0.6223,0.6393,0.6685
"7895",194824,"RENSSELAER POLYTECHNIC INSTITUTE",1,0,2001,"24820","233.383","429","770","1109",283,826,730,"532",198,0.6996,0.6441,0.6583,0.6943
"7896",194824,"RENSSELAER POLYTECHNIC INSTITUTE",1,0,2002,"26400","248.933","399","751","1047",263,784,672,"490",182,0.692,0.625,0.6418,0.7173
"7897",194824,"RENSSELAER POLYTECHNIC INSTITUTE",1,0,2003,"27700","279.611","407","973","1341",320,1021,856,"626",230,0.7188,0.6131,0.6383,0.7256
"7898",194824,"RENSSELAER POLYTECHNIC INSTITUTE",1,0,2004,"28950","296.327","405","792","1079",259,820,696,"521",175,0.6757,0.6354,0.645,0.734
"7899",194824,"Rensselaer Polytechnic Institute",1,0,2005,"31000","309.978","400","937","1236",283,953,745,"550",195,0.689,0.5771,0.6028,0.7581
"7900",194824,"Rensselaer Polytechnic Institute",1,0,2006,"32600","335.036","393","966","1269",362,907,766,"544",222,0.6133,0.5998,0.6036,0.7612
"7901",194824,"Rensselaer Polytechnic Institute",1,0,2007,"34900","346.933","400","985","1288",389,899,836,"576",260,0.6684,0.6407,0.6491,0.7648
"7902",194824,"Rensselaer Polytechnic Institute",1,0,2008,"36950","374.068","394","980","1355",380,975,833,"599",234,0.6158,0.6144,0.6148,0.7232
"7903",194824,"Rensselaer Polytechnic Institute",1,0,2009,"38100","382.445","383","967","1337",360,977,840,"599",241,0.6694,0.6131,0.6283,0.7233
"7904",194824,"Rensselaer Polytechnic Institute",1,0,2010,"39600","384.823","378","834","1152",322,830,703,"494",209,0.6491,0.5952,0.6102,0.724
"7905",195003,"ROCHESTER INSTITUTE OF TECHNOLOGY",0,1,1991,"12058","205.841","637","1034","1265",370,895,287,"162",125,0.3378,0.181,0.2269,0.8174
"7906",195003,"ROCHESTER INSTITUTE OF TECHNOLOGY",0,1,1992,"12760","219.294","640","1144","1482",432,1050,323,"172",151,0.3495,0.1638,0.2179,0.7719
"7907",195003,"ROCHESTER INSTITUTE OF TECHNOLOGY",0,1,1993,"13555","224.833","664","1062","1343",425,918,310,"146",164,0.3859,0.159,0.2308,0.7908
"7908",195003,"ROCHESTER INSTITUTE OF TECHNOLOGY",0,1,1995,"14977","238.708","629","1218","1634",502,1132,621,"379",242,0.4821,0.3348,0.38,0.7454
"7909",195003,"ROCHESTER INSTITUTE OF TECHNOLOGY",0,1,1996,"15691","237.505","537","1400","1725",571,1154,690,"419",271,0.4746,0.3631,0.4,0.8116
"7910",195003,"ROCHESTER INSTITUTE OF TECHNOLOGY",0,1,1997,"16399","211.823","622","1457","1836",617,1219,727,"446",281,0.4554,0.3659,0.396,0.7936
"7911",195003,"ROCHESTER INSTITUTE OF TECHNOLOGY",0,1,1998,"17067","226.268","634","1369","1980",609,1371,816,"526",290,0.4762,0.3837,0.4121,0.6914
"7912",195003,"ROCHESTER INSTITUTE OF TECHNOLOGY",0,1,1999,"17328","247.1","605","1614","2107",602,1505,366,"187",179,0.2973,0.1243,0.1737,0.766
"7913",195003,"ROCHESTER INSTITUTE OF TECHNOLOGY",0,1,2000,"17934","283.63","616","1758","2278",636,1642,453,"244",209,0.3286,0.1486,0.1989,0.7717
"7914",195003,"ROCHESTER INSTITUTE OF TECHNOLOGY",0,1,2001,"18633","291.011","627","1630","2227",574,1653,451,"249",202,0.3519,0.1506,0.2025,0.7319
"7915",195003,"ROCHESTER INSTITUTE OF TECHNOLOGY",0,1,2002,"19470","321.408","684","1685","2327",614,1713,563,"299",264,0.43,0.1745,0.2419,0.7241
"7916",195003,"ROCHESTER INSTITUTE OF TECHNOLOGY",0,1,2003,"21027","340.208","799","1522","2121",567,1554,538,"286",252,0.4444,0.184,0.2537,0.7176
"7917",195003,"ROCHESTER INSTITUTE OF TECHNOLOGY",0,1,2004,"22056","363.329","731","1659","2233",562,1671,577,"316",261,0.4644,0.1891,0.2584,0.7429
"7918",195003,"Rochester Institute of Technology",0,1,2005,"23247","356.592","794","1582","2184",656,1528,587,"289",298,0.4543,0.1891,0.2688,0.7244
"7919",195003,"Rochester Institute of Technology",0,1,2006,"24627","384.507","766","1787","2355",675,1680,589,"315",274,0.4059,0.1875,0.2501,0.7588
"7920",195003,"Rochester Institute of Technology",0,1,2007,"26085","388.459","797","1881","2497",788,1709,648,"306",342,0.434,0.1791,0.2595,0.7533
"7921",195003,"Rochester Institute of Technology",0,1,2008,"27624","393.29","924","1945","2594",848,1746,706,"357",349,0.4116,0.2045,0.2722,0.7498
"7922",195003,"Rochester Institute of Technology",0,1,2009,"28866","428.38","945","1858","2582",798,1784,796,"413",383,0.4799,0.2315,0.3083,0.7196
"7923",195003,"Rochester Institute of Technology",0,1,2010,"30282","467.52","961","1395","2583",820,1763,699,"346",353,0.4305,0.1963,0.2706,0.5401
"7924",195030,"UNIVERSITY OF ROCHESTER",1,0,1991,"15513","656.319","526","856","1215",537,678,805,"440",365,0.6797,0.649,0.6626,0.7045
"7925",195030,"UNIVERSITY OF ROCHESTER",1,0,1992,"16444","708.766","521","910","1266",585,681,824,"425",399,0.6821,0.6241,0.6509,0.7188
"7926",195030,"UNIVERSITY OF ROCHESTER",1,0,1993,"17345","790.713","508","867","1229",599,630,754,"365",389,0.6494,0.5794,0.6135,0.7055
"7927",195030,"UNIVERSITY OF ROCHESTER",1,0,1995,"19165","878.668","501","837","1205",583,622,751,"354",397,0.681,0.5691,0.6232,0.6946
"7928",195030,"UNIVERSITY OF ROCHESTER",1,0,1996,"20080","887.459","498","677","1011",501,510,719,"336",383,0.7645,0.6588,0.7112,0.6696
"7929",195030,"UNIVERSITY OF ROCHESTER",1,0,1997,"21020","867.324","486","639","892",404,488,592,"301",291,0.7203,0.6168,0.6637,0.7164
"7930",195030,"UNIVERSITY OF ROCHESTER",1,0,1998,"21981","1042.609","476","696","1062",481,581,730,"372",358,0.7443,0.6403,0.6874,0.6554
"7931",195030,"UNIVERSITY OF ROCHESTER",1,0,1999,"22300","1168.407","475","739","1211",525,686,828,"429",399,0.76,0.6254,0.6837,0.6102
"7932",195030,"UNIVERSITY OF ROCHESTER",1,0,2000,"23130","1309.506","487","640","1044",460,584,741,"395",346,0.7522,0.6764,0.7098,0.613
"7933",195030,"UNIVERSITY OF ROCHESTER",1,0,2001,"24150","1383.682","499","699","1095",481,614,767,"390",377,0.7838,0.6352,0.7005,0.6384
"7934",195030,"UNIVERSITY OF ROCHESTER",1,0,2002,"25430","1528.304","506","675","1055",492,563,776,"392",384,0.7805,0.6963,0.7355,0.6398
"7935",195030,"UNIVERSITY OF ROCHESTER",1,0,2003,"26900","1632.857","513","650","1086",508,578,747,"368",379,0.7461,0.6367,0.6878,0.5985
"7936",195030,"UNIVERSITY OF ROCHESTER",1,0,2004,"28250","1774.62","556","726","1083",496,587,808,"409",399,0.8044,0.6968,0.7461,0.6704
"7937",195030,"University of Rochester",1,0,2005,"30540","1878.694","552","712","1106",563,543,808,"376",432,0.7673,0.6924,0.7306,0.6438
"7938",195030,"University of Rochester",1,0,2006,"32650","2041.783","569","667","1219",561,658,906,"467",439,0.7825,0.7097,0.7432,0.5472
"7939",195030,"University of Rochester",1,0,2007,"34380","2177.08","566","635","1181",603,578,905,"415",490,0.8126,0.718,0.7663,0.5377
"7940",195030,"University of Rochester",1,0,2008,"36410","2338.735","567","683","1282",642,640,936,"442",494,0.7695,0.6906,0.7301,0.5328
"7941",195030,"University of Rochester",1,0,2009,"37870","2448.374","573","631","1195",594,601,890,"431",459,0.7727,0.7171,0.7448,0.528
"7942",195030,"University of Rochester",1,0,2010,"39480","2518.123","588","777","1305",641,664,120,"69",51,0.0796,0.1039,0.092,0.5954
"7943",195164,"SAINT BONAVENTURE UNIVERSITY",1,0,1991,"9067","37.06","145","440","479",236,243,267,"117",150,0.6356,0.4815,0.5574,0.9186
"7944",195164,"SAINT BONAVENTURE UNIVERSITY",1,0,1992,"9284","40.363","169","399","441",216,225,226,"93",133,0.6157,0.4133,0.5125,0.9048
"7945",195164,"SAINT BONAVENTURE UNIVERSITY",1,0,1993,"9656","43.159","154","350","370",187,183,215,"95",120,0.6417,0.5191,0.5811,0.9459
"7946",195164,"SAINT BONAVENTURE UNIVERSITY",1,0,1995,"11604","35.539","110","482","547",278,269,285,"127",158,0.5683,0.4721,0.521,0.8812
"7947",195164,"SAINT BONAVENTURE UNIVERSITY",1,0,1996,"12439","41.838863","116","534","590",311,279,327,"153",174,0.5595,0.5484,0.5542,0.9051
"7948",195164,"SAINT BONAVENTURE UNIVERSITY",1,0,1997,"13100","34.018764","121","292","542",274,268,309,"144",165,0.6022,0.5373,0.5701,0.5387
"7949",195164,"SAINT BONAVENTURE UNIVERSITY",1,0,1998,"13800","36.644475","133","463","568",284,284,290,"126",164,0.5775,0.4437,0.5106,0.8151
"7950",195164,"SAINT BONAVENTURE UNIVERSITY",1,0,1999,"13880","39.205258","147","276","520",294,226,273,"100",173,0.5884,0.4425,0.525,0.5308
"7951",195164,"SAINT BONAVENTURE UNIVERSITY",1,0,2000,"14510","41.28382","147.5","306","584",316,268,309,"116",193,0.6108,0.4328,0.5291,0.524
"7952",195164,"SAINT BONAVENTURE UNIVERSITY",1,0,2001,"15526","42.337653","148","286","518",263,255,280,"121",159,0.6046,0.4745,0.5405,0.5521
"7953",195164,"SAINT BONAVENTURE UNIVERSITY",1,0,2002,"16210","47.62525","154","340","584",295,289,300,"136",164,0.5559,0.4706,0.5137,0.5822
"7954",195164,"SAINT BONAVENTURE UNIVERSITY",1,0,2003,"17190","52.636959","156","371","595",292,303,296,"135",161,0.5514,0.4455,0.4975,0.6235
"7955",195164,"SAINT BONAVENTURE UNIVERSITY",1,0,2004,"18650","52.360004","153","387","574",304,270,305,"134",171,0.5625,0.4963,0.5314,0.6742
"7956",195164,"Saint Bonaventure University",1,0,2005,"20610","53.531564","157","352","477",225,252,239,"112",127,0.5644,0.4444,0.501,0.7379
"7957",195164,"Saint Bonaventure University",1,0,2006,"21650","52.846935","149","361","459",234,225,235,"105",130,0.5556,0.4667,0.512,0.7865
"7958",195164,"Saint Bonaventure University",1,0,2007,"22740","49.142191","141","389","527",264,263,283,"133",150,0.5682,0.5057,0.537,0.7381
"7959",195164,"Saint Bonaventure University",1,0,2008,"23920","50.856328","145","416","563",315,248,310,"113",197,0.6254,0.4556,0.5506,0.7389
"7960",195164,"Saint Bonaventure University",1,0,2009,"24920","52.292147","155","338","465",249,216,252,"106",146,0.5863,0.4907,0.5419,0.7269
"7961",195164,"Saint Bonaventure University",1,0,2010,"25930","50.729018","157","366","494",242,252,257,"116",141,0.5826,0.4603,0.5202,0.7409
"7962",195173,"ST FRANCIS COLLEGE",1,0,1991,"5850","13.068","52","196","353",207,146,68,"26",42,0.2029,0.1781,0.1926,0.5552
"7963",195173,"ST FRANCIS COLLEGE",1,0,1992,"6550","16.59","53","206","372",200,172,63,"26",37,0.185,0.1512,0.1694,0.5538
"7964",195173,"ST FRANCIS COLLEGE",1,0,1993,"6710","18.200745","56","212","358",214,144,107,"40",67,0.3131,0.2778,0.2989,0.5922
"7965",195173,"ST FRANCIS COLLEGE",1,0,1995,"7360","16.669","59","170","281",145,136,89,"48",41,0.2828,0.3529,0.3167,0.605
"7966",195173,"ST FRANCIS COLLEGE",1,0,1996,"7739","18.926491","58","163","305",181,124,93,"35",58,0.3204,0.2823,0.3049,0.5344
"7967",195173,"ST FRANCIS COLLEGE",1,0,1997,"8160","14.619698","62","217","410",253,157,95,"26",69,0.2727,0.1656,0.2317,0.5293
"7968",195173,"ST FRANCIS COLLEGE",1,0,1998,"8480","16.271836","65","237","440",259,181,146,"40",106,0.4093,0.221,0.3318,0.5386
"7969",195173,"ST FRANCIS COLLEGE",1,0,1999,"8250","18.221099","66","277","474",284,190,130,"54",76,0.2676,0.2842,0.2743,0.5844
"7970",195173,"ST FRANCIS COLLEGE",1,0,2000,"8900","19.761108","66","253","434",242,192,191,"72",119,0.4917,0.375,0.4401,0.5829
"7971",195173,"ST FRANCIS COLLEGE",1,0,2001,"9450","21.472859","66","235","471",220,251,171,"75",96,0.4364,0.2988,0.3631,0.4989
"7972",195173,"ST FRANCIS COLLEGE",1,0,2002,"9920","22.799697","65","258","454",238,216,153,"61",92,0.3866,0.2824,0.337,0.5683
"7973",195173,"ST FRANCIS COLLEGE",1,0,2003,"10620","23.27176","69","225","428",224,204,71,"18",53,0.2366,0.0882,0.1659,0.5257
"7974",195173,"ST FRANCIS COLLEGE",1,0,2004,"11420","26.206499","70","226","473",228,245,148,"67",81,0.3553,0.2735,0.3129,0.4778
"7975",195173,"St Francis College",1,0,2005,"12450","27.888619","71","238","497",224,273,140,"68",72,0.3214,0.2491,0.2817,0.4789
"7976",195173,"St Francis College",1,0,2006,"13500","30.370135","76","228","474",253,221,137,"61",76,0.3004,0.276,0.289,0.481
"7977",195173,"St Francis College",1,0,2007,"14400","34.174412","76","204","478",261,217,130,"48",82,0.3142,0.2212,0.272,0.4268
"7978",195173,"St. Francis College",1,0,2008,"15200","33.494012","75","275","566",292,274,160,"68",92,0.3151,0.2482,0.2827,0.4859
"7979",195173,"St. Francis College",1,0,2009,"16040","37.593041","77","279","580",301,279,168,"63",105,0.3488,0.2258,0.2897,0.481
"7980",195173,"St. Francis College",1,0,2010,"16720","38.290308","80","223","559",289,270,151,"65",86,0.2976,0.2407,0.2701,0.3989
"7981",195216,"SAINT LAWRENCE UNIVERSITY",1,0,1991,"15735","54.136","158","381","421",213,208,322,"142",180,0.8451,0.6827,0.7648,0.905
"7982",195216,"ST LAWRENCE UNIVERSITY",1,0,1992,"16820","56.726","151","552","601",294,307,413,"207",206,0.7007,0.6743,0.6872,0.9185
"7983",195216,"ST LAWRENCE UNIVERSITY",1,0,1993,"17890","59.739","153","442","507",260,247,353,"167",186,0.7154,0.6761,0.6963,0.8718
"7984",195216,"ST LAWRENCE UNIVERSITY",1,0,1995,"19790","62.201","154","517","571",287,284,382,"176",206,0.7178,0.6197,0.669,0.9054
"7985",195216,"ST LAWRENCE UNIVERSITY",1,0,1996,"20560","68.136278","149","529","592",281,311,388,"209",179,0.637,0.672,0.6554,0.8936
"7986",195216,"ST LAWRENCE UNIVERSITY",1,0,1997,"21325","53.771733","154","434","476",232,244,328,"148",180,0.7759,0.6066,0.6891,0.9118
"7987",195216,"ST LAWRENCE UNIVERSITY",1,0,1998,"22120","54.990281","153","364","479",255,224,339,"155",184,0.7216,0.692,0.7077,0.7599
"7988",195216,"ST LAWRENCE UNIVERSITY",1,0,1999,"22905","59.123953","156","459","575",301,274,410,"182",228,0.7575,0.6642,0.713,0.7983
"7989",195216,"ST LAWRENCE UNIVERSITY",1,0,2000,"23765","63.984889","157","440","612",325,287,436,"186",250,0.7692,0.6481,0.7124,0.719
"7990",195216,"ST LAWRENCE UNIVERSITY",1,0,2001,"24655","69.788155","158","341","511",269,242,377,"179",198,0.7361,0.7397,0.7378,0.6673
"7991",195216,"ST LAWRENCE UNIVERSITY",1,0,2002,"26280","74.009371","171","427","615",316,299,443,"197",246,0.7785,0.6589,0.7203,0.6943
"7992",195216,"ST LAWRENCE UNIVERSITY",1,0,2003,"27985","81.862382","168","394","565",296,269,444,"196",248,0.8378,0.7286,0.7858,0.6973
"7993",195216,"ST LAWRENCE UNIVERSITY",1,0,2004,"30270","84.971315","171","419","566",298,268,444,"203",241,0.8087,0.7575,0.7845,0.7403
"7994",195216,"St Lawrence University",1,0,2005,"31935","88.718122","181","415","534",268,266,407,"190",217,0.8097,0.7143,0.7622,0.7772
"7995",195216,"St Lawrence University",1,0,2006,"33690","94.065092","179","495","608",325,283,463,"210",253,0.7785,0.742,0.7615,0.8141
"7996",195216,"St Lawrence University",1,0,2007,"35375","96.504418","187","508","627",383,244,482,"181",301,0.7859,0.7418,0.7687,0.8102
"7997",195216,"St Lawrence University",1,0,2008,"37675","106.976435","190","512","616",334,282,490,"220",270,0.8084,0.7801,0.7955,0.8312
"7998",195216,"St Lawrence University",1,0,2009,"39520","109.151302","183","492","579",307,272,476,"219",257,0.8371,0.8051,0.8221,0.8497
"7999",195216,"St Lawrence University",1,0,2010,"40905","109.12866","179","495","609",316,293,492,"227",265,0.8386,0.7747,0.8079,0.8128
"8000",195234,"COLLEGE OF SAINT ROSE",1,0,1991,"8420","25.563","118","184","207",152,55,106,"24",82,0.5395,0.4364,0.5121,0.8889
"8001",195234,"COLLEGE OF SAINT ROSE",1,0,1992,"9036","30.529","118","204","233",177,56,122,"21",101,0.5706,0.375,0.5236,0.8755
"8002",195234,"COLLEGE OF SAINT ROSE",1,0,1993,"9562","33.295","129","213","236",160,76,116,"24",92,0.575,0.3158,0.4915,0.9025
"8003",195234,"THE COLLEGE OF SAINT ROSE",1,0,1995,"10610","38.172","135","225","248",170,78,111,"34",77,0.4529,0.4359,0.4476,0.9073
"8004",195234,"THE COLLEGE OF SAINT ROSE",1,0,1996,"11174","38.014557","130","273","319",226,93,146,"30",116,0.5133,0.3226,0.4577,0.8558
"8005",195234,"THE COLLEGE OF SAINT ROSE",1,0,1997,"11684","31.965706","135","290","311",223,88,146,"29",117,0.5247,0.3295,0.4695,0.9325
"8006",195234,"THE COLLEGE OF SAINT ROSE",1,0,1998,"11968","33.043686","130","313","345",262,83,175,"29",146,0.5573,0.3494,0.5072,0.9072
"8007",195234,"THE COLLEGE OF SAINT ROSE",1,0,1999,"12434","35.754293","138","368","401",297,104,202,"39",163,0.5488,0.375,0.5037,0.9177
"8008",195234,"THE COLLEGE OF SAINT ROSE",1,0,2000,"12870","38.611289","148.5","442","485",349,136,216,"47",169,0.4842,0.3456,0.4454,0.9113
"8009",195234,"THE COLLEGE OF SAINT ROSE",1,0,2001,"13578","42.481622","159","435","490",356,134,239,"45",194,0.5449,0.3358,0.4878,0.8878
"8010",195234,"THE COLLEGE OF SAINT ROSE",1,0,2002,"14244","47.392703","163","467","526",391,135,303,"65",238,0.6087,0.4815,0.576,0.8878
"8011",195234,"THE COLLEGE OF SAINT ROSE",1,0,2003,"15242","52.224842","166","455","531",397,134,277,"52",225,0.5668,0.3881,0.5217,0.8569
"8012",195234,"THE COLLEGE OF SAINT ROSE",1,0,2004,"16230","52.975308","171","388","563",408,155,387,"91",296,0.7255,0.5871,0.6874,0.6892
"8013",195234,"The College of Saint Rose",1,0,2005,"17368","58.261525","181","452","595",411,184,330,"75",255,0.6204,0.4076,0.5546,0.7597
"8014",195234,"The College of Saint Rose",1,0,2006,"18672","63.516062","197","510","630",423,207,328,"88",240,0.5674,0.4251,0.5206,0.8095
"8015",195234,"The College of Saint Rose",1,0,2007,"19860","69.45843","204","487","611",456,155,326,"63",263,0.5768,0.4065,0.5336,0.7971
"8016",195234,"The College of Saint Rose",1,0,2008,"21260","75.704513","204","462","574",415,159,312,"72",240,0.5783,0.4528,0.5436,0.8049
"8017",195234,"The College of Saint Rose",1,0,2009,"22324","82.451682","207","425","583",381,202,271,"76",195,0.5118,0.3762,0.4648,0.729
"8018",195234,"The College of Saint Rose",1,0,2010,"23330","84.350729","206","474","639",432,207,313,"83",230,0.5324,0.401,0.4898,0.7418
"8019",195243,"SAINT THOMAS AQUINAS COLLEGE",1,0,1991,"6750","11.579","66","177","198",113,85,95,"28",67,0.5929,0.3294,0.4798,0.8939
"8020",195243,"SAINT THOMAS AQUINAS COLLEGE",1,0,1992,"7350","13.901","63","162","214",125,89,53,"9",44,0.352,0.1011,0.2477,0.757
"8021",195243,"SAINT THOMAS AQUINAS COLLEGE",1,0,1993,"8150","14.761","63","170","211",132,79,86,"24",62,0.4697,0.3038,0.4076,0.8057
"8022",195243,"SAINT THOMAS AQUINAS COLLEGE",1,0,1995,"9450","18.72","63","192","276",162,114,74,"22",52,0.321,0.193,0.2681,0.6957
"8023",195243,"SAINT THOMAS AQUINAS COLLEGE",1,0,1996,"10100","20.741311","63","183","238",142,96,65,"16",49,0.3451,0.1667,0.2731,0.7689
"8024",195243,"SAINT THOMAS AQUINAS COLLEGE",1,0,1997,"10700","17.316485","61","241","300",179,121,106,"34",72,0.4022,0.281,0.3533,0.8033
"8025",195243,"SAINT THOMAS AQUINAS COLLEGE",1,0,1998,"11420","18.645096","62","236","306",179,127,97,"34",63,0.352,0.2677,0.317,0.7712
"8026",195243,"SAINT THOMAS AQUINAS COLLEGE",1,0,1999,"11800","19.057319","61","213","304",168,136,103,"33",70,0.4167,0.2426,0.3388,0.7007
"8027",195243,"SAINT THOMAS AQUINAS COLLEGE",1,0,2000,"12500","19.825788","61","188","298",173,125,117,"38",79,0.4566,0.304,0.3926,0.6309
"8028",195243,"SAINT THOMAS AQUINAS COLLEGE",1,0,2001,"13120","21.382591","61","195","301",164,137,101,"35",66,0.4024,0.2555,0.3355,0.6478
"8029",195243,"SAINT THOMAS AQUINAS COLLEGE",1,0,2002,"13780","22.614356","62","209","329",191,138,130,"38",92,0.4817,0.2754,0.3951,0.6353
"8030",195243,"SAINT THOMAS AQUINAS COLLEGE",1,0,2003,"14500","24.727578","65","231","343",188,155,97,"39",58,0.3085,0.2516,0.2828,0.6735
"8031",195243,"SAINT THOMAS AQUINAS COLLEGE",1,0,2004,"15300","26.091865","64","225","349",168,181,112,"56",56,0.3333,0.3094,0.3209,0.6447
"8032",195243,"Saint Thomas Aquinas College",1,0,2005,"16200","22.444659","61","238","327",188,139,119,"43",76,0.4043,0.3094,0.3639,0.7278
"8033",195243,"Saint Thomas Aquinas College",1,0,2006,"17200","23.284487","62","229","323",185,138,113,"39",74,0.4,0.2826,0.3498,0.709
"8034",195243,"Saint Thomas Aquinas College",1,0,2007,"18400","24.265306","64","227","324",163,161,117,"49",68,0.4172,0.3043,0.3611,0.7006
"8035",195243,"Saint Thomas Aquinas College",1,0,2008,"19500","26.449588","63","239","352",213,139,140,"44",96,0.4507,0.3165,0.3977,0.679
"8036",195243,"Saint Thomas Aquinas College",1,0,2009,"20670","27.713658","66","195","293",156,137,105,"56",49,0.3141,0.4088,0.3584,0.6655
"8037",195243,"Saint Thomas Aquinas College",1,0,2010,"21910","28.014191","61","178","290",173,117,123,"40",83,0.4798,0.3419,0.4241,0.6138
"8038",195304,"SARAH LAWRENCE COLLEGE",1,0,1991,"16750","24.582","64","193","228",168,60,125,"34",91,0.5417,0.5667,0.5482,0.8465
"8039",195304,"SARAH LAWRENCE COLLEGE",1,0,1992,"17640","26.444","67","181","220",168,52,127,"30",97,0.5774,0.5769,0.5773,0.8227
"8040",195304,"SARAH LAWRENCE COLLEGE",1,0,1993,"18460","28.727","69","200","255",195,60,131,"31",100,0.5128,0.5167,0.5137,0.7843
"8041",195304,"SARAH LAWRENCE COLLEGE",1,0,1995,"20708","32.929","76","183","233",183,50,118,"29",89,0.4863,0.58,0.5064,0.7854
"8042",195304,"SARAH LAWRENCE COLLEGE",1,0,1996,"21836","35.153068","78","234","294",219,75,193,"47",146,0.6667,0.6267,0.6565,0.7959
"8043",195304,"SARAH LAWRENCE COLLEGE",1,0,1997,"22936","30.741031","76","236","283",222,61,174,"33",141,0.6351,0.541,0.6148,0.8339
"8044",195304,"SARAH LAWRENCE COLLEGE",1,0,1998,"24066","33.307823","78","243","306",227,79,202,"57",145,0.6388,0.7215,0.6601,0.7941
"8045",195304,"SARAH LAWRENCE COLLEGE",1,0,1999,"24810","36.519407","88","203","278",215,63,180,"44",136,0.6326,0.6984,0.6475,0.7302
"8046",195304,"SARAH LAWRENCE COLLEGE",1,0,2000,"26040","39.789081","92.5","203","292",212,80,204,"56",148,0.6981,0.7,0.6986,0.6952
"8047",195304,"SARAH LAWRENCE COLLEGE",1,0,2001,"27330","43.029005","97","239","323",240,83,213,"50",163,0.6792,0.6024,0.6594,0.7399
"8048",195304,"SARAH LAWRENCE COLLEGE",1,0,2002,"28680","46.272909","103","261","323",249,74,205,"56",149,0.5984,0.7568,0.6347,0.808
"8049",195304,"SARAH LAWRENCE COLLEGE",1,0,2003,"30120","50.605341","106","243","322",234,88,218,"63",155,0.6624,0.7159,0.677,0.7547
"8050",195304,"SARAH LAWRENCE COLLEGE",1,0,2004,"31680","53.860223","104","254","329",253,76,233,"50",183,0.7233,0.6579,0.7082,0.772
"8051",195304,"Sarah Lawrence College",1,0,2005,"33270","56.315867","111","308","376",285,91,237,"50",187,0.6561,0.5495,0.6303,0.8191
"8052",195304,"Sarah Lawrence College",1,0,2006,"35280","62.27891","112","286","381",286,95,261,"62",199,0.6958,0.6526,0.685,0.7507
"8053",195304,"Sarah Lawrence College",1,0,2007,"37230","65.033092","111","209","363",278,85,226,"50",176,0.6331,0.5882,0.6226,0.5758
"8054",195304,"Sarah Lawrence College",1,0,2008,"39450","68.143873","113","254","348",273,75,246,"57",189,0.6923,0.76,0.7069,0.7299
"8055",195304,"Sarah Lawrence College",1,0,2009,"41040","69.708637","107","270","365",273,92,263,"72",191,0.6996,0.7826,0.7205,0.7397
"8056",195304,"Sarah Lawrence College",1,0,2010,"42600","68.550836","102","231","338",238,100,249,"68",181,0.7605,0.68,0.7367,0.6834
"8057",195474,"SIENA COLLEGE",1,0,1991,"9060","36.743","143","537","584",307,277,455,"220",235,0.7655,0.7942,0.7791,0.9195
"8058",195474,"SIENA COLLEGE",1,0,1992,"9810","38.697","149","497","544",315,229,399,"153",246,0.781,0.6681,0.7335,0.9136
"8059",195474,"SIENA COLLEGE",1,0,1993,"10505","41.501","155","554","616",339,277,421,"185",236,0.6962,0.6679,0.6834,0.8994
"8060",195474,"SIENA COLLEGE",1,0,1995,"11650","44.587","145","552","590",317,273,393,"182",211,0.6656,0.6667,0.6661,0.9356
"8061",195474,"SIENA COLLEGE",1,0,1996,"12150","49.699806","139","522","558",325,233,354,"137",217,0.6677,0.588,0.6344,0.9355
"8062",195474,"SIENA COLLEGE",1,0,1997,"12770","39.064707","139","545","583",301,282,400,"181",219,0.7276,0.6418,0.6861,0.9348
"8063",195474,"SIENA COLLEGE",1,0,1998,"13545","41.273855","139","570","619",311,308,436,"202",234,0.7524,0.6558,0.7044,0.9208
"8064",195474,"SIENA COLLEGE",1,0,1999,"13660","45.448554","145","603","677",381,296,491,"197",294,0.7717,0.6655,0.7253,0.8907
"8065",195474,"SIENA COLLEGE",1,0,2000,"14330","48.115188","150.5","704","765",404,361,547,"234",313,0.7748,0.6482,0.715,0.9203
"8066",195474,"SIENA COLLEGE",1,0,2001,"15330","50.642308","156","639","713",394,319,530,"230",300,0.7614,0.721,0.7433,0.8962
"8067",195474,"SIENA COLLEGE",1,0,2002,"16405","56.650974","160","591","677",405,272,497,"185",312,0.7704,0.6801,0.7341,0.873
"8068",195474,"SIENA COLLEGE",1,0,2003,"17555","60.346165","165","660","759",438,321,519,"204",315,0.7192,0.6355,0.6838,0.8696
"8069",195474,"SIENA COLLEGE",1,0,2004,"18590","63.410491","169","616","715",412,303,532,"212",320,0.7767,0.6997,0.7441,0.8615
"8070",195474,"Siena College",1,0,2005,"20100","65.175192","172","646","763",443,320,531,"225",306,0.6907,0.7031,0.6959,0.8467
"8071",195474,"Siena College",1,0,2006,"21285","69.764077","175","579","688",393,295,478,"190",288,0.7328,0.6441,0.6948,0.8416
"8072",195474,"Siena College",1,0,2007,"22510","71.69741","178","668","781",463,318,578,"219",359,0.7754,0.6887,0.7401,0.8553
"8073",195474,"Siena College",1,0,2008,"23750","76.778319","181","704","824",444,380,613,"272",341,0.768,0.7158,0.7439,0.8544
"8074",195474,"Siena College",1,0,2009,"25060","84.258251","188","656","783",417,366,563,"239",324,0.777,0.653,0.719,0.8378
"8075",195474,"Siena College",1,0,2010,"26185","90.353589","199","634","768",410,358,539,"228",311,0.7585,0.6369,0.7018,0.8255
"8076",195526,"SKIDMORE COLLEGE",1,0,1991,"15991","56.238","171","538","652",392,260,401,"139",262,0.6684,0.5346,0.615,0.8252
"8077",195526,"SKIDMORE COLLEGE",1,0,1992,"16650","59.695","165","505","615",369,246,425,"144",281,0.7615,0.5854,0.6911,0.8211
"8078",195526,"SKIDMORE COLLEGE",1,0,1993,"17560","63.317","168","476","588",355,233,414,"153",261,0.7352,0.6567,0.7041,0.8095
"8079",195526,"SKIDMORE COLLEGE",1,0,1995,"19725","68.399","158","487","606",373,233,438,"152",286,0.7668,0.6524,0.7228,0.8036
"8080",195526,"SKIDMORE COLLEGE",1,0,1996,"20670","71.27","158","559","702",424,278,501,"196",305,0.7193,0.705,0.7137,0.7963
"8081",195526,"SKIDMORE COLLEGE",1,0,1997,"21750","66.011","173","485","605",372,233,452,"175",277,0.7446,0.7511,0.7471,0.8017
"8082",195526,"SKIDMORE COLLEGE",1,0,1998,"22853","68.054","198","471","596",366,230,482,"193",289,0.7896,0.8391,0.8087,0.7903
"8083",195526,"SKIDMORE COLLEGE",1,0,1999,"24000","73.362","211","485","642",367,275,470,"189",281,0.7657,0.6873,0.7321,0.7555
"8084",195526,"SKIDMORE COLLEGE",1,0,2000,"25190","76.108","203.5","433","599",345,254,461,"186",275,0.7971,0.7323,0.7696,0.7229
"8085",195526,"SKIDMORE COLLEGE",1,0,2001,"26400","78.549","196","430","598",352,246,469,"196",273,0.7756,0.7967,0.7843,0.7191
"8086",195526,"SKIDMORE COLLEGE",1,0,2002,"27700","87.017","192","443","634",383,251,494,"191",303,0.7911,0.761,0.7792,0.6987
"8087",195526,"SKIDMORE COLLEGE",1,0,2003,"29350","94.123","231","452","642",377,265,527,"208",319,0.8462,0.7849,0.8209,0.704
"8088",195526,"SKIDMORE COLLEGE",1,0,2004,"30800","91.677","237","490","676",383,293,539,"229",310,0.8094,0.7816,0.7973,0.7249
"8089",195526,"Skidmore College",1,0,2005,"32340","97.665","236","508","694",433,261,567,"202",365,0.843,0.7739,0.817,0.732
"8090",195526,"Skidmore College",1,0,2006,"34224","105.361","257","495","672",388,284,565,"231",334,0.8608,0.8134,0.8408,0.7366
"8091",195526,"Skidmore College",1,0,2007,"36126","116.889","248","470","682",406,276,564,"213",351,0.8645,0.7717,0.827,0.6891
"8092",195526,"Skidmore College",1,0,2008,"38114","127.472","258","484","652",400,252,552,"212",340,0.85,0.8413,0.8466,0.7423
"8093",195526,"Skidmore College",1,0,2009,"39600","124.735","248","494","663",414,249,549,"194",355,0.8575,0.7791,0.8281,0.7451
"8094",195526,"Skidmore College",1,0,2010,"40350","129.966","244","526","768",485,283,653,"225",428,0.8825,0.7951,0.8503,0.6849
"8095",195544,"SAINT JOSEPHS COLLEGE MAIN CAMPUS",1,0,1991,"6280","14.842","80","46","65",47,18,41,"9",32,0.6809,0.5,0.6308,0.7077
"8096",195544,"SAINT JOSEPHS COLLEGE MAIN CAMPUS",1,0,1992,"6700","17.146","80","36","55",42,13,32,"7",25,0.5952,0.5385,0.5818,0.6545
"8097",195544,"SAINT JOSEPHS COLLEGE-MAIN CAMPUS",1,0,1993,"7122","19.227","81","55","78",61,17,42,"10",32,0.5246,0.5882,0.5385,0.7051
"8098",195544,"SAINT JOSEPHS COLLEGE-MAIN CAMPUS",1,0,1995,"7818","25.393","87","62","84",64,20,56,"9",47,0.7344,0.45,0.6667,0.7381
"8099",195544,"SAINT JOSEPHS COLLEGE-MAIN CAMPUS",1,0,1996,"8116","25.194207","89","68","97",76,21,59,"8",51,0.6711,0.381,0.6082,0.701
"8100",195544,"SAINT JOSEPHS COLLEGE-MAIN CAMPUS",1,0,1997,"8428","22.926","92","73","107",74,33,60,"18",42,0.5676,0.5455,0.5607,0.6822
"8101",195544,"SAINT JOSEPHS COLLEGE-MAIN CAMPUS",1,0,1998,"8672","23.18","100","72","100",82,18,69,"9",60,0.7317,0.5,0.69,0.72
"8102",195544,"SAINT JOSEPHS COLLEGE-MAIN CAMPUS",1,0,1999,"8600","25.007","108","57","77",55,22,51,"8",43,0.7818,0.3636,0.6623,0.7403
"8103",195544,"SAINT JOSEPHS COLLEGE-MAIN CAMPUS",1,0,2000,"9030","28.257","113","66","98",80,18,67,"6",61,0.7625,0.3333,0.6837,0.6735
"8104",195544,"SAINT JOSEPHS COLLEGE-MAIN CAMPUS",1,0,2001,"9480","32.496","118","45","66",56,10,43,"4",39,0.6964,0.4,0.6515,0.6818
"8105",195544,"SAINT JOSEPHS COLLEGE-MAIN CAMPUS",1,0,2002,"10050","34.749","128","71","109",92,17,78,"11",67,0.7283,0.6471,0.7156,0.6514
"8106",195544,"SAINT JOSEPHS COLLEGE-MAIN CAMPUS",1,0,2003,"10550","38.442","130","67","96",80,16,67,"10",57,0.7125,0.625,0.6979,0.6979
"8107",195544,"SAINT JOSEPHS COLLEGE-MAIN CAMPUS",1,0,2004,"11078","43.212","138","418","593",420,173,311,"68",243,0.5786,0.3931,0.5245,0.7049
"8108",195544,"Saint Josephs College-Main Campus",1,0,2005,"11854","47.792","148","466","605",446,159,291,"57",234,0.5247,0.3585,0.481,0.7702
"8109",195544,"Saint Josephs College-Main Campus",1,0,2006,"12564","12.2","50","453","597",424,173,309,"68",241,0.5684,0.3931,0.5176,0.7588
"8110",195544,"Saint Josephs College-Main Campus",1,0,2007,"14000","13.36","48","502","672",474,198,373,"87",286,0.6034,0.4394,0.5551,0.747
"8111",195544,"Saint Josephs College-Main Campus",1,0,2008,"15400","14.415","50","462","613",420,193,326,"84",242,0.5762,0.4352,0.5318,0.7537
"8112",195544,"Saint Josephs College-Main Campus",1,0,2009,"16200","15.151","52","489","700",519,181,374,"73",301,0.58,0.4033,0.5343,0.6986
"8113",195544,"Saint Joseph's College-New York",1,0,2010,"17000","68.71","172","465","697",498,199,403,"102",301,0.6044,0.5126,0.5782,0.6671
"8114",195809,"SAINT JOHN'S UNIVERSITY NEW YORK",1,0,1991,"7530","147.205","934","1423","2483",1282,1201,612,"253",359,0.28,0.2107,0.2465,0.5731
"8115",195809,"SAINT JOHN'S UNIVERSITY NEW YORK",1,0,1992,"8230","184.347","610","1376","2326",1211,1115,526,"223",303,0.2502,0.2,0.2261,0.5916
"8116",195809,"SAINT JOHNS UNIVERSITY-NEW YORK",1,0,1993,"8980","188.35603","610","1371","2324",1174,1150,565,"223",342,0.2913,0.1939,0.2431,0.5899
"8117",195809,"SAINT JOHNS UNIVERSITY-NEW YORK",1,0,1995,"10450","212.386","582","1146","2206",1181,1025,629,"234",395,0.3345,0.2283,0.2851,0.5195
"8118",195809,"SAINT JOHNS UNIVERSITY-NEW YORK",1,0,1996,"11380","207.633653","553","1105","2157",1146,1011,629,"229",400,0.349,0.2265,0.2916,0.5123
"8119",195809,"SAINT JOHNS UNIVERSITY-NEW YORK",1,0,1997,"12230","186.338842","548","1135","2480",1358,1122,789,"311",478,0.352,0.2772,0.3181,0.4577
"8120",195809,"SAINT JOHNS UNIVERSITY-NEW YORK",1,0,1998,"13630","200.679921","540","1157","2504",1417,1087,886,"318",568,0.4008,0.2925,0.3538,0.4621
"8121",195809,"SAINT JOHNS UNIVERSITY-NEW YORK",1,0,1999,"13990","203.843594","538","1087","2650",1500,1150,954,"357",597,0.398,0.3104,0.36,0.4102
"8122",195809,"ST JOHN'S UNIVERSITY-NEW YORK",1,0,2000,"15500","224.582488","539","1187","2853",1619,1234,997,"387",610,0.3768,0.3136,0.3495,0.4161
"8123",195809,"ST JOHN'S UNIVERSITY-NEW YORK",1,0,2001,"16900","249.237345","540","1103","2670",1523,1147,957,"357",600,0.394,0.3112,0.3584,0.4131
"8124",195809,"ST JOHN'S UNIVERSITY-NEW YORK",1,0,2002,"17850","273.409197","550","1167","2954",1736,1218,1001,"347",654,0.3767,0.2849,0.3389,0.3951
"8125",195809,"ST JOHN'S UNIVERSITY-NEW YORK",1,0,2003,"19600","285.298169","563","1265","2966",1749,1217,1058,"381",677,0.3871,0.3131,0.3567,0.4265
"8126",195809,"ST JOHN'S UNIVERSITY-NEW YORK",1,0,2004,"21150","301.519775","579","1112","2996",1696,1300,1035,"384",651,0.3838,0.2954,0.3455,0.3712
"8127",195809,"St. John's University-New York",1,0,2005,"22800","326.112793","597","1133","3153",1742,1411,1098,"435",663,0.3806,0.3083,0.3482,0.3593
"8128",195809,"St. John's University-New York",1,0,2006,"24400","345.781924","620","1158","3260",1713,1547,1198,"494",704,0.411,0.3193,0.3675,0.3552
"8129",195809,"St. John's University-New York",1,0,2007,"26200","365.76538","655","1120","3151",1689,1462,1121,"455",666,0.3943,0.3112,0.3558,0.3554
"8130",195809,"St. John's University-New York",1,0,2008,"28100","398.710255","671","1116","3258",1737,1521,1294,"521",773,0.445,0.3425,0.3972,0.3425
"8131",195809,"St. John's University-New York",1,0,2009,"29350","427.513331","668","1119","3101",1651,1450,1245,"534",711,0.4306,0.3683,0.4015,0.3609
"8132",195809,"St John's University-New York",1,0,2010,"31250","464.699698","628","1028","3105",1626,1479,1117,"500",617,0.3795,0.3381,0.3597,0.3311
"8133",196413,"SYRACUSE UNIVERSITY MAIN CAMPUS",1,0,1991,"12957","382.306","928","1697","2513",1294,1219,1388,"596",792,0.6121,0.4889,0.5523,0.6753
"8134",196413,"SYRACUSE UNIVERSITY MAIN CAMPUS",1,0,1992,"13811","377.017","896","1879","2581",1329,1252,1465,"628",837,0.6298,0.5016,0.5676,0.728
"8135",196413,"SYRACUSE UNIVERSITY-MAIN CAMPUS",1,0,1993,"14707","391.254","891","1707","2418",1270,1148,1386,"590",796,0.6268,0.5139,0.5732,0.706
"8136",196413,"SYRACUSE UNIVERSITY",1,0,1995,"16280","412.096","817","1699","2392",1259,1133,1467,"631",836,0.664,0.5569,0.6133,0.7103
"8137",196413,"SYRACUSE UNIVERSITY",1,0,1996,"17092","430.548066","807","1959","2652",1429,1223,1722,"735",987,0.6907,0.601,0.6493,0.7387
"8138",196413,"SYRACUSE UNIVERSITY",1,0,1997,"17950","357.006312","807","1864","2562",1417,1145,1773,"713",1060,0.7481,0.6227,0.692,0.7276
"8139",196413,"SYRACUSE UNIVERSITY",1,0,1998,"18850","372.694419","805","1799","2566",1383,1183,1689,"702",987,0.7137,0.5934,0.6582,0.7011
"8140",196413,"SYRACUSE UNIVERSITY",1,0,1999,"19360","399.748878","822","1991","2724",1534,1190,1841,"748",1093,0.7125,0.6286,0.6758,0.7309
"8141",196413,"SYRACUSE UNIVERSITY",1,0,2000,"20380","413.927395","827","2126","2791",1569,1222,1981,"805",1176,0.7495,0.6588,0.7098,0.7617
"8142",196413,"SYRACUSE UNIVERSITY",1,0,2001,"21500","454.474352","832","1850","2601",1493,1108,1837,"716",1121,0.7508,0.6462,0.7063,0.7113
"8143",196413,"SYRACUSE UNIVERSITY",1,0,2002,"22800","471.817948","859","1987","2894",1676,1218,2021,"793",1228,0.7327,0.6511,0.6983,0.6866
"8144",196413,"SYRACUSE UNIVERSITY",1,0,2003,"24170","517.539464","864","1926","2628",1501,1127,1914,"755",1159,0.7722,0.6699,0.7283,0.7329
"8145",196413,"SYRACUSE UNIVERSITY",1,0,2004,"25720","534.830611","879","1920","2662",1505,1157,1907,"766",1141,0.7581,0.6621,0.7164,0.7213
"8146",196413,"Syracuse University",1,0,2005,"27210","569.202965","891","2000","3243",1849,1394,2261,"903",1358,0.7345,0.6478,0.6972,0.6167
"8147",196413,"Syracuse University",1,0,2006,"28820","610.026774","906","1919","3045",1686,1359,2099,"839",1260,0.7473,0.6174,0.6893,0.6302
"8148",196413,"Syracuse University",1,0,2007,"30470","634.982371","913","1863","3092",1756,1336,2119,"846",1273,0.7249,0.6332,0.6853,0.6025
"8149",196413,"Syracuse University",1,0,2008,"32180","683.620756","947","1634","3161",1853,1308,2173,"846",1327,0.7161,0.6468,0.6874,0.5169
"8150",196413,"Syracuse University",1,0,2009,"33630","716.381803","955","1843","3240",1868,1372,2215,"854",1361,0.7286,0.6224,0.6836,0.5688
"8151",196413,"Syracuse University",1,0,2010,"34970","743.213766","982","2085","3452",1929,1523,2379,"962",1417,0.7346,0.6316,0.6892,0.604
"8152",196592,"TOURO COLLEGE",1,0,1991,"6650","58.764","202","0","503",330,173,37,"15",22,0.0667,0.0867,0.0736,0
"8153",196592,"TOURO COLLEGE",1,0,1992,"7030","98.781","232","801","1037",676,361,63,"14",49,0.0725,0.0388,0.0608,0.7724
"8154",196592,"TOURO COLLEGE",1,0,1993,"7130","103.794","253","982","1236",815,421,70,"6",64,0.0785,0.0143,0.0566,0.7945
"8155",196592,"TOURO COLLEGE",1,0,1995,"8700","107.376","223","1445","1899",1266,633,136,"70",66,0.0521,0.1106,0.0716,0.7609
"8156",196592,"TOURO COLLEGE",1,0,1996,"8700","103.468775","219","1633","2337",1646,691,73,"40",33,0.02,0.0579,0.0312,0.6988
"8157",196592,"TOURO COLLEGE",1,0,1997,"8750","59.240234","262","1348","2028",1457,571,85,"27",58,0.0398,0.0473,0.0419,0.6647
"8158",196592,"TOURO COLLEGE",1,0,1998,"8850","66.750936","264","1005","1651",1155,496,221,"65",156,0.1351,0.131,0.1339,0.6087
"8159",196592,"TOURO COLLEGE",1,0,1999,"9250","75.080045","273","1230","1756",1210,546,152,"50",102,0.0843,0.0916,0.0866,0.7005
"8160",196592,"TOURO COLLEGE",1,0,2000,"9750","79.260904","268.5","790","1272",919,353,121,"46",75,0.0816,0.1303,0.0951,0.6211
"8161",196592,"TOURO COLLEGE",1,0,2001,"9950","83.572132","264","968","1520",1064,456,146,"42",104,0.0977,0.0921,0.0961,0.6368
"8162",196592,"TOURO COLLEGE",1,0,2002,"9900","96.970423","282","922","1877",1306,571,159,"40",119,0.0911,0.0701,0.0847,0.4912
"8163",196592,"TOURO COLLEGE",1,0,2003,"9900","107.888011","275","936","1967",1343,624,247,"74",173,0.1288,0.1186,0.1256,0.4759
"8164",196592,"TOURO COLLEGE",1,0,2004,"10200","126.665","392","977","1863",1278,585,246,"86",160,0.1252,0.147,0.132,0.5244
"8165",196592,"Touro College",1,0,2005,"10900","150.077","375","956","1839",1261,578,40,"13",27,0.0214,0.0225,0.0218,0.5198
"8166",196592,"Touro College",1,0,2006,"11800","169.556","497","474","1479",988,491,60,"25",35,0.0354,0.0509,0.0406,0.3205
"8167",196592,"Touro College",1,0,2007,"12300","192.127","474","352","848",545,303,80,"22",58,0.1064,0.0726,0.0943,0.4151
"8168",196592,"Touro College",1,0,2008,"12800","235.184","527","375","790",486,304,69,"27",42,0.0864,0.0888,0.0873,0.4747
"8169",196592,"Touro College",1,0,2009,"13300","259.059","593","356","867",555,312,58,"7",51,0.0919,0.0224,0.0669,0.4106
"8170",196592,"Touro College",1,0,2010,"13700","198.488","506","592","1030",668,362,152,"21",131,0.1961,0.058,0.1476,0.5748
"8171",197045,"UTICA COLLEGE OF SYRACUSE UNIVERSITY",1,0,1991,"10536","23.271","111","258","328",169,159,96,"42",54,0.3195,0.2642,0.2927,0.7866
"8172",197045,"UTICA COLLEGE OF SYRACUSE UNIVERSITY",1,0,1992,"11230","27.096","111","250","323",183,140,90,"37",53,0.2896,0.2643,0.2786,0.774
"8173",197045,"UTICA COLLEGE OF SYRACUSE UNIVERSITY",1,0,1993,"11980","28.334","105","214","256",140,116,84,"35",49,0.35,0.3017,0.3281,0.8359
"8174",197045,"UTICA COLLEGE OF SYRACUSE UNIVERSITY",1,0,1995,"13406","29.187","99","184","255",162,93,100,"27",73,0.4506,0.2903,0.3922,0.7216
"8175",197045,"UTICA COLLEGE OF SYRACUSE UNIVERSITY",1,0,1996,"14206","28.142921","96","222","338",223,115,126,"34",92,0.4126,0.2957,0.3728,0.6568
"8176",197045,"UTICA COLLEGE OF SYRACUSE UNIVERSITY",1,0,1997,"14912","20.99355","98","232","320",216,104,130,"44",86,0.3981,0.4231,0.4062,0.725
"8177",197045,"UTICA COLLEGE OF SYRACUSE UNIVERSITY",1,0,1998,"15654","22.143433","96","189","306",203,103,107,"31",76,0.3744,0.301,0.3497,0.6176
"8178",197045,"UTICA COLLEGE OF SYRACUSE UNIVERSITY",1,0,1999,"16150","23.050994","100","240","365",221,144,158,"49",109,0.4932,0.3403,0.4329,0.6575
"8179",197045,"UTICA COLLEGE OF SYRACUSE UNIVERSITY",1,0,2000,"16844","26.041984","102","287","445",260,185,139,"41",98,0.3769,0.2216,0.3124,0.6449
"8180",197045,"UTICA COLLEGE OF SYRACUSE UNIVERSITY",1,0,2001,"17790","28.10146","104","333","475",218,257,154,"76",78,0.3578,0.2957,0.3242,0.7011
"8181",197045,"UTICA COLLEGE",1,0,2002,"18848","31.477461","102","327","451",226,225,180,"73",107,0.4735,0.3244,0.3991,0.7251
"8182",197045,"UTICA COLLEGE",1,0,2003,"19980","34.869303","107","256","447",254,193,169,"70",99,0.3898,0.3627,0.3781,0.5727
"8183",197045,"UTICA COLLEGE",1,0,2004,"20980","38.944107","108","310","484",248,236,143,"68",75,0.3024,0.2881,0.2955,0.6405
"8184",197045,"Utica College",1,0,2005,"22030","43.199889","119","276","468",264,204,139,"52",87,0.3295,0.2549,0.297,0.5897
"8185",197045,"Utica College",1,0,2006,"23130","48.075161","123","270","495",277,218,164,"62",102,0.3682,0.2844,0.3313,0.5455
"8186",197045,"Utica College",1,0,2007,"24264","49.423452","120","316","492",265,227,146,"60",86,0.3245,0.2643,0.2967,0.6423
"8187",197045,"Utica College",1,0,2008,"25538","54.249221","126","354","568",254,314,171,"82",89,0.3504,0.2611,0.3011,0.6232
"8188",197045,"Utica College",1,0,2009,"27764","55.722917","131","351","559",271,288,161,"76",85,0.3137,0.2639,0.288,0.6279
"8189",197045,"Utica College",1,0,2010,"28100","58.80589","136","376","564",281,283,190,"83",107,0.3808,0.2933,0.3369,0.6667
"8190",197133,"VASSAR COLLEGE",1,0,1991,"16510","74.446","209","454","592",364,228,460,"167",293,0.8049,0.7325,0.777,0.7669
"8191",197133,"VASSAR COLLEGE",1,0,1992,"17620","81.355","218","458","597",370,227,478,"175",303,0.8189,0.7709,0.8007,0.7672
"8192",197133,"VASSAR COLLEGE",1,0,1993,"18456","86.325","218","490","649",414,235,497,"169",328,0.7923,0.7191,0.7658,0.755
"8193",197133,"VASSAR COLLEGE",1,0,1995,"20420","89.348","215","511","632",381,251,509,"193",316,0.8294,0.7689,0.8054,0.8085
"8194",197133,"VASSAR COLLEGE",1,0,1996,"21330","98.630304","215","466","614",375,239,499,"191",308,0.8213,0.7992,0.8127,0.759
"8195",197133,"VASSAR COLLEGE",1,0,1997,"22090","95.657431","215","482","646",409,237,529,"186",343,0.8386,0.7848,0.8189,0.7461
"8196",197133,"VASSAR COLLEGE",1,0,1998,"23000","99.379919","215","470","626",379,247,504,"191",313,0.8259,0.7733,0.8051,0.7508
"8197",197133,"VASSAR COLLEGE",1,0,1999,"23700","105.48156","247","478","633",381,252,543,"209",334,0.8766,0.8294,0.8578,0.7551
"8198",197133,"VASSAR COLLEGE",1,0,2000,"24610","110.30251","246.5","484","639",389,250,544,"211",333,0.856,0.844,0.8513,0.7574
"8199",197133,"VASSAR COLLEGE",1,0,2001,"25890","99.790888","246","508","695",447,248,612,"211",401,0.8971,0.8508,0.8806,0.7309
"8200",197133,"VASSAR COLLEGE",1,0,2002,"27550","108.91771","258","473","632",377,255,552,"217",335,0.8886,0.851,0.8734,0.7484
"8201",197133,"VASSAR COLLEGE",1,0,2003,"29095","114.973414","253","478","631",367,264,554,"226",328,0.8937,0.8561,0.878,0.7575
"8202",197133,"VASSAR COLLEGE",1,0,2004,"30895","123.709649","267","466","654",419,235,586,"198",388,0.926,0.8426,0.896,0.7125
"8203",197133,"Vassar College",1,0,2005,"33310","133.826456","277","482","647",374,273,572,"238",334,0.893,0.8718,0.8841,0.745
"8204",197133,"Vassar College",1,0,2006,"35520","138.459928","281","488","668",412,256,534,"173",361,0.8762,0.6758,0.7994,0.7305
"8205",197133,"Vassar College",1,0,2007,"37570","149.081067","293","467","677",409,268,607,"233",374,0.9144,0.8694,0.8966,0.6898
"8206",197133,"Vassar College",1,0,2008,"39635","155.662273","299","444","638",365,273,560,"235",325,0.8904,0.8608,0.8777,0.6959
"8207",197133,"Vassar College",1,0,2009,"41335","163.957231","296","430","658",392,266,568,"217",351,0.8954,0.8158,0.8632,0.6535
"8208",197133,"Vassar College",1,0,2010,"42560","164.403958","279","419","665",382,283,576,"242",334,0.8743,0.8551,0.8662,0.6301
"8209",197869,"APPALACHIAN STATE UNIVERSITY",1,0,1991,"1166","115.226141","533","1780","1916",1025,891,562,"185",377,0.3678,0.2076,0.2933,0.929
"8210",197869,"APPALACHIAN STATE UNIVERSITY",1,0,1992,"1264","122.585066","539","1944","2060",1146,914,621,"215",406,0.3543,0.2352,0.3015,0.9437
"8211",197869,"APPALACHIAN STATE UNIVERSITY",1,0,1993,"1459","127.711344","545","1809","1931",1098,833,603,"192",411,0.3743,0.2305,0.3123,0.9368
"8212",197869,"APPALACHIAN STATE UNIVERSITY",1,0,1995,"1627","142.694988","572","2082","2205",1198,1007,749,"273",476,0.3973,0.2711,0.3397,0.9442
"8213",197869,"APPALACHIAN STATE UNIVERSITY",1,0,1996,"1663","153.713287","583","1920","2026",1111,915,689,"226",463,0.4167,0.247,0.3401,0.9477
"8214",197869,"APPALACHIAN STATE UNIVERSITY",1,0,1997,"1703","154.836945","574","2029","2161",1177,984,711,"235",476,0.4044,0.2388,0.329,0.9389
"8215",197869,"APPALACHIAN STATE UNIVERSITY",1,0,1998,"1753","172.892778","581","2184","2312",1192,1120,687,"239",448,0.3758,0.2134,0.2971,0.9446
"8216",197869,"APPALACHIAN STATE UNIVERSITY",1,0,1999,"962","184.212974","592","2059","2199",1186,1013,778,"266",512,0.4317,0.2626,0.3538,0.9363
"8217",197869,"APPALACHIAN STATE UNIVERSITY",1,0,2000,"982","191.685996","612.5","2380","2544",1370,1174,872,"285",587,0.4285,0.2428,0.3428,0.9355
"8218",197869,"APPALACHIAN STATE UNIVERSITY",1,0,2001,"1222","212.26451","633","2181","2303",1196,1107,857,"309",548,0.4582,0.2791,0.3721,0.947
"8219",197869,"APPALACHIAN STATE UNIVERSITY",1,0,2002,"1520","198.652044","619","2165","2412",1261,1151,964,"385",579,0.4592,0.3345,0.3997,0.8976
"8220",197869,"APPALACHIAN STATE UNIVERSITY",1,0,2003,"1596","209.909328","663","2219","2462",1216,1246,920,"360",560,0.4605,0.2889,0.3737,0.9013
"8221",197869,"APPALACHIAN STATE UNIVERSITY",1,0,2004,"1821","217.531011","674","2229","2507",1247,1260,941,"357",584,0.4683,0.2833,0.3753,0.8891
"8222",197869,"Appalachian State University",1,0,2005,"1821","229.622134","703","2308","2536",1265,1271,974,"391",583,0.4609,0.3076,0.3841,0.9101
"8223",197869,"Appalachian State University",1,0,2006,"2221","254.82784","710","2369","2707",1403,1304,1080,"402",678,0.4833,0.3083,0.399,0.8751
"8224",197869,"Appalachian State University",1,0,2007,"2221","278.025184","737","2347","2730",1401,1329,1133,"431",702,0.5011,0.3243,0.415,0.8597
"8225",197869,"Appalachian State University",1,0,2008,"2263","308.872354","779","2403","2768",1415,1353,1221,"462",759,0.5364,0.3415,0.4411,0.8681
"8226",197869,"Appalachian State University",1,0,2009,"2341","317.606233","824","2437","2732",1471,1261,1267,"464",803,0.5459,0.368,0.4638,0.892
"8227",197869,"Appalachian State University",1,0,2010,"2961","337.57788","862","2434","2816",1538,1278,1387,"500",887,0.5767,0.3912,0.4925,0.8643
"8228",197984,"BELMONT ABBEY COLLEGE",1,0,1991,"7470","11.460826","51","141","174",92,82,56,"21",35,0.3804,0.2561,0.3218,0.8103
"8229",197984,"BELMONT ABBEY COLLEGE",1,0,1992,"7974","11.171813","49","122","145",67,78,42,"22",20,0.2985,0.2821,0.2897,0.8414
"8230",197984,"BELMONT ABBEY COLLEGE",1,0,1993,"8684","12.003017","46","120","136",69,67,44,"20",24,0.3478,0.2985,0.3235,0.8824
"8231",197984,"BELMONT ABBEY COLLEGE",1,0,1995,"9818","11.550027","41","98","114",45,69,47,"26",21,0.4667,0.3768,0.4123,0.8596
"8232",197984,"BELMONT ABBEY COLLEGE",1,0,1996,"10408","11.703736","36","156","181",93,88,62,"30",32,0.3441,0.3409,0.3425,0.8619
"8233",197984,"BELMONT ABBEY COLLEGE",1,0,1997,"11034","9.461328","36","133","159",68,91,61,"27",34,0.5,0.2967,0.3836,0.8365
"8234",197984,"BELMONT ABBEY COLLEGE",1,0,1998,"11640","13.564159","38","179","198",94,104,87,"41",46,0.4894,0.3942,0.4394,0.904
"8235",197984,"BELMONT ABBEY COLLEGE",1,0,1999,"11650","14.633627","40","163","195",90,105,57,"27",30,0.3333,0.2571,0.2923,0.8359
"8236",197984,"BELMONT ABBEY COLLEGE",1,0,2000,"12116","15.549141","41.5","162","188",113,75,63,"22",41,0.3628,0.2933,0.3351,0.8617
"8237",197984,"BELMONT ABBEY COLLEGE",1,0,2001,"12722","16.727383","43","113","143",68,75,61,"22",39,0.5735,0.2933,0.4266,0.7902
"8238",197984,"BELMONT ABBEY COLLEGE",1,0,2002,"13358","17.403576","43","137","223",136,87,64,"20",44,0.3235,0.2299,0.287,0.6143
"8239",197984,"BELMONT ABBEY COLLEGE",1,0,2003,"14160","18.04651","43","110","147",70,77,48,"25",23,0.3286,0.3247,0.3265,0.7483
"8240",197984,"BELMONT ABBEY COLLEGE",1,0,2004,"15010","17.145778","40","123","174",96,78,47,"20",27,0.2812,0.2564,0.2701,0.7069
"8241",197984,"Belmont Abbey College",1,0,2005,"15910","18.502063","48","154","224",109,115,75,"23",52,0.4771,0.2,0.3348,0.6875
"8242",197984,"Belmont Abbey College",1,0,2006,"16870","18.231243","53","198","279",142,137,94,"34",60,0.4225,0.2482,0.3369,0.7097
"8243",197984,"Belmont Abbey College",1,0,2007,"17880","19.988701","54","144","210",90,120,69,"28",41,0.4556,0.2333,0.3286,0.6857
"8244",197984,"Belmont Abbey College",1,0,2008,"19114","21.007087","59","184","286",134,152,93,"39",54,0.403,0.2566,0.3252,0.6434
"8245",197984,"Belmont Abbey College",1,0,2009,"20356","23.67045","69","211","396",224,172,138,"50",88,0.3929,0.2907,0.3485,0.5328
"8246",197984,"Belmont Abbey College",1,0,2010,"23183","24.039767","72","21","307",139,168,103,"53",50,0.3597,0.3155,0.3355,0.0684
"8247",198385,"DAVIDSON COLLEGE",1,0,1991,"14058","40.727735","126","352","397",179,218,339,"178",161,0.8994,0.8165,0.8539,0.8866
"8248",198385,"DAVIDSON COLLEGE",1,0,1992,"14950","44.513862","126","375","414",221,193,367,"170",197,0.8914,0.8808,0.8865,0.9058
"8249",198385,"DAVIDSON COLLEGE",1,0,1993,"16263","48.240561","130","383","452",195,257,381,"212",169,0.8667,0.8249,0.8429,0.8473
"8250",198385,"DAVIDSON COLLEGE",1,0,1995,"18626","54.756557","137","373","429",209,220,373,"186",187,0.8947,0.8455,0.8695,0.8695
"8251",198385,"DAVIDSON COLLEGE",1,0,1996,"19631","56.970449","137","399","439",230,209,385,"181",204,0.887,0.866,0.877,0.9089
"8252",198385,"DAVIDSON COLLEGE",1,0,1997,"20595","49.321087","147","407","470",230,240,417,"206",211,0.9174,0.8583,0.8872,0.866
"8253",198385,"DAVIDSON COLLEGE",1,0,1998,"21395","51.223707","145","405","472",253,219,423,"198",225,0.8893,0.9041,0.8962,0.8581
"8254",198385,"DAVIDSON COLLEGE",1,0,1999,"22014","57.42596","152","394","456",226,230,380,"187",193,0.854,0.813,0.8333,0.864
"8255",198385,"DAVIDSON COLLEGE",1,0,2000,"22872","62.358784","153","407","465",229,236,413,"193",220,0.9607,0.8178,0.8882,0.8753
"8256",198385,"DAVIDSON COLLEGE",1,0,2001,"23739","67.897975","154","369","465",246,219,420,"193",227,0.9228,0.8813,0.9032,0.7935
"8257",198385,"DAVIDSON COLLEGE",1,0,2002,"24930","72.023737","159","382","468",243,225,430,"201",229,0.9424,0.8933,0.9188,0.8162
"8258",198385,"DAVIDSON COLLEGE",1,0,2003,"24987","75.904845","159","385","489",237,252,435,"218",217,0.9156,0.8651,0.8896,0.7873
"8259",198385,"DAVIDSON COLLEGE",1,0,2004,"26211","76.822029","158","345","462",238,224,410,"192",218,0.916,0.8571,0.8874,0.7468
"8260",198385,"Davidson College",1,0,2005,"27653","82.384817","158","358","459",234,225,400,"182",218,0.9316,0.8089,0.8715,0.78
"8261",198385,"Davidson College",1,0,2006,"29119","82.996372","162","340","461",233,228,410,"197",213,0.9142,0.864,0.8894,0.7375
"8262",198385,"Davidson College",1,0,2007,"30662","89.711974","167","346","464",234,230,417,"198",219,0.9359,0.8609,0.8987,0.7457
"8263",198385,"Davidson College",1,0,2008,"33148","91.721726","168","345","480",250,230,436,"209",227,0.908,0.9087,0.9083,0.7188
"8264",198385,"Davidson College",1,0,2009,"34776","93.774858","164","365","487",252,235,438,"207",231,0.9167,0.8809,0.8994,0.7495
"8265",198385,"Davidson College",1,0,2010,"36320","90.91657","166","344","499",246,253,452,"223",229,0.9309,0.8814,0.9058,0.6894
"8266",198464,"EAST CAROLINA UNIVERSITY",1,0,1991,"1204","225.204867","741","2025","2338",1288,1050,386,"124",262,0.2034,0.1181,0.1651,0.8661
"8267",198464,"EAST CAROLINA UNIVERSITY",1,0,1992,"1246","245.591802","791","2552","2880",1673,1207,561,"166",395,0.2361,0.1375,0.1948,0.8861
"8268",198464,"EAST CAROLINA UNIVERSITY",1,0,1993,"1366","272.241795","792","2106","2428",1417,1011,558,"151",407,0.2872,0.1494,0.2298,0.8674
"8269",198464,"EAST CAROLINA UNIVERSITY",1,0,1995,"1673","289.129262","804","2263","2635",1550,1085,630,"189",441,0.2845,0.1742,0.2391,0.8588
"8270",198464,"EAST CAROLINA UNIVERSITY",1,0,1996,"1752","292.550208","804","2208","2626",1581,1045,673,"216",457,0.2891,0.2067,0.2563,0.8408
"8271",198464,"EAST CAROLINA UNIVERSITY",1,0,1997,"1832","315.663244","808","2411","2871",1718,1153,705,"222",483,0.2811,0.1925,0.2456,0.8398
"8272",198464,"EAST CAROLINA UNIVERSITY",1,0,1998,"1886","344.24723","808","2288","2803",1714,1089,720,"196",524,0.3057,0.18,0.2569,0.8163
"8273",198464,"EAST CAROLINA UNIVERSITY",1,0,1999,"992","366.997754","827","2600","3255",1931,1324,822,"266",556,0.2879,0.2009,0.2525,0.7988
"8274",198464,"EAST CAROLINA UNIVERSITY",1,0,2000,"1195","386.714191","791","2533","3105",1837,1268,856,"248",608,0.331,0.1956,0.2757,0.8158
"8275",198464,"EAST CAROLINA UNIVERSITY",1,0,2001,"1453","421.525847","755","2576","3182",1877,1305,813,"242",571,0.3042,0.1854,0.2555,0.8096
"8276",198464,"EAST CAROLINA UNIVERSITY",1,0,2002,"1819","411.394191","791","2973","3561",2117,1444,968,"294",674,0.3184,0.2036,0.2718,0.8349
"8277",198464,"EAST CAROLINA UNIVERSITY",1,0,2003,"1910","426.72762","886","2811","3458",2117,1341,1035,"293",742,0.3505,0.2185,0.2993,0.8129
"8278",198464,"EAST CAROLINA UNIVERSITY",1,0,2004,"2135","476.668385","932","2746","3451",2143,1308,1009,"294",715,0.3336,0.2248,0.2924,0.7957
"8279",198464,"East Carolina University",1,0,2005,"2135","526.722495","961","2505","3220",1973,1247,1048,"345",703,0.3563,0.2767,0.3255,0.778
"8280",198464,"East Carolina University",1,0,2006,"2335","575.311906","1033","2820","3784",2331,1453,1240,"347",893,0.3831,0.2388,0.3277,0.7452
"8281",198464,"East Carolina University",1,0,2007,"2431","631.349386","1058","3123","4195",2535,1660,1294,"391",903,0.3562,0.2355,0.3085,0.7445
"8282",198464,"East Carolina University",1,0,2008,"2445","658.46538","1280","3483","4515",2608,1907,1468,"483",985,0.3777,0.2533,0.3251,0.7714
"8283",198464,"East Carolina University",1,0,2009,"2491","704.06687","1234","3021","3942",2273,1669,1397,"445",952,0.4188,0.2666,0.3544,0.7664
"8284",198464,"East Carolina University",1,0,2010,"2881","728.230354","1246","2984","4196",2446,1750,1417,"448",969,0.3962,0.256,0.3377,0.7112
"8285",198507,"ELIZABETH CITY STATE UNIVERSITY",1,0,1991,"1150","24.497328","103","49","402",217,185,135,"48",87,0.4009,0.2595,0.3358,0.1219
"8286",198507,"ELIZABETH CITY STATE UNIVERSITY",1,0,1992,"1184","28.220777","105","72","541",317,224,181,"47",134,0.4227,0.2098,0.3346,0.1331
"8287",198507,"ELIZABETH CITY STATE UNIVERSITY",1,0,1993,"1242","31.129007","105","93","460",273,187,164,"47",117,0.4286,0.2513,0.3565,0.2022
"8288",198507,"ELIZABETH CITY STATE UNIVERSITY",1,0,1995,"1410","34.584354","109","49","381",222,159,162,"47",115,0.518,0.2956,0.4252,0.1286
"8289",198507,"ELIZABETH CITY STATE UNIVERSITY",1,0,1996,"1468","37.076434","108","66","380",205,175,130,"44",86,0.4195,0.2514,0.3421,0.1737
"8290",198507,"ELIZABETH CITY STATE UNIVERSITY",1,0,1997,"1522","38.836281","86","70","424",251,173,133,"33",100,0.3984,0.1908,0.3137,0.1651
"8291",198507,"ELIZABETH CITY STATE UNIVERSITY",1,0,1998,"1572","39.976108","98","51","378",229,149,109,"22",87,0.3799,0.1477,0.2884,0.1349
"8292",198507,"ELIZABETH CITY STATE UNIVERSITY",1,0,1999,"806","39.626719","109","71","402",247,155,109,"22",87,0.3522,0.1419,0.2711,0.1766
"8293",198507,"ELIZABETH CITY STATE UNIVERSITY",1,0,2000,"822","41.201019","105.5","51","441",248,193,133,"32",101,0.4073,0.1658,0.3016,0.1156
"8294",198507,"ELIZABETH CITY STATE UNIVERSITY",1,0,2001,"896","42.6369","102","49","363",200,163,102,"32",70,0.35,0.1963,0.281,0.135
"8295",198507,"ELIZABETH CITY STATE UNIVERSITY",1,0,2002,"1118","40.697191","122","60","458",270,188,108,"16",92,0.3407,0.0851,0.2358,0.131
"8296",198507,"ELIZABETH CITY STATE UNIVERSITY",1,0,2003,"1174","45.929229","133","73","459",258,201,104,"36",68,0.2636,0.1791,0.2266,0.159
"8297",198507,"ELIZABETH CITY STATE UNIVERSITY",1,0,2004,"1399","46.288376","131","78","554",295,259,107,"30",77,0.261,0.1158,0.1931,0.1408
"8298",198507,"Elizabeth City State University",1,0,2005,"1399","50.75924","128","66","556",328,228,99,"28",71,0.2165,0.1228,0.1781,0.1187
"8299",198507,"Elizabeth City State University",1,0,2006,"1490","59.044607","149","49","534",313,221,90,"20",70,0.2236,0.0905,0.1685,0.0918
"8300",198507,"Elizabeth City State University",1,0,2007,"1587","64.960364","175","49","642",391,251,138,"39",99,0.2532,0.1554,0.215,0.0763
"8301",198507,"Elizabeth City State University",1,0,2008,"1611","73.353102","161","41","636",368,268,95,"25",70,0.1902,0.0933,0.1494,0.0645
"8302",198507,"Elizabeth City State University",1,0,2009,"1681","76.600139","165","70","659",375,284,106,"35",71,0.1893,0.1232,0.1608,0.1062
"8303",198507,"Elizabeth City State University",1,0,2010,"2204","76.956426","170","45","573",319,254,94,"31",63,0.1975,0.122,0.164,0.0785
"8304",198516,"ELON COLLEGE",1,0,1991,"7520","31.344142","134","729","780",461,319,381,"121",260,0.564,0.3793,0.4885,0.9346
"8305",198516,"ELON COLLEGE",1,0,1992,"8110","29.83544","136","742","817",470,347,455,"175",280,0.5957,0.5043,0.5569,0.9082
"8306",198516,"ELON COLLEGE",1,0,1993,"8630","35.080115","138","787","857",492,365,478,"197",281,0.5711,0.5397,0.5578,0.9183
"8307",198516,"ELON COLLEGE",1,0,1995,"9910","42.494165","148","827","907",545,362,548,"198",350,0.6422,0.547,0.6042,0.9118
"8308",198516,"ELON COLLEGE",1,0,1996,"10667","45.08607","151","851","941",569,372,551,"204",347,0.6098,0.5484,0.5855,0.9044
"8309",198516,"ELON COLLEGE",1,0,1997,"11542","39.357973","158","860","964",584,380,599,"207",392,0.6712,0.5447,0.6214,0.8921
"8310",198516,"ELON COLLEGE",1,0,1998,"12147","45.518109","175","894","1013",632,381,660,"234",426,0.6741,0.6142,0.6515,0.8825
"8311",198516,"ELON COLLEGE",1,0,1999,"12671","49.804075","192","885","999",637,362,701,"232",469,0.7363,0.6409,0.7017,0.8859
"8312",198516,"ELON COLLEGE",1,0,2000,"13556","55.93619","201","1034","1144",718,426,744,"244",500,0.6964,0.5728,0.6503,0.9038
"8313",198516,"ELON UNIVERSITY",1,0,2001,"14335","63.794254","210","1058","1212",757,455,797,"263",534,0.7054,0.578,0.6576,0.8729
"8314",198516,"ELON UNIVERSITY",1,0,2002,"15280","70.851898","235","1054","1192",736,456,856,"308",548,0.7446,0.6754,0.7181,0.8842
"8315",198516,"ELON UNIVERSITY",1,0,2003,"16325","78.478277","252","1083","1227",775,452,875,"294",581,0.7497,0.6504,0.7131,0.8826
"8316",198516,"ELON UNIVERSITY",1,0,2004,"17310","83.913654","261","1038","1230",775,455,918,"319",599,0.7729,0.7011,0.7463,0.8439
"8317",198516,"Elon University",1,0,2005,"18699","90.303254","279","1060","1237",748,489,959,"370",589,0.7874,0.7566,0.7753,0.8569
"8318",198516,"Elon University",1,0,2006,"20171","100.339646","291","1064","1283",740,543,991,"378",613,0.8284,0.6961,0.7724,0.8293
"8319",198516,"Elon University",1,0,2007,"21886","115.642833","311","1055","1286",746,540,987,"380",607,0.8137,0.7037,0.7675,0.8204
"8320",198516,"Elon University",1,0,2008,"23746","129.576324","333","983","1290",777,513,977,"358",619,0.7967,0.6979,0.7574,0.762
"8321",198516,"Elon University",1,0,2009,"25159","141.121837","343","1065","1290",774,516,1025,"374",651,0.8411,0.7248,0.7946,0.8256
"8322",198516,"Elon University",1,0,2010,"26480","141.950536","358","1052","1359",794,565,1041,"386",655,0.8249,0.6832,0.766,0.7741
"8323",198835,"LENOIR-RHYNE COLLEGE",1,0,1991,"8520","22.773798","95","251","279",153,126,113,"33",80,0.5229,0.2619,0.405,0.8996
"8324",198835,"LENOIR-RHYNE COLLEGE",1,0,1992,"9500","21.269513","95","227","255",162,93,104,"30",74,0.4568,0.3226,0.4078,0.8902
"8325",198835,"LENOIR-RHYNE COLLEGE",1,0,1993,"10220","19.651894","91","229","254",135,119,115,"39",76,0.563,0.3277,0.4528,0.9016
"8326",198835,"LENOIR-RHYNE COLLEGE",1,0,1995,"10960","19.683676","91","258","287",157,130,132,"47",85,0.5414,0.3615,0.4599,0.899
"8327",198835,"LENOIR-RHYNE COLLEGE",1,0,1996,"11416","21.256545","98","205","232",135,97,96,"32",64,0.4741,0.3299,0.4138,0.8836
"8328",198835,"LENOIR-RHYNE COLLEGE",1,0,1997,"12036","16.901113","102","270","306",167,139,119,"41",78,0.4671,0.295,0.3889,0.8824
"8329",198835,"LENOIR-RHYNE COLLEGE",1,0,1998,"12386","18.198562","104","219","267",138,129,112,"38",74,0.5362,0.2946,0.4195,0.8202
"8330",198835,"LENOIR-RHYNE COLLEGE",1,0,1999,"12310","19.197636","101","228","288",168,120,117,"37",80,0.4762,0.3083,0.4062,0.7917
"8331",198835,"LENOIR-RHYNE COLLEGE",1,0,2000,"12870","16.837039","98","229","268",142,126,122,"42",80,0.5634,0.3333,0.4552,0.8545
"8332",198835,"LENOIR-RHYNE COLLEGE",1,0,2001,"13600","21.337059","95","234","268",159,109,107,"27",80,0.5031,0.2477,0.3993,0.8731
"8333",198835,"LENOIR-RHYNE COLLEGE",1,0,2002,"14350","22.039818","95","271","319",161,158,145,"69",76,0.472,0.4367,0.4545,0.8495
"8334",198835,"LENOIR-RHYNE COLLEGE",1,0,2003,"15750","23.323801","86","264","308",178,130,124,"45",79,0.4438,0.3462,0.4026,0.8571
"8335",198835,"LENOIR-RHYNE COLLEGE",1,0,2004,"17120","22.656152","90","262","322",196,126,123,"35",88,0.449,0.2778,0.382,0.8137
"8336",198835,"Lenoir-Rhyne College",1,0,2005,"18130","24.265021","88","264","326",203,123,122,"37",85,0.4187,0.3008,0.3742,0.8098
"8337",198835,"Lenoir-Rhyne College",1,0,2006,"19350","25.526336","90","275","347",195,152,117,"40",77,0.3949,0.2632,0.3372,0.7925
"8338",198835,"Lenoir-Rhyne College",1,0,2007,"20690","27.05097","93","288","367",214,153,146,"48",98,0.4579,0.3137,0.3978,0.7847
"8339",198835,"Lenoir-Rhyne University",1,0,2008,"23070","28.135779","93","259","345",217,128,140,"32",108,0.4977,0.25,0.4058,0.7507
"8340",198835,"Lenoir-Rhyne University",1,0,2009,"24200","30.200387","88","170","355",215,140,119,"36",83,0.386,0.2571,0.3352,0.4789
"8341",198835,"Lenoir-Rhyne University",1,0,2010,"25290","29.516899","89","325","423",229,194,149,"53",96,0.4192,0.2732,0.3522,0.7683
"8342",198969,"METHODIST COLLEGE",1,0,1991,"7700","11.273277","53","217","254",86,168,59,"35",24,0.2791,0.2083,0.2323,0.8543
"8343",198969,"METHODIST COLLEGE",1,0,1992,"8250","14.574503","58","217","290",98,192,54,"36",18,0.1837,0.1875,0.1862,0.7483
"8344",198969,"METHODIST COLLEGE",1,0,1993,"8850","16.701561","62","227","310",81,229,49,"28",21,0.2593,0.1223,0.1581,0.7323
"8345",198969,"METHODIST COLLEGE",1,0,1995,"9950","20.591729","94","267","370",121,249,67,"37",30,0.2479,0.1486,0.1811,0.7216
"8346",198969,"METHODIST COLLEGE",1,0,1996,"10600","22.705511","93","241","320",100,220,55,"30",25,0.25,0.1364,0.1719,0.7531
"8347",198969,"METHODIST COLLEGE",1,0,1997,"11250","17.388701","87","270","350",107,243,69,"41",28,0.2617,0.1687,0.1971,0.7714
"8348",198969,"METHODIST COLLEGE",1,0,1998,"11900","18.99573","82","312","437",117,320,88,"55",33,0.2821,0.1719,0.2014,0.714
"8349",198969,"METHODIST COLLEGE",1,0,1999,"12600","20.110164","101","285","378",123,255,53,"23",30,0.2439,0.0902,0.1402,0.754
"8350",198969,"METHODIST COLLEGE",1,0,2000,"13300","22.129217","98","226","308",115,193,46,"18",28,0.2435,0.0933,0.1494,0.7338
"8351",198969,"METHODIST COLLEGE",1,0,2001,"14070","23.884343","95","265","379",117,262,59,"28",31,0.265,0.1069,0.1557,0.6992
"8352",198969,"METHODIST COLLEGE",1,0,2002,"14840","26.131627","100","274","395",118,277,58,"20",38,0.322,0.0722,0.1468,0.6937
"8353",198969,"METHODIST COLLEGE",1,0,2003,"15650","27.398706","101","275","384",120,264,58,"26",32,0.2667,0.0985,0.151,0.7161
"8354",198969,"METHODIST COLLEGE",1,0,2004,"16500","27.181021","108","290","435",143,292,71,"25",46,0.3217,0.0856,0.1632,0.6667
"8355",198969,"Methodist College",1,0,2005,"17580","29.418621","119","266","387",143,244,59,"22",37,0.2587,0.0902,0.1525,0.6873
"8356",198969,"Methodist University",1,0,2006,"18780","31.290309","117","306","449",135,314,75,"31",44,0.3259,0.0987,0.167,0.6815
"8357",198969,"Methodist University",1,0,2007,"20050","34.33552","127","262","433",138,295,76,"31",45,0.3261,0.1051,0.1755,0.6051
"8358",198969,"Methodist University",1,0,2008,"21470","34.717404","127","239","439",148,291,64,"26",38,0.2568,0.0893,0.1458,0.5444
"8359",198969,"Methodist University",1,0,2009,"22620","36.052448","128","161","472",144,328,80,"35",45,0.3125,0.1067,0.1695,0.3411
"8360",198969,"Methodist University",1,0,2010,"23780","37.492816","139","282","531",190,341,104,"46",58,0.3053,0.1349,0.1959,0.5311
"8361",199102,"NORTH CAROLINA AGRICULTURAL AND TECHNICAL ST UNIV",1,0,1991,"1228","78.839421","318","35","1469",803,666,275,"63",212,0.264,0.0946,0.1872,0.0238
"8362",199102,"NORTH CAROLINA AGRICULTURAL AND TECHNICAL ST UNIV",1,0,1992,"1270","83.49568","352","40","1484",780,704,290,"86",204,0.2615,0.1222,0.1954,0.027
"8363",199102,"NORTH CAROLINA AGRICULTURAL AND TECHNICAL ST UNIV",1,0,1993,"1367","90.884592","361","40","1429",775,654,300,"85",215,0.2774,0.13,0.2099,0.028
"8364",199102,"NORTH CAROLINA AGRICULTURAL AND TECHNICAL ST UNIV",1,0,1995,"1532","111.172058","398","40","1396",706,690,339,"117",222,0.3144,0.1696,0.2428,0.0287
"8365",199102,"NORTH CAROLINA AGRICULTURAL AND TECHNICAL ST UNIV",1,0,1996,"1561","114.866282","414","30","1313",692,621,300,"90",210,0.3035,0.1449,0.2285,0.0228
"8366",199102,"NORTH CAROLINA AGRICULTURAL AND TECHNICAL ST UNIV",1,0,1997,"1622","120.999876","401","43","1383",727,656,363,"118",245,0.337,0.1799,0.2625,0.0311
"8367",199102,"NORTH CAROLINA AGRICULTURAL AND TECHNICAL ST UNIV",1,0,1998,"1680","121.886119","412","34","1366",695,671,323,"104",219,0.3151,0.155,0.2365,0.0249
"8368",199102,"NORTH CAROLINA AGRICULTURAL AND TECHNICAL ST UNIV",1,0,1999,"962","129.952156","369","37","1530",850,680,348,"112",236,0.2776,0.1647,0.2275,0.0242
"8369",199102,"NORTH CAROLINA AGRICULTURAL AND TECHNICAL ST UNIV",1,0,2000,"982","139.947635","368.5","46","1661",884,777,321,"97",224,0.2534,0.1248,0.1933,0.0277
"8370",199102,"NORTH CAROLINA AGRICULTURAL AND TECHNICAL ST UNIV",1,0,2001,"1222","150.164438","368","56","1760",874,886,354,"117",237,0.2712,0.1321,0.2011,0.0318
"8371",199102,"NORTH CAROLINA AGRICULTURAL AND TECHNICAL ST UNIV",1,0,2002,"1470","145.150522","367","60","2025",1043,982,299,"90",209,0.2004,0.0916,0.1477,0.0296
"8372",199102,"NORTH CAROLINA A & T STATE UNIVERSITY",1,0,2003,"1544","160.390063","307","69","2221",1176,1045,389,"104",285,0.2423,0.0995,0.1751,0.0311
"8373",199102,"NORTH CAROLINA  A &T STATE UNIVERSITY",1,0,2004,"1769","173.229624","339","39","2212",1147,1065,335,"86",249,0.2171,0.0808,0.1514,0.0176
"8374",199102,"North Carolina A & T State University",1,0,2005,"1769","196.699042","364","34","2237",1178,1059,369,"116",253,0.2148,0.1095,0.165,0.0152
"8375",199102,"North Carolina A & T State University",1,0,2006,"1994","205.94527","425","53","2068",1102,966,340,"81",259,0.235,0.0839,0.1644,0.0256
"8376",199102,"North Carolina A & T State University",1,0,2007,"1994","219.771837","442","34","1569",819,750,251,"64",187,0.2283,0.0853,0.16,0.0217
"8377",199102,"North Carolina A & T State University",1,0,2008,"1994","227.411422","472","44","1592",848,744,342,"105",237,0.2795,0.1411,0.2148,0.0276
"8378",199102,"North Carolina A & T State University",1,0,2009,"1994","236.594179","522","45","1875",1028,847,383,"116",267,0.2597,0.137,0.2043,0.024
"8379",199102,"North Carolina A & T State University",1,0,2010,"2621","257.302365","519","38","2040",1065,975,374,"108",266,0.2498,0.1108,0.1833,0.0186
"8380",199111,"UNIVERSITY OF NORTH CAROLINA AT ASHEVILLE",1,0,1991,"1116","26.481493","139","316","336",199,137,77,"18",59,0.2965,0.1314,0.2292,0.9405
"8381",199111,"UNIVERSITY OF NORTH CAROLINA AT ASHEVILLE",1,0,1992,"1150","28.04759","144","339","364",195,169,101,"33",68,0.3487,0.1953,0.2775,0.9313
"8382",199111,"UNIVERSITY OF NORTH CAROLINA AT ASHEVILLE",1,0,1993,"1436","29.407068","147","368","394",222,172,129,"42",87,0.3919,0.2442,0.3274,0.934
"8383",199111,"UNIVERSITY OF NORTH CAROLINA AT ASHEVILLE",1,0,1995,"1658","33.558433","153","346","393",235,158,123,"35",88,0.3745,0.2215,0.313,0.8804
"8384",199111,"UNIVERSITY OF NORTH CAROLINA AT ASHEVILLE",1,0,1996,"1723","35.712571","158","408","450",275,175,139,"42",97,0.3527,0.24,0.3089,0.9067
"8385",199111,"UNIVERSITY OF NORTH CAROLINA AT ASHEVILLE",1,0,1997,"1784","37.528625","156","427","470",264,206,138,"49",89,0.3371,0.2379,0.2936,0.9085
"8386",199111,"UNIVERSITY OF NORTH CAROLINA AT ASHEVILLE",1,0,1998,"1832","40.164358","161","434","474",278,196,120,"35",85,0.3058,0.1786,0.2532,0.9156
"8387",199111,"UNIVERSITY OF NORTH CAROLINA AT ASHEVILLE",1,0,1999,"806","44.418181","157","414","456",267,189,128,"48",80,0.2996,0.254,0.2807,0.9079
"8388",199111,"UNIVERSITY OF NORTH CAROLINA AT ASHEVILLE",1,0,2000,"822","46.427863","165","451","496",284,212,154,"54",100,0.3521,0.2547,0.3105,0.9093
"8389",199111,"UNIVERSITY OF NORTH CAROLINA AT ASHEVILLE",1,0,2001,"1196","49.917632","173","396","446",281,165,149,"43",106,0.3772,0.2606,0.3341,0.8879
"8390",199111,"UNIVERSITY OF NORTH CAROLINA AT ASHEVILLE",1,0,2002,"1592","50.597343","180","383","421",250,171,140,"41",99,0.396,0.2398,0.3325,0.9097
"8391",199111,"UNIVERSITY OF NORTH CAROLINA AT ASHEVILLE",1,0,2003,"1672","52.16513","177","535","590",332,258,170,"45",125,0.3765,0.1744,0.2881,0.9068
"8392",199111,"UNIVERSITY OF NORTH CAROLINA AT ASHEVILLE",1,0,2004,"1897","56.97968","184","626","694",418,276,208,"59",149,0.3565,0.2138,0.2997,0.902
"8393",199111,"University of North Carolina at Asheville",1,0,2005,"1897","65.739029","200","418","471",291,180,154,"51",103,0.354,0.2833,0.327,0.8875
"8394",199111,"University of North Carolina at Asheville",1,0,2006,"2172","69.635046","206","503","567",328,239,180,"57",123,0.375,0.2385,0.3175,0.8871
"8395",199111,"University of North Carolina at Asheville",1,0,2007,"2307","73.316585","207","487","571",341,230,211,"67",144,0.4223,0.2913,0.3695,0.8529
"8396",199111,"University of North Carolina at Asheville",1,0,2008,"2339","76.1667","207","498","586",361,225,225,"77",148,0.41,0.3422,0.384,0.8498
"8397",199111,"University of North Carolina at Asheville",1,0,2009,"2389","77.421385","208","556","637",363,274,230,"75",155,0.427,0.2737,0.3611,0.8728
"8398",199111,"University of North Carolina at Asheville",1,0,2010,"2626","77.320999","217","497","590",335,255,231,"87",144,0.4299,0.3412,0.3915,0.8424
"8399",199120,"UNIVERSITY OF NORTH CAROLINA AT CHAPEL HILL",1,0,1991,"1248","686.365846","1261","2589","3133",1941,1192,1966,"672",1294,0.6667,0.5638,0.6275,0.8264
"8400",199120,"UNIVERSITY OF NORTH CAROLINA AT CHAPEL HILL",1,0,1992,"1249","729.021834","1277","2626","3200",1957,1243,2009,"733",1276,0.652,0.5897,0.6278,0.8206
"8401",199120,"UNIVERSITY OF NORTH CAROLINA AT CHAPEL HILL",1,0,1993,"1419","792.652542","1268","2702","3310",2048,1262,2089,"744",1345,0.6567,0.5895,0.6311,0.8163
"8402",199120,"UNIVERSITY OF NORTH CAROLINA AT CHAPEL HILL",1,0,1995,"1640","918.411488","1261","2610","3229",1982,1247,2101,"732",1369,0.6907,0.587,0.6507,0.8083
"8403",199120,"UNIVERSITY OF NORTH CAROLINA AT CHAPEL HILL",1,0,1996,"2110","974.985662","1225","2629","3270",2065,1205,2185,"718",1467,0.7104,0.5959,0.6682,0.804
"8404",199120,"UNIVERSITY OF NORTH CAROLINA AT CHAPEL HILL",1,0,1997,"2173","1050.409","1222","2728","3412",2118,1294,2371,"816",1555,0.7342,0.6306,0.6949,0.7995
"8405",199120,"UNIVERSITY OF NORTH CAROLINA AT CHAPEL HILL",1,0,1998,"2211","1116.68","1240","2778","3425",2116,1309,2289,"794",1495,0.7065,0.6066,0.6683,0.8111
"8406",199120,"UNIVERSITY OF NORTH CAROLINA AT CHAPEL HILL",1,0,1999,"1528","1185.644","1285","2706","3388",2099,1289,2389,"797",1592,0.7585,0.6183,0.7051,0.7987
"8407",199120,"UNIVERSITY OF NORTH CAROLINA AT CHAPEL HILL",1,0,2000,"1860","1259.979","1244","2680","3406",2121,1285,2426,"829",1597,0.7529,0.6451,0.7123,0.7868
"8408",199120,"UNIVERSITY OF NORTH CAROLINA AT CHAPEL HILL",1,0,2001,"2328","1368.498","1203","2827","3681",2195,1486,2611,"986",1625,0.7403,0.6635,0.7093,0.768
"8409",199120,"UNIVERSITY OF NORTH CAROLINA AT CHAPEL HILL",1,0,2002,"2814","1499.705592","1356","2581","3455",2053,1402,2513,"935",1578,0.7686,0.6669,0.7274,0.747
"8410",199120,"UNIVERSITY OF NORTH CAROLINA AT CHAPEL HILL",1,0,2003,"2955","1561.296449","1296","2558","3511",2068,1443,2535,"945",1590,0.7689,0.6549,0.722,0.7286
"8411",199120,"UNIVERSITY OF NORTH CAROLINA AT CHAPEL HILL",1,0,2004,"3205","1629.856862","1318","2610","3584",2099,1485,2685,"1027",1658,0.7899,0.6916,0.7492,0.7282
"8412",199120,"University of North Carolina at Chapel Hill",1,0,2005,"3205","1703.723624","1382","2740","3747",2270,1477,2819,"1050",1769,0.7793,0.7109,0.7523,0.7313
"8413",199120,"University of North Carolina at Chapel Hill",1,0,2006,"3455","1842.583328","1490","2649","3796",2276,1520,2893,"1107",1786,0.7847,0.7283,0.7621,0.6978
"8414",199120,"University of North Carolina at Chapel Hill",1,0,2007,"3705","1995.887493","1514","2684","3877",2338,1539,3124,"1151",1973,0.8439,0.7479,0.8058,0.6923
"8415",199120,"University of North Carolina at Chapel Hill",1,0,2008,"3705","2149.017644","1600","2641","3852",2270,1582,3096,"1188",1908,0.8405,0.7509,0.8037,0.6856
"8416",199120,"University of North Carolina at Chapel Hill",1,0,2009,"3865","2286.087886","1628","2655","3955",2354,1601,3216,"1225",1991,0.8458,0.7651,0.8131,0.6713
"8417",199120,"University of North Carolina at Chapel Hill",1,0,2010,"4815","2360.248766","1671","2763","3944",2371,1573,3299,"1235",2064,0.8705,0.7851,0.8365,0.7006
"8418",199139,"UNIVERSITY OF NORTH CAROLINA AT CHARLOTTE",1,0,1991,"1147","107.863199","611","1216","1552",876,676,347,"86",261,0.2979,0.1272,0.2236,0.7835
"8419",199139,"UNIVERSITY OF NORTH CAROLINA AT CHARLOTTE",1,0,1992,"1189","118.29785","639","1202","1575",813,762,291,"111",180,0.2214,0.1457,0.1848,0.7632
"8420",199139,"UNIVERSITY OF NORTH CAROLINA AT CHARLOTTE",1,0,1993,"1383","125.129376","643","1245","1685",845,840,312,"111",201,0.2379,0.1321,0.1852,0.7389
"8421",199139,"UNIVERSITY OF NORTH CAROLINA AT CHARLOTTE",1,0,1995,"1618","142.53602","625","1231","1663",974,689,396,"115",281,0.2885,0.1669,0.2381,0.7402
"8422",199139,"UNIVERSITY OF NORTH CAROLINA AT CHARLOTTE",1,0,1996,"1716","167.739656","637","1243","1682",952,730,359,"113",246,0.2584,0.1548,0.2134,0.739
"8423",199139,"UNIVERSITY OF NORTH CAROLINA AT CHARLOTTE",1,0,1997,"1777","169.817197","643","1417","1904",1077,827,418,"155",263,0.2442,0.1874,0.2195,0.7442
"8424",199139,"UNIVERSITY OF NORTH CAROLINA AT CHARLOTTE",1,0,1998,"1834","186.043587","644","1508","2122",1178,944,456,"169",287,0.2436,0.179,0.2149,0.7107
"8425",199139,"UNIVERSITY OF NORTH CAROLINA AT CHARLOTTE",1,0,1999,"962","195.828945","664","1575","2078",1111,967,489,"181",308,0.2772,0.1872,0.2353,0.7579
"8426",199139,"UNIVERSITY OF NORTH CAROLINA AT CHARLOTTE",1,0,2000,"1132","206.923641","654","1648","2142",1208,934,553,"194",359,0.2972,0.2077,0.2582,0.7694
"8427",199139,"UNIVERSITY OF NORTH CAROLINA AT CHARLOTTE",1,0,2001,"1417","224.101462","644","1795","2309",1273,1036,610,"209",401,0.315,0.2017,0.2642,0.7774
"8428",199139,"UNIVERSITY OF NORTH CAROLINA AT CHARLOTTE",1,0,2002,"1813","200.206907","721","1890","2383",1234,1149,577,"204",373,0.3023,0.1775,0.2421,0.7931
"8429",199139,"UNIVERSITY OF NORTH CAROLINA AT CHARLOTTE",1,0,2003,"1904","217.919178","769","1975","2472",1291,1181,630,"244",386,0.299,0.2066,0.2549,0.7989
"8430",199139,"UNIVERSITY OF NORTH CAROLINA AT CHARLOTTE",1,0,2004,"2129","229.119828","787","2092","2599",1416,1183,707,"249",458,0.3234,0.2105,0.272,0.8049
"8431",199139,"University of North Carolina at Charlotte",1,0,2005,"2129","258.544125","837","2288","2859",1498,1361,741,"273",468,0.3124,0.2006,0.2592,0.8003
"8432",199139,"University of North Carolina at Charlotte",1,0,2006,"2344","298.111461","878","2161","2764",1475,1289,728,"280",448,0.3037,0.2172,0.2634,0.7818
"8433",199139,"University of North Carolina at Charlotte",1,0,2007,"2461","342.003149","922","2238","2926",1520,1406,749,"304",445,0.2928,0.2162,0.256,0.7649
"8434",199139,"University of North Carolina at Charlotte",1,0,2008,"2516","363.877005","971","2238","3059",1610,1449,766,"289",477,0.2963,0.1994,0.2504,0.7316
"8435",199139,"University of North Carolina at Charlotte",1,0,2009,"2516","391.494696","953","2078","3152",1571,1581,820,"319",501,0.3189,0.2018,0.2602,0.6593
"8436",199139,"University of North Carolina at Charlotte",1,0,2010,"3044","409.143441","949","1927","2947",1513,1434,840,"312",528,0.349,0.2176,0.285,0.6539
"8437",199148,"UNIVERSITY OF NORTH CAROLINA AT GREENSBORO",1,0,1991,"1492","101.871101","568","1090","1345",890,455,358,"82",276,0.3101,0.1802,0.2662,0.8104
"8438",199148,"UNIVERSITY OF NORTH CAROLINA AT GREENSBORO",1,0,1992,"1540","113.40492","580","1182","1509",1000,509,363,"80",283,0.283,0.1572,0.2406,0.7833
"8439",199148,"UNIVERSITY OF NORTH CAROLINA AT GREENSBORO",1,0,1993,"1717","119.797086","572","1187","1500",959,541,297,"61",236,0.2461,0.1128,0.198,0.7913
"8440",199148,"UNIVERSITY OF NORTH CAROLINA AT GREENSBORO",1,0,1995,"1868","139.143822","548","1333","1804",1234,570,376,"77",299,0.2423,0.1351,0.2084,0.7389
"8441",199148,"UNIVERSITY OF NORTH CAROLINA AT GREENSBORO",1,0,1996,"1943","148.242922","562","1182","1552",1075,477,390,"77",313,0.2912,0.1614,0.2513,0.7616
"8442",199148,"UNIVERSITY OF NORTH CAROLINA AT GREENSBORO",1,0,1997,"2019","151.222261","565","1150","1577",1091,486,431,"90",341,0.3126,0.1852,0.2733,0.7292
"8443",199148,"UNIVERSITY OF NORTH CAROLINA AT GREENSBORO",1,0,1998,"2039","170.790514","587","1283","1791",1257,534,472,"94",378,0.3007,0.176,0.2635,0.7164
"8444",199148,"UNIVERSITY OF NORTH CAROLINA AT GREENSBORO",1,0,1999,"1086","195.549607","601","1373","1908",1346,562,540,"107",433,0.3217,0.1904,0.283,0.7196
"8445",199148,"UNIVERSITY OF NORTH CAROLINA AT GREENSBORO",1,0,2000,"1108","203.577098","624","1363","1867",1355,512,556,"112",444,0.3277,0.2188,0.2978,0.73
"8446",199148,"UNIVERSITY OF NORTH CAROLINA AT GREENSBORO",1,0,2001,"1358","218.468517","647","1336","1898",1350,548,511,"102",409,0.303,0.1861,0.2692,0.7039
"8447",199148,"UNIVERSITY OF NORTH CAROLINA AT GREENSBORO",1,0,2002,"1717","203.985076","629","1487","2071",1420,651,570,"118",452,0.3183,0.1813,0.2752,0.718
"8448",199148,"UNIVERSITY OF NORTH CAROLINA AT GREENSBORO",1,0,2003,"1803","218.765786","686","1436","2039",1422,617,577,"123",454,0.3193,0.1994,0.283,0.7043
"8449",199148,"UNIVERSITY OF NORTH CAROLINA AT GREENSBORO",1,0,2004,"2028","238.766913","695","1517","2159",1525,634,625,"124",501,0.3285,0.1956,0.2895,0.7026
"8450",199148,"University of North Carolina at Greensboro",1,0,2005,"2028","249.736811","727","1664","2399",1690,709,670,"125",545,0.3225,0.1763,0.2793,0.6936
"8451",199148,"University of North Carolina at Greensboro",1,0,2006,"2308","273.884654","736","1546","2400",1698,702,706,"128",578,0.3404,0.1823,0.2942,0.6442
"8452",199148,"University of North Carolina at Greensboro",1,0,2007,"2458","301.083371","784","1532","2431",1689,742,721,"166",555,0.3286,0.2237,0.2966,0.6302
"8453",199148,"University of North Carolina at Greensboro",1,0,2008,"2507","321.637738","796","1581","2471",1703,768,759,"183",576,0.3382,0.2383,0.3072,0.6398
"8454",199148,"University of North Carolina at Greensboro",1,0,2009,"2590","336.132177","788","1553","2495",1733,762,804,"180",624,0.3601,0.2362,0.3222,0.6224
"8455",199148,"University of North Carolina at Greensboro",1,0,2010,"3243","360.22787","839","1485","2505",1722,783,762,"162",600,0.3484,0.2069,0.3042,0.5928
"8456",199157,"NORTH CAROLINA CENTRAL UNIVERSITY",1,0,1991,"1169","50.76848","234","7","531",336,195,93,"21",72,0.2143,0.1077,0.1751,0.0132
"8457",199157,"NORTH CAROLINA CENTRAL UNIVERSITY",1,0,1992,"1211","51.887945","241","12","759",452,307,134,"30",104,0.2301,0.0977,0.1765,0.0158
"8458",199157,"NORTH CAROLINA CENTRAL UNIVERSITY",1,0,1993,"1338","53.324808","263","5","810",525,285,201,"40",161,0.3067,0.1404,0.2481,0.0062
"8459",199157,"NORTH CAROLINA CENTRAL UNIVERSITY",1,0,1995,"1512","64.814473","269","21","510",309,201,139,"34",105,0.3398,0.1692,0.2725,0.0412
"8460",199157,"NORTH CAROLINA CENTRAL UNIVERSITY",1,0,1996,"1595","67.890327","281","11","681",441,240,179,"38",141,0.3197,0.1583,0.2628,0.0162
"8461",199157,"NORTH CAROLINA CENTRAL UNIVERSITY",1,0,1997,"1736","72.018916","261","17","712",467,245,202,"45",157,0.3362,0.1837,0.2837,0.0239
"8462",199157,"NORTH CAROLINA CENTRAL UNIVERSITY",1,0,1998,"1793","75.549944","264","17","673",409,264,184,"41",143,0.3496,0.1553,0.2734,0.0253
"8463",199157,"NORTH CAROLINA CENTRAL UNIVERSITY",1,0,1999,"962","82.15088","265","9","625",345,280,143,"31",112,0.3246,0.1107,0.2288,0.0144
"8464",199157,"NORTH CAROLINA CENTRAL UNIVERSITY",1,0,2000,"982","84.967619","251","12","720",443,277,162,"26",136,0.307,0.0939,0.225,0.0167
"8465",199157,"NORTH CAROLINA CENTRAL UNIVERSITY",1,0,2001,"1272","88.654041","237","9","763",492,271,174,"29",145,0.2947,0.107,0.228,0.0118
"8466",199157,"NORTH CAROLINA CENTRAL UNIVERSITY",1,0,2002,"1574","96.967571","234","15","821",542,279,191,"42",149,0.2749,0.1505,0.2326,0.0183
"8467",199157,"NORTH CAROLINA CENTRAL UNIVERSITY",1,0,2003,"1653","102.360182","250","13","1025",679,346,190,"32",158,0.2327,0.0925,0.1854,0.0127
"8468",199157,"NORTH CAROLINA CENTRAL UNIVERSITY",1,0,2004,"1878","122.185588","240","18","1138",732,406,205,"51",154,0.2104,0.1256,0.1801,0.0158
"8469",199157,"North Carolina Central University",1,0,2005,"1878","131.837965","281","20","1195",800,395,181,"45",136,0.17,0.1139,0.1515,0.0167
"8470",199157,"North Carolina Central University",1,0,2006,"2078","146.845127","319","18","975",631,344,145,"30",115,0.1823,0.0872,0.1487,0.0185
"8471",199157,"North Carolina Central University",1,0,2007,"2218","160.07293","348","26","1236",764,472,185,"47",138,0.1806,0.0996,0.1497,0.021
"8472",199157,"North Carolina Central University",1,0,2008,"2218","170.78743","366","23","1026",683,343,224,"56",168,0.246,0.1633,0.2183,0.0224
"8473",199157,"North Carolina Central University",1,0,2009,"2264","181.323965","369","27","1345",858,487,215,"49",166,0.1935,0.1006,0.1599,0.0201
"8474",199157,"North Carolina Central University",1,0,2010,"2812","184.346845","412","22","1218",809,409,238,"56",182,0.225,0.1369,0.1954,0.0181
"8475",199193,"NORTH CAROLINA STATE UNIVERSITY AT RALEIGH",1,0,1991,"1238","460.027562","1233","2724","3296",1290,2006,773,"370",403,0.3124,0.1844,0.2345,0.8265
"8476",199193,"NORTH CAROLINA STATE UNIVERSITY AT RALEIGH",1,0,1992,"1286","478.02451","1240","2589","3176",1219,1957,759,"338",421,0.3454,0.1727,0.239,0.8152
"8477",199193,"NORTH CAROLINA STATE UNIVERSITY AT RALEIGH",1,0,1993,"1389","510.774934","1235","2724","3277",1248,2029,841,"397",444,0.3558,0.1957,0.2566,0.8312
"8478",199193,"NORTH CAROLINA STATE UNIVERSITY AT RALEIGH",1,0,1995,"1732","578.099302","1210","2898","3607",1523,2084,900,"395",505,0.3316,0.1895,0.2495,0.8034
"8479",199193,"NORTH CAROLINA STATE UNIVERSITY AT RALEIGH",1,0,1996,"2200","594.95607","1198","2996","3630",1457,2173,968,"442",526,0.361,0.2034,0.2667,0.8253
"8480",199193,"NORTH CAROLINA STATE UNIVERSITY AT RALEIGH",1,0,1997,"2270","638.099864","1215","3049","3756",1496,2260,961,"427",534,0.357,0.1889,0.2559,0.8118
"8481",199193,"NORTH CAROLINA STATE UNIVERSITY AT RALEIGH",1,0,1998,"2634","676.615974","1171","3044","3751",1513,2238,1075,"492",583,0.3853,0.2198,0.2866,0.8115
"8482",199193,"NORTH CAROLINA STATE UNIVERSITY AT RALEIGH",1,0,1999,"1528","733.688339","1202","3029","3636",1499,2137,1253,"559",694,0.463,0.2616,0.3446,0.8331
"8483",199193,"NORTH CAROLINA STATE UNIVERSITY AT RALEIGH",1,0,2000,"1860","766.576509","1234","3082","3816",1622,2194,1379,"634",745,0.4593,0.289,0.3614,0.8077
"8484",199193,"NORTH CAROLINA STATE UNIVERSITY AT RALEIGH",1,0,2001,"2328","816.003937","1266","3128","3862",1630,2232,1404,"619",785,0.4816,0.2773,0.3635,0.8099
"8485",199193,"NORTH CAROLINA STATE UNIVERSITY AT RALEIGH",1,0,2002,"2814","781.426292","1285","3032","3713",1561,2152,1391,"580",811,0.5195,0.2695,0.3746,0.8166
"8486",199193,"NORTH CAROLINA STATE UNIVERSITY AT RALEIGH",1,0,2003,"2955","811.816688","1647","3235","3915",1665,2250,1595,"734",861,0.5171,0.3262,0.4074,0.8263
"8487",199193,"NORTH CAROLINA STATE UNIVERSITY AT RALEIGH",1,0,2004,"3205","845.755865","1638","3154","3935",1702,2233,1585,"682",903,0.5306,0.3054,0.4028,0.8015
"8488",199193,"North Carolina State University at Raleigh",1,0,2005,"3205","894.641835","1671","3513","4364",1918,2446,1732,"716",1016,0.5297,0.2927,0.3969,0.805
"8489",199193,"North Carolina State University at Raleigh",1,0,2006,"3530","965.075655","1652","3719","4667",2067,2600,1781,"761",1020,0.4935,0.2927,0.3816,0.7969
"8490",199193,"North Carolina State University at Raleigh",1,0,2007,"3760","1026.727112","1723","3908","4895",2179,2716,1975,"836",1139,0.5227,0.3078,0.4035,0.7984
"8491",199193,"North Carolina State University at Raleigh",1,0,2008,"3860","1113.056893","1768","3770","4792",2184,2608,2029,"863",1166,0.5339,0.3309,0.4234,0.7867
"8492",199193,"North Carolina State University at Raleigh",1,0,2009,"3953","1138.694539","1773","3589","4716",2067,2649,2031,"920",1111,0.5375,0.3473,0.4307,0.761
"8493",199193,"North Carolina State University at Raleigh",1,0,2010,"4853","1138.229261","1755","3592","4685",2098,2587,2187,"962",1225,0.5839,0.3719,0.4668,0.7667
"8494",199218,"UNIVERSITY OF NORTH CAROLINA AT WILMINGTON",1,0,1991,"1302","63.652438","340","1444","1545",923,622,385,"111",274,0.2969,0.1785,0.2492,0.9346
"8495",199218,"UNIVERSITY OF NORTH CAROLINA AT WILMINGTON",1,0,1992,"1344","70.627464","356","1104","1225",771,454,320,"95",225,0.2918,0.2093,0.2612,0.9012
"8496",199218,"UNIVERSITY OF NORTH CAROLINA AT WILMINGTON",1,0,1993,"1492","76.864933","346","1296","1439",860,579,417,"131",286,0.3326,0.2263,0.2898,0.9006
"8497",199218,"UNIVERSITY OF NORTH CAROLINA AT WILMINGTON",1,0,1995,"1664","86.305397","363","1253","1370",863,507,463,"133",330,0.3824,0.2623,0.338,0.9146
"8498",199218,"UNIVERSITY OF NORTH CAROLINA AT WILMINGTON",1,0,1996,"1734","90.08563","369","1472","1619",990,629,602,"196",406,0.4101,0.3116,0.3718,0.9092
"8499",199218,"UNIVERSITY OF NORTH CAROLINA-WILMINGTON",1,0,1997,"1782","94.89501","382","1216","1350",837,513,478,"149",329,0.3931,0.2904,0.3541,0.9007
"8500",199218,"UNIVERSITY OF NORTH CAROLINA-WILMINGTON",1,0,1998,"1934","106.406075","388","1551","1681",1030,651,628,"180",448,0.435,0.2765,0.3736,0.9227
"8501",199218,"UNIVERSITY OF NORTH CAROLINA-WILMINGTON",1,0,1999,"962","119.60446","413","1522","1649",1011,638,672,"213",459,0.454,0.3339,0.4075,0.923
"8502",199218,"UNIVERSITY OF NORTH CAROLINA-WILMINGTON",1,0,2000,"1102","130.773146","423","1524","1661",1081,580,711,"185",526,0.4866,0.319,0.4281,0.9175
"8503",199218,"UNIVERSITY OF NORTH CAROLINA-WILMINGTON",1,0,2001,"1317","139.462003","433","1823","1983",1246,737,824,"205",619,0.4968,0.2782,0.4155,0.9193
"8504",199218,"UNIVERSITY OF NORTH CAROLINA-WILMINGTON",1,0,2002,"1622","139.826196","433","1489","1629",1014,615,733,"209",524,0.5168,0.3398,0.45,0.9141
"8505",199218,"UNIVERSITY OF NORTH CAROLINA-WILMINGTON",1,0,2003,"1703","144.505671","467","1557","1764",1133,631,783,"227",556,0.4907,0.3597,0.4439,0.8827
"8506",199218,"UNIVERSITY OF NORTH CAROLINA-WILMINGTON",1,0,2004,"1928","155.306593","464","1668","1891",1154,737,841,"272",569,0.4931,0.3691,0.4447,0.8821
"8507",199218,"University of North Carolina-Wilmington",1,0,2005,"1928","167.180811","493","1693","1933",1133,800,842,"302",540,0.4766,0.3775,0.4356,0.8758
"8508",199218,"University of North Carolina-Wilmington",1,0,2006,"2221","183.416805","515","1652","1980",1140,840,973,"335",638,0.5596,0.3988,0.4914,0.8343
"8509",199218,"University of North Carolina-Wilmington",1,0,2007,"2413","214.366584","543","1607","1913",1138,775,991,"340",651,0.5721,0.4387,0.518,0.84
"8510",199218,"University of North Carolina-Wilmington",1,0,2008,"2459","241.451001","580","1761","2069",1229,840,1017,"326",691,0.5622,0.3881,0.4915,0.8511
"8511",199218,"University of North Carolina-Wilmington",1,0,2009,"2565","237.664684","617","1607","1943",1178,765,975,"314",661,0.5611,0.4105,0.5018,0.8271
"8512",199218,"University of North Carolina at Wilmington",1,0,2010,"3029","254.030596","617","1655","1985",1236,749,1044,"320",724,0.5858,0.4272,0.5259,0.8338
"8513",199281,"PEMBROKE STATE UNIVERSITY",1,0,1991,"914","23.802216","141","229","379",195,184,58,"21",37,0.1897,0.1141,0.153,0.6042
"8514",199281,"PEMBROKE STATE UNIVERSITY",1,0,1992,"948","23.912464","145","251","417",199,218,68,"26",42,0.2111,0.1193,0.1631,0.6019
"8515",199281,"PEMBROKE STATE UNIVERSITY",1,0,1993,"1078","25.184577","143","245","422",216,206,71,"19",52,0.2407,0.0922,0.1682,0.5806
"8516",199281,"UNIVERSITY OF NORTH CAROLINA-PEMBROKE",1,0,1995,"1325","27.732418","144","230","410",199,211,81,"34",47,0.2362,0.1611,0.1976,0.561
"8517",199281,"UNIVERSITY OF NORTH CAROLINA-PEMBROKE",1,0,1996,"1467","30.259011","145","228","450",211,239,80,"30",50,0.237,0.1255,0.1778,0.5067
"8518",199281,"UNIVERSITY OF NORTH CAROLINA-PEMBROKE",1,0,1997,"1536","32.42613","143","272","480",258,222,98,"34",64,0.2481,0.1532,0.2042,0.5667
"8519",199281,"UNIVERSITY OF NORTH CAROLINA AT PEMBROKE",1,0,1998,"1600","34.499131","145","241","464",244,220,99,"36",63,0.2582,0.1636,0.2134,0.5194
"8520",199281,"UNIVERSITY OF NORTH CAROLINA AT PEMBROKE",1,0,1999,"962","38.301605","145","268","475",241,234,89,"33",56,0.2324,0.141,0.1874,0.5642
"8521",199281,"UNIVERSITY OF NORTH CAROLINA AT PEMBROKE",1,0,2000,"982","40.04449","156","307","567",303,264,114,"34",80,0.264,0.1288,0.2011,0.5414
"8522",199281,"UNIVERSITY OF NORTH CAROLINA AT PEMBROKE",1,0,2001,"1152","44.609544","167","378","688",363,325,100,"31",69,0.1901,0.0954,0.1453,0.5494
"8523",199281,"UNIVERSITY OF NORTH CAROLINA AT PEMBROKE",1,0,2002,"1394","47.712591","180","413","709",376,333,101,"38",63,0.1676,0.1141,0.1425,0.5825
"8524",199281,"UNIVERSITY OF NORTH CAROLINA AT PEMBROKE",1,0,2003,"1464","53.920608","202","459","792",415,377,130,"45",85,0.2048,0.1194,0.1641,0.5795
"8525",199281,"UNIVERSITY OF NORTH CAROLINA AT PEMBROKE",1,0,2004,"1689","63.395151","219","358","741",393,348,113,"44",69,0.1756,0.1264,0.1525,0.4831
"8526",199281,"University of North Carolina at Pembroke",1,0,2005,"1689","69.402329","243","437","961",528,433,142,"50",92,0.1742,0.1155,0.1478,0.4547
"8527",199281,"University of North Carolina at Pembroke",1,0,2006,"1869","77.214905","257","414","929",475,454,148,"54",94,0.1979,0.1189,0.1593,0.4456
"8528",199281,"University of North Carolina at Pembroke",1,0,2007,"1949","88.941257","285","487","1101",585,516,170,"57",113,0.1932,0.1105,0.1544,0.4423
"8529",199281,"University of North Carolina at Pembroke",1,0,2008,"2007","110.511061","291","448","1054",563,491,157,"50",107,0.1901,0.1018,0.149,0.425
"8530",199281,"University of North Carolina at Pembroke",1,0,2009,"2060","108.863703","293","454","1202",642,560,218,"77",141,0.2196,0.1375,0.1814,0.3777
"8531",199281,"University of North Carolina at Pembroke",1,0,2010,"2423","114.850322","329","410","1036",582,454,209,"74",135,0.232,0.163,0.2017,0.3958
"8532",199306,"PFEIFFER COLLEGE",1,0,1991,"7295","9.764805","47","149","166",82,84,45,"17",28,0.3415,0.2024,0.2711,0.8976
"8533",199306,"PFEIFFER COLLEGE",1,0,1992,"7730","10.148392","47","130","147",66,81,45,"18",27,0.4091,0.2222,0.3061,0.8844
"8534",199306,"PFEIFFER COLLEGE",1,0,1993,"8190","10.438322","49","126","156",70,86,40,"14",26,0.3714,0.1628,0.2564,0.8077
"8535",199306,"PFEIFFER UNIVERSITY",1,0,1995,"8990","11.065736","47","121","146",66,80,31,"10",21,0.3182,0.125,0.2123,0.8288
"8536",199306,"PFEIFFER UNIVERSITY",1,0,1996,"9260","11.900116","51","99","120",54,66,26,"12",14,0.2593,0.1818,0.2167,0.825
"8537",199306,"PFEIFFER UNIVERSITY",1,0,1997,"9816","11.491205","51","129","162",59,103,40,"21",19,0.322,0.2039,0.2469,0.7963
"8538",199306,"PFEIFFER UNIVERSITY",1,0,1998,"10230","12.718556","58","122","148",67,81,45,"17",28,0.4179,0.2099,0.3041,0.8243
"8539",199306,"PFEIFFER UNIVERSITY",1,0,1999,"10844","12.797199","59","126","159",80,79,52,"15",37,0.4625,0.1899,0.327,0.7925
"8540",199306,"PFEIFFER UNIVERSITY",1,0,2000,"11380","13.453906","58.5","154","185",90,95,58,"17",41,0.4556,0.1789,0.3135,0.8324
"8541",199306,"PFEIFFER UNIVERSITY",1,0,2001,"12066","14.310055","58","120","146",69,77,63,"26",37,0.5362,0.3377,0.4315,0.8219
"8542",199306,"PFEIFFER UNIVERSITY",1,0,2002,"12780","15.476383","63","138","166",97,69,71,"29",42,0.433,0.4203,0.4277,0.8313
"8543",199306,"PFEIFFER UNIVERSITY",1,0,2003,"13550","17.659535","65","130","158",86,72,56,"20",36,0.4186,0.2778,0.3544,0.8228
"8544",199306,"PFEIFFER UNIVERSITY",1,0,2004,"14570","18.813564","65","153","191",88,103,54,"17",37,0.4205,0.165,0.2827,0.801
"8545",199306,"Pfeiffer University",1,0,2005,"15590","19.929176","65","147","198",90,108,74,"28",46,0.5111,0.2593,0.3737,0.7424
"8546",199306,"Pfeiffer University",1,0,2006,"16450","22.047782","67","145","196",85,111,72,"38",34,0.4,0.3423,0.3673,0.7398
"8547",199306,"Pfeiffer University",1,0,2007,"17520","24.063619","77","154","189",90,99,63,"28",35,0.3889,0.2828,0.3333,0.8148
"8548",199306,"Pfeiffer University",1,0,2008,"18570","26.632146","74","133","192",91,101,48,"15",33,0.3626,0.1485,0.25,0.6927
"8549",199306,"Pfeiffer University",1,0,2009,"19040","24.578762","73","172","225",100,125,71,"34",37,0.37,0.272,0.3156,0.7644
"8550",199306,"Pfeiffer University",1,0,2010,"20182","24.782605","81","127","199",88,111,67,"31",36,0.4091,0.2793,0.3367,0.6382
"8551",199412,"QUEENS COLLEGE",1,0,1991,"9300","13.917283","67","117","144",102,42,47,"9",38,0.3725,0.2143,0.3264,0.8125
"8552",199412,"QUEENS COLLEGE",1,0,1992,"9850","18.821992","66","102","127",95,32,45,"8",37,0.3895,0.25,0.3543,0.8031
"8553",199412,"QUEENS COLLEGE",1,0,1993,"10400","15.576455","63","139","169",134,35,60,"13",47,0.3507,0.3714,0.355,0.8225
"8554",199412,"QUEENS COLLEGE",1,0,1995,"11520","19.080135","64","113","146",110,36,72,"19",53,0.4818,0.5278,0.4932,0.774
"8555",199412,"QUEENS COLLEGE",1,0,1996,"12310","18.985364","64","117","155",116,39,80,"14",66,0.569,0.359,0.5161,0.7548
"8556",199412,"QUEENS COLLEGE",1,0,1997,"12980","15.57692","65","148","198",142,56,80,"20",60,0.4225,0.3571,0.404,0.7475
"8557",199412,"QUEENS COLLEGE",1,0,1998,"9410","16.05939","69","114","147",111,36,67,"15",52,0.4685,0.4167,0.4558,0.7755
"8558",199412,"QUEENS COLLEGE",1,0,1999,"10020","18.275776","62","89","123",85,38,67,"15",52,0.6118,0.3947,0.5447,0.7236
"8559",199412,"QUEENS COLLEGE",1,0,2000,"10680","19.984631","61","150","188",136,52,93,"23",70,0.5147,0.4423,0.4947,0.7979
"8560",199412,"QUEENS COLLEGE",1,0,2001,"11360","21.514483","60","165","209",166,43,105,"23",82,0.494,0.5349,0.5024,0.7895
"8561",199412,"QUEENS UNIVERSITY OF CHARLOTTE",1,0,2002,"12290","23.407894","63","168","193",150,43,111,"24",87,0.58,0.5581,0.5751,0.8705
"8562",199412,"QUEENS UNIVERSITY OF CHARLOTTE",1,0,2003,"15650","25.870898","75","216","252",186,66,127,"34",93,0.5,0.5152,0.504,0.8571
"8563",199412,"QUEENS UNIVERSITY OF CHARLOTTE",1,0,2004,"17008","24.500933","85","183","223",154,69,98,"28",70,0.4545,0.4058,0.4395,0.8206
"8564",199412,"Queens University of Charlotte",1,0,2005,"18028","27.521609","90","189","238",171,67,116,"30",86,0.5029,0.4478,0.4874,0.7941
"8565",199412,"Queens University of Charlotte",1,0,2006,"19450","28.659767","92","148","235",173,62,104,"22",82,0.474,0.3548,0.4426,0.6298
"8566",199412,"Queens University of Charlotte",1,0,2007,"20720","30.769153","102","202","290",198,92,126,"32",94,0.4747,0.3478,0.4345,0.6966
"8567",199412,"Queens University of Charlotte",1,0,2008,"22068","37.936556","103","190","307",214,93,164,"49",115,0.5374,0.5269,0.5342,0.6189
"8568",199412,"Queens University of Charlotte",1,0,2009,"22730","39.712385","109","177","311",232,79,144,"31",113,0.4871,0.3924,0.463,0.5691
"8569",199412,"Queens University of Charlotte",1,0,2010,"23752","44.431377","119","205","349",252,97,162,"38",124,0.4921,0.3918,0.4642,0.5874
"8570",199582,"SAINT AUGUSTINE'S COLLEGE",1,0,1991,"4950","24.601848","109","1","418",237,181,44,"10",34,0.1435,0.0552,0.1053,0.0024
"8571",199582,"SAINT AUGUSTINE'S COLLEGE",1,0,1992,"5300","24.158006","89","0","401",232,169,61,"14",47,0.2026,0.0828,0.1521,0
"8572",199582,"SAINT AUGUSTINES COLLEGE",1,0,1993,"5700","25.173806","91","1","361",196,165,49,"12",37,0.1888,0.0727,0.1357,0.0028
"8573",199582,"SAINT AUGUSTINES COLLEGE",1,0,1995,"5872","23.370969","94","0","385",203,182,61,"17",44,0.2167,0.0934,0.1584,0
"8574",199582,"SAINT AUGUSTINES COLLEGE",1,0,1996,"6284","29.01601","94","0","408",228,180,46,"21",25,0.1096,0.1167,0.1127,0
"8575",199582,"SAINT AUGUSTINES COLLEGE",1,0,1997,"6472","22.849424","91","1","400",228,172,60,"14",46,0.2018,0.0814,0.15,0.0025
"8576",199582,"SAINT AUGUSTINES COLLEGE",1,0,1998,"6796","22.782591","85","1","299",164,135,57,"13",44,0.2683,0.0963,0.1906,0.0033
"8577",199582,"SAINT AUGUSTINES COLLEGE",1,0,1999,"5132","23.949176","87","0","331",173,158,57,"16",41,0.237,0.1013,0.1722,0
"8578",199582,"SAINT AUGUSTINES COLLEGE",1,0,2000,"5650","24.317507","82","1","398",232,166,67,"17",50,0.2155,0.1024,0.1683,0.0025
"8579",199582,"SAINT AUGUSTINES COLLEGE",1,0,2001,"5780","23.153979","77","0","324",172,152,52,"16",36,0.2093,0.1053,0.1605,0
"8580",199582,"SAINT AUGUSTINES COLLEGE",1,0,2002,"6030","22.7774","79","0","449",183,266,25,"13",12,0.0656,0.0489,0.0557,0
"8581",199582,"SAINT AUGUSTINES COLLEGE",1,0,2003,"7398","24.617634","78","3","542",238,304,46,"15",31,0.1303,0.0493,0.0849,0.0055
"8582",199582,"SAINT AUGUSTINES COLLEGE",1,0,2004,"8138","27.238148","89","3","324",140,184,45,"15",30,0.2143,0.0815,0.1389,0.0093
"8583",199582,"Saint Augustines College",1,0,2005,"8952","25.543337","78","0","261",129,132,34,"16",18,0.1395,0.1212,0.1303,0
"8584",199582,"Saint Augustines College",1,0,2006,"9980","26.046792","78","2","363",146,217,58,"23",35,0.2397,0.106,0.1598,0.0055
"8585",199582,"Saint Augustines College",1,0,2007,"10580","27.090028","82","4","417",188,229,91,"31",60,0.3191,0.1354,0.2182,0.0096
"8586",199582,"Saint Augustines College",1,0,2008,"10580","30.946509","72","3","484",233,251,87,"33",54,0.2318,0.1315,0.1798,0.0062
"8587",199582,"Saint Augustines College",1,0,2009,"12004","33.153065","72","13","424",206,218,91,"35",56,0.2718,0.1606,0.2146,0.0307
"8588",199582,"Saint Augustines College",1,0,2010,"12364","36.154727","79","3","440",196,244,78,"25",53,0.2704,0.1025,0.1773,0.0068
"8589",199643,"SHAW UNIVERSITY",1,0,1991,"4894","19.786174","73","22","579",330,249,190,"82",108,0.3273,0.3293,0.3282,0.038
"8590",199643,"SHAW UNIVERSITY",1,0,1992,"5272","22.451455","103","17","740",428,312,124,"33",91,0.2126,0.1058,0.1676,0.023
"8591",199643,"SHAW UNIVERSITY",1,0,1993,"5562","27.717843","92","7","601",336,265,140,"43",97,0.2887,0.1623,0.2329,0.0116
"8592",199643,"SHAW UNIVERSITY",1,0,1995,"5946","30.102557","99","14","518",305,213,127,"29",98,0.3213,0.1362,0.2452,0.027
"8593",199643,"SHAW UNIVERSITY",1,0,1996,"5946","32.18454","82","5","374",232,142,67,"17",50,0.2155,0.1197,0.1791,0.0134
"8594",199643,"SHAW UNIVERSITY",1,0,1997,"6304","29.75521","84","5","304",173,131,43,"12",31,0.1792,0.0916,0.1414,0.0164
"8595",199643,"SHAW UNIVERSITY",1,0,1998,"6494","31.870102","88","8","382",220,162,73,"20",53,0.2409,0.1235,0.1911,0.0209
"8596",199643,"SHAW UNIVERSITY",1,0,1999,"6272","24.372092","80","3","440",258,182,61,"21",40,0.155,0.1154,0.1386,0.0068
"8597",199643,"SHAW UNIVERSITY",1,0,2000,"6712","38.043487","88","7","401",247,154,43,"13",30,0.1215,0.0844,0.1072,0.0175
"8598",199643,"SHAW UNIVERSITY",1,0,2001,"7056","40.720949","96","13","445",283,162,83,"18",65,0.2297,0.1111,0.1865,0.0292
"8599",199643,"SHAW UNIVERSITY",1,0,2002,"7560","29.89823","85","11","526",240,286,67,"26",41,0.1708,0.0909,0.1274,0.0209
"8600",199643,"SHAW UNIVERSITY",1,0,2003,"7800","35.945192","88","6","469",249,220,79,"31",48,0.1928,0.1409,0.1684,0.0128
"8601",199643,"SHAW UNIVERSITY",1,0,2004,"7800","38.941877","105","9","417",227,190,61,"16",45,0.1982,0.0842,0.1463,0.0216
"8602",199643,"Shaw University",1,0,2005,"7800","44.333827","111","5","573",307,266,75,"29",46,0.1498,0.109,0.1309,0.0087
"8603",199643,"Shaw University",1,0,2006,"8280","41.67657","112","10","674",423,251,82,"23",59,0.1395,0.0916,0.1217,0.0148
"8604",199643,"Shaw University",1,0,2007,"8800","46.607835","116","11","565",321,244,89,"35",54,0.1682,0.1434,0.1575,0.0195
"8605",199643,"Shaw University",1,0,2008,"9336","51.415955","114","9","532",308,224,64,"21",43,0.1396,0.0938,0.1203,0.0169
"8606",199643,"Shaw University",1,0,2009,"9336","49.133124","105","11","581",334,247,74,"24",50,0.1497,0.0972,0.1274,0.0189
"8607",199643,"Shaw University",1,0,2010,"9840","46.36996","120","9","679",360,319,54,"23",31,0.0861,0.0721,0.0795,0.0133
"8608",199847,"WAKE FOREST UNIVERSITY",1,0,1991,"10800","296.979272","317","753","857",425,432,659,"299",360,0.8471,0.6921,0.769,0.8786
"8609",199847,"WAKE FOREST UNIVERSITY",1,0,1992,"12000","325.932635","313","805","909",445,464,639,"300",339,0.7618,0.6466,0.703,0.8856
"8610",199847,"WAKE FOREST UNIVERSITY",1,0,1993,"13000","357.49889","323","793","904",443,461,676,"314",362,0.8172,0.6811,0.7478,0.8772
"8611",199847,"WAKE FOREST UNIVERSITY",1,0,1995,"14750","411.465504","331","841","962",458,504,720,"357",363,0.7926,0.7083,0.7484,0.8742
"8612",199847,"WAKE FOREST UNIVERSITY",1,0,1996,"18500","448.124309","365","802","934",500,434,707,"297",410,0.82,0.6843,0.757,0.8587
"8613",199847,"WAKE FOREST UNIVERSITY",1,0,1997,"19450","477.012669","383","849","962",483,479,739,"338",401,0.8302,0.7056,0.7682,0.8825
"8614",199847,"WAKE FOREST UNIVERSITY",1,0,1998,"20450","516.337","394","875","993",505,488,746,"334",412,0.8158,0.6844,0.7513,0.8812
"8615",199847,"WAKE FOREST UNIVERSITY",1,0,1999,"21420","562.383172","409","865","969",498,471,760,"327",433,0.8695,0.6943,0.7843,0.8927
"8616",199847,"WAKE FOREST UNIVERSITY",1,0,2000,"22410","602.731","418","886","1020",530,490,804,"355",449,0.8472,0.7245,0.7882,0.8686
"8617",199847,"WAKE FOREST UNIVERSITY",1,0,2001,"23530","637.563","427","846","960",481,479,756,"343",413,0.8586,0.7161,0.7875,0.8812
"8618",199847,"WAKE FOREST UNIVERSITY",1,0,2002,"24750","694.329","430","847","999",509,490,832,"393",439,0.8625,0.802,0.8328,0.8478
"8619",199847,"WAKE FOREST UNIVERSITY",1,0,2003,"26490","747.149","434","850","984",507,477,834,"386",448,0.8836,0.8092,0.8476,0.8638
"8620",199847,"WAKE FOREST UNIVERSITY",1,0,2004,"28210","776.132","431","946","1109",552,557,921,"438",483,0.875,0.7864,0.8305,0.853
"8621",199847,"Wake Forest University",1,0,2005,"30110","848.437","450","916","1114",565,549,918,"431",487,0.8619,0.7851,0.8241,0.8223
"8622",199847,"Wake Forest University",1,0,2006,"32040","880.155","466","927","1119",576,543,927,"432",495,0.8594,0.7956,0.8284,0.8284
"8623",199847,"Wake Forest University",1,0,2007,"34230","947.914307","468","936","1123",573,550,919,"433",486,0.8482,0.7873,0.8183,0.8335
"8624",199847,"Wake Forest University",1,0,2008,"36560","1007.182797","471","969","1197",621,576,991,"455",536,0.8631,0.7899,0.8279,0.8095
"8625",199847,"Wake Forest University",1,0,2009,"38206","1032.195854","476","914","1193",628,565,983,"445",538,0.8567,0.7876,0.824,0.7661
"8626",199847,"Wake Forest University",1,0,2010,"39544","1094.58","505","941","1217",639,578,1019,"462",557,0.8717,0.7993,0.8373,0.7732
"8627",199962,"WINGATE COLLEGE",1,0,1991,"6120","14.441504","79","321","371",181,190,93,"28",65,0.3591,0.1474,0.2507,0.8652
"8628",199962,"WINGATE COLLEGE",1,0,1992,"6740","14.801292","77","307","365",179,186,84,"36",48,0.2682,0.1935,0.2301,0.8411
"8629",199962,"WINGATE COLLEGE",1,0,1993,"7410","15.511844","79","314","376",171,205,78,"31",47,0.2749,0.1512,0.2074,0.8351
"8630",199962,"WINGATE UNIVERSITY",1,0,1995,"8760","17.11071","80","289","334",157,177,113,"45",68,0.4331,0.2542,0.3383,0.8653
"8631",199962,"WINGATE UNIVERSITY",1,0,1996,"11090","18.129196","83","289","331",137,194,101,"43",58,0.4234,0.2216,0.3051,0.8731
"8632",199962,"WINGATE UNIVERSITY",1,0,1997,"11730","20.898424","82","255","296",123,173,103,"43",60,0.4878,0.2486,0.348,0.8615
"8633",199962,"WINGATE UNIVERSITY",1,0,1998,"12150","22.610917","79","245","273",127,146,89,"34",55,0.4331,0.2329,0.326,0.8974
"8634",199962,"WINGATE UNIVERSITY",1,0,1999,"11950","22.896256","79","242","301",144,157,102,"32",70,0.4861,0.2038,0.3389,0.804
"8635",199962,"WINGATE UNIVERSITY",1,0,2000,"12300","25.14358","79.5","303","380",181,199,142,"54",88,0.4862,0.2714,0.3737,0.7974
"8636",199962,"WINGATE UNIVERSITY",1,0,2001,"12900","21.88753","80","334","393",209,184,147,"44",103,0.4928,0.2391,0.374,0.8499
"8637",199962,"WINGATE UNIVERSITY",1,0,2002,"13550","21.480104","83","314","374",197,177,167,"62",105,0.533,0.3503,0.4465,0.8396
"8638",199962,"WINGATE UNIVERSITY",1,0,2003,"14200","23.276722","95","314","372",198,174,160,"55",105,0.5303,0.3161,0.4301,0.8441
"8639",199962,"WINGATE UNIVERSITY",1,0,2004,"15000","25.920346","100","296","358",174,184,155,"66",89,0.5115,0.3587,0.433,0.8268
"8640",199962,"Wingate University",1,0,2005,"15800","27.134805","102","319","371",183,188,154,"54",100,0.5464,0.2872,0.4151,0.8598
"8641",199962,"Wingate University",1,0,2006,"16600","29.988279","110","294","385",198,187,152,"57",95,0.4798,0.3048,0.3948,0.7636
"8642",199962,"Wingate University",1,0,2007,"17430","32.288341","114","318","426",209,217,200,"87",113,0.5407,0.4009,0.4695,0.7465
"8643",199962,"Wingate University",1,0,2008,"18300","34.755853","111","291","431",223,208,183,"79",104,0.4664,0.3798,0.4246,0.6752
"8644",199962,"Wingate University",1,0,2009,"18990","37.651227","122","243","375",195,180,150,"59",91,0.4667,0.3278,0.4,0.648
"8645",199962,"Wingate University",1,0,2010,"19990","38.599921","120","366","605",336,269,267,"95",172,0.5119,0.3532,0.4413,0.605
"8646",199999,"WINSTON-SALEM STATE UNIVERSITY",1,0,1991,"1060","28.014394","147","16","431",287,144,59,"7",52,0.1812,0.0486,0.1369,0.0371
"8647",199999,"WINSTON-SALEM STATE UNIVERSITY",1,0,1992,"1094","29.794754","146","14","391",267,124,83,"20",63,0.236,0.1613,0.2123,0.0358
"8648",199999,"WINSTON-SALEM STATE UNIVERSITY",1,0,1993,"1172","29.731085","149","19","369",225,144,79,"26",53,0.2356,0.1806,0.2141,0.0515
"8649",199999,"WINSTON-SALEM STATE UNIVERSITY",1,0,1995,"1351","35.005407","156","27","446",298,148,121,"32",89,0.2987,0.2162,0.2713,0.0605
"8650",199999,"WINSTON-SALEM STATE UNIVERSITY",1,0,1996,"1414","38.083276","156","35","480",351,129,95,"19",76,0.2165,0.1473,0.1979,0.0729
"8651",199999,"WINSTON-SALEM STATE UNIVERSITY",1,0,1997,"1504","44.122182","157","23","485",329,156,117,"27",90,0.2736,0.1731,0.2412,0.0474
"8652",199999,"WINSTON SALEM STATE UNIVERSITY",1,0,1998,"1561","43.694628","163","19","524",364,160,114,"23",91,0.25,0.1437,0.2176,0.0363
"8653",199999,"WINSTON-SALEM STATE UNIVERSITY",1,0,1999,"806","46.380188","162","12","476",316,160,103,"19",84,0.2658,0.1187,0.2164,0.0252
"8654",199999,"WINSTON-SALEM STATE UNIVERSITY",1,0,2000,"822","49.045277","168.5","21","499",359,140,97,"19",78,0.2173,0.1357,0.1944,0.0421
"8655",199999,"WINSTON-SALEM STATE UNIVERSITY",1,0,2001,"896","54.027212","175","15","614",424,190,124,"17",107,0.2524,0.0895,0.202,0.0244
"8656",199999,"WINSTON-SALEM STATE UNIVERSITY",1,0,2002,"1168","55.039536","179","25","670",471,199,121,"28",93,0.1975,0.1407,0.1806,0.0373
"8657",199999,"WINSTON-SALEM STATE UNIVERSITY",1,0,2003,"1226","60.688933","170","17","883",580,303,124,"25",99,0.1707,0.0825,0.1404,0.0193
"8658",199999,"WINSTON-SALEM STATE UNIVERSITY",1,0,2004,"1451","75.641559","191","29","891",619,272,117,"35",82,0.1325,0.1287,0.1313,0.0325
"8659",199999,"Winston-Salem State University",1,0,2005,"1451","85.167369","200","37","1050",701,349,167,"42",125,0.1783,0.1203,0.159,0.0352
"8660",199999,"Winston-Salem State University",1,0,2006,"1651","98.48319","258","24","976",692,284,144,"36",108,0.1561,0.1268,0.1475,0.0246
"8661",199999,"Winston-Salem State University",1,0,2007,"1701","119.859841","319","34","962",661,301,171,"40",131,0.1982,0.1329,0.1778,0.0353
"8662",199999,"Winston-Salem State University",1,0,2008,"1701","125.464808","338","27","1353",886,467,234,"62",172,0.1941,0.1328,0.1729,0.02
"8663",199999,"Winston-Salem State University",1,0,2009,"1769","132.733103","325","21","794",540,254,135,"39",96,0.1778,0.1535,0.17,0.0264
"8664",199999,"Winston-Salem State University",1,0,2010,"2274","137.864428","343","32","690",465,225,139,"25",114,0.2452,0.1111,0.2014,0.0464
"8665",200004,"WESTERN CAROLINA UNIVERSITY",1,0,1991,"1229","64.499457","291","933","1011",522,489,210,"84",126,0.2414,0.1718,0.2077,0.9228
"8666",200004,"WESTERN CAROLINA UNIVERSITY",1,0,1992,"1271","67.987254","308","998","1065",543,522,208,"76",132,0.2431,0.1456,0.1953,0.9371
"8667",200004,"WESTERN CAROLINA UNIVERSITY",1,0,1993,"1391","75.278888","319","968","1051",509,542,226,"91",135,0.2652,0.1679,0.215,0.921
"8668",200004,"WESTERN CAROLINA UNIVERSITY",1,0,1995,"1589","79.62621","325","1062","1156",608,548,259,"78",181,0.2977,0.1423,0.224,0.9187
"8669",200004,"WESTERN CAROLINA UNIVERSITY",1,0,1996,"1663","82.723451","335","1090","1177",560,617,260,"87",173,0.3089,0.141,0.2209,0.9261
"8670",200004,"WESTERN CAROLINA UNIVERSITY",1,0,1997,"1723","85.820486","328","1119","1224",629,595,310,"100",210,0.3339,0.1681,0.2533,0.9142
"8671",200004,"WESTERN CAROLINA UNIVERSITY",1,0,1998,"1793","90.469027","316","1004","1098",544,554,249,"80",169,0.3107,0.1444,0.2268,0.9144
"8672",200004,"WESTERN CAROLINA UNIVERSITY",1,0,1999,"962","95.250648","313","1043","1151",569,582,261,"103",158,0.2777,0.177,0.2268,0.9062
"8673",200004,"WESTERN CAROLINA UNIVERSITY",1,0,2000,"982","98.092911","309","1075","1211",594,617,298,"120",178,0.2997,0.1945,0.2461,0.8877
"8674",200004,"WESTERN CAROLINA UNIVERSITY",1,0,2001,"1072","101.874263","305","1057","1176",530,646,266,"108",158,0.2981,0.1672,0.2262,0.8988
"8675",200004,"WESTERN CAROLINA UNIVERSITY",1,0,2002,"1358","97.568645","315","1074","1216",627,589,344,"127",217,0.3461,0.2156,0.2829,0.8832
"8676",200004,"WESTERN CAROLINA UNIVERSITY",1,0,2003,"1426","103.453787","326","1346","1485",739,746,394,"138",256,0.3464,0.185,0.2653,0.9064
"8677",200004,"WESTERN CAROLINA UNIVERSITY",1,0,2004,"1651","117.975762","359","1400","1571",805,766,447,"154",293,0.364,0.201,0.2845,0.8912
"8678",200004,"Western Carolina University",1,0,2005,"1651","128.711491","416","1354","1549",775,774,453,"181",272,0.351,0.2339,0.2924,0.8741
"8679",200004,"Western Carolina University",1,0,2006,"1904","148.232425","433","1341","1558",784,774,434,"163",271,0.3457,0.2106,0.2786,0.8607
"8680",200004,"Western Carolina University",1,0,2007,"2028","161.104681","456","1038","1249",651,598,400,"142",258,0.3963,0.2375,0.3203,0.8311
"8681",200004,"Western Carolina University",1,0,2008,"2078","172.883555","472","1036","1218",617,601,485,"198",287,0.4652,0.3295,0.3982,0.8506
"8682",200004,"Western Carolina University",1,0,2009,"2106","177.025145","460","1253","1547",848,699,568,"211",357,0.421,0.3019,0.3672,0.81
"8683",200004,"Western Carolina University",1,0,2010,"2816","168.434269","451","1176","1415",746,669,520,"196",324,0.4343,0.293,0.3675,0.8311
"8684",200059,"DICKINSON STATE UNIVERSITY",1,0,1991,"1706","10.560906","67","306","315",165,150,30,"12",18,0.1091,0.08,0.0952,0.9714
"8685",200059,"DICKINSON STATE UNIVERSITY",1,0,1992,"1706","11.008164","67","328","336",191,145,32,"9",23,0.1204,0.0621,0.0952,0.9762
"8686",200059,"DICKINSON STATE UNIVERSITY",1,0,1993,"1782","11.852361","72","289","300",148,152,22,"5",17,0.1149,0.0329,0.0733,0.9633
"8687",200059,"DICKINSON STATE UNIVERSITY",1,0,1995,"1856","12.57954","73","279","296",140,156,27,"10",17,0.1214,0.0641,0.0912,0.9426
"8688",200059,"DICKINSON STATE UNIVERSITY",1,0,1996,"1970","12.524529","72","375","397",193,204,24,"9",15,0.0777,0.0441,0.0605,0.9446
"8689",200059,"DICKINSON STATE UNIVERSITY",1,0,1997,"2096","13.272999","71","391","408",233,175,39,"15",24,0.103,0.0857,0.0956,0.9583
"8690",200059,"DICKINSON STATE UNIVERSITY",1,0,1998,"2196","13.496673","70","349","363",204,159,26,"4",22,0.1078,0.0252,0.0716,0.9614
"8691",200059,"DICKINSON STATE UNIVERSITY",1,0,1999,"1906","15.683917","72","346","359",179,180,39,"15",24,0.1341,0.0833,0.1086,0.9638
"8692",200059,"DICKINSON STATE UNIVERSITY",1,0,2000,"1982","17.513993","71.5","329","350",208,142,34,"14",20,0.0962,0.0986,0.0971,0.94
"8693",200059,"DICKINSON STATE UNIVERSITY",1,0,2001,"2067","18.488388","71","341","375",188,187,39,"8",31,0.1649,0.0428,0.104,0.9093
"8694",200059,"DICKINSON STATE UNIVERSITY",1,0,2002,"2202","18.04474","72","327","368",193,175,32,"8",24,0.1244,0.0457,0.087,0.8886
"8695",200059,"DICKINSON STATE UNIVERSITY",1,0,2003,"2554","18.949013","83","335","383",201,182,42,"14",28,0.1393,0.0769,0.1097,0.8747
"8696",200059,"DICKINSON STATE UNIVERSITY",1,0,2004,"3040","20.135147","94","286","332",170,162,37,"15",22,0.1294,0.0926,0.1114,0.8614
"8697",200059,"Dickinson State University",1,0,2005,"3329","22.104203","89","263","317",162,155,29,"11",18,0.1111,0.071,0.0915,0.8297
"8698",200059,"Dickinson State University",1,0,2006,"3645","24.219064","87","240","333",160,173,50,"22",28,0.175,0.1272,0.1502,0.7207
"8699",200059,"Dickinson State University",1,0,2007,"3828","26.348263","86","270","355",191,164,48,"19",29,0.1518,0.1159,0.1352,0.7606
"8700",200059,"Dickinson State University",1,0,2008,"4019","27.259803","93","228","320",142,178,34,"16",18,0.1268,0.0899,0.1062,0.7125
"8701",200059,"Dickinson State University",1,0,2009,"4160","29.008236","95","211","307",177,130,43,"13",30,0.1695,0.1,0.1401,0.6873
"8702",200059,"Dickinson State University",1,0,2010,"4304","29.571623","93","226","307",146,161,33,"14",19,0.1301,0.087,0.1075,0.7362
"8703",200156,"JAMESTOWN COLLEGE",1,0,1991,"6670","9.987004","48","256","288",134,154,68,"21",47,0.3507,0.1364,0.2361,0.8889
"8704",200156,"JAMESTOWN COLLEGE",1,0,1992,"6920","12.370116","47","263","292",140,152,86,"27",59,0.4214,0.1776,0.2945,0.9007
"8705",200156,"JAMESTOWN COLLEGE",1,0,1993,"7270","12.310374","52","244","262",121,141,62,"27",35,0.2893,0.1915,0.2366,0.9313
"8706",200156,"JAMESTOWN COLLEGE",1,0,1995,"7970","13.235665","50","282","289",144,145,89,"32",57,0.3958,0.2207,0.308,0.9758
"8707",200156,"JAMESTOWN COLLEGE",1,0,1996,"8420","13.583434","52","269","288",159,129,90,"25",65,0.4088,0.1938,0.3125,0.934
"8708",200156,"JAMESTOWN COLLEGE",1,0,1997,"8770","9.711538","51","220","232",134,98,100,"36",64,0.4776,0.3673,0.431,0.9483
"8709",200156,"JAMESTOWN COLLEGE",1,0,1998,"6770","9.942702","50","261","278",150,128,99,"39",60,0.4,0.3047,0.3561,0.9388
"8710",200156,"JAMESTOWN COLLEGE",1,0,1999,"7150","10.842389","53","269","284",165,119,84,"31",53,0.3212,0.2605,0.2958,0.9472
"8711",200156,"JAMESTOWN COLLEGE",1,0,2000,"7550","11.799264","53.5","304","331",192,139,107,"35",72,0.375,0.2518,0.3233,0.9184
"8712",200156,"JAMESTOWN COLLEGE",1,0,2001,"7925","12.48553","54","274","293",173,120,96,"35",61,0.3526,0.2917,0.3276,0.9352
"8713",200156,"JAMESTOWN COLLEGE",1,0,2002,"8350","12.332878","57","302","332",176,156,98,"29",69,0.392,0.1859,0.2952,0.9096
"8714",200156,"JAMESTOWN COLLEGE",1,0,2003,"8750","12.568543","58","232","261",142,119,82,"27",55,0.3873,0.2269,0.3142,0.8889
"8715",200156,"JAMESTOWN COLLEGE",1,0,2004,"9400","13.791444","56","210","229",135,94,63,"33",30,0.2222,0.3511,0.2751,0.917
"8716",200156,"Jamestown College",1,0,2005,"10000","13.087106","56","249","270",139,131,67,"24",43,0.3094,0.1832,0.2481,0.9222
"8717",200156,"Jamestown College",1,0,2006,"10550","13.641549","56","223","238",129,109,75,"21",54,0.4186,0.1927,0.3151,0.937
"8718",200156,"Jamestown College",1,0,2007,"11235","14.037446","54","239","264",140,124,88,"26",62,0.4429,0.2097,0.3333,0.9053
"8719",200156,"Jamestown College",1,0,2008,"12748","14.930614","55","234","267",123,144,74,"27",47,0.3821,0.1875,0.2772,0.8764
"8720",200156,"Jamestown College",1,0,2009,"14432","15.716489","57","208","233",116,117,49,"17",32,0.2759,0.1453,0.2103,0.8927
"8721",200156,"Jamestown College",1,0,2010,"15680","15.757374","58","161","202",98,104,72,"27",45,0.4592,0.2596,0.3564,0.797
"8722",200217,"UNIVERSITY OF MARY",1,0,1991,"5550","11.369664","66","294","317",179,138,96,"33",63,0.352,0.2391,0.3028,0.9274
"8723",200217,"UNIVERSITY OF MARY",1,0,1992,"5900","13.030383","70","312","343",205,138,104,"30",74,0.361,0.2174,0.3032,0.9096
"8724",200217,"UNIVERSITY OF MARY",1,0,1993,"6260","14.575056","75","326","350",224,126,91,"20",71,0.317,0.1587,0.26,0.9314
"8725",200217,"UNIVERSITY OF MARY",1,0,1995,"6950","16.232706","76","388","412",234,178,115,"32",83,0.3547,0.1798,0.2791,0.9417
"8726",200217,"UNIVERSITY OF MARY",1,0,1996,"7330","21.913103","78","408","440",266,174,117,"36",81,0.3045,0.2069,0.2659,0.9273
"8727",200217,"UNIVERSITY OF MARY",1,0,1997,"7590","18.391483","82","366","381",242,139,131,"32",99,0.4091,0.2302,0.3438,0.9606
"8728",200217,"UNIVERSITY OF MARY",1,0,1998,"8080","20.575285","85","385","404",244,160,149,"39",110,0.4508,0.2438,0.3688,0.953
"8729",200217,"UNIVERSITY OF MARY",1,0,1999,"8200","20.326058","83","359","373",242,131,155,"42",113,0.4669,0.3206,0.4155,0.9625
"8730",200217,"UNIVERSITY OF MARY",1,0,2000,"8500","23.864083","87","335","351",201,150,142,"37",105,0.5224,0.2467,0.4046,0.9544
"8731",200217,"UNIVERSITY OF MARY",1,0,2001,"8800","25.860343","91","348","372",213,159,143,"43",100,0.4695,0.2704,0.3844,0.9355
"8732",200217,"UNIVERSITY OF MARY",1,0,2002,"9200","28.025394","91","381","402",240,162,168,"44",124,0.5167,0.2716,0.4179,0.9478
"8733",200217,"UNIVERSITY OF MARY",1,0,2003,"9600","28.364408","90","353","390",226,164,147,"36",111,0.4912,0.2195,0.3769,0.9051
"8734",200217,"UNIVERSITY OF MARY",1,0,2004,"9990","29.697446","93","400","430",251,179,156,"46",110,0.4382,0.257,0.3628,0.9302
"8735",200217,"University of Mary",1,0,2005,"10600","31.573727","100","358","392",220,172,103,"28",75,0.3409,0.1628,0.2628,0.9133
"8736",200217,"University of Mary",1,0,2006,"11100","32.692775","100","316","343",187,156,19,"10",9,0.0481,0.0641,0.0554,0.9213
"8737",200217,"University of Mary",1,0,2007,"11530","34.078643","103","302","352",206,146,99,"20",79,0.3835,0.137,0.2812,0.858
"8738",200217,"University of Mary",1,0,2008,"11940","35.86203","98","339","373",227,146,108,"25",83,0.3656,0.1712,0.2895,0.9088
"8739",200217,"University of Mary",1,0,2009,"12360","37.054471","95","280","311",192,119,122,"32",90,0.4688,0.2689,0.3923,0.9003
"8740",200217,"University of Mary",1,0,2010,"12800","36.616858","93","307","362",203,159,138,"38",100,0.4926,0.239,0.3812,0.8481
"8741",200226,"MAYVILLE STATE UNIVERSITY",0,1,1991,"2133","6.489673","33","150","162",83,79,21,"3",18,0.2169,0.038,0.1296,0.9259
"8742",200226,"MAYVILLE STATE UNIVERSITY",1,0,1992,"2755","7.097166","36","143","165",86,79,15,"5",10,0.1163,0.0633,0.0909,0.8667
"8743",200226,"MAYVILLE STATE UNIVERSITY",1,0,1993,"1831","7.679234","37","122","146",61,85,17,"4",13,0.2131,0.0471,0.1164,0.8356
"8744",200226,"MAYVILLE STATE UNIVERSITY",1,0,1995,"2340","7.907681","36","172","193",80,113,25,"10",15,0.1875,0.0885,0.1295,0.8912
"8745",200226,"MAYVILLE STATE UNIVERSITY",1,0,1996,"2016","8.187579","39","141","148",79,69,22,"7",15,0.1899,0.1014,0.1486,0.9527
"8746",200226,"MAYVILLE STATE UNIVERSITY",1,0,1997,"2946","8.629243","37","112","129",73,56,20,"6",14,0.1918,0.1071,0.155,0.8682
"8747",200226,"MAYVILLE STATE UNIVERSITY",1,0,1998,"3032","9.141511","38","132","153",56,97,32,"16",16,0.2857,0.1649,0.2092,0.8627
"8748",200226,"MAYVILLE STATE UNIVERSITY",1,0,1999,"1906","9.350614","39","130","140",71,69,41,"15",26,0.3662,0.2174,0.2929,0.9286
"8749",200226,"MAYVILLE STATE UNIVERSITY",1,0,2000,"1982","9.239771","37.5","145","153",73,80,22,"6",16,0.2192,0.075,0.1438,0.9477
"8750",200226,"MAYVILLE STATE UNIVERSITY",1,0,2001,"2067","9.748057","36","127","133",62,71,18,"6",12,0.1935,0.0845,0.1353,0.9549
"8751",200226,"MAYVILLE STATE UNIVERSITY",1,0,2002,"2202","11.110985","39","125","135",79,56,32,"4",28,0.3544,0.0714,0.237,0.9259
"8752",200226,"MAYVILLE STATE UNIVERSITY",1,0,2003,"2576","12.08186","36","113","135",70,65,26,"9",17,0.2429,0.1385,0.1926,0.837
"8753",200226,"MAYVILLE STATE UNIVERSITY",1,0,2004,"3014","11.486732","37","128","162",72,90,25,"5",20,0.2778,0.0556,0.1543,0.7901
"8754",200226,"Mayville State University",1,0,2005,"3300","13.30326","36","121","144",63,81,28,"10",18,0.2857,0.1235,0.1944,0.8403
"8755",200226,"Mayville State University",1,0,2006,"3614","12.743712","36","116","137",59,78,29,"7",22,0.3729,0.0897,0.2117,0.8467
"8756",200226,"Mayville State University",1,0,2007,"3795","12.724384","42","76","89",42,47,18,"5",13,0.3095,0.1064,0.2022,0.8539
"8757",200226,"Mayville State University",1,0,2008,"3985","13.502006","40","71","89",52,37,17,"5",12,0.2308,0.1351,0.191,0.7978
"8758",200226,"Mayville State University",1,0,2009,"4124","13.63168","39","98","147",57,90,17,"7",10,0.1754,0.0778,0.1156,0.6667
"8759",200226,"Mayville State University",1,0,2010,"4268","15.716217","38","99","130",54,76,17,"10",7,0.1296,0.1316,0.1308,0.7615
"8760",200253,"MINOT STATE UNIVERSITY",0,1,1991,"1701","21.227869","166","457","546",363,183,52,"14",38,0.1047,0.0765,0.0952,0.837
"8761",200253,"MINOT STATE UNIVERSITY",1,0,1992,"1710","23.801848","169","483","624",398,226,30,"6",24,0.0603,0.0265,0.0481,0.774
"8762",200253,"MINOT STATE UNIVERSITY",1,0,1993,"1836","25.424522","188","455","579",346,233,48,"13",35,0.1012,0.0558,0.0829,0.7858
"8763",200253,"MINOT STATE UNIVERSITY",1,0,1995,"1960","28.543612","183","447","525",322,203,36,"11",25,0.0776,0.0542,0.0686,0.8514
"8764",200253,"MINOT STATE UNIVERSITY",1,0,1996,"2044","27.355287","209","396","457",304,153,35,"10",25,0.0822,0.0654,0.0766,0.8665
"8765",200253,"MINOT STATE UNIVERSITY",1,0,1997,"2139","31.36524","176","389","442",270,172,38,"9",29,0.1074,0.0523,0.086,0.8801
"8766",200253,"MINOT STATE UNIVERSITY",1,0,1998,"2240","32.105149","166","325","371",217,154,28,"7",21,0.0968,0.0455,0.0755,0.876
"8767",200253,"MINOT STATE UNIVERSITY",1,0,1999,"2050","33.196981","186","395","433",251,182,40,"11",29,0.1155,0.0604,0.0924,0.9122
"8768",200253,"MINOT STATE UNIVERSITY",1,0,2000,"2144","30.012989","171","396","452",260,192,61,"25",36,0.1385,0.1302,0.135,0.8761
"8769",200253,"MINOT STATE UNIVERSITY",1,0,2001,"2244","32.123074","156","370","419",241,178,43,"11",32,0.1328,0.0618,0.1026,0.8831
"8770",200253,"MINOT STATE UNIVERSITY",1,0,2002,"2344","31.983363","177","414","476",268,208,62,"11",51,0.1903,0.0529,0.1303,0.8697
"8771",200253,"MINOT STATE UNIVERSITY",1,0,2003,"2730","36.654774","159","375","435",252,183,70,"16",54,0.2143,0.0874,0.1609,0.8621
"8772",200253,"MINOT STATE UNIVERSITY",1,0,2004,"3160","37.133801","176","369","431",254,177,72,"20",52,0.2047,0.113,0.1671,0.8561
"8773",200253,"Minot State University",1,0,2005,"3460","38.539855","171","378","431",240,191,64,"19",45,0.1875,0.0995,0.1485,0.877
"8774",200253,"Minot State University",1,0,2006,"3790","39.90512","185","355","461",263,198,58,"13",45,0.1711,0.0657,0.1258,0.7701
"8775",200253,"Minot State University",1,0,2007,"3980","42.563128","180","347","418",231,187,60,"21",39,0.1688,0.1123,0.1435,0.8301
"8776",200253,"Minot State University",1,0,2008,"4179","41.42809","189","318","406",259,147,55,"11",44,0.1699,0.0748,0.1355,0.7833
"8777",200253,"Minot State University",1,0,2009,"4325","43.176406","179","321","418",238,180,68,"21",47,0.1975,0.1167,0.1627,0.7679
"8778",200253,"Minot State University",1,0,2010,"4476","49.394209","187","344","461",298,163,83,"10",73,0.245,0.0613,0.18,0.7462
"8779",200280,"UNIVERSITY OF NORTH DAKOTA-MAIN CAMPUS",1,0,1991,"2145","178.321194","458","1188","1288",588,700,161,"78",83,0.1412,0.1114,0.125,0.9224
"8780",200280,"UNIVERSITY OF NORTH DAKOTA-MAIN CAMPUS",1,0,1992,"2165","195.727621","473","1466","1579",724,855,189,"87",102,0.1409,0.1018,0.1197,0.9284
"8781",200280,"UNIVERSITY OF NORTH DAKOTA-MAIN CAMPUS",1,0,1993,"2298","200.56233","472","1371","1465",747,718,205,"80",125,0.1673,0.1114,0.1399,0.9358
"8782",200280,"UNIVERSITY OF NORTH DAKOTA-MAIN CAMPUS",1,0,1995,"2428","217.025833","505","1314","1407",665,742,190,"81",109,0.1639,0.1092,0.135,0.9339
"8783",200280,"UNIVERSITY OF NORTH DAKOTA-MAIN CAMPUS",1,0,1996,"2528","202.017128","495","1269","1365",630,735,194,"92",102,0.1619,0.1252,0.1421,0.9297
"8784",200280,"UNIVERSITY OF NORTH DAKOTA-MAIN CAMPUS",1,0,1997,"2677","192.078254","457","1394","1516",742,774,222,"94",128,0.1725,0.1214,0.1464,0.9195
"8785",200280,"UNIVERSITY OF NORTH DAKOTA-MAIN CAMPUS",1,0,1998,"2830","205.996973","440","1377","1465",722,743,326,"141",185,0.2562,0.1898,0.2225,0.9399
"8786",200280,"UNIVERSITY OF NORTH DAKOTA-MAIN CAMPUS",1,0,1999,"2956","200.226704","442","1636","1742",846,896,394,"179",215,0.2541,0.1998,0.2262,0.9392
"8787",200280,"UNIVERSITY OF NORTH DAKOTA-MAIN CAMPUS",1,0,2000,"2604","199.352765","455.5","1731","1832",858,974,394,"192",202,0.2354,0.1971,0.2151,0.9449
"8788",200280,"UNIVERSITY OF NORTH DAKOTA-MAIN CAMPUS",1,0,2001,"2754","210.147716","469","1816","1969",870,1099,436,"191",245,0.2816,0.1738,0.2214,0.9223
"8789",200280,"UNIVERSITY OF NORTH DAKOTA-MAIN CAMPUS",1,0,2002,"2954","235.044663","482","1856","1987",935,1052,438,"205",233,0.2492,0.1949,0.2204,0.9341
"8790",200280,"UNIVERSITY OF NORTH DAKOTA-MAIN CAMPUS",1,0,2003,"3441","246.246874","515","2063","2213",1039,1174,511,"244",267,0.257,0.2078,0.2309,0.9322
"8791",200280,"UNIVERSITY OF NORTH DAKOTA-MAIN CAMPUS",1,0,2004,"4009","272.185438","526","2015","2178",1016,1162,459,"216",243,0.2392,0.1859,0.2107,0.9252
"8792",200280,"University of North Dakota",1,0,2005,"4390","293.657592","577","1769","1851",858,993,425,"198",227,0.2646,0.1994,0.2296,0.9557
"8793",200280,"University of North Dakota",1,0,2006,"4786","304.062813","485","1754","1868",869,999,438,"199",239,0.275,0.1992,0.2345,0.939
"8794",200280,"University of North Dakota",1,0,2007,"5025","317.457758","488","1673","1832",883,949,441,"200",241,0.2729,0.2107,0.2407,0.9132
"8795",200280,"University of North Dakota",1,0,2008,"5276","333.474592","505","1781","1923",896,1027,450,"214",236,0.2634,0.2084,0.234,0.9262
"8796",200280,"University of North Dakota",1,0,2009,"5461","359.245923","527","1744","1970",940,1030,468,"218",250,0.266,0.2117,0.2376,0.8853
"8797",200280,"University of North Dakota",1,0,2010,"5652","374.77697","550","1773","2073",978,1095,527,"237",290,0.2965,0.2164,0.2542,0.8553
"8798",200332,"NORTH DAKOTA STATE UNIVERSITY MAIN CAMPUS",0,1,1991,"2248","120.230824","465","1157","1192",491,701,134,"58",76,0.1548,0.0827,0.1124,0.9706
"8799",200332,"NORTH DAKOTA STATE UNIVERSITY MAIN CAMPUS",1,0,1992,"2032","131.704195","464","1504","1550",674,876,155,"68",87,0.1291,0.0776,0.1,0.9703
"8800",200332,"NORTH DAKOTA STATE UNIVERSITY MAIN CAMPUS",1,0,1993,"2184","133.019603","448","1395","1433",571,862,182,"76",106,0.1856,0.0882,0.127,0.9735
"8801",200332,"NORTH DAKOTA STATE UNIVERSITY MAIN CAMPUS",1,0,1995,"2310","144.666895","501","1445","1482",661,821,189,"87",102,0.1543,0.106,0.1275,0.975
"8802",200332,"NORTH DAKOTA STATE UNIVERSITY MAIN CAMPUS",1,0,1996,"2410","145.564523","484","1250","1295",543,752,169,"83",86,0.1584,0.1104,0.1305,0.9653
"8803",200332,"NORTH DAKOTA STATE UNIVERSITY MAIN CAMPUS",1,0,1997,"2566","149.863168","487","1154","1199",497,702,194,"83",111,0.2233,0.1182,0.1618,0.9625
"8804",200332,"NORTH DAKOTA STATE UNIVERSITY-MAIN CAMPUS",1,0,1998,"2730","154.633478","473","1191","1259",524,735,181,"83",98,0.187,0.1129,0.1438,0.946
"8805",200332,"NORTH DAKOTA STATE UNIVERSITY-MAIN CAMPUS",1,0,1999,"2596","163.599463","484","1204","1268",514,754,240,"111",129,0.251,0.1472,0.1893,0.9495
"8806",200332,"NORTH DAKOTA STATE UNIVERSITY-MAIN CAMPUS",1,0,2000,"2604","167.737324","487.5","1234","1280",512,768,217,"102",115,0.2246,0.1328,0.1695,0.9641
"8807",200332,"NORTH DAKOTA STATE UNIVERSITY-MAIN CAMPUS",1,0,2001,"2754","184.680315","491","1130","1187",491,696,162,"80",82,0.167,0.1149,0.1365,0.952
"8808",200332,"NORTH DAKOTA STATE UNIVERSITY-MAIN CAMPUS",1,0,2002,"2904","204.971957","527","1721","1803",785,1018,387,"186",201,0.2561,0.1827,0.2146,0.9545
"8809",200332,"NORTH DAKOTA STATE UNIVERSITY-MAIN CAMPUS",1,0,2003,"3374","216.557185","527","1840","1944",902,1042,423,"178",245,0.2716,0.1708,0.2176,0.9465
"8810",200332,"NORTH DAKOTA STATE UNIVERSITY-MAIN CAMPUS",1,0,2004,"3981","226.343511","531","1940","2089",949,1140,481,"220",261,0.275,0.193,0.2303,0.9287
"8811",200332,"North Dakota State University-Main Campus",1,0,2005,"4360","241.514229","837","1879","1970",940,1030,457,"191",266,0.283,0.1854,0.232,0.9538
"8812",200332,"North Dakota State University-Main Campus",1,0,2006,"4774","262.386066","580","1902","2040",920,1120,486,"221",265,0.288,0.1973,0.2382,0.9324
"8813",200332,"North Dakota State University-Main Campus",1,0,2007,"5013","273.79201","609","1999","2125",965,1160,544,"244",300,0.3109,0.2103,0.256,0.9407
"8814",200332,"North Dakota State University-Main Campus",1,0,2008,"5264","298.618911","539","2439","2650",1182,1468,667,"326",341,0.2885,0.2221,0.2517,0.9204
"8815",200332,"North Dakota State University-Main Campus",1,0,2009,"5448","322.595971","564","2250","2435",1111,1324,655,"299",356,0.3204,0.2258,0.269,0.924
"8816",200332,"North Dakota State University-Main Campus",1,0,2010,"5639","350.326893","568","2131","2373",1074,1299,635,"297",338,0.3147,0.2286,0.2676,0.898
"8817",200572,"VALLEY CITY STATE UNIVERSITY",0,1,1991,"1707","8.405845","54","171","186",100,86,21,"2",19,0.19,0.0233,0.1129,0.9194
"8818",200572,"VALLEY CITY STATE UNIVERSITY",1,0,1992,"1707","8.916437","56","172","193",90,103,28,"12",16,0.1778,0.1165,0.1451,0.8912
"8819",200572,"VALLEY CITY STATE UNIVERSITY",1,0,1993,"1815","9.131216","55","171","196",80,116,34,"12",22,0.275,0.1034,0.1735,0.8724
"8820",200572,"VALLEY CITY STATE UNIVERSITY",1,0,1995,"1893","9.988352","53","149","166",80,86,32,"11",21,0.2625,0.1279,0.1928,0.8976
"8821",200572,"VALLEY CITY STATE UNIVERSITY",1,0,1996,"2843","10.438168","53","167","178",99,79,38,"15",23,0.2323,0.1899,0.2135,0.9382
"8822",200572,"VALLEY CITY STATE UNIVERSITY",1,0,1997,"2919","11.372601","51","158","177",100,77,37,"8",29,0.29,0.1039,0.209,0.8927
"8823",200572,"VALLEY CITY STATE UNIVERSITY",1,0,1998,"3023","11.853363","50","172","193",100,93,47,"12",35,0.35,0.129,0.2435,0.8912
"8824",200572,"VALLEY CITY STATE UNIVERSITY",1,0,1999,"1906","12.212215","56","142","158",76,82,35,"8",27,0.3553,0.0976,0.2215,0.8987
"8825",200572,"VALLEY CITY STATE UNIVERSITY",1,0,2000,"1982","12.744333","57","160","179",92,87,35,"11",24,0.2609,0.1264,0.1955,0.8939
"8826",200572,"VALLEY CITY STATE UNIVERSITY",1,0,2001,"2067","13.341774","58","140","155",75,80,40,"15",25,0.3333,0.1875,0.2581,0.9032
"8827",200572,"VALLEY CITY STATE UNIVERSITY",1,0,2002,"2202","14.46102","61","133","153",72,81,41,"21",20,0.2778,0.2593,0.268,0.8693
"8828",200572,"VALLEY CITY STATE UNIVERSITY",1,0,2003,"2652","12.932444","61","143","159",71,88,36,"15",21,0.2958,0.1705,0.2264,0.8994
"8829",200572,"VALLEY CITY STATE UNIVERSITY",1,0,2004,"3130","13.836535","60","143","167",71,96,39,"16",23,0.3239,0.1667,0.2335,0.8563
"8830",200572,"Valley City State University",1,0,2005,"3656","14.291693","65","135","171",73,98,40,"16",24,0.3288,0.1633,0.2339,0.7895
"8831",200572,"Valley City State University",1,0,2006,"4003","14.88441","62","150","177",70,107,44,"20",24,0.3429,0.1869,0.2486,0.8475
"8832",200572,"Valley City State University",1,0,2007,"4204","15.067855","55","154","184",86,98,42,"14",28,0.3256,0.1429,0.2283,0.837
"8833",200572,"Valley City State University",1,0,2008,"4412","15.904956","56","121","154",70,84,35,"14",21,0.3,0.1667,0.2273,0.7857
"8834",200572,"Valley City State University",1,0,2009,"4568","16.670507","58","119","152",53,99,32,"13",19,0.3585,0.1313,0.2105,0.7829
"8835",200572,"Valley City State University",1,0,2010,"4433","18.69049","66","173","217",95,122,45,"22",23,0.2421,0.1803,0.2074,0.7972
"8836",201104,"ASHLAND UNIVERSITY",1,0,1991,"9985","40.979715","150","454","542",238,304,145,"52",93,0.3908,0.1711,0.2675,0.8376
"8837",201104,"ASHLAND UNIVERSITY",1,0,1992,"10583","49.065779","165","559","650",307,343,172,"69",103,0.3355,0.2012,0.2646,0.86
"8838",201104,"ASHLAND UNIVERSITY",1,0,1993,"10733","51.692454","162","452","510",268,242,134,"29",105,0.3918,0.1198,0.2627,0.8863
"8839",201104,"ASHLAND UNIVERSITY",1,0,1995,"12174","52.815921","218","493","549",269,280,214,"67",147,0.5465,0.2393,0.3898,0.898
"8840",201104,"ASHLAND UNIVERSITY",1,0,1996,"12600","56.301754","200","398","432",240,192,150,"47",103,0.4292,0.2448,0.3472,0.9213
"8841",201104,"ASHLAND UNIVERSITY",1,0,1997,"13293","55.581886","192","493","531",302,229,220,"76",144,0.4768,0.3319,0.4143,0.9284
"8842",201104,"ASHLAND UNIVERSITY",1,0,1998,"13726","60.752007","176","541","570",351,219,235,"66",169,0.4815,0.3014,0.4123,0.9491
"8843",201104,"ASHLAND UNIVERSITY",1,0,1999,"14276","64.235154","198","512","541",313,228,246,"80",166,0.5304,0.3509,0.4547,0.9464
"8844",201104,"ASHLAND UNIVERSITY",1,0,2000,"15134","70.051231","207.5","413","448",265,183,187,"51",136,0.5132,0.2787,0.4174,0.9219
"8845",201104,"ASHLAND UNIVERSITY",1,0,2001,"15814","62.717782","217","458","492",273,219,200,"69",131,0.4799,0.3151,0.4065,0.9309
"8846",201104,"ASHLAND UNIVERSITY",1,0,2002,"16764","66.44947","213","512","559",373,186,258,"60",198,0.5308,0.3226,0.4615,0.9159
"8847",201104,"ASHLAND UNIVERSITY",1,0,2003,"17518","72.87815","224","547","605",379,226,275,"76",199,0.5251,0.3363,0.4545,0.9041
"8848",201104,"ASHLAND UNIVERSITY",1,0,2004,"18394","81.611282","234","522","571",340,231,245,"70",175,0.5147,0.303,0.4291,0.9142
"8849",201104,"Ashland University",1,0,2005,"19314","85.362587","232","530","573",357,216,271,"86",185,0.5182,0.3981,0.4729,0.925
"8850",201104,"Ashland University",1,0,2006,"20666","88.625975","229","477","554",313,241,238,"78",160,0.5112,0.3237,0.4296,0.861
"8851",201104,"Ashland University",1,0,2007,"22216","90.869415","234","558","639",371,268,264,"77",187,0.504,0.2873,0.4131,0.8732
"8852",201104,"Ashland University",1,0,2008,"23550","95.993437","233","455","570",306,264,236,"83",153,0.5,0.3144,0.414,0.7982
"8853",201104,"Ashland University",1,0,2009,"24828","95.662639","213","507","614",338,276,281,"94",187,0.5533,0.3406,0.4577,0.8257
"8854",201104,"Ashland University",1,0,2010,"26566","92.876485","272","607","688",407,281,345,"115",230,0.5651,0.4093,0.5015,0.8823
"8855",201371,"BLUFFTON COLLEGE",0,1,1991,"8100","8.856202","45","178","193",93,100,85,"30",55,0.5914,0.3,0.4404,0.9223
"8856",201371,"BLUFFTON COLLEGE",0,1,1992,"8685","9.878359","45","173","181",104,77,92,"39",53,0.5096,0.5065,0.5083,0.9558
"8857",201371,"BLUFFTON COLLEGE",0,1,1993,"9225","10.96465","49","193","214",105,109,110,"43",67,0.6381,0.3945,0.514,0.9019
"8858",201371,"BLUFFTON COLLEGE",0,1,1995,"10620","14.257746","51","235","248",163,85,125,"39",86,0.5276,0.4588,0.504,0.9476
"8859",201371,"BLUFFTON COLLEGE",0,1,1996,"11250","16.709091","65","174","183",115,68,97,"38",59,0.513,0.5588,0.5301,0.9508
"8860",201371,"BLUFFTON COLLEGE",0,1,1997,"11835","14.604545","65","233","254",149,105,124,"37",87,0.5839,0.3524,0.4882,0.9173
"8861",201371,"BLUFFTON COLLEGE",0,1,1998,"12375","14.561143","65","177","190",112,78,102,"32",70,0.625,0.4103,0.5368,0.9316
"8862",201371,"BLUFFTON COLLEGE",1,0,1999,"13156","14.715198","66","231","248",156,92,114,"32",82,0.5256,0.3478,0.4597,0.9315
"8863",201371,"BLUFFTON COLLEGE",1,0,2000,"14076","16.173238","69","210","227",124,103,114,"48",66,0.5323,0.466,0.5022,0.9251
"8864",201371,"BLUFFTON COLLEGE",1,0,2001,"15076","17.631733","72","225","239",133,106,117,"44",73,0.5489,0.4151,0.4895,0.9414
"8865",201371,"BLUFFTON COLLEGE",1,0,2002,"16130","18.81365","72","226","262",141,121,135,"55",80,0.5674,0.4545,0.5153,0.8626
"8866",201371,"BLUFFTON COLLEGE",1,0,2003,"17260","20.177741","71","208","236",143,93,133,"51",82,0.5734,0.5484,0.5636,0.8814
"8867",201371,"BLUFFTON UNIVERSITY",1,0,2004,"17950","20.43422","64","236","266",130,136,136,"61",75,0.5769,0.4485,0.5113,0.8872
"8868",201371,"Bluffton University",1,0,2005,"19028","20.579279","67","198","228",141,87,123,"45",78,0.5532,0.5172,0.5395,0.8684
"8869",201371,"Bluffton University",1,0,2006,"20170","21.329259","68","203","241",122,119,119,"50",69,0.5656,0.4202,0.4938,0.8423
"8870",201371,"Bluffton University",1,0,2007,"21380","21.723051","66","181","206",117,89,108,"41",67,0.5726,0.4607,0.5243,0.8786
"8871",201371,"Bluffton University",1,0,2008,"22470","21.987626","64","250","272",140,132,144,"62",82,0.5857,0.4697,0.5294,0.9191
"8872",201371,"Bluffton University",1,0,2009,"23594","22.269485","62","213","257",116,141,107,"48",59,0.5086,0.3404,0.4163,0.8288
"8873",201371,"Bluffton University",1,0,2010,"24480","21.721263","63","169","219",91,128,96,"45",51,0.5604,0.3516,0.4384,0.7717
"8874",201548,"CAPITAL UNIVERSITY",1,0,1991,"11085","31.710296","137","342","370",218,152,232,"87",145,0.6651,0.5724,0.627,0.9243
"8875",201548,"CAPITAL UNIVERSITY",1,0,1992,"11810","36.621178","139","296","330",213,117,163,"56",107,0.5023,0.4786,0.4939,0.897
"8876",201548,"CAPITAL UNIVERSITY",1,0,1993,"12500","39.762702","158","396","448",266,182,238,"81",157,0.5902,0.4451,0.5312,0.8839
"8877",201548,"CAPITAL UNIVERSITY",1,0,1995,"13700","47.388273","176","415","474",296,178,306,"108",198,0.6689,0.6067,0.6456,0.8755
"8878",201548,"CAPITAL UNIVERSITY",1,0,1996,"14200","52.318895","174","399","468",285,183,275,"90",185,0.6491,0.4918,0.5876,0.8526
"8879",201548,"CAPITAL UNIVERSITY",1,0,1997,"14760","44.032742","176","413","478",290,188,239,"82",157,0.5414,0.4362,0.5,0.864
"8880",201548,"CAPITAL UNIVERSITY",1,0,1998,"15260","42.772794","171","444","518",313,205,250,"79",171,0.5463,0.3854,0.4826,0.8571
"8881",201548,"CAPITAL UNIVERSITY",1,0,1999,"16000","45.108336","174","474","532",301,231,255,"101",154,0.5116,0.4372,0.4793,0.891
"8882",201548,"CAPITAL UNIVERSITY",1,0,2000,"16880","46.540902","178","476","558",333,225,305,"111",194,0.5826,0.4933,0.5466,0.853
"8883",201548,"CAPITAL UNIVERSITY",1,0,2001,"17990","50.636628","182","449","519",324,195,243,"68",175,0.5401,0.3487,0.4682,0.8651
"8884",201548,"CAPITAL UNIVERSITY",1,0,2002,"18980","51.51101","196","482","563",330,233,296,"104",192,0.5818,0.4464,0.5258,0.8561
"8885",201548,"CAPITAL UNIVERSITY",1,0,2003,"20500","55.712693","198","473","565",352,213,284,"100",184,0.5227,0.4695,0.5027,0.8372
"8886",201548,"CAPITAL UNIVERSITY",1,0,2004,"22035","63.004367","201","438","517",298,219,253,"96",157,0.5268,0.4384,0.4894,0.8472
"8887",201548,"Capital University",1,0,2005,"23433","70.226515","218","504","599",363,236,310,"109",201,0.5537,0.4619,0.5175,0.8414
"8888",201548,"Capital University",1,0,2006,"25100","74.800352","223","591","690",410,280,342,"130",212,0.5171,0.4643,0.4957,0.8565
"8889",201548,"Capital University",1,0,2007,"26360","71.587675","217","525","627",377,250,323,"117",206,0.5464,0.468,0.5152,0.8373
"8890",201548,"Capital University",1,0,2008,"27680","68.680876","199","517","632",354,278,321,"122",199,0.5621,0.4388,0.5079,0.818
"8891",201548,"Capital University",1,0,2009,"28480","71.729324","203","520","608",323,285,336,"150",186,0.5759,0.5263,0.5526,0.8553
"8892",201548,"Capital University",1,0,2010,"29310","71.371474","202","616","715",409,306,381,"167",214,0.5232,0.5458,0.5329,0.8615
"8893",201645,"CASE WESTERN RESERVE UNIVERSITY",1,0,1991,"13708","282.647","507","438","647",245,402,327,"173",154,0.6286,0.4303,0.5054,0.677
"8894",201645,"CASE WESTERN RESERVE UNIVERSITY",1,0,1992,"14616","297.891","507","542","762",321,441,350,"152",198,0.6168,0.3447,0.4593,0.7113
"8895",201645,"CASE WESTERN RESERVE UNIVERSITY",1,0,1993,"15322","322.8","530","487","712",249,463,354,"201",153,0.6145,0.4341,0.4972,0.684
"8896",201645,"CASE WESTERN RESERVE UNIVERSITY",1,0,1995,"16430","366.326","517","544","729",275,454,388,"205",183,0.6655,0.4515,0.5322,0.7462
"8897",201645,"CASE WESTERN RESERVE UNIVERSITY",1,0,1996,"17235","379.286475","532","507","738",284,454,387,"202",185,0.6514,0.4449,0.5244,0.687
"8898",201645,"CASE WESTERN RESERVE UNIVERSITY",1,0,1997,"17942","359.011","536","494","736",269,467,408,"235",173,0.6431,0.5032,0.5543,0.6712
"8899",201645,"CASE WESTERN RESERVE UNIVERSITY",1,0,1998,"18546","329.785334","536","554","830",301,529,476,"265",211,0.701,0.5009,0.5735,0.6675
"8900",201645,"CASE WESTERN RESERVE UNIVERSITY",1,0,1999,"19200","394.271","553","579","762",292,470,432,"245",187,0.6404,0.5213,0.5669,0.7598
"8901",201645,"CASE WESTERN RESERVE UNIVERSITY",1,0,2000,"20100","448.445907","557.5","615","833",305,528,489,"279",210,0.6885,0.5284,0.587,0.7383
"8902",201645,"CASE WESTERN RESERVE UNIVERSITY",1,0,2001,"21000","474.312221","562","523","737",288,449,433,"228",205,0.7118,0.5078,0.5875,0.7096
"8903",201645,"CASE WESTERN RESERVE UNIVERSITY",1,0,2002,"22500","513.304963","590","603","835",322,513,482,"264",218,0.677,0.5146,0.5772,0.7222
"8904",201645,"CASE WESTERN RESERVE UNIVERSITY",1,0,2003,"24100","571.603766","637","624","874",350,524,552,"292",260,0.7429,0.5573,0.6316,0.714
"8905",201645,"CASE WESTERN RESERVE UNIVERSITY",1,0,2004,"26500","639.329928","686","511","782",306,476,508,"282",226,0.7386,0.5924,0.6496,0.6535
"8906",201645,"Case Western Reserve University",1,0,2005,"28400","719.930321","646","682","1162",456,706,702,"386",316,0.693,0.5467,0.6041,0.5869
"8907",201645,"Case Western Reserve University",1,0,2006,"31090","780.035911","651","632","1015",441,574,636,"325",311,0.7052,0.5662,0.6266,0.6227
"8908",201645,"Case Western Reserve University",1,0,2007,"32800","791.650861","656","652","1132",492,640,734,"368",366,0.7439,0.575,0.6484,0.576
"8909",201645,"Case Western Reserve University",1,0,2008,"34450","774.80591","664","566","1023",442,581,651,"337",314,0.7104,0.58,0.6364,0.5533
"8910",201645,"Case Western Reserve University",1,0,2009,"35900","806.905477","683","546","965",401,564,609,"309",300,0.7481,0.5479,0.6311,0.5658
"8911",201645,"Case Western Reserve University",1,0,2010,"37300","817.854575","680","537","1019",415,604,655,"356",299,0.7205,0.5894,0.6428,0.527
"8912",201690,"CENTRAL STATE UNIVERSITY",0,1,1991,"2388","38.314533","114","13","661",327,334,92,"34",58,0.1774,0.1018,0.1392,0.0197
"8913",201690,"CENTRAL STATE UNIVERSITY",0,1,1992,"2679","40.946469","128","6","665",319,346,42,"12",30,0.094,0.0347,0.0632,0.009
"8914",201690,"CENTRAL STATE UNIVERSITY",0,1,1993,"2811","43.160099","136","2","613",301,312,66,"18",48,0.1595,0.0577,0.1077,0.0033
"8915",201690,"CENTRAL STATE UNIVERSITY",0,1,1995,"2664","41.997668","94","4","597",262,335,25,"5",20,0.0763,0.0149,0.0419,0.0067
"8916",201690,"CENTRAL STATE UNIVERSITY",0,1,1996,"3318","42.817451","95","1","330",161,169,28,"12",16,0.0994,0.071,0.0848,0.003
"8917",201690,"CENTRAL STATE UNIVERSITY",0,1,1997,"3318","38.778423","75","0","88",47,41,4,"0",4,0.0851,0,0.0455,0
"8918",201690,"CENTRAL STATE UNIVERSITY",0,1,1998,"3336","30.59557","69","13","230",130,100,27,"5",22,0.1692,0.05,0.1174,0.0565
"8919",201690,"CENTRAL STATE UNIVERSITY",0,1,1999,"1926","39.404625","75","5","294",164,130,46,"12",34,0.2073,0.0923,0.1565,0.017
"8920",201690,"CENTRAL STATE UNIVERSITY",0,1,2000,"2046","37.82545","76","5","307",173,134,39,"5",34,0.1965,0.0373,0.127,0.0163
"8921",201690,"CENTRAL STATE UNIVERSITY",0,1,2001,"2064","43.646589","77","0","397",204,193,33,"7",26,0.1275,0.0363,0.0831,0
"8922",201690,"CENTRAL STATE UNIVERSITY",0,1,2002,"2208","43.965408","87","2","378",207,171,51,"14",37,0.1787,0.0819,0.1349,0.0053
"8923",201690,"CENTRAL STATE UNIVERSITY",0,1,2003,"2340","46.981958","87","4","542",277,265,43,"10",33,0.1191,0.0377,0.0793,0.0074
"8924",201690,"CENTRAL STATE UNIVERSITY",0,1,2004,"2571","46.483398","92","2","583",270,313,46,"11",35,0.1296,0.0351,0.0789,0.0034
"8925",201690,"Central State University",1,0,2005,"2726","50.715931","90","3","343",156,187,31,"15",16,0.1026,0.0802,0.0904,0.0087
"8926",201690,"Central State University",1,0,2006,"2890","51.392088","97","5","535",266,269,65,"21",44,0.1654,0.0781,0.1215,0.0093
"8927",201690,"Central State University",1,0,2007,"2890","50.761774","107","1","564",278,286,59,"15",44,0.1583,0.0524,0.1046,0.0018
"8928",201690,"Central State University",1,0,2008,"2890","57.147067","106","2","646",330,316,72,"10",62,0.1879,0.0316,0.1115,0.0031
"8929",201690,"Central State University",1,0,2009,"2890","58.068978","113","4","702",363,339,42,"14",28,0.0771,0.0413,0.0598,0.0057
"8930",201690,"Central State University",1,0,2010,"2992","63.559722","111","4","503",231,272,49,"18",31,0.1342,0.0662,0.0974,0.008
"8931",202134,"CLEVELAND STATE UNIVERSITY",0,1,1991,"2682","132.83856","553","699","959",435,524,70,"34",36,0.0828,0.0649,0.073,0.7289
"8932",202134,"CLEVELAND STATE UNIVERSITY",0,1,1992,"2976","137.304685","556","625","868",409,459,55,"21",34,0.0831,0.0458,0.0634,0.72
"8933",202134,"CLEVELAND STATE UNIVERSITY",0,1,1993,"3126","135.782259","530","641","942",479,463,77,"26",51,0.1065,0.0562,0.0817,0.6805
"8934",202134,"CLEVELAND STATE UNIVERSITY",0,1,1995,"3332","140.904418","517","511","856",463,393,71,"26",45,0.0972,0.0662,0.0829,0.597
"8935",202134,"CLEVELAND STATE UNIVERSITY",0,1,1996,"3442","146.915084","499","505","845",443,402,80,"25",55,0.1242,0.0622,0.0947,0.5976
"8936",202134,"CLEVELAND STATE UNIVERSITY",0,1,1997,"3456","152.132019","513","588","924",464,460,89,"36",53,0.1142,0.0783,0.0963,0.6364
"8937",202134,"CLEVELAND STATE UNIVERSITY",0,1,1998,"3670","164.788475","522","509","962",455,507,86,"37",49,0.1077,0.073,0.0894,0.5291
"8938",202134,"CLEVELAND STATE UNIVERSITY",1,0,1999,"3864","173.034479","543","661","1048",494,554,114,"50",64,0.1296,0.0903,0.1088,0.6307
"8939",202134,"CLEVELAND STATE UNIVERSITY",1,0,2000,"4110","183.1551","534","561","934",471,463,103,"42",61,0.1295,0.0907,0.1103,0.6006
"8940",202134,"CLEVELAND STATE UNIVERSITY",1,0,2001,"4464","190.573188","525","614","1008",493,515,95,"47",48,0.0974,0.0913,0.0942,0.6091
"8941",202134,"CLEVELAND STATE UNIVERSITY",1,0,2002,"5196","201.263175","534","571","946",463,483,80,"39",41,0.0886,0.0807,0.0846,0.6036
"8942",202134,"CLEVELAND STATE UNIVERSITY",1,0,2003,"5760","209.416654","541","530","925",463,462,65,"34",31,0.067,0.0736,0.0703,0.573
"8943",202134,"CLEVELAND STATE UNIVERSITY",1,0,2004,"6792","226.387259","564","527","922",463,459,79,"31",48,0.1037,0.0675,0.0857,0.5716
"8944",202134,"Cleveland State University",1,0,2005,"6972","235.887718","575","553","955",507,448,87,"31",56,0.1105,0.0692,0.0911,0.5791
"8945",202134,"Cleveland State University",1,0,2006,"7920","241.944811","572","560","947",520,427,95,"31",64,0.1231,0.0726,0.1003,0.5913
"8946",202134,"Cleveland State University",1,0,2007,"7920","248.174106","571","612","1132",622,510,94,"37",57,0.0916,0.0725,0.083,0.5406
"8947",202134,"Cleveland State University",1,0,2008,"7920","260.171626","549","616","1005",548,457,150,"50",100,0.1825,0.1094,0.1493,0.6129
"8948",202134,"Cleveland State University",1,0,2009,"7920","273.255255","537","662","1127",601,526,181,"70",111,0.1847,0.1331,0.1606,0.5874
"8949",202134,"Cleveland State University",1,0,2010,"8466","275.01334","538","704","1148",615,533,237,"105",132,0.2146,0.197,0.2064,0.6132
"8950",202480,"UNIVERSITY OF DAYTON",0,1,1991,"9410","150.603072","420","1361","1499",744,755,758,"322",436,0.586,0.4265,0.5057,0.9079
"8951",202480,"UNIVERSITY OF DAYTON",0,1,1992,"10210","163.544431","420","1467","1622",778,844,832,"343",489,0.6285,0.4064,0.5129,0.9044
"8952",202480,"UNIVERSITY OF DAYTON",0,1,1993,"11090","175.292767","419","1360","1507",730,777,769,"324",445,0.6096,0.417,0.5103,0.9025
"8953",202480,"UNIVERSITY OF DAYTON",0,1,1995,"12350","196.145421","404","1466","1610",836,774,890,"342",548,0.6555,0.4419,0.5528,0.9106
"8954",202480,"UNIVERSITY OF DAYTON",0,1,1996,"13640","201.046909","404","1437","1553",845,708,890,"310",580,0.6864,0.4379,0.5731,0.9253
"8955",202480,"UNIVERSITY OF DAYTON",0,1,1997,"14180","186.509273","400","1473","1622",872,750,896,"351",545,0.625,0.468,0.5524,0.9081
"8956",202480,"UNIVERSITY OF DAYTON",0,1,1998,"14670","193.217097","387","1620","1792",919,873,991,"385",606,0.6594,0.441,0.553,0.904
"8957",202480,"UNIVERSITY OF DAYTON",0,1,1999,"15020","195.810904","386","1516","1744",921,823,1041,"412",629,0.683,0.5006,0.5969,0.8693
"8958",202480,"UNIVERSITY OF DAYTON",0,1,2000,"15550","209.354136","387","1619","1764",932,832,1055,"431",624,0.6695,0.518,0.5981,0.9178
"8959",202480,"UNIVERSITY OF DAYTON",0,1,2001,"16320","230.69935","388","1574","1715",879,836,971,"389",582,0.6621,0.4653,0.5662,0.9178
"8960",202480,"UNIVERSITY OF DAYTON",0,1,2002,"17450","236.267","407","1404","1644",797,847,944,"390",554,0.6951,0.4604,0.5742,0.854
"8961",202480,"UNIVERSITY OF DAYTON",0,1,2003,"18390","248.65","401","1568","1858",956,902,1084,"431",653,0.6831,0.4778,0.5834,0.8439
"8962",202480,"UNIVERSITY OF DAYTON",0,1,2004,"19570","270.478","439","1574","1805",905,900,1048,"437",611,0.6751,0.4856,0.5806,0.872
"8963",202480,"University of Dayton",1,0,2005,"21246","278.527","446","1783","1970",1004,966,1149,"475",674,0.6713,0.4917,0.5832,0.9051
"8964",202480,"University of Dayton",1,0,2006,"23000","294.491","458","1595","1738",864,874,1041,"450",591,0.684,0.5149,0.599,0.9177
"8965",202480,"University of Dayton",1,0,2007,"24880","316.162","457","1563","1763",893,870,1064,"460",604,0.6764,0.5287,0.6035,0.8866
"8966",202480,"University of Dayton",1,0,2008,"26200","333.988","462","1732","1985",1045,940,1177,"452",725,0.6938,0.4809,0.5929,0.8725
"8967",202480,"University of Dayton",1,0,2009,"27510","363.804","514","1493","1692",834,858,1050,"463",587,0.7038,0.5396,0.6206,0.8824
"8968",202480,"University of Dayton",1,0,2010,"28700","361.684","545","1752","2029",995,1034,1187,"506",681,0.6844,0.4894,0.585,0.8635
"8969",202523,"DENISON UNIVERSITY",1,0,1991,"14700","42.785936","159","438","501",271,230,351,"150",201,0.7417,0.6522,0.7006,0.8743
"8970",202523,"DENISON UNIVERSITY",1,0,1992,"15640","44.679899","157","506","570",301,269,392,"174",218,0.7243,0.6468,0.6877,0.8877
"8971",202523,"DENISON UNIVERSITY",1,0,1993,"15950","47.584744","146","496","535",290,245,342,"142",200,0.6897,0.5796,0.6393,0.9271
"8972",202523,"DENISON UNIVERSITY",1,0,1995,"18630","48.139208","138","606","701",357,344,488,"221",267,0.7479,0.6424,0.6961,0.8645
"8973",202523,"DENISON UNIVERSITY",1,0,1996,"19470","52.724862","141","562","642",305,337,464,"229",235,0.7705,0.6795,0.7227,0.8754
"8974",202523,"DENISON UNIVERSITY",1,0,1997,"20250","45.690252","149","510","593",325,268,438,"185",253,0.7785,0.6903,0.7386,0.86
"8975",202523,"DENISON UNIVERSITY",1,0,1998,"21060","48.993211","141","527","631",364,267,456,"173",283,0.7775,0.6479,0.7227,0.8352
"8976",202523,"DENISON UNIVERSITY",1,0,1999,"20680","52.962477","152","499","587",335,252,444,"171",273,0.8149,0.6786,0.7564,0.8501
"8977",202523,"DENISON UNIVERSITY",1,0,2000,"21710","55.858982","164.5","553","648",370,278,484,"198",286,0.773,0.7122,0.7469,0.8534
"8978",202523,"DENISON UNIVERSITY",1,0,2001,"22550","58.286634","177","450","553",309,244,414,"170",244,0.7896,0.6967,0.7486,0.8137
"8979",202523,"DENISON UNIVERSITY",1,0,2002,"23680","70.227853","189","519","633",338,295,469,"192",277,0.8195,0.6508,0.7409,0.8199
"8980",202523,"DENISON UNIVERSITY",1,0,2003,"25090","73.858438","180","535","629",358,271,502,"199",303,0.8464,0.7343,0.7981,0.8506
"8981",202523,"DENISON UNIVERSITY",1,0,2004,"26700","80.562639","179","512","616",362,254,501,"200",301,0.8315,0.7874,0.8133,0.8312
"8982",202523,"Denison University",1,0,2005,"28170","87.092483","202","506","620",337,283,473,"211",262,0.7774,0.7456,0.7629,0.8161
"8983",202523,"Denison University",1,0,2006,"29860","89.759158","218","479","573",335,238,481,"190",291,0.8687,0.7983,0.8394,0.836
"8984",202523,"Denison University",1,0,2007,"32160","94.419742","217","480","585",325,260,455,"199",256,0.7877,0.7654,0.7778,0.8205
"8985",202523,"Denison University",1,0,2008,"34410","98.145736","214","472","604",325,279,476,"202",274,0.8431,0.724,0.7881,0.7815
"8986",202523,"Denison University",1,0,2009,"35650","101.606153","213","486","649",362,287,500,"205",295,0.8149,0.7143,0.7704,0.7488
"8987",202523,"Denison University",1,0,2010,"37270","103.044708","224","452","623",349,274,482,"199",283,0.8109,0.7263,0.7737,0.7255
"8988",202763,"THE UNIVERSITY OF FINDLAY",1,0,1991,"8880","25.124522","102","262","342",152,190,95,"46",49,0.3224,0.2421,0.2778,0.7661
"8989",202763,"THE UNIVERSITY OF FINDLAY",1,0,1992,"10054","29.733986","110","337","412",197,215,153,"62",91,0.4619,0.2884,0.3714,0.818
"8990",202763,"THE UNIVERSITY OF FINDLAY",1,0,1993,"10920","35.463005","115","286","394",190,204,162,"76",86,0.4526,0.3725,0.4112,0.7259
"8991",202763,"THE UNIVERSITY OF FINDLAY",1,0,1995,"12500","39.533904","116","386","591",306,285,205,"78",127,0.415,0.2737,0.3469,0.6531
"8992",202763,"THE UNIVERSITY OF FINDLAY",1,0,1996,"13112","46.152899","124","428","553",302,251,210,"83",127,0.4205,0.3307,0.3797,0.774
"8993",202763,"THE UNIVERSITY OF FINDLAY",1,0,1997,"13766","33.634057","126","545","651",390,261,264,"75",189,0.4846,0.2874,0.4055,0.8372
"8994",202763,"THE UNIVERSITY OF FINDLAY",1,0,1998,"14320","37.199479","130","533","585",384,201,228,"64",164,0.4271,0.3184,0.3897,0.9111
"8995",202763,"THE UNIVERSITY OF FINDLAY",1,0,1999,"15080","42.091065","130","452","522",337,185,212,"52",160,0.4748,0.2811,0.4061,0.8659
"8996",202763,"THE UNIVERSITY OF FINDLAY",1,0,2000,"15830","47.076375","145","603","684",399,285,257,"87",170,0.4261,0.3053,0.3757,0.8816
"8997",202763,"THE UNIVERSITY OF FINDLAY",1,0,2001,"17088","51.111684","160","537","613",377,236,255,"69",186,0.4934,0.2924,0.416,0.876
"8998",202763,"THE UNIVERSITY OF FINDLAY",1,0,2002,"18114","54.38298","157","571","651",386,265,276,"98",178,0.4611,0.3698,0.424,0.8771
"8999",202763,"THE UNIVERSITY OF FINDLAY",1,0,2003,"19052","56.007203","154","569","671",441,230,260,"72",188,0.4263,0.313,0.3875,0.848
"9000",202763,"THE UNIVERSITY OF FINDLAY",1,0,2004,"19996","59.50477","164","517","580",387,193,248,"60",188,0.4858,0.3109,0.4276,0.8914
"9001",202763,"The University of Findlay",1,0,2005,"20796","57.794716","164","537","584",399,185,240,"64",176,0.4411,0.3459,0.411,0.9195
"9002",202763,"The University of Findlay",1,0,2006,"21836","61.385756","176","541","616",441,175,243,"58",185,0.4195,0.3314,0.3945,0.8782
"9003",202763,"The University of Findlay",1,0,2007,"22906","66.586782","190","535","594",416,178,258,"53",205,0.4928,0.2978,0.4343,0.9007
"9004",202763,"The University of Findlay",1,0,2008,"23938","70.801046","192","504","562",391,171,242,"56",186,0.4757,0.3275,0.4306,0.8968
"9005",202763,"The University of Findlay",1,0,2009,"25016","72.921968","194","461","565",398,167,251,"51",200,0.5025,0.3054,0.4442,0.8159
"9006",202763,"The University of Findlay",1,0,2010,"26016","72.868861","201","585","659",461,198,338,"95",243,0.5271,0.4798,0.5129,0.8877
"9007",203085,"HEIDELBERG COLLEGE",1,0,1991,"11680","14.739912","70","236","252",100,152,100,"56",44,0.44,0.3684,0.3968,0.9365
"9008",203085,"HEIDELBERG COLLEGE",1,0,1992,"12380","16.568755","70","203","229",88,141,86,"46",40,0.4545,0.3262,0.3755,0.8865
"9009",203085,"HEIDELBERG COLLEGE",1,0,1993,"13000","19.110902","68","204","217",105,112,86,"38",48,0.4571,0.3393,0.3963,0.9401
"9010",203085,"HEIDELBERG COLLEGE",1,0,1995,"14606","20.385018","70","208","220",87,133,94,"46",48,0.5517,0.3459,0.4273,0.9455
"9011",203085,"HEIDELBERG COLLEGE",1,0,1996,"15140","21.688976","66","273","303",141,162,141,"68",73,0.5177,0.4198,0.4653,0.901
"9012",203085,"HEIDELBERG COLLEGE",1,0,1997,"15594","17.874275","65","249","264",114,150,127,"58",69,0.6053,0.3867,0.4811,0.9432
"9013",203085,"HEIDELBERG COLLEGE",1,0,1998,"16100","19.071604","71","274","290",138,152,130,"54",76,0.5507,0.3553,0.4483,0.9448
"9014",203085,"HEIDELBERG COLLEGE",1,0,1999,"16422","19.493955","70","246","259",98,161,124,"61",63,0.6429,0.3789,0.4788,0.9498
"9015",203085,"HEIDELBERG COLLEGE",1,0,2000,"16998","20.107683","71.5","255","277",137,140,121,"39",82,0.5985,0.2786,0.4368,0.9206
"9016",203085,"HEIDELBERG COLLEGE",1,0,2001,"17848","21.871967","73","228","262",119,143,113,"38",75,0.6303,0.2657,0.4313,0.8702
"9017",203085,"HEIDELBERG COLLEGE",1,0,2002,"12850","21.96894","72","252","278",160,118,103,"34",69,0.4312,0.2881,0.3705,0.9065
"9018",203085,"HEIDELBERG COLLEGE",1,0,2003,"13620","22.434477","62","264","298",142,156,116,"43",73,0.5141,0.2756,0.3893,0.8859
"9019",203085,"HEIDELBERG COLLEGE",1,0,2004,"14574","22.801973","64","318","354",159,195,132,"47",85,0.5346,0.241,0.3729,0.8983
"9020",203085,"Heidelberg College",1,0,2005,"15740","25.387721","60","283","324",135,189,174,"85",89,0.6593,0.4497,0.537,0.8735
"9021",203085,"Heidelberg College",1,0,2006,"17000","27.395647","58","214","267",131,136,105,"38",67,0.5115,0.2794,0.3933,0.8015
"9022",203085,"Heidelberg College",1,0,2007,"18190","25.729547","60","297","369",149,220,130,"64",66,0.443,0.2909,0.3523,0.8049
"9023",203085,"Heidelberg University",1,0,2008,"19464","27.721929","62","313","402",177,225,142,"61",81,0.4576,0.2711,0.3532,0.7786
"9024",203085,"Heidelberg University",1,0,2009,"20826","28.32879","65","279","375",168,207,118,"48",70,0.4167,0.2319,0.3147,0.744
"9025",203085,"Heidelberg University",1,0,2010,"22242","28.270597","65","258","334",158,176,137,"57",80,0.5063,0.3239,0.4102,0.7725
"9026",203128,"HIRAM COLLEGE",0,1,1991,"11950","21.657528","80","255","287",148,139,159,"69",90,0.6081,0.4964,0.554,0.8885
"9027",203128,"HIRAM COLLEGE",0,1,1992,"12897","23.514741","79","253","277",134,143,116,"116",0,0,0.8112,0.4188,0.9134
"9028",203128,"HIRAM COLLEGE",0,1,1993,"13665","25.476797","81","231","263",127,136,134,"64",70,0.5512,0.4706,0.5095,0.8783
"9029",203128,"HIRAM COLLEGE",0,1,1995,"15270","26.178795","69","180","217",119,98,124,"47",77,0.6471,0.4796,0.5714,0.8295
"9030",203128,"HIRAM COLLEGE",1,0,1996,"15600","27.372476","68","194","232",129,103,144,"60",84,0.6512,0.5825,0.6207,0.8362
"9031",203128,"HIRAM COLLEGE",1,0,1997,"16224","20.958958","68","199","240",123,117,136,"54",82,0.6667,0.4615,0.5667,0.8292
"9032",203128,"HIRAM COLLEGE",1,0,1998,"17010","27.90189","68","200","231",106,125,137,"63",74,0.6981,0.504,0.5931,0.8658
"9033",203128,"HIRAM COLLEGE",1,0,1999,"17230","29.6567","65","241","279",143,136,153,"64",89,0.6224,0.4706,0.5484,0.8638
"9034",203128,"HIRAM COLLEGE",1,0,2000,"17870","24.528704","69","214","244",139,105,128,"54",74,0.5324,0.5143,0.5246,0.877
"9035",203128,"HIRAM COLLEGE",1,0,2001,"18720","24.707126","73","221","269",157,112,149,"52",97,0.6178,0.4643,0.5539,0.8216
"9036",203128,"HIRAM COLLEGE",1,0,2002,"19650","26.315148","75","191","233",126,107,132,"52",80,0.6349,0.486,0.5665,0.8197
"9037",203128,"HIRAM COLLEGE",1,0,2003,"20440","27.490416","72","194","236",127,109,151,"59",92,0.7244,0.5413,0.6398,0.822
"9038",203128,"HIRAM COLLEGE",1,0,2004,"21533","27.936993","74","154","220",106,114,137,"62",75,0.7075,0.5439,0.6227,0.7
"9039",203128,"Hiram College",1,0,2005,"23510","27.037615","64","161","208",101,107,125,"57",68,0.6733,0.5327,0.601,0.774
"9040",203128,"Hiram College",1,0,2006,"23510","26.354671","60","176","298",143,155,174,"80",94,0.6573,0.5161,0.5839,0.5906
"9041",203128,"Hiram College",1,0,2007,"24215","29.442872","68","229","333",184,149,199,"77",122,0.663,0.5168,0.5976,0.6877
"9042",203128,"Hiram College",1,0,2008,"24940","32.977497","74","230","331",164,167,189,"82",107,0.6524,0.491,0.571,0.6949
"9043",203128,"Hiram College",1,0,2009,"26435","34.928089","79","223","293",143,150,154,"74",80,0.5594,0.4933,0.5256,0.7611
"9044",203128,"Hiram College",1,0,2010,"26435","34.201104","78","215","295",157,138,160,"65",95,0.6051,0.471,0.5424,0.7288
"9045",203368,"JOHN CARROLL UNIVERSITY",1,0,1991,"9600","50.561079","201","692","765",386,379,465,"212",253,0.6554,0.5594,0.6078,0.9046
"9046",203368,"JOHN CARROLL UNIVERSITY",1,0,1992,"10440","56.883175","199","685","748",395,353,452,"184",268,0.6785,0.5212,0.6043,0.9158
"9047",203368,"JOHN CARROLL UNIVERSITY",1,0,1993,"11060","58.673433","203","746","813",422,391,487,"216",271,0.6422,0.5524,0.599,0.9176
"9048",203368,"JOHN CARROLL UNIVERSITY",1,0,1995,"12390","64.423106","223","784","844",424,420,587,"257",330,0.7783,0.6119,0.6955,0.9289
"9049",203368,"JOHN CARROLL UNIVERSITY",1,0,1996,"13122","71.673132","225","712","775",425,350,483,"201",282,0.6635,0.5743,0.6232,0.9187
"9050",203368,"JOHN CARROLL UNIVERSITY",1,0,1997,"13883","54.191108","222","728","790",408,382,495,"217",278,0.6814,0.5681,0.6266,0.9215
"9051",203368,"JOHN CARROLL UNIVERSITY",1,0,1998,"14670","57.038946","218","772","854",433,421,532,"241",291,0.6721,0.5724,0.623,0.904
"9052",203368,"JOHN CARROLL UNIVERSITY",1,0,1999,"15424","61.701434","221","756","833",451,382,539,"204",335,0.7428,0.534,0.6471,0.9076
"9053",203368,"JOHN CARROLL UNIVERSITY",1,0,2000,"16334","62.549053","227.5","750","830",467,363,543,"214",329,0.7045,0.5895,0.6542,0.9036
"9054",203368,"JOHN CARROLL UNIVERSITY",1,0,2001,"17478","66.643259","234","711","789",442,347,515,"219",296,0.6697,0.6311,0.6527,0.9011
"9055",203368,"JOHN CARROLL UNIVERSITY",1,0,2002,"18832","75.846246","239","763","843",456,387,599,"256",343,0.7522,0.6615,0.7106,0.9051
"9056",203368,"JOHN CARROLL UNIVERSITY",1,0,2003,"20566","79.141032","237","760","859",453,406,543,"226",317,0.6998,0.5567,0.6321,0.8847
"9057",203368,"JOHN CARROLL UNIVERSITY",1,0,2004,"22108","85.779373","226","641","734",383,351,466,"207",259,0.6762,0.5897,0.6349,0.8733
"9058",203368,"John Carroll University",1,0,2005,"23380","85.587749","222","663","786",401,385,504,"217",287,0.7157,0.5636,0.6412,0.8435
"9059",203368,"John Carroll University",1,0,2006,"24782","87.923854","209","604","712",385,327,469,"205",264,0.6857,0.6269,0.6587,0.8483
"9060",203368,"John Carroll University",1,0,2007,"26144","88.314974","207","561","720",358,362,471,"216",255,0.7123,0.5967,0.6542,0.7792
"9061",203368,"John Carroll University",1,0,2008,"27190","87.602274","200","580","789",393,396,473,"209",264,0.6718,0.5278,0.5995,0.7351
"9062",203368,"John Carroll University",1,0,2009,"27940","86.213719","206","561","660",335,325,373,"163",210,0.6269,0.5015,0.5652,0.85
"9063",203368,"John Carroll University",1,0,2010,"29250","82.475659","199","553","703",380,323,460,"189",271,0.7132,0.5851,0.6543,0.7866
"9064",203517,"KENT STATE UNIVERSITY MAIN CAMPUS",1,0,1991,"3300","222.56641","721","2415","2692",1609,1083,579,"168",411,0.2554,0.1551,0.2151,0.8971
"9065",203517,"KENT STATE UNIVERSITY MAIN CAMPUS",1,0,1992,"3596","232.61076","727","2302","2581",1580,1001,508,"135",373,0.2361,0.1349,0.1968,0.8919
"9066",203517,"KENT STATE UNIVERSITY-MAIN CAMPUS",1,0,1993,"3740","223.922499","682","2093","2371",1476,895,540,"163",377,0.2554,0.1821,0.2278,0.8827
"9067",203517,"KENT STATE UNIVERSITY-MAIN CAMPUS",1,0,1995,"4084","229.005329","641","2319","2623",1580,1043,353,"85",268,0.1696,0.0815,0.1346,0.8841
"9068",203517,"KENT STATE UNIVERSITY-MAIN CAMPUS",1,0,1996,"4288","243.70468","637","2307","2600",1516,1084,448,"150",298,0.1966,0.1384,0.1723,0.8873
"9069",203517,"KENT STATE UNIVERSITY-MAIN CAMPUS",1,0,1997,"4460","250.16862","663","2252","2573",1524,1049,508,"173",335,0.2198,0.1649,0.1974,0.8752
"9070",203517,"KENT STATE UNIVERSITY-MAIN CAMPUS",1,0,1998,"4660","256.226797","689","2622","3019",1867,1152,491,"154",337,0.1805,0.1337,0.1626,0.8685
"9071",203517,"KENT STATE UNIVERSITY-MAIN CAMPUS",1,0,1999,"4011","271.345697","654","2974","3476",2160,1316,668,"187",481,0.2227,0.1421,0.1922,0.8556
"9072",203517,"KENT STATE UNIVERSITY-MAIN CAMPUS",1,0,2000,"4234","287.979731","664","3054","3556",2184,1372,748,"226",522,0.239,0.1647,0.2103,0.8588
"9073",203517,"KENT STATE UNIVERSITY-MAIN CAMPUS",1,0,2001,"4490","307.953095","674","3137","3588",2202,1386,556,"158",398,0.1807,0.114,0.155,0.8743
"9074",203517,"KENT STATE UNIVERSITY-MAIN CAMPUS",1,0,2002,"6374","328.094253","763","3148","3640",2232,1408,892,"283",609,0.2728,0.201,0.2451,0.8648
"9075",203517,"KENT STATE UNIVERSITY-MAIN CAMPUS",1,0,2003,"6882","358.492161","823","3153","3746",2293,1453,895,"266",629,0.2743,0.1831,0.2389,0.8417
"9076",203517,"KENT STATE UNIVERSITY-MAIN CAMPUS",1,0,2004,"7504","363.656051","792","3278","3841",2428,1413,969,"271",698,0.2875,0.1918,0.2523,0.8534
"9077",203517,"Kent State University-Kent Campus",1,0,2005,"7954","366.668959","841","3089","3727",2325,1402,970,"294",676,0.2908,0.2097,0.2603,0.8288
"9078",203517,"Kent State University-Kent Campus",1,0,2006,"8430","392.976","856","2921","3610",2214,1396,977,"295",682,0.308,0.2113,0.2706,0.8091
"9079",203517,"Kent State University-Kent Campus",1,0,2007,"8430","402.740936","877","2984","3729",2300,1429,1031,"308",723,0.3143,0.2155,0.2765,0.8002
"9080",203517,"Kent State University Kent Campus",1,0,2008,"8430","450.252602","901","3039","3684",2261,1423,1135,"325",810,0.3582,0.2284,0.3081,0.8249
"9081",203517,"Kent State University Kent Campus",1,0,2009,"8726","475.696188","886","3238","4003",2437,1566,1298,"400",898,0.3685,0.2554,0.3243,0.8089
"9082",203517,"Kent State University at Kent",1,0,2010,"9030","600.698","885","2931","3887",2325,1562,1243,"396",847,0.3643,0.2535,0.3198,0.7541
"9083",203535,"KENYON COLLEGE",1,0,1991,"16050","36.114286","125","367","420",218,202,347,"167",180,0.8257,0.8267,0.8262,0.8738
"9084",203535,"KENYON COLLEGE",1,0,1992,"17060","37.904443","123","363","413",218,195,319,"147",172,0.789,0.7538,0.7724,0.8789
"9085",203535,"KENYON COLLEGE",1,0,1993,"18140","40.469438","131","348","408",231,177,316,"129",187,0.8095,0.7288,0.7745,0.8529
"9086",203535,"KENYON COLLEGE",1,0,1995,"20270","46.032921","122","380","438",223,215,350,"161",189,0.8475,0.7488,0.7991,0.8676
"9087",203535,"KENYON COLLEGE",1,0,1996,"21370","47.464688","140","375","423",238,185,338,"147",191,0.8025,0.7946,0.7991,0.8865
"9088",203535,"KENYON COLLEGE",1,0,1997,"22200","39.637349","127","394","441",255,186,349,"143",206,0.8078,0.7688,0.7914,0.8934
"9089",203535,"KENYON COLLEGE",1,0,1998,"22990","41.213893","131","397","451",252,199,369,"156",213,0.8452,0.7839,0.8182,0.8803
"9090",203535,"KENYON COLLEGE",1,0,1999,"23900","44.52169","141","403","459",255,204,367,"166",201,0.7882,0.8137,0.7996,0.878
"9091",203535,"KENYON COLLEGE",1,0,2000,"25370","48.524044","141.5","351","436",227,209,371,"168",203,0.8943,0.8038,0.8509,0.805
"9092",203535,"KENYON COLLEGE",1,0,2001,"26800","53.822308","142","347","424",243,181,344,"149",195,0.8025,0.8232,0.8113,0.8184
"9093",203535,"KENYON COLLEGE",1,0,2002,"27900","57.746688","148","381","440",246,194,376,"158",218,0.8862,0.8144,0.8545,0.8659
"9094",203535,"KENYON COLLEGE",1,0,2003,"29500","61.13251","151","387","453",247,206,386,"176",210,0.8502,0.8544,0.8521,0.8543
"9095",203535,"KENYON COLLEGE",1,0,2004,"31260","63.140196","146","375","467",237,230,396,"189",207,0.8734,0.8217,0.848,0.803
"9096",203535,"Kenyon College",1,0,2005,"32980","63.834866","151","372","439",239,200,364,"165",199,0.8326,0.825,0.8292,0.8474
"9097",203535,"Kenyon College",1,0,2006,"34990","75.924818","153","370","457",226,231,397,"190",207,0.9159,0.8225,0.8687,0.8096
"9098",203535,"Kenyon College",1,0,2007,"37030","78.13954","152","366","458",249,209,395,"175",220,0.8835,0.8373,0.8624,0.7991
"9099",203535,"Kenyon College",1,0,2008,"39080","82.499636","159","360","455",237,218,404,"192",212,0.8945,0.8807,0.8879,0.7912
"9100",203535,"Kenyon College",1,0,2009,"39810","84.769192","156","355","468",248,220,393,"176",217,0.875,0.8,0.8397,0.7585
"9101",203535,"Kenyon College",1,0,2010,"39420","85.218598","159","395","483",265,218,429,"191",238,0.8981,0.8761,0.8882,0.8178
"9102",203580,"LAKE ERIE COLLEGE",1,0,1991,"8480","7.349585","27","59","61",49,12,18,"3",15,0.3061,0.25,0.2951,0.9672
"9103",203580,"LAKE ERIE COLLEGE",1,0,1992,"8960","8.18","30","35","36",29,7,14,"1",13,0.4483,0.1429,0.3889,0.9722
"9104",203580,"LAKE ERIE COLLEGE",1,0,1993,"9600","6.884","29","47","51",39,12,12,"1",11,0.2821,0.0833,0.2353,0.9216
"9105",203580,"LAKE ERIE COLLEGE",1,0,1995,"12320","8.396","32","61","66",50,16,26,"5",21,0.42,0.3125,0.3939,0.9242
"9106",203580,"LAKE ERIE COLLEGE",1,0,1996,"12950","8.553","29","56","61",44,17,32,"10",22,0.5,0.5882,0.5246,0.918
"9107",203580,"LAKE ERIE COLLEGE",1,0,1997,"13750","7.045488","27","64","70",47,23,29,"13",16,0.3404,0.5652,0.4143,0.9143
"9108",203580,"LAKE ERIE COLLEGE",1,0,1998,"14298","8.067466","27","65","68",62,6,32,"3",29,0.4677,0.5,0.4706,0.9559
"9109",203580,"LAKE ERIE COLLEGE",1,0,1999,"14280","8.416791","28","87","103",70,33,36,"8",28,0.4,0.2424,0.3495,0.8447
"9110",203580,"LAKE ERIE COLLEGE",1,0,2000,"15140","9.108464","30","79","86",63,23,26,"6",20,0.3175,0.2609,0.3023,0.9186
"9111",203580,"LAKE ERIE COLLEGE",1,0,2001,"15750","10.160394","32","103","127",98,29,46,"7",39,0.398,0.2414,0.3622,0.811
"9112",203580,"LAKE ERIE COLLEGE",1,0,2002,"16370","11.507228","37","113","133",102,31,38,"4",34,0.3333,0.129,0.2857,0.8496
"9113",203580,"LAKE ERIE COLLEGE",1,0,2003,"16880","12.262836","35","95","120",86,34,41,"13",28,0.3256,0.3824,0.3417,0.7917
"9114",203580,"LAKE ERIE COLLEGE",1,0,2004,"17724","12.506951","37","115","141",104,37,48,"10",38,0.3654,0.2703,0.3404,0.8156
"9115",203580,"Lake Erie College",1,0,2005,"20500","13.920016","32","94","116",88,28,49,"8",41,0.4659,0.2857,0.4224,0.8103
"9116",203580,"Lake Erie College",1,0,2006,"21936","14.327006","36","112","131",89,42,48,"13",35,0.3933,0.3095,0.3664,0.855
"9117",203580,"Lake Erie College",1,0,2007,"22814","16.732008","36","194","237",108,129,66,"21",45,0.4167,0.1628,0.2785,0.8186
"9118",203580,"Lake Erie College",1,0,2008,"23950","19.931577","45","206","249",131,118,91,"29",62,0.4733,0.2458,0.3655,0.8273
"9119",203580,"Lake Erie College",1,0,2009,"23950","24.082135","45","201","263",127,136,95,"44",51,0.4016,0.3235,0.3612,0.7643
"9120",203580,"Lake Erie College",1,0,2010,"24308","23.359666","46","204","256",123,133,78,"28",50,0.4065,0.2105,0.3047,0.7969
"9121",203775,"MALONE COLLEGE",1,0,1991,"7860","13.327146","68","297","312",206,106,89,"21",68,0.3301,0.1981,0.2853,0.9519
"9122",203775,"MALONE COLLEGE",1,0,1992,"8490","15.846216","69","352","363",236,127,114,"33",81,0.3432,0.2598,0.314,0.9697
"9123",203775,"MALONE COLLEGE",1,0,1993,"9172","17.342333","70","392","427",218,209,110,"34",76,0.3486,0.1627,0.2576,0.918
"9124",203775,"MALONE COLLEGE",1,0,1995,"10345","21.74768","83","390","408",261,147,131,"39",92,0.3525,0.2653,0.3211,0.9559
"9125",203775,"MALONE COLLEGE",1,0,1996,"10765","26.695728","85","384","400",234,166,141,"41",100,0.4274,0.247,0.3525,0.96
"9126",203775,"MALONE COLLEGE",1,0,1997,"11280","14.698843","89","446","464",293,171,208,"73",135,0.4608,0.4269,0.4483,0.9612
"9127",203775,"MALONE COLLEGE",1,0,1998,"11795","19.202775","93","378","398",235,163,153,"56",97,0.4128,0.3436,0.3844,0.9497
"9128",203775,"MALONE COLLEGE",1,0,1999,"12150","21.068317","99","388","406",248,158,160,"47",113,0.4556,0.2975,0.3941,0.9557
"9129",203775,"MALONE COLLEGE",1,0,2000,"12800","23.037292","101","371","388",240,148,157,"49",108,0.45,0.3311,0.4046,0.9562
"9130",203775,"MALONE COLLEGE",1,0,2001,"13310","23.897171","103","335","355",214,141,145,"46",99,0.4626,0.3262,0.4085,0.9437
"9131",203775,"MALONE COLLEGE",1,0,2002,"13910","25.507162","100","329","348",219,129,148,"54",94,0.4292,0.4186,0.4253,0.9454
"9132",203775,"MALONE COLLEGE",1,0,2003,"14745","25.965578","99","369","389",238,151,173,"48",125,0.5252,0.3179,0.4447,0.9486
"9133",203775,"MALONE COLLEGE",1,0,2004,"15630","27.025013","104","379","400",239,161,181,"53",128,0.5356,0.3292,0.4525,0.9475
"9134",203775,"Malone College",1,0,2005,"16530","28.865687","105","323","357",199,158,165,"61",104,0.5226,0.3861,0.4622,0.9048
"9135",203775,"Malone College",1,0,2006,"17520","30.792719","108","315","341",208,133,159,"58",101,0.4856,0.4361,0.4663,0.9238
"9136",203775,"Malone College",1,0,2007,"18600","32.998553","108","365","387",235,152,177,"58",119,0.5064,0.3816,0.4574,0.9432
"9137",203775,"Malone University",1,0,2008,"19740","35.395562","110","364","389",233,156,147,"44",103,0.4421,0.2821,0.3779,0.9357
"9138",203775,"Malone University",1,0,2009,"20730","38.197102","110","432","477",275,202,230,"80",150,0.5455,0.396,0.4822,0.9057
"9139",203775,"Malone University",1,0,2010,"21954","39.131812","107","330","375",196,179,167,"68",99,0.5051,0.3799,0.4453,0.88
"9140",203845,"MARIETTA COLLEGE",1,0,1991,"11800","20.074519","73","206","215",108,107,102,"41",61,0.5648,0.3832,0.4744,0.9581
"9141",203845,"MARIETTA COLLEGE",1,0,1992,"12370","21.779082","72","360","370",150,220,165,"82",83,0.5533,0.3727,0.4459,0.973
"9142",203845,"MARIETTA COLLEGE",1,0,1993,"13170","21.287665","69","324","342",145,197,174,"84",90,0.6207,0.4264,0.5088,0.9474
"9143",203845,"MARIETTA COLLEGE",1,0,1995,"14850","25.206353","71","231","292",120,172,124,"51",73,0.6083,0.2965,0.4247,0.7911
"9144",203845,"MARIETTA COLLEGE",1,0,1996,"15490","25.738121","71","239","271",111,160,110,"50",60,0.5405,0.3125,0.4059,0.8819
"9145",203845,"MARIETTA COLLEGE",1,0,1997,"15950","22.07927","71","284","331",163,168,157,"72",85,0.5215,0.4286,0.4743,0.858
"9146",203845,"MARIETTA COLLEGE",1,0,1998,"16790","22.981899","73","294","338",177,161,146,"46",100,0.565,0.2857,0.432,0.8698
"9147",203845,"MARIETTA COLLEGE",1,0,1999,"17310","23.876858","75","244","302",136,166,149,"70",79,0.5809,0.4217,0.4934,0.8079
"9148",203845,"MARIETTA COLLEGE",1,0,2000,"18010","24.638029","76","262","303",141,162,154,"75",79,0.5603,0.463,0.5083,0.8647
"9149",203845,"MARIETTA COLLEGE",1,0,2001,"18838","25.556049","77","300","362",151,211,164,"77",87,0.5762,0.3649,0.453,0.8287
"9150",203845,"MARIETTA COLLEGE",1,0,2002,"19762","26.963981","76","231","263",129,134,120,"49",71,0.5504,0.3657,0.4563,0.8783
"9151",203845,"MARIETTA COLLEGE",1,0,2003,"20356","28.22678","78","328","376",168,208,160,"70",90,0.5357,0.3365,0.4255,0.8723
"9152",203845,"MARIETTA COLLEGE",1,0,2004,"21170","29.897823","94","365","439",215,224,200,"78",122,0.5674,0.3482,0.4556,0.8314
"9153",203845,"Marietta College",1,0,2005,"22070","31.905607","96","309","387",179,208,162,"68",94,0.5251,0.3269,0.4186,0.7984
"9154",203845,"Marietta College",1,0,2006,"23200","33.939295","94","315","385",191,194,206,"83",123,0.644,0.4278,0.5351,0.8182
"9155",203845,"Marietta College",1,0,2007,"24220","36.53662","97","308","415",201,214,182,"75",107,0.5323,0.3505,0.4386,0.7422
"9156",203845,"Marietta College",1,0,2008,"25430","39.105535","103","308","385",178,207,201,"95",106,0.5955,0.4589,0.5221,0.8
"9157",203845,"Marietta College",1,0,2009,"26386","42.377923","104","290","386",178,208,218,"109",109,0.6124,0.524,0.5648,0.7513
"9158",203845,"Marietta College",1,0,2010,"27640","41.597312","108","276","387",191,196,199,"85",114,0.5969,0.4337,0.5142,0.7132
"9159",204024,"MIAMI UNIVERSITY OXFORD CAMPUS",1,0,1991,"3692","185.866635","769","3053","3241",1858,1383,2040,"736",1304,0.7018,0.5322,0.6294,0.942
"9160",204024,"MIAMI UNIVERSITY OXFORD CAMPUS",1,0,1992,"4024","198.405828","750","2779","2985",1653,1332,1815,"700",1115,0.6745,0.5255,0.608,0.931
"9161",204024,"MIAMI UNIVERSITY-OXFORD",1,0,1993,"4226","200.940949","763","3021","3264",1782,1482,1948,"739",1209,0.6785,0.4987,0.5968,0.9256
"9162",204024,"MIAMI UNIVERSITY-OXFORD",1,0,1995,"4810","216.603573","766","2896","3211",1817,1394,1990,"750",1240,0.6824,0.538,0.6197,0.9019
"9163",204024,"MIAMI UNIVERSITY-OXFORD",1,0,1996,"5158","233.67457","756","2984","3342",1935,1407,2180,"798",1382,0.7142,0.5672,0.6523,0.8929
"9164",204024,"MIAMI UNIVERSITY-OXFORD",1,0,1997,"5466","249.479193","750","3039","3379",1914,1465,2180,"855",1325,0.6923,0.5836,0.6452,0.8994
"9165",204024,"MIAMI UNIVERSITY-OXFORD",1,0,1998,"5786","266.171757","767","2983","3332",1904,1428,2182,"856",1326,0.6964,0.5994,0.6549,0.8953
"9166",204024,"MIAMI UNIVERSITY-OXFORD",1,0,1999,"5052","276.516992","772","3185","3588",2030,1558,2351,"922",1429,0.7039,0.5918,0.6552,0.8877
"9167",204024,"MIAMI UNIVERSITY-OXFORD",1,0,2000,"5358","302.333377","793","2973","3359",1947,1412,2271,"870",1401,0.7196,0.6161,0.6761,0.8851
"9168",204024,"MIAMI UNIVERSITY-OXFORD",1,0,2001,"5796","326.584451","814","3005","3440",1922,1518,2305,"905",1400,0.7284,0.5962,0.6701,0.8735
"9169",204024,"MIAMI UNIVERSITY-OXFORD",1,0,2002,"6386","348.796873","807","3168","3614",1998,1616,2461,"1008",1453,0.7272,0.6238,0.681,0.8766
"9170",204024,"MIAMI UNIVERSITY-OXFORD",1,0,2003,"7019","369.639274","825","2927","3362",1844,1518,2371,"1002",1369,0.7424,0.6601,0.7052,0.8706
"9171",204024,"MIAMI UNIVERSITY-OXFORD",1,0,2004,"18236","393.407718","849","2900","3475",1950,1525,2354,"961",1393,0.7144,0.6302,0.6774,0.8345
"9172",204024,"Miami University-Oxford",1,0,2005,"19877","421.399202","832","2679","3150",1708,1442,2198,"902",1296,0.7588,0.6255,0.6978,0.8505
"9173",204024,"Miami University-Oxford",1,0,2006,"20991","451.402651","813","3155","3630",2017,1613,2472,"1010",1462,0.7248,0.6262,0.681,0.8691
"9174",204024,"Miami University-Oxford",1,0,2007,"8443","481.273761","828","2985","3456",1902,1554,2359,"968",1391,0.7313,0.6229,0.6826,0.8637
"9175",204024,"Miami University-Oxford",1,0,2008,"8178","459.923777","867","3052","3598",1955,1643,2357,"959",1398,0.7151,0.5837,0.6551,0.8482
"9176",204024,"Miami University-Oxford",1,0,2009,"10122","479.890319","827","2686","3219",1745,1474,2104,"855",1249,0.7158,0.5801,0.6536,0.8344
"9177",204024,"Miami University-Oxford",1,0,2010,"10427","509.61079","850","3029","3574",1944,1630,2368,"969",1399,0.7197,0.5945,0.6626,0.8475
"9178",204185,"MOUNT UNION COLLEGE",1,0,1991,"11320","23.470421","79","374","417",194,223,189,"80",109,0.5619,0.3587,0.4532,0.8969
"9179",204185,"MOUNT UNION COLLEGE",1,0,1992,"11200","23.909799","79","340","380",178,202,170,"73",97,0.5449,0.3614,0.4474,0.8947
"9180",204185,"MOUNT UNION COLLEGE",1,0,1993,"12320","24.891769","78","370","396",194,202,197,"89",108,0.5567,0.4406,0.4975,0.9343
"9181",204185,"MOUNT UNION COLLEGE",1,0,1995,"13480","29.148048","85","445","478",229,249,248,"107",141,0.6157,0.4297,0.5188,0.931
"9182",204185,"MOUNT UNION COLLEGE",1,0,1996,"13880","31.711685","90","451","483",217,266,254,"113",141,0.6498,0.4248,0.5259,0.9337
"9183",204185,"MOUNT UNION COLLEGE",1,0,1997,"14290","24.872686","98","517","540",297,243,306,"113",193,0.6498,0.465,0.5667,0.9574
"9184",204185,"MOUNT UNION COLLEGE",1,0,1998,"14480","26.059414","105","533","568",289,279,318,"116",202,0.699,0.4158,0.5599,0.9384
"9185",204185,"MOUNT UNION COLLEGE",1,0,1999,"14080","28.418511","111","545","601",323,278,292,"86",206,0.6378,0.3094,0.4859,0.9068
"9186",204185,"MOUNT UNION COLLEGE",1,0,2000,"14720","30.149081","115.5","516","555",315,240,277,"93",184,0.5841,0.3875,0.4991,0.9297
"9187",204185,"MOUNT UNION COLLEGE",1,0,2001,"15440","33.738107","120","548","591",329,262,298,"89",209,0.6353,0.3397,0.5042,0.9272
"9188",204185,"MOUNT UNION COLLEGE",1,0,2002,"16240","34.727948","126","511","579",299,280,299,"115",184,0.6154,0.4107,0.5164,0.8826
"9189",204185,"MOUNT UNION COLLEGE",1,0,2003,"16900","37.732891","128","548","579",276,303,287,"114",173,0.6268,0.3762,0.4957,0.9465
"9190",204185,"MOUNT UNION COLLEGE",1,0,2004,"18560","40.426061","128","486","547",256,291,292,"128",164,0.6406,0.4399,0.5338,0.8885
"9191",204185,"Mount Union College",1,0,2005,"19600","43.36226","123","458","503",260,243,274,"104",170,0.6538,0.428,0.5447,0.9105
"9192",204185,"Mount Union College",1,0,2006,"20720","41.895264","124","548","636",284,352,343,"149",194,0.6831,0.4233,0.5393,0.8616
"9193",204185,"Mount Union College",1,0,2007,"21800","43.390522","125","502","593",282,311,316,"130",186,0.6596,0.418,0.5329,0.8465
"9194",204185,"Mount Union College",1,0,2008,"22870","44.263843","125","539","663",321,342,336,"126",210,0.6542,0.3684,0.5068,0.813
"9195",204185,"Mount Union College",1,0,2009,"23630","47.949536","124","464","578",286,292,315,"124",191,0.6678,0.4247,0.545,0.8028
"9196",204185,"University of Mount Union",1,0,2010,"24500","48.993982","126","523","630",261,369,333,"151",182,0.6973,0.4092,0.5286,0.8302
"9197",204194,"MOUNT VERNON NAZARENE COLLEGE",1,0,1991,"5750","11.606392","57","222","231",145,86,82,"31",51,0.3517,0.3605,0.355,0.961
"9198",204194,"MOUNT VERNON NAZARENE COLLEGE",1,0,1992,"6230","12.690462","55","274","283",168,115,86,"36",50,0.2976,0.313,0.3039,0.9682
"9199",204194,"MOUNT VERNON NAZARENE COLLEGE",1,0,1993,"7190","14.036023","51","330","335",201,134,108,"35",73,0.3632,0.2612,0.3224,0.9851
"9200",204194,"MOUNT VERNON NAZARENE COLLEGE",1,0,1995,"8590","18.251949","61","366","379",228,151,121,"51",70,0.307,0.3377,0.3193,0.9657
"9201",204194,"MOUNT VERNON NAZARENE COLLEGE",1,0,1996,"9240","21.350696","67","388","407",252,155,154,"43",111,0.4405,0.2774,0.3784,0.9533
"9202",204194,"MOUNT VERNON NAZARENE COLLEGE",1,0,1997,"9430","20.274893","66","325","333",195,138,119,"45",74,0.3795,0.3261,0.3574,0.976
"9203",204194,"MOUNT VERNON NAZARENE COLLEGE",1,0,1998,"10124","21.00088","66","335","345",205,140,141,"44",97,0.4732,0.3143,0.4087,0.971
"9204",204194,"MOUNT VERNON NAZARENE COLLEGE",1,0,1999,"10792","22.495438","74","375","393",231,162,145,"49",96,0.4156,0.3025,0.369,0.9542
"9205",204194,"MOUNT VERNON NAZARENE COLLEGE",1,0,2000,"11468","24.389932","72.5","343","365",228,137,139,"39",100,0.4386,0.2847,0.3808,0.9397
"9206",204194,"MOUNT VERNON NAZARENE COLLEGE",1,0,2001,"12122","27.162993","71","310","321",176,145,110,"34",76,0.4318,0.2345,0.3427,0.9657
"9207",204194,"MOUNT VERNON NAZARENE UNIVERSITY",1,0,2002,"12810","28.568318","72","315","332",203,129,129,"48",81,0.399,0.3721,0.3886,0.9488
"9208",204194,"MOUNT VERNON NAZARENE UNIVERSITY",1,0,2003,"13794","30.455076","87","357","373",221,152,137,"51",86,0.3891,0.3355,0.3673,0.9571
"9209",204194,"MOUNT VERNON NAZARENE UNIVERSITY",1,0,2004,"14482","32.165633","90","292","303",184,119,130,"44",86,0.4674,0.3697,0.429,0.9637
"9210",204194,"Mount Vernon Nazarene University",1,0,2005,"15384","34.499998","101","355","380",241,139,149,"49",100,0.4149,0.3525,0.3921,0.9342
"9211",204194,"Mount Vernon Nazarene University",1,0,2006,"16366","37.111769","112","324","346",201,145,160,"66",94,0.4677,0.4552,0.4624,0.9364
"9212",204194,"Mount Vernon Nazarene University",1,0,2007,"17544","38.172918","116","334","350",210,140,171,"56",115,0.5476,0.4,0.4886,0.9543
"9213",204194,"Mount Vernon Nazarene University",1,0,2008,"18770","36.765004","119","348","368",234,134,183,"66",117,0.5,0.4925,0.4973,0.9457
"9214",204194,"Mount Vernon Nazarene University",1,0,2009,"19730","38.989901","108","278","300",190,110,172,"61",111,0.5842,0.5545,0.5733,0.9267
"9215",204194,"Mount Vernon Nazarene University",1,0,2010,"20700","38.556466","106","355","388",240,148,217,"83",134,0.5583,0.5608,0.5593,0.9149
"9216",204617,"OHIO DOMINICAN COLLEGE",1,0,1991,"7020","11.239344","52","132","205",108,97,54,"24",30,0.2778,0.2474,0.2634,0.6439
"9217",204617,"OHIO DOMINICAN COLLEGE",1,0,1992,"7370","12.820227","53","141","208",121,87,56,"19",37,0.3058,0.2184,0.2692,0.6779
"9218",204617,"OHIO DOMINICAN COLLEGE",1,0,1993,"7730","13.858256","53","153","225",123,102,61,"16",45,0.3659,0.1569,0.2711,0.68
"9219",204617,"OHIO DOMINICAN COLLEGE",1,0,1995,"8490","16.462636","57","119","172",110,62,46,"12",34,0.3091,0.1935,0.2674,0.6919
"9220",204617,"OHIO DOMINICAN COLLEGE",1,0,1996,"8910","15.397779","56","135","180",113,67,52,"11",41,0.3628,0.1642,0.2889,0.75
"9221",204617,"OHIO DOMINICAN COLLEGE",1,0,1997,"9350","14.984692","54","143","180",101,79,65,"18",47,0.4653,0.2278,0.3611,0.7944
"9222",204617,"OHIO DOMINICAN COLLEGE",1,0,1998,"9790","15.774291","57","142","184",118,66,73,"18",55,0.4661,0.2727,0.3967,0.7717
"9223",204617,"OHIO DOMINICAN COLLEGE",1,0,1999,"10250","16.992874","55","129","186",120,66,68,"16",52,0.4333,0.2424,0.3656,0.6935
"9224",204617,"OHIO DOMINICAN COLLEGE",1,0,2000,"10710","19.700807","57.5","120","179",118,61,48,"15",33,0.2797,0.2459,0.2682,0.6704
"9225",204617,"OHIO DOMINICAN COLLEGE",1,0,2001,"12530","21.209939","60","133","174",116,58,51,"18",33,0.2845,0.3103,0.2931,0.7644
"9226",204617,"OHIO DOMINICAN UNIVERSITY",1,0,2002,"16200","23.624202","61","199","251",163,88,94,"34",60,0.3681,0.3864,0.3745,0.7928
"9227",204617,"OHIO DOMINICAN UNIVERSITY",1,0,2003,"17200","25.709814","60","221","296",191,105,88,"27",61,0.3194,0.2571,0.2973,0.7466
"9228",204617,"OHIO DOMINICAN UNIVERSITY",1,0,2004,"18000","25.696196","64","349","415",202,213,143,"57",86,0.4257,0.2676,0.3446,0.841
"9229",204617,"Ohio Dominican University",1,0,2005,"19400","27.358204","66","298","372",172,200,129,"65",64,0.3721,0.325,0.3468,0.8011
"9230",204617,"Ohio Dominican University",1,0,2006,"20500","29.836325","70","258","354",177,177,107,"51",56,0.3164,0.2881,0.3023,0.7288
"9231",204617,"Ohio Dominican University",1,0,2007,"21720","30.749572","68","307","391",207,184,112,"48",64,0.3092,0.2609,0.2864,0.7852
"9232",204617,"Ohio Dominican University",1,0,2008,"22990","32.878649","72","266","356",194,162,113,"49",64,0.3299,0.3025,0.3174,0.7472
"9233",204617,"Ohio Dominican University",1,0,2009,"24116","34.862668","75","201","274",143,131,98,"40",58,0.4056,0.3053,0.3577,0.7336
"9234",204617,"Ohio Dominican University",1,0,2010,"24780","37.458282","74","163","272",146,126,78,"30",48,0.3288,0.2381,0.2868,0.5993
"9235",204796,"OHIO STATE UNIVERSITY-MAIN CAMPUS",0,1,1991,"2568","1182.441182","1960","4641","5502",2705,2797,1061,"375",686,0.2536,0.1341,0.1928,0.8435
"9236",204796,"OHIO STATE UNIVERSITY-MAIN CAMPUS",0,1,1992,"2799","1310.605399","1925","4458","5389",2625,2764,1024,"351",673,0.2564,0.127,0.19,0.8272
"9237",204796,"OHIO STATE UNIVERSITY-MAIN CAMPUS",0,1,1993,"2940","1291.432401","1922","4340","5283",2710,2573,1074,"371",703,0.2594,0.1442,0.2033,0.8215
"9238",204796,"OHIO STATE UNIVERSITY-MAIN CAMPUS",0,1,1995,"3273","1475.886784","1794","4696","5788",2951,2837,1354,"478",876,0.2968,0.1685,0.2339,0.8113
"9239",204796,"OHIO STATE UNIVERSITY-MAIN CAMPUS",0,1,1996,"3468","1449.156679","1853","4920","6027",3018,3009,1526,"565",961,0.3184,0.1878,0.2532,0.8163
"9240",204796,"OHIO STATE UNIVERSITY-MAIN CAMPUS",0,1,1997,"3687","1488.25369","1979","4671","5897",3081,2816,1719,"555",1164,0.3778,0.1971,0.2915,0.7921
"9241",204796,"OHIO STATE UNIVERSITY-MAIN CAMPUS",0,1,1998,"3906","1634.147441","1946","4950","6151",3177,2974,1886,"610",1276,0.4016,0.2051,0.3066,0.8047
"9242",204796,"OHIO STATE UNIVERSITY-MAIN CAMPUS",0,1,1999,"3780","1720.01204","2075","4806","6067",3029,3038,2120,"777",1343,0.4434,0.2558,0.3494,0.7922
"9243",204796,"OHIO STATE UNIVERSITY-MAIN CAMPUS",0,1,2000,"4005","1953.264579","2044.5","4584","5831",3008,2823,2282,"851",1431,0.4757,0.3015,0.3914,0.7861
"9244",204796,"OHIO STATE UNIVERSITY-MAIN CAMPUS",0,1,2001,"4410","2060.759969","2014","4568","5955",2935,3020,2381,"906",1475,0.5026,0.3,0.3998,0.7671
"9245",204796,"OHIO STATE UNIVERSITY-MAIN CAMPUS",0,1,2002,"5304","2240.293807","2006","4606","5936",2945,2991,2511,"989",1522,0.5168,0.3307,0.423,0.7759
"9246",204796,"OHIO STATE UNIVERSITY-MAIN CAMPUS",0,1,2003,"6228","2428.951409","2181","5067","6347",3201,3146,2938,"1132",1806,0.5642,0.3598,0.4629,0.7983
"9247",204796,"OHIO STATE UNIVERSITY-MAIN CAMPUS",0,1,2004,"7077","2722.321327","2178","4917","6031",2891,3140,2930,"1241",1689,0.5842,0.3952,0.4858,0.8153
"9248",204796,"Ohio State University-Main Campus",0,1,2005,"7509","3003.00159","2072","4783","5929",3005,2924,3032,"1219",1813,0.6033,0.4169,0.5114,0.8067
"9249",204796,"Ohio State University-Main Campus",0,1,2006,"7983","3285.884749","2158","5059","6262",3104,3158,3295,"1373",1922,0.6192,0.4348,0.5262,0.8079
"9250",204796,"Ohio State University-Main Campus",0,1,2007,"7983","3578.71934","2173","4978","6155",3039,3116,3602,"1534",2068,0.6805,0.4923,0.5852,0.8088
"9251",204796,"Ohio State University-Main Campus",0,1,2008,"7983","3827.289168","2167","4905","6151",3068,3083,3780,"1643",2137,0.6965,0.5329,0.6145,0.7974
"9252",204796,"Ohio State University-Main Campus",0,1,2009,"7983","3990.319458","2160","5297","6724",3237,3487,3935,"1699",2236,0.6908,0.4872,0.5852,0.7878
"9253",204796,"Ohio State University-Main Campus",0,1,2010,"8541","4240.565511","2133","4981","6651",3319,3332,3907,"1657",2250,0.6779,0.4973,0.5874,0.7489
"9254",204857,"OHIO UNIVERSITY MAIN CAMPUS",0,1,1991,"2967","213.892042","693","2927","3187",1819,1368,1308,"448",860,0.4728,0.3275,0.4104,0.9184
"9255",204857,"OHIO UNIVERSITY MAIN CAMPUS",0,1,1992,"3234","223.997468","680","2985","3235",1952,1283,1396,"427",969,0.4964,0.3328,0.4315,0.9227
"9256",204857,"OHIO UNIVERSITY MAIN CAMPUS",0,1,1993,"3384","229.869156","687","2940","3148",1782,1366,1297,"433",864,0.4848,0.317,0.412,0.9339
"9257",204857,"OHIO UNIVERSITY MAIN CAMPUS",0,1,1995,"3666","272.36418","718","3114","3358",1939,1419,1459,"479",980,0.5054,0.3376,0.4345,0.9273
"9258",204857,"OHIO UNIVERSITY MAIN CAMPUS",0,1,1996,"4080","291.182964","739","2922","3123",1832,1291,1390,"446",944,0.5153,0.3455,0.4451,0.9356
"9259",204857,"OHIO UNIVERSITY-MAIN CAMPUS",0,1,1997,"4275","305.973667","723","3045","3255",1913,1342,1401,"427",974,0.5091,0.3182,0.4304,0.9355
"9260",204857,"OHIO UNIVERSITY-MAIN CAMPUS",0,1,1998,"4530","326.294182","695","3123","3369",1988,1381,1489,"480",1009,0.5075,0.3476,0.442,0.927
"9261",204857,"OHIO UNIVERSITY-MAIN CAMPUS",0,1,1999,"4800","349.252929","697","3201","3389",1977,1412,1553,"490",1063,0.5377,0.347,0.4582,0.9445
"9262",204857,"OHIO UNIVERSITY-MAIN CAMPUS",0,1,2000,"5085","367.76493","697.5","3359","3586",2041,1545,1693,"588",1105,0.5414,0.3806,0.4721,0.9367
"9263",204857,"OHIO UNIVERSITY-MAIN CAMPUS",0,1,2001,"5493","384.940928","698","3490","3697",2200,1497,1778,"594",1184,0.5382,0.3968,0.4809,0.944
"9264",204857,"OHIO UNIVERSITY-MAIN CAMPUS",0,1,2002,"6336","372.944404","724","3406","3628",2068,1560,1832,"670",1162,0.5619,0.4295,0.505,0.9388
"9265",204857,"OHIO UNIVERSITY-MAIN CAMPUS",0,1,2003,"7128","385.017363","746","3359","3587",2026,1561,1722,"638",1084,0.535,0.4087,0.4801,0.9364
"9266",204857,"OHIO UNIVERSITY-MAIN CAMPUS",0,1,2004,"7770","397.251899","737","3498","3734",2050,1684,1703,"616",1087,0.5302,0.3658,0.4561,0.9368
"9267",204857,"Ohio University-Main Campus",0,1,2005,"8235","422.214569","869","3744","4078",2148,1930,1788,"697",1091,0.5079,0.3611,0.4385,0.9181
"9268",204857,"Ohio University-Main Campus",0,1,2006,"8727","430.61779","873","3668","4009",2063,1946,1766,"693",1073,0.5201,0.3561,0.4405,0.9149
"9269",204857,"Ohio University-Main Campus",0,1,2007,"8907","462.914373","854","3571","3970",2059,1911,1902,"781",1121,0.5444,0.4087,0.4791,0.8995
"9270",204857,"Ohio University-Main Campus",0,1,2008,"8907","465.069029","881","3457","3908",2114,1794,1910,"769",1141,0.5397,0.4287,0.4887,0.8846
"9271",204857,"Ohio University-Main Campus",0,1,2009,"8973","498.346521","907","3591","4052",2217,1835,1954,"702",1252,0.5647,0.3826,0.4822,0.8862
"9272",204857,"Ohio University-Main Campus",0,1,2010,"9603","574.716179","898","3476","3949",2129,1820,1799,"689",1110,0.5214,0.3786,0.4556,0.8802
"9273",206330,"URBANA UNIVERSITY",1,0,1991,"7155","9.643245","33","122","188",66,122,16,"9",7,0.1061,0.0738,0.0851,0.6489
"9274",206330,"URBANA UNIVERSITY",1,0,1992,"8075","10.371839","34","95","148",48,100,15,"7",8,0.1667,0.07,0.1014,0.6419
"9275",206330,"URBANA UNIVERSITY",1,0,1993,"9025","11.394986","37","131","200",61,139,33,"15",18,0.2951,0.1079,0.165,0.655
"9276",206330,"URBANA UNIVERSITY",1,0,1995,"9454","12.407485","36","140","213",87,126,28,"12",16,0.1839,0.0952,0.1315,0.6573
"9277",206330,"URBANA UNIVERSITY",1,0,1996,"9824","13.844677","36","166","235",94,141,31,"12",19,0.2021,0.0851,0.1319,0.7064
"9278",206330,"URBANA UNIVERSITY",1,0,1997,"10172","7.152293","32","75","96",40,56,12,"4",8,0.2,0.0714,0.125,0.7812
"9279",206330,"URBANA UNIVERSITY",1,0,1998,"10530","6.8131","34","109","143",68,75,37,"13",24,0.3529,0.1733,0.2587,0.7622
"9280",206330,"URBANA UNIVERSITY",1,0,1999,"10846","7.413615","38","104","121",40,81,45,"20",25,0.625,0.2469,0.3719,0.8595
"9281",206330,"URBANA UNIVERSITY",1,0,2000,"11388","8.22537","40.5","165","215",84,131,38,"19",19,0.2262,0.145,0.1767,0.7674
"9282",206330,"URBANA UNIVERSITY",1,0,2001,"11844","9.455549","43","142","202",67,135,42,"19",23,0.3433,0.1407,0.2079,0.703
"9283",206330,"URBANA UNIVERSITY",1,0,2002,"12820","9.893068","47","114","150",51,99,22,"11",11,0.2157,0.1111,0.1467,0.76
"9284",206330,"URBANA UNIVERSITY",1,0,2003,"13540","11.842468","50","161","216",72,144,27,"6",21,0.2917,0.0417,0.125,0.7454
"9285",206330,"URBANA UNIVERSITY",1,0,2004,"14220","13.680889","50","151","177",70,107,38,"18",20,0.2857,0.1682,0.2147,0.8531
"9286",206330,"Urbana University",1,0,2005,"15050","14.180573","52","204","240",74,166,51,"27",24,0.3243,0.1627,0.2125,0.85
"9287",206330,"Urbana University",1,0,2006,"16254","14.610324","53","199","238",91,147,61,"19",42,0.4615,0.1293,0.2563,0.8361
"9288",206330,"Urbana University",1,0,2007,"17544","15.72361","52","171","240",101,139,57,"29",28,0.2772,0.2086,0.2375,0.7125
"9289",206330,"Urbana University",1,0,2008,"18960","16.872316","52","128","226",72,154,67,"32",35,0.4861,0.2078,0.2965,0.5664
"9290",206330,"Urbana University",1,0,2009,"19600","16.763186","55","132","182",75,107,28,"10",18,0.24,0.0935,0.1538,0.7253
"9291",206330,"Urbana University",1,0,2010,"20188","16.589764","55","86","145",68,77,36,"17",19,0.2794,0.2208,0.2483,0.5931
"9292",206589,"COLLEGE OF WOOSTER",1,0,1991,"13410","45.679929","131","385","466",219,247,290,"135",155,0.7078,0.5466,0.6223,0.8262
"9293",206589,"COLLEGE OF WOOSTER",1,0,1992,"14380","47.185408","127","377","459",240,219,273,"118",155,0.6458,0.5388,0.5948,0.8214
"9294",206589,"COLLEGE OF WOOSTER",1,0,1993,"15425","48.266982","122","454","548",291,257,346,"139",207,0.7113,0.5409,0.6314,0.8285
"9295",206589,"COLLEGE OF WOOSTER",1,0,1995,"17600","51.45569","123","381","433",228,205,347,"147",200,0.8772,0.7171,0.8014,0.8799
"9296",206589,"COLLEGE OF WOOSTER",1,0,1996,"18380","56.665532","127","429","516",255,261,302,"136",166,0.651,0.5211,0.5853,0.8314
"9297",206589,"COLLEGE OF WOOSTER",1,0,1997,"19230","47.241808","128","448","538",289,249,328,"130",198,0.6851,0.5221,0.6097,0.8327
"9298",206589,"COLLEGE OF WOOSTER",1,0,1998,"19940","49.065521","127","436","504",259,245,335,"147",188,0.7259,0.6,0.6647,0.8651
"9299",206589,"COLLEGE OF WOOSTER",1,0,1999,"25950","53.009736","130","432","513",265,248,372,"164",208,0.7849,0.6613,0.7251,0.8421
"9300",206589,"COLLEGE OF WOOSTER",1,0,2000,"21520","55.812133","132","416","501",258,243,331,"137",194,0.7519,0.5638,0.6607,0.8303
"9301",206589,"COLLEGE OF WOOSTER",1,0,2001,"22282","60.921684","134","438","532",282,250,342,"143",199,0.7057,0.572,0.6429,0.8233
"9302",206589,"COLLEGE OF WOOSTER",1,0,2002,"23687","65.939353","141","380","514",281,233,354,"140",214,0.7616,0.6009,0.6887,0.7393
"9303",206589,"COLLEGE OF WOOSTER",1,0,2003,"24885","65.826349","140","416","552",281,271,373,"169",204,0.726,0.6236,0.6757,0.7536
"9304",206589,"COLLEGE OF WOOSTER",1,0,2004,"26380","70.60663","145","361","478",239,239,334,"147",187,0.7824,0.6151,0.6987,0.7552
"9305",206589,"The College of Wooster",1,0,2005,"28030","68.211726","133","431","536",267,269,362,"158",204,0.764,0.5874,0.6754,0.8041
"9306",206589,"The College of Wooster",1,0,2006,"29840","71.643104","137","358","494",242,252,345,"163",182,0.7521,0.6468,0.6984,0.7247
"9307",206589,"The College of Wooster",1,0,2007,"31630","74.587078","167","395","545",287,258,384,"159",225,0.784,0.6163,0.7046,0.7248
"9308",206589,"The College of Wooster",1,0,2008,"33520","76.070428","160","351","518",267,251,364,"160",204,0.764,0.6375,0.7027,0.6776
"9309",206589,"The College of Wooster",1,0,2009,"34690","72.728223","164","327","479",264,215,371,"154",217,0.822,0.7163,0.7745,0.6827
"9310",206589,"The College of Wooster",1,0,2010,"36320","72.966328","167","432","617",332,285,436,"180",256,0.7711,0.6316,0.7066,0.7002
"9311",206604,"WRIGHT STATE UNIVERSITY MAIN CAMPUS",0,1,1991,"2674","154.045968","495","1860","2111",1061,1050,199,"66",133,0.1254,0.0629,0.0943,0.8811
"9312",206604,"WRIGHT STATE UNIVERSITY MAIN CAMPUS",0,1,1992,"2934","156.090186","493","1672","1941",1028,913,159,"42",117,0.1138,0.046,0.0819,0.8614
"9313",206604,"WRIGHT STATE UNIVERSITY-MAIN CAMPUS",0,1,1993,"3084","158.300309","493","1658","2002",1045,957,190,"73",117,0.112,0.0763,0.0949,0.8282
"9314",206604,"WRIGHT STATE UNIVERSITY-MAIN CAMPUS",0,1,1995,"3429","174.241561","480","1586","1910",1033,877,214,"68",146,0.1413,0.0775,0.112,0.8304
"9315",206604,"WRIGHT STATE UNIVERSITY-MAIN CAMPUS",0,1,1996,"3600","185.29337","489","1514","1859",995,864,281,"78",203,0.204,0.0903,0.1512,0.8144
"9316",206604,"WRIGHT STATE UNIVERSITY-MAIN CAMPUS",0,1,1997,"3708","192.172317","482","1605","2025",1103,922,336,"126",210,0.1904,0.1367,0.1659,0.7926
"9317",206604,"WRIGHT STATE UNIVERSITY-MAIN CAMPUS",0,1,1998,"3930","202.90718","481","1638","2101",1178,923,354,"109",245,0.208,0.1181,0.1685,0.7796
"9318",206604,"WRIGHT STATE UNIVERSITY-MAIN CAMPUS",0,1,1999,"4128","217.798248","445","1617","2127",1202,925,352,"99",253,0.2105,0.107,0.1655,0.7602
"9319",206604,"WRIGHT STATE UNIVERSITY-MAIN CAMPUS",0,1,2000,"4335","231.448176","465","1709","2124",1217,907,403,"117",286,0.235,0.129,0.1897,0.8046
"9320",206604,"WRIGHT STATE UNIVERSITY-MAIN CAMPUS",0,1,2001,"4596","239.823917","485","1709","2117",1165,952,373,"129",244,0.2094,0.1355,0.1762,0.8073
"9321",206604,"WRIGHT STATE UNIVERSITY-MAIN CAMPUS",0,1,2002,"5262","243.011984","530","1732","2169",1225,944,407,"128",279,0.2278,0.1356,0.1876,0.7985
"9322",206604,"WRIGHT STATE UNIVERSITY-MAIN CAMPUS",0,1,2003,"5682","262.390831","528","1739","2272",1312,960,78,"16",62,0.0473,0.0167,0.0343,0.7654
"9323",206604,"WRIGHT STATE UNIVERSITY-MAIN CAMPUS",0,1,2004,"6245","279.689037","595","1665","2289",1302,987,418,"156",262,0.2012,0.1581,0.1826,0.7274
"9324",206604,"Wright State University-Main Campus",0,1,2005,"6619","301.183606","597","1717","2302",1331,971,413,"141",272,0.2044,0.1452,0.1794,0.7459
"9325",206604,"Wright State University-Main Campus",0,1,2006,"7018","313.426879","625","1629","2178",1211,967,422,"155",267,0.2205,0.1603,0.1938,0.7479
"9326",206604,"Wright State University-Main Campus",0,1,2007,"7018","344.335415","649","1726","2371",1339,1032,447,"160",287,0.2143,0.155,0.1885,0.728
"9327",206604,"Wright State University-Main Campus",0,1,2008,"7018","360.572579","665","1866","2596",1496,1100,556,"193",363,0.2426,0.1755,0.2142,0.7188
"9328",206604,"Wright State University-Main Campus",0,1,2009,"7263","374.112762","665","1790","2463",1378,1085,515,"196",319,0.2315,0.1806,0.2091,0.7268
"9329",206604,"Wright State University-Main Campus",0,1,2010,"7518","397.063459","657","1877","2739",1586,1153,527,"197",330,0.2081,0.1709,0.1924,0.6853
"9330",206622,"XAVIER UNIVERSITY",1,0,1991,"9700","54.053612","229","634","719",380,339,383,"193",190,0.5,0.5693,0.5327,0.8818
"9331",206622,"XAVIER UNIVERSITY",1,0,1992,"10450","59.264195","231","592","672",331,341,345,"166",179,0.5408,0.4868,0.5134,0.881
"9332",206622,"XAVIER UNIVERSITY",1,0,1993,"10970","63.819631","230","623","696",381,315,368,"170",198,0.5197,0.5397,0.5287,0.8951
"9333",206622,"XAVIER UNIVERSITY",1,0,1995,"12270","71.600906","221","628","698",396,302,394,"177",217,0.548,0.5861,0.5645,0.8997
"9334",206622,"XAVIER UNIVERSITY",1,0,1996,"12950","76.739334","231","697","778",461,317,458,"184",274,0.5944,0.5804,0.5887,0.8959
"9335",206622,"XAVIER UNIVERSITY",1,0,1997,"13650","64.579493","229","675","757",439,318,512,"220",292,0.6651,0.6918,0.6764,0.8917
"9336",206622,"XAVIER UNIVERSITY",1,0,1998,"14400","69.347613","223","755","831",483,348,541,"227",314,0.6501,0.6523,0.651,0.9085
"9337",206622,"XAVIER UNIVERSITY",1,0,1999,"14950","72.958926","230","681","771",464,307,540,"213",327,0.7047,0.6938,0.7004,0.8833
"9338",206622,"XAVIER UNIVERSITY",1,0,2000,"15680","77.417919","228.5","678","776",436,340,515,"223",292,0.6697,0.6559,0.6637,0.8737
"9339",206622,"XAVIER UNIVERSITY",1,0,2001,"16540","89.83761","227","708","795",426,369,555,"249",306,0.7183,0.6748,0.6981,0.8906
"9340",206622,"XAVIER UNIVERSITY",1,0,2002,"17780","95.523392","268","659","757",424,333,518,"224",294,0.6934,0.6727,0.6843,0.8705
"9341",206622,"XAVIER UNIVERSITY",1,0,2003,"18850","102.526841","278","672","786",428,358,526,"230",296,0.6916,0.6425,0.6692,0.855
"9342",206622,"XAVIER UNIVERSITY",1,0,2004,"20100","110.642002","282","725","878",470,408,611,"268",343,0.7298,0.6569,0.6959,0.8257
"9343",206622,"Xavier University",1,0,2005,"21850","113.241532","294","607","765",430,335,523,"206",317,0.7372,0.6149,0.6837,0.7935
"9344",206622,"Xavier University",1,0,2006,"23270","119.824316","298","654","812",459,353,574,"244",330,0.719,0.6912,0.7069,0.8054
"9345",206622,"Xavier University",1,0,2007,"23990","124.357032","309","706","858",447,411,572,"268",304,0.6801,0.6521,0.6667,0.8228
"9346",206622,"Xavier University",1,0,2008,"26250","130.392696","309","686","859",436,423,542,"244",298,0.6835,0.5768,0.631,0.7986
"9347",206622,"Xavier University",1,0,2009,"27900","136.877748","313","1019","1178",637,541,779,"352",427,0.6703,0.6506,0.6613,0.865
"9348",206622,"Xavier University",1,0,2010,"29300","144.450304","330","836","1042",554,488,641,"298",343,0.6191,0.6107,0.6152,0.8023
"9349",206695,"YOUNGSTOWN STATE UNIVERSITY",0,1,1991,"2415","103.473403","475","1665","1904",981,923,88,"31",57,0.0581,0.0336,0.0462,0.8745
"9350",206695,"YOUNGSTOWN STATE UNIVERSITY",0,1,1992,"2640","106.029814","465","1649","1908",962,946,129,"59",70,0.0728,0.0624,0.0676,0.8643
"9351",206695,"YOUNGSTOWN STATE UNIVERSITY",0,1,1993,"2772","105.717233","459","1708","1967",1005,962,180,"78",102,0.1015,0.0811,0.0915,0.8683
"9352",206695,"YOUNGSTOWN STATE UNIVERSITY",0,1,1995,"3084","125.826217","453","1661","1905",1004,901,208,"85",123,0.1225,0.0943,0.1092,0.8719
"9353",206695,"YOUNGSTOWN STATE UNIVERSITY",0,1,1996,"3336","107.573682","421","1429","1685",859,826,212,"88",124,0.1444,0.1065,0.1258,0.8481
"9354",206695,"YOUNGSTOWN STATE UNIVERSITY",0,1,1997,"3558","106.605649","418","1480","1764",924,840,231,"85",146,0.158,0.1012,0.131,0.839
"9355",206695,"YOUNGSTOWN STATE UNIVERSITY",0,1,1998,"3762","112.274935","412","1553","1839",954,885,250,"81",169,0.1771,0.0915,0.1359,0.8445
"9356",206695,"YOUNGSTOWN STATE UNIVERSITY",0,1,1999,"3783","120.326142","402","1580","1911",954,957,241,"89",152,0.1593,0.093,0.1261,0.8268
"9357",206695,"YOUNGSTOWN STATE UNIVERSITY",1,0,2000,"3876","129.650055","394.5","1563","1853",943,910,220,"95",125,0.1326,0.1044,0.1187,0.8435
"9358",206695,"YOUNGSTOWN STATE UNIVERSITY",1,0,2001,"4083","146.658652","387","1566","1951",1041,910,243,"81",162,0.1556,0.089,0.1246,0.8027
"9359",206695,"YOUNGSTOWN STATE UNIVERSITY",1,0,2002,"4868","137.674553","402","1548","1944",1058,886,234,"76",158,0.1493,0.0858,0.1204,0.7963
"9360",206695,"YOUNGSTOWN STATE UNIVERSITY",1,0,2003,"4320","151.463192","407","1574","1976",1048,928,207,"73",134,0.1279,0.0787,0.1048,0.7966
"9361",206695,"YOUNGSTOWN STATE UNIVERSITY",1,0,2004,"4647","155.239012","422","1561","2025",1081,944,247,"91",156,0.1443,0.0964,0.122,0.7709
"9362",206695,"Youngstown State University",1,0,2005,"5000","164.887394","427","1503","2012",1029,983,177,"61",116,0.1127,0.0621,0.088,0.747
"9363",206695,"Youngstown State University",1,0,2006,"5364","171.084695","426","1589","2169",1095,1074,187,"74",113,0.1032,0.0689,0.0862,0.7326
"9364",206695,"Youngstown State University",1,0,2007,"5364","176.030151","429","1487","2140",1101,1039,168,"70",98,0.089,0.0674,0.0785,0.6949
"9365",206695,"Youngstown State University",1,0,2008,"5364","185.90762","440","1579","2189",1090,1099,199,"74",125,0.1147,0.0673,0.0909,0.7213
"9366",206695,"Youngstown State University",1,0,2009,"6727","194.250251","447","1755","2564",1306,1258,240,"111",129,0.0988,0.0882,0.0936,0.6845
"9367",206695,"Youngstown State University",1,0,2010,"6970","209.997945","456","1803","2633",1330,1303,250,"122",128,0.0962,0.0936,0.0949,0.6848
"9368",206914,"CAMERON UNIVERSITY",1,0,1991,"1377","24.854263","186","329","466",220,246,23,"9",14,0.0636,0.0366,0.0494,0.706
"9369",206914,"CAMERON UNIVERSITY",1,0,1992,"1377","27.689414","185","394","577",323,254,27,"6",21,0.065,0.0236,0.0468,0.6828
"9370",206914,"CAMERON UNIVERSITY",1,0,1993,"1510","28.042075","177","447","626",350,276,54,"26",28,0.08,0.0942,0.0863,0.7141
"9371",206914,"CAMERON UNIVERSITY",1,0,1995,"1362","27.299934","175","435","620",358,262,61,"26",35,0.0978,0.0992,0.0984,0.7016
"9372",206914,"CAMERON UNIVERSITY",1,0,1996,"1759","28.886842","165","441","616",353,263,63,"25",38,0.1076,0.0951,0.1023,0.7159
"9373",206914,"CAMERON UNIVERSITY",1,0,1997,"1872","32.188752","171","424","615",322,293,50,"21",29,0.0901,0.0717,0.0813,0.6894
"9374",206914,"CAMERON UNIVERSITY",1,0,1998,"1895","32.94733","168","406","590",327,263,35,"13",22,0.0673,0.0494,0.0593,0.6881
"9375",206914,"CAMERON UNIVERSITY",1,0,1999,"1470","35.6465","180","430","673",355,318,54,"16",38,0.107,0.0503,0.0802,0.6389
"9376",206914,"CAMERON UNIVERSITY",1,0,2000,"1470","36.406959","185","367","620",339,281,68,"24",44,0.1298,0.0854,0.1097,0.5919
"9377",206914,"CAMERON UNIVERSITY",1,0,2001,"1572","36.924559","190","430","673",355,318,55,"16",39,0.1099,0.0503,0.0817,0.6389
"9378",206914,"CAMERON UNIVERSITY",1,0,2002,"1682","38.884499","190","372","583",330,253,39,"17",22,0.0667,0.0672,0.0669,0.6381
"9379",206914,"CAMERON UNIVERSITY",1,0,2003,"1950","39.431025","178","385","667",375,292,34,"15",19,0.0507,0.0514,0.051,0.5772
"9380",206914,"CAMERON UNIVERSITY",1,0,2004,"2100","41.467715","180","466","762",409,353,31,"10",21,0.0513,0.0283,0.0407,0.6115
"9381",206914,"Cameron University",1,0,2005,"2220","46.716701","184","396","714",430,284,37,"22",15,0.0349,0.0775,0.0518,0.5546
"9382",206914,"Cameron University",1,0,2006,"2352","49.827142","172","376","686",402,284,40,"16",24,0.0597,0.0563,0.0583,0.5481
"9383",206914,"Cameron University",1,0,2007,"2571","52.962379","175","379","716",382,334,50,"22",28,0.0733,0.0659,0.0698,0.5293
"9384",206914,"Cameron University",1,0,2008,"2805","56.620532","167","389","817",457,360,66,"22",44,0.0963,0.0611,0.0808,0.4761
"9385",206914,"Cameron University",1,0,2009,"2805","60.099956","183","410","855",489,366,73,"28",45,0.092,0.0765,0.0854,0.4795
"9386",206914,"Cameron University",1,0,2010,"2963","62.604126","184","378","892",520,372,43,"21",22,0.0423,0.0565,0.0482,0.4238
"9387",207209,"LANGSTON UNIVERSITY",1,0,1991,"1347","21.087955","70","53","525",295,230,19,"2",17,0.0576,0.0087,0.0362,0.101
"9388",207209,"LANGSTON UNIVERSITY",1,0,1992,"1360","25.40991","69","55","411",215,196,23,"4",19,0.0884,0.0204,0.056,0.1338
"9389",207209,"LANGSTON UNIVERSITY",1,0,1993,"1441","24.383527","110","36","479",253,226,28,"10",18,0.0711,0.0442,0.0585,0.0752
"9390",207209,"LANGSTON UNIVERSITY",1,0,1995,"1707","26.101961","103","29","485",220,265,24,"7",17,0.0773,0.0264,0.0495,0.0598
"9391",207209,"LANGSTON UNIVERSITY",1,0,1996,"1707","28.106617","112","29","518",259,259,33,"8",25,0.0965,0.0309,0.0637,0.056
"9392",207209,"LANGSTON UNIVERSITY",1,0,1997,"1893","32.386364","110","18","566",304,262,34,"3",31,0.102,0.0115,0.0601,0.0318
"9393",207209,"LANGSTON UNIVERSITY",1,0,1998,"1896","31.055206","130","9","517",262,255,22,"3",19,0.0725,0.0118,0.0426,0.0174
"9394",207209,"LANGSTON UNIVERSITY",1,0,1999,"1410","34.968543","126","9","446",232,214,17,"4",13,0.056,0.0187,0.0381,0.0202
"9395",207209,"LANGSTON UNIVERSITY",1,0,2000,"1485","26.696678","126.5","19","690",328,362,40,"14",26,0.0793,0.0387,0.058,0.0275
"9396",207209,"LANGSTON UNIVERSITY",1,0,2001,"635","31.667948","127","9","446",232,214,18,"5",13,0.056,0.0234,0.0404,0.0202
"9397",207209,"LANGSTON UNIVERSITY",1,0,2002,"1635","33.490998","142","23","492",248,244,31,"8",23,0.0927,0.0328,0.063,0.0467
"9398",207209,"LANGSTON UNIVERSITY",1,0,2003,"1818","47.760274","143","23","553",256,297,23,"9",14,0.0547,0.0303,0.0416,0.0416
"9399",207209,"LANGSTON UNIVERSITY",1,0,2004,"1909","48.25616","149","14","530",245,285,16,"6",10,0.0408,0.0211,0.0302,0.0264
"9400",207209,"Langston University",1,0,2005,"1946","51.465273","109","14","670",316,354,31,"3",28,0.0886,0.0085,0.0463,0.0209
"9401",207209,"Langston University",1,0,2006,"2190","51.488429","155","18","533",271,262,32,"8",24,0.0886,0.0305,0.06,0.0338
"9402",207209,"Langston University",1,0,2007,"2409","40.268052","152","21","559",270,289,48,"8",40,0.1481,0.0277,0.0859,0.0376
"9403",207209,"Langston University",1,0,2008,"2640","33.700296","145","10","593",281,312,19,"2",17,0.0605,0.0064,0.032,0.0169
"9404",207209,"Langston University",1,0,2009,"2640","38.196546","154","9","561",253,308,17,"6",11,0.0435,0.0195,0.0303,0.016
"9405",207209,"Langston University",1,0,2010,"2772","60.282405","139","17","469",226,243,11,"2",9,0.0398,0.0082,0.0235,0.0362
"9406",207306,"NORTHWESTERN OKLAHOMA STATE UNIVERSITY",1,0,1991,"1423","10.782536","79","323","356",176,180,43,"18",25,0.142,0.1,0.1208,0.9073
"9407",207306,"NORTHWESTERN OKLAHOMA STATE UNIVERSITY",1,0,1992,"1423","11.783202","81","296","317",164,153,36,"13",23,0.1402,0.085,0.1136,0.9338
"9408",207306,"NORTHWESTERN OKLAHOMA STATE UNIVERSITY",1,0,1993,"1423","13.237628","77","211","228",119,109,33,"12",21,0.1765,0.1101,0.1447,0.9254
"9409",207306,"NORTHWESTERN OKLAHOMA STATE UNIVERSITY",1,0,1995,"1718","12.52655","78","226","240",127,113,39,"11",28,0.2205,0.0973,0.1625,0.9417
"9410",207306,"NORTHWESTERN OKLAHOMA STATE UNIVERSITY",1,0,1996,"1748","12.816145","78","204","234",110,124,22,"11",11,0.1,0.0887,0.094,0.8718
"9411",207306,"NORTHWESTERN OKLAHOMA STATE UNIVERSITY",1,0,1997,"1834","16.335172","81","259","293",148,145,35,"11",24,0.1622,0.0759,0.1195,0.884
"9412",207306,"NORTHWESTERN OKLAHOMA STATE UNIVERSITY",1,0,1998,"1874","18.030099","81","258","290",147,143,35,"15",20,0.1361,0.1049,0.1207,0.8897
"9413",207306,"NORTHWESTERN OKLAHOMA STATE UNIVERSITY",1,0,1999,"1584","16.492992","85","276","310",138,172,36,"16",20,0.1449,0.093,0.1161,0.8903
"9414",207306,"NORTHWESTERN OKLAHOMA STATE UNIVERSITY",1,0,2000,"1584","15.644029","89","297","329",159,170,46,"15",31,0.195,0.0882,0.1398,0.9027
"9415",207306,"NORTHWESTERN OKLAHOMA STATE UNIVERSITY",1,0,2001,"1641","18.271013","93","276","310",138,172,36,"16",20,0.1449,0.093,0.1161,0.8903
"9416",207306,"NORTHWESTERN OKLAHOMA STATE UNIVERSITY",1,0,2002,"1756","18.21318","80","253","298",164,134,56,"19",37,0.2256,0.1418,0.1879,0.849
"9417",207306,"NORTHWESTERN OKLAHOMA STATE UNIVERSITY",1,0,2003,"2015","18.563929","85","271","308",139,169,45,"20",25,0.1799,0.1183,0.1461,0.8799
"9418",207306,"NORTHWESTERN OKLAHOMA STATE UNIVERSITY",1,0,2004,"2263","19.346449","83","248","292",156,136,40,"12",28,0.1795,0.0882,0.137,0.8493
"9419",207306,"Northwestern Oklahoma State University",1,0,2005,"2604","19.813068","86","229","279",150,129,37,"10",27,0.18,0.0775,0.1326,0.8208
"9420",207306,"Northwestern Oklahoma State University",1,0,2006,"2922","20.98747","85","192","243",121,122,29,"9",20,0.1653,0.0738,0.1193,0.7901
"9421",207306,"Northwestern Oklahoma State University",1,0,2007,"3232","21.754412","87","272","328",173,155,43,"13",30,0.1734,0.0839,0.1311,0.8293
"9422",207306,"Northwestern Oklahoma State University",1,0,2008,"3604","23.934689","88","258","317",162,155,47,"14",33,0.2037,0.0903,0.1483,0.8139
"9423",207306,"Northwestern Oklahoma State University",1,0,2009,"3604","26.010932","87","280","402",199,203,32,"8",24,0.1206,0.0394,0.0796,0.6965
"9424",207306,"Northwestern Oklahoma State University",1,0,2010,"3836","26.224857","91","262","382",182,200,51,"16",35,0.1923,0.08,0.1335,0.6859
"9425",207324,"OKLAHOMA CHRISTIAN UNIVERSITY OF SCIENCE AND ARTS",0,1,1991,"4840","17.222404","73","233","304",160,144,76,"37",39,0.2438,0.2569,0.25,0.7664
"9426",207324,"OKLAHOMA CHRISTIAN UNIVERSITY OF SCIENCE AND ARTS",0,1,1992,"5280","18.44017","67","309","355",183,172,97,"41",56,0.306,0.2384,0.2732,0.8704
"9427",207324,"OKLAHOMA CHRISTIAN UNIVERSITY OF SCIENCE AND ARTS",0,1,1993,"5780","18.088245","80","251","291",157,134,56,"31",25,0.1592,0.2313,0.1924,0.8625
"9428",207324,"OKLAHOMA CHRISTIAN UNIVERSITY OF SCIENCE AND ARTS",0,1,1995,"7160","23.133141","79","281","320",158,162,78,"28",50,0.3165,0.1728,0.2438,0.8781
"9429",207324,"OKLAHOMA CHRISTIAN UNIVERSITY OF SCIENCE AND ARTS",0,1,1996,"7500","30.396485","69","409","464",234,230,106,"41",65,0.2778,0.1783,0.2284,0.8815
"9430",207324,"OKLAHOMA CHRISTIAN UNIVERSITY OF SCIENCE AND ARTS",0,1,1997,"7600","19.480304","70","390","453",222,231,73,"32",41,0.1847,0.1385,0.1611,0.8609
"9431",207324,"OKLAHOMA CHRISTIAN UNIVERSITY OF SCIENCE AND ARTS",0,1,1998,"8200","31.375603","81","400","468",277,191,93,"33",60,0.2166,0.1728,0.1987,0.8547
"9432",207324,"OKLAHOMA CHRISTIAN UNIVERSITY OF SCIENCE AND ARTS",0,1,1999,"8110","33.729428","80","346","391",219,172,123,"44",79,0.3607,0.2558,0.3146,0.8849
"9433",207324,"OKLAHOMA CHRISTIAN UNIVERSITY",1,0,2000,"9700","34.406091","83.5","402","449",226,223,100,"45",55,0.2434,0.2018,0.2227,0.8953
"9434",207324,"OKLAHOMA CHRISTIAN UNIVERSITY",1,0,2001,"10500","37.124255","87","409","465",234,231,107,"42",65,0.2778,0.1818,0.2301,0.8796
"9435",207324,"OKLAHOMA CHRISTIAN UNIVERSITY",1,0,2002,"11100","36.402658","108","343","405",215,190,93,"43",50,0.2326,0.2263,0.2296,0.8469
"9436",207324,"OKLAHOMA CHRISTIAN UNIVERSITY",1,0,2003,"11490","38.016834","87","306","356",199,157,99,"38",61,0.3065,0.242,0.2781,0.8596
"9437",207324,"OKLAHOMA CHRISTIAN UNIVERSITY",1,0,2004,"11780","33.588227","84","469","545",291,254,117,"50",67,0.2302,0.1969,0.2147,0.8606
"9438",207324,"Oklahoma Christian University",1,0,2005,"12486","38.293764","89","461","523",270,253,144,"57",87,0.3222,0.2253,0.2753,0.8815
"9439",207324,"Oklahoma Christian University",1,0,2006,"13422","44.188622","102","443","512",260,252,166,"76",90,0.3462,0.3016,0.3242,0.8652
"9440",207324,"Oklahoma Christian University",1,0,2007,"14020","47.501215","104","431","521",269,252,148,"63",85,0.316,0.25,0.2841,0.8273
"9441",207324,"Oklahoma Christian University",1,0,2008,"14690","51.334639","106","347","430",206,224,113,"50",63,0.3058,0.2232,0.2628,0.807
"9442",207324,"Oklahoma Christian University",1,0,2009,"14690","50.162152","110","375","471",218,253,148,"67",81,0.3716,0.2648,0.3142,0.7962
"9443",207324,"Oklahoma Christian University",1,0,2010,"15600","50.123364","110","379","497",247,250,166,"77",89,0.3603,0.308,0.334,0.7626
"9444",207388,"OKLAHOMA STATE UNIVERSITY MAIN CAMPUS",1,0,1991,"1758","252.672887","843","1732","2092",1038,1054,399,"144",255,0.2457,0.1366,0.1907,0.8279
"9445",207388,"OKLAHOMA STATE UNIVERSITY MAIN CAMPUS",1,0,1992,"1758","276.391645","855","1746","2148",1116,1032,400,"130",270,0.2419,0.126,0.1862,0.8128
"9446",207388,"OKLAHOMA STATE UNIVERSITY-MAIN CAMPUS",1,0,1993,"1882","277.373494","810","1685","2050",999,1051,377,"130",247,0.2472,0.1237,0.1839,0.822
"9447",207388,"OKLAHOMA STATE UNIVERSITY-MAIN CAMPUS",1,0,1995,"2148","292.244595","824","1953","2362",1185,1177,475,"186",289,0.2439,0.158,0.2011,0.8268
"9448",207388,"OKLAHOMA STATE UNIVERSITY-MAIN CAMPUS",1,0,1996,"2161","300.487583","927","1905","2336",1223,1113,488,"155",333,0.2723,0.1393,0.2089,0.8155
"9449",207388,"OKLAHOMA STATE UNIVERSITY-MAIN CAMPUS",1,0,1997,"2356","335.675206","913","1920","2321",1214,1107,565,"194",371,0.3056,0.1752,0.2434,0.8272
"9450",207388,"OKLAHOMA STATE UNIVERSITY-MAIN CAMPUS",1,0,1998,"2356","370.754956","844","2141","2584",1301,1283,624,"226",398,0.3059,0.1761,0.2415,0.8286
"9451",207388,"OKLAHOMA STATE UNIVERSITY-MAIN CAMPUS",1,0,1999,"1890","398.083551","845","2304","2795",1491,1304,705,"206",499,0.3347,0.158,0.2522,0.8243
"9452",207388,"OKLAHOMA STATE UNIVERSITY-MAIN CAMPUS",1,0,2000,"1890","430.75453","843","2440","2953",1615,1338,802,"272",530,0.3282,0.2033,0.2716,0.8263
"9453",207388,"OKLAHOMA STATE UNIVERSITY-MAIN CAMPUS",1,0,2001,"2022","445.732843","841","2499","3111",1594,1517,834,"285",549,0.3444,0.1879,0.2681,0.8033
"9454",207388,"OKLAHOMA STATE UNIVERSITY-MAIN CAMPUS",1,0,2002,"2163","453.15848","848","2641","3206",1698,1508,939,"327",612,0.3604,0.2168,0.2929,0.8238
"9455",207388,"OKLAHOMA STATE UNIVERSITY-MAIN CAMPUS",1,0,2003,"2596","488.086621","835","2576","3128",1666,1462,958,"336",622,0.3733,0.2298,0.3063,0.8235
"9456",207388,"OKLAHOMA STATE UNIVERSITY-MAIN CAMPUS",1,0,2004,"2910","507.409579","908","2560","3126",1601,1525,991,"360",631,0.3941,0.2361,0.317,0.8189
"9457",207388,"Oklahoma State University-Main Campus",1,0,2005,"3099","520.983329","1023","2630","3221",1662,1559,1106,"436",670,0.4031,0.2797,0.3434,0.8165
"9458",207388,"Oklahoma State University-Main Campus",1,0,2006,"3263","554.403087","1058","2567","3132",1658,1474,1068,"383",685,0.4131,0.2598,0.341,0.8196
"9459",207388,"Oklahoma State University-Main Campus",1,0,2007,"3585","596.638391","1039","2450","3111",1599,1512,1013,"399",614,0.384,0.2639,0.3256,0.7875
"9460",207388,"Oklahoma State University-Main Campus",1,0,2008,"3941","634.408414","1052","2333","2946",1501,1445,992,"361",631,0.4204,0.2498,0.3367,0.7919
"9461",207388,"Oklahoma State University-Main Campus",1,0,2009,"3941","684.681298","1064","2248","2973",1544,1429,997,"365",632,0.4093,0.2554,0.3354,0.7561
"9462",207388,"Oklahoma State University-Main Campus",1,0,2010,"4103","706.838394","1068","2519","3403",1761,1642,1320,"497",823,0.4673,0.3027,0.3879,0.7402
"9463",207500,"UNIVERSITY OF OKLAHOMA NORMAN CAMPUS",1,0,1991,"1722","237.569","785","1686","2249",1082,1167,277,"101",176,0.1627,0.0865,0.1232,0.7497
"9464",207500,"UNIVERSITY OF OKLAHOMA NORMAN CAMPUS",1,0,1992,"1768","264.968","801","1705","2376",1164,1212,264,"110",154,0.1323,0.0908,0.1111,0.7176
"9465",207500,"UNIVERSITY OF OKLAHOMA NORMAN CAMPUS",1,0,1993,"1901","261.361","778","1671","2235",1072,1163,337,"139",198,0.1847,0.1195,0.1508,0.7477
"9466",207500,"UNIVERSITY OF OKLAHOMA NORMAN CAMPUS",1,0,1995,"2024","277.592","801","1960","2712",1321,1391,519,"191",328,0.2483,0.1373,0.1914,0.7227
"9467",207500,"UNIVERSITY OF OKLAHOMA NORMAN CAMPUS",1,0,1996,"2178","298.585","809","1896","2605",1264,1341,525,"200",325,0.2571,0.1491,0.2015,0.7278
"9468",207500,"UNIVERSITY OF OKLAHOMA NORMAN CAMPUS",1,0,1997,"2309","315.953","834","2083","2895",1523,1372,552,"195",357,0.2344,0.1421,0.1907,0.7195
"9469",207500,"UNIVERSITY OF OKLAHOMA NORMAN CAMPUS",1,0,1998,"2313","357.154","876","2293","3148",1618,1530,641,"214",427,0.2639,0.1399,0.2036,0.7284
"9470",207500,"UNIVERSITY OF OKLAHOMA NORMAN CAMPUS",1,0,1999,"1890","379.715","918","2326","3206",1603,1603,619,"237",382,0.2383,0.1478,0.1931,0.7255
"9471",207500,"UNIVERSITY OF OKLAHOMA NORMAN CAMPUS",1,0,2000,"1890","410.942","927.5","2480","3326",1760,1566,791,"268",523,0.2972,0.1711,0.2378,0.7456
"9472",207500,"UNIVERSITY OF OKLAHOMA NORMAN CAMPUS",1,0,2001,"2022","447.77","937","2782","3629",1908,1721,897,"332",565,0.2961,0.1929,0.2472,0.7666
"9473",207500,"UNIVERSITY OF OKLAHOMA NORMAN CAMPUS",1,0,2002,"2163","472.778","963","2940","3749",1940,1809,973,"350",623,0.3211,0.1935,0.2595,0.7842
"9474",207500,"UNIVERSITY OF OKLAHOMA NORMAN CAMPUS",1,0,2003,"2541","488.725","971","2907","3729",1921,1808,1100,"406",694,0.3613,0.2246,0.295,0.7796
"9475",207500,"UNIVERSITY OF OKLAHOMA NORMAN CAMPUS",1,0,2004,"2778","494.116","976","2778","3537",1876,1661,1122,"397",725,0.3865,0.239,0.3172,0.7854
"9476",207500,"University of Oklahoma Norman Campus",1,0,2005,"2862","543.273","1003","2448","3189",1695,1494,1107,"418",689,0.4065,0.2798,0.3471,0.7676
"9477",207500,"University of Oklahoma Norman Campus",1,0,2006,"3006","596.519","1059","2445","3285",1732,1553,1190,"457",733,0.4232,0.2943,0.3623,0.7443
"9478",207500,"University of Oklahoma Norman Campus",1,0,2007,"3261","650.783","1113","2858","3824",2043,1781,1331,"452",879,0.4302,0.2538,0.3481,0.7474
"9479",207500,"University of Oklahoma Norman Campus",1,0,2008,"3537","711.341","1131","2913","3750",2058,1692,1394,"525",869,0.4223,0.3103,0.3717,0.7768
"9480",207500,"University of Oklahoma Norman Campus",1,0,2009,"3537","749.23","1142","2695","3700",1917,1783,1411,"555",856,0.4465,0.3113,0.3814,0.7284
"9481",207500,"University of Oklahoma Norman Campus",1,0,2010,"3678","750.785","1135","2117","3669",1945,1724,1455,"549",906,0.4658,0.3184,0.3966,0.577
"9482",207722,"UNIVERSITY OF SCIENCE AND ARTS OF OKLAHOMA",0,1,1991,"1316","8.525152","54","174","203",143,60,16,"2",14,0.0979,0.0333,0.0788,0.8571
"9483",207722,"UNIVERSITY OF SCIENCE AND ARTS OF OKLAHOMA",0,1,1992,"1316","9.622918","54","192","219",151,68,33,"10",23,0.1523,0.1471,0.1507,0.8767
"9484",207722,"UNIVERSITY OF SCIENCE AND ARTS OF OKLAHOMA",0,1,1993,"1408","9.53276","53","180","207",128,79,21,"6",15,0.1172,0.0759,0.1014,0.8696
"9485",207722,"UNIVERSITY OF SCIENCE AND ARTS OF OKLAHOMA",0,1,1995,"1538","10.214084","52","209","259",164,95,33,"6",27,0.1646,0.0632,0.1274,0.8069
"9486",207722,"UNIVERSITY OF SCIENCE AND ARTS OF OKLAHOMA",0,1,1996,"1568","10.032125","52","203","261",138,123,26,"11",15,0.1087,0.0894,0.0996,0.7778
"9487",207722,"UNIVERSITY OF SCIENCE AND ARTS OF OKLAHOMA",0,1,1997,"1725","10.640073","55","184","222",133,89,32,"9",23,0.1729,0.1011,0.1441,0.8288
"9488",207722,"UNIVERSITY OF SCIENCE AND ARTS OF OKLAHOMA",0,1,1998,"1740","11.202434","55","231","279",159,120,48,"19",29,0.1824,0.1583,0.172,0.828
"9489",207722,"UNIVERSITY OF SCIENCE AND ARTS OF OKLAHOMA",0,1,1999,"1470","11.569701","55","179","229",133,96,32,"12",20,0.1504,0.125,0.1397,0.7817
"9490",207722,"UNIVERSITY OF SCIENCE AND ARTS OF OKLAHOMA",0,1,2000,"1176","12.307457","53.5","149","206",135,71,29,"6",23,0.1704,0.0845,0.1408,0.7233
"9491",207722,"UNIVERSITY OF SCIENCE AND ARTS OF OKLAHOMA",0,1,2001,"1699","12.884392","52","203","261",138,123,26,"11",15,0.1087,0.0894,0.0996,0.7778
"9492",207722,"UNIVERSITY OF SCIENCE AND ARTS OF OKLAHOMA",0,1,2002,"1699","13.716936","54","216","280",186,94,44,"11",33,0.1774,0.117,0.1571,0.7714
"9493",207722,"UNIVERSITY OF SCIENCE AND ARTS OF OKLAHOMA",0,1,2003,"1680","13.547454","49","216","282",172,110,54,"11",43,0.25,0.1,0.1915,0.766
"9494",207722,"UNIVERSITY OF SCIENCE AND ARTS OF OKLAHOMA",0,1,2004,"1824","13.213707","49","187","244",148,96,45,"13",32,0.2162,0.1354,0.1844,0.7664
"9495",207722,"University of Science and Arts of Oklahoma",0,1,2005,"1992","14.927518","51","182","233",122,111,61,"30",31,0.2541,0.2703,0.2618,0.7811
"9496",207722,"University of Science and Arts of Oklahoma",0,1,2006,"2112","15.940272","56","156","208",139,69,58,"16",42,0.3022,0.2319,0.2788,0.75
"9497",207722,"University of Science and Arts of Oklahoma",0,1,2007,"2304","17.411899","58","150","198",123,75,51,"13",38,0.3089,0.1733,0.2576,0.7576
"9498",207722,"University of Science and Arts of Oklahoma",0,1,2008,"2616","17.46157","56","142","203",126,77,88,"28",60,0.4762,0.3636,0.4335,0.6995
"9499",207722,"University of Science and Arts of Oklahoma",0,1,2009,"2616","18.6898","58","121","166",113,53,49,"12",37,0.3274,0.2264,0.2952,0.7289
"9500",207722,"University of Science and Arts of Oklahoma",0,1,2010,"2808","19.437661","57","143","199",129,70,54,"13",41,0.3178,0.1857,0.2714,0.7186
"9501",207847,"SOUTHEASTERN OKLAHOMA STATE UNIVERSITY",1,0,1991,"1340","26.0099","146","323","537",291,246,55,"21",34,0.1168,0.0854,0.1024,0.6015
"9502",207847,"SOUTHEASTERN OKLAHOMA STATE UNIVERSITY",1,0,1992,"1350","28.12039","151","298","503",287,216,60,"19",41,0.1429,0.088,0.1193,0.5924
"9503",207847,"SOUTHEASTERN OKLAHOMA STATE UNIVERSITY",1,0,1993,"1494","29.80127","148","336","541",295,246,77,"31",46,0.1559,0.126,0.1423,0.6211
"9504",207847,"SOUTHEASTERN OKLAHOMA STATE UNIVERSITY",1,0,1995,"1665","30.95411","148","347","570",282,288,91,"48",43,0.1525,0.1667,0.1596,0.6088
"9505",207847,"SOUTHEASTERN OKLAHOMA STATE UNIVERSITY",1,0,1996,"1687","30.545483","147","361","579",266,313,78,"41",37,0.1391,0.131,0.1347,0.6235
"9506",207847,"SOUTHEASTERN OKLAHOMA STATE UNIVERSITY",1,0,1997,"1879","31.399941","148","339","578",314,264,89,"33",56,0.1783,0.125,0.154,0.5865
"9507",207847,"SOUTHEASTERN OKLAHOMA STATE UNIVERSITY",1,0,1998,"1889","32.515849","155","316","499",260,239,59,"21",38,0.1462,0.0879,0.1182,0.6333
"9508",207847,"SOUTHEASTERN OKLAHOMA STATE UNIVERSITY",1,0,1999,"1485","34.382026","149","316","572",307,265,67,"26",41,0.1336,0.0981,0.1171,0.5524
"9509",207847,"SOUTHEASTERN OKLAHOMA STATE UNIVERSITY",1,0,2000,"1372","34.557653","145.5","307","509",261,248,54,"21",33,0.1264,0.0847,0.1061,0.6031
"9510",207847,"SOUTHEASTERN OKLAHOMA STATE UNIVERSITY",1,0,2001,"1467","39.585643","142","361","579",266,313,75,"40",35,0.1316,0.1278,0.1295,0.6235
"9511",207847,"SOUTHEASTERN OKLAHOMA STATE UNIVERSITY",1,0,2002,"1569","39.535768","145","392","577",287,290,64,"29",35,0.122,0.1,0.1109,0.6794
"9512",207847,"SOUTHEASTERN OKLAHOMA STATE UNIVERSITY",1,0,2003,"1950","39.955724","139","395","651",339,312,70,"27",43,0.1268,0.0865,0.1075,0.6068
"9513",207847,"SOUTHEASTERN OKLAHOMA STATE UNIVERSITY",1,0,2004,"2126","42.4767","134","360","609",310,299,59,"29",30,0.0968,0.097,0.0969,0.5911
"9514",207847,"Southeastern Oklahoma State University",1,0,2005,"2195","42.284682","135","352","587",298,289,62,"22",40,0.1342,0.0761,0.1056,0.5997
"9515",207847,"Southeastern Oklahoma State University",1,0,2006,"2897","47.604112","140","337","586",313,273,67,"26",41,0.131,0.0952,0.1143,0.5751
"9516",207847,"Southeastern Oklahoma State University",1,0,2007,"3249","51.687783","141","376","631",326,305,82,"33",49,0.1503,0.1082,0.13,0.5959
"9517",207847,"Southeastern Oklahoma State University",1,0,2008,"3639","51.239503","141","321","583",296,287,68,"29",39,0.1318,0.101,0.1166,0.5506
"9518",207847,"Southeastern Oklahoma State University",1,0,2009,"3639","53.808331","142","355","639",313,326,84,"38",46,0.147,0.1166,0.1315,0.5556
"9519",207847,"Southeastern Oklahoma State University",1,0,2010,"3875","54.494473","141","350","651",344,307,55,"20",35,0.1017,0.0651,0.0845,0.5376
"9520",207865,"SOUTHWESTERN OKLAHOMA STATE UNIVERSITY",1,0,1991,"1295","29.47737","221","767","867",502,365,70,"24",46,0.0916,0.0658,0.0807,0.8847
"9521",207865,"SOUTHWESTERN OKLAHOMA STATE UNIVERSITY",1,0,1992,"1310","31.03076","222","855","945",534,411,79,"21",58,0.1086,0.0511,0.0836,0.9048
"9522",207865,"SOUTHWESTERN OKLAHOMA STATE UNIVERSITY",1,0,1993,"1392","30.936353","214","704","791",409,382,68,"19",49,0.1198,0.0497,0.086,0.89
"9523",207865,"SOUTHWESTERN OKLAHOMA STATE UNIVERSITY",1,0,1995,"1599","35.466941","215","671","769",470,299,123,"34",89,0.1894,0.1137,0.1599,0.8726
"9524",207865,"SOUTHWESTERN OKLAHOMA STATE UNIVERSITY",1,0,1996,"1599","34.505528","210","671","737",386,351,92,"34",58,0.1503,0.0969,0.1248,0.9104
"9525",207865,"SOUTHWESTERN OKLAHOMA STATE UNIVERSITY",1,0,1997,"1798","36.431061","206","632","717",386,331,107,"28",79,0.2047,0.0846,0.1492,0.8815
"9526",207865,"SOUTHWESTERN OKLAHOMA STATE UNIVERSITY",1,0,1998,"1798","38.366936","198","752","866",453,413,136,"38",98,0.2163,0.092,0.157,0.8684
"9527",207865,"SOUTHWESTERN OKLAHOMA STATE UNIVERSITY",1,0,1999,"1485","41.677747","200","681","779",448,331,116,"35",81,0.1808,0.1057,0.1489,0.8742
"9528",207865,"SOUTHWESTERN OKLAHOMA STATE UNIVERSITY",1,0,2000,"1485","42.603868","198","688","815",464,351,135,"27",108,0.2328,0.0769,0.1656,0.8442
"9529",207865,"SOUTHWESTERN OKLAHOMA STATE UNIVERSITY",1,0,2001,"1589","44.072267","196","708","853",481,372,128,"45",83,0.1726,0.121,0.1501,0.83
"9530",207865,"SOUTHWESTERN OKLAHOMA STATE UNIVERSITY",1,0,2002,"1700","45.614803","200","771","926",486,440,121,"46",75,0.1543,0.1045,0.1307,0.8326
"9531",207865,"SOUTHWESTERN OKLAHOMA STATE UNIVERSITY",1,0,2003,"1950","45.580127","194","758","980",492,488,119,"38",81,0.1646,0.0779,0.1214,0.7735
"9532",207865,"SOUTHWESTERN OKLAHOMA STATE UNIVERSITY",1,0,2004,"2100","46.971796","193","744","941",493,448,130,"41",89,0.1805,0.0915,0.1382,0.7906
"9533",207865,"Southwestern Oklahoma State University",1,0,2005,"2490","49.121284","197","592","766",403,363,127,"43",84,0.2084,0.1185,0.1658,0.7728
"9534",207865,"Southwestern Oklahoma State University",1,0,2006,"2700","51.704337","194","640","844",485,359,129,"31",98,0.2021,0.0864,0.1528,0.7583
"9535",207865,"Southwestern Oklahoma State University",1,0,2007,"3000","54.629136","195","690","896",552,344,116,"32",84,0.1522,0.093,0.1295,0.7701
"9536",207865,"Southwestern Oklahoma State University",1,0,2008,"3360","57.986431","198","724","920",511,409,124,"41",83,0.1624,0.1002,0.1348,0.787
"9537",207865,"Southwestern Oklahoma State University",1,0,2009,"3360","61.454768","211","662","900",481,419,105,"30",75,0.1559,0.0716,0.1167,0.7356
"9538",207865,"Southwestern Oklahoma State University",1,0,2010,"3405","65.294353","215","697","977",529,448,123,"44",79,0.1493,0.0982,0.1259,0.7134
"9539",208822,"GEORGE FOX COLLEGE",1,0,1991,"9114","12.312239","59","239","258",154,104,91,"33",58,0.3766,0.3173,0.3527,0.9264
"9540",208822,"GEORGE FOX COLLEGE",1,0,1992,"10040","14.93866","68","264","282",176,106,134,"52",82,0.4659,0.4906,0.4752,0.9362
"9541",208822,"GEORGE FOX COLLEGE",1,0,1993,"11740","18.458183","77","313","343",198,145,159,"62",97,0.4899,0.4276,0.4636,0.9125
"9542",208822,"GEORGE FOX UNIVERSITY",1,0,1995,"13690","25.376278","92","312","347",232,115,162,"54",108,0.4655,0.4696,0.4669,0.8991
"9543",208822,"GEORGE FOX UNIVERSITY",1,0,1996,"14520","28.05693","105","356","386",250,136,200,"71",129,0.516,0.5221,0.5181,0.9223
"9544",208822,"GEORGE FOX UNIVERSITY",1,0,1997,"15520","25.893166","108","277","345",225,120,212,"70",142,0.6311,0.5833,0.6145,0.8029
"9545",208822,"GEORGE FOX UNIVERSITY",1,0,1998,"15950","27.831485","116","223","361",240,121,208,"73",135,0.5625,0.6033,0.5762,0.6177
"9546",208822,"GEORGE FOX UNIVERSITY",1,0,1999,"16600","29.152207","121","265","282",163,119,145,"48",97,0.5951,0.4034,0.5142,0.9397
"9547",208822,"GEORGE FOX UNIVERSITY",1,0,2000,"17300","32.123432","115.5","295","352",205,147,209,"81",128,0.6244,0.551,0.5938,0.8381
"9548",208822,"GEORGE FOX UNIVERSITY",1,0,2001,"18000","34.402779","110","268","301",180,121,172,"64",108,0.6,0.5289,0.5714,0.8904
"9549",208822,"GEORGE FOX UNIVERSITY",1,0,2002,"18575","35.067836","127","286","319",204,115,171,"60",111,0.5441,0.5217,0.5361,0.8966
"9550",208822,"GEORGE FOX UNIVERSITY",1,0,2003,"19500","37.604578","135","293","336",203,133,177,"73",104,0.5123,0.5489,0.5268,0.872
"9551",208822,"GEORGE FOX UNIVERSITY",1,0,2004,"20280","41.000794","133","339","397",259,138,235,"79",156,0.6023,0.5725,0.5919,0.8539
"9552",208822,"George Fox University",1,0,2005,"21400","44.198284","144","379","460",287,173,241,"86",155,0.5401,0.4971,0.5239,0.8239
"9553",208822,"George Fox University",1,0,2006,"22250","48.552774","156","325","415",262,153,223,"81",142,0.542,0.5294,0.5373,0.7831
"9554",208822,"George Fox University",1,0,2007,"23470","53.040576","167","338","435",279,156,225,"61",164,0.5878,0.391,0.5172,0.777
"9555",208822,"George Fox University",1,0,2008,"24870","56.402305","156","291","401",245,156,204,"74",130,0.5306,0.4744,0.5087,0.7257
"9556",208822,"George Fox University",1,0,2009,"25860","56.71071","168","329","411",239,172,249,"102",147,0.6151,0.593,0.6058,0.8005
"9557",208822,"George Fox University",1,0,2010,"27640","59.337102","170","342","488",287,201,275,"119",156,0.5436,0.592,0.5635,0.7008
"9558",209056,"LEWIS AND CLARK COLLEGE",0,1,1991,"13470","46.832345","175","309","357",213,144,191,"72",119,0.5587,0.5,0.535,0.8655
"9559",209056,"LEWIS AND CLARK COLLEGE",0,1,1992,"14265","48.378465","182","341","395",235,160,221,"78",143,0.6085,0.4875,0.5595,0.8633
"9560",209056,"LEWIS AND CLARK COLLEGE",0,1,1993,"15051","50.513743","174","396","469",274,195,259,"113",146,0.5328,0.5795,0.5522,0.8443
"9561",209056,"LEWIS AND CLARK COLLEGE",1,0,1995,"16820","58.122766","177","333","455",280,175,228,"85",143,0.5107,0.4857,0.5011,0.7319
"9562",209056,"LEWIS AND CLARK COLLEGE",1,0,1996,"17740","62.505602","179","318","443",262,181,249,"91",158,0.6031,0.5028,0.5621,0.7178
"9563",209056,"LEWIS AND CLARK COLLEGE",1,0,1997,"18530","48.453675","181","298","463",272,191,289,"121",168,0.6176,0.6335,0.6242,0.6436
"9564",209056,"LEWIS AND CLARK COLLEGE",1,0,1998,"19356","55.635811","179","295","424",253,171,249,"94",155,0.6126,0.5497,0.5873,0.6958
"9565",209056,"LEWIS AND CLARK COLLEGE",1,0,1999,"20136","59.146216","190","325","510",307,203,330,"127",203,0.6612,0.6256,0.6471,0.6373
"9566",209056,"LEWIS AND CLARK COLLEGE",1,0,2000,"21330","62.974217","193","291","426",263,163,251,"91",160,0.6084,0.5583,0.5892,0.6831
"9567",209056,"LEWIS & CLARK COLLEGE",1,0,2001,"22410","67.028759","196","283","415",240,175,277,"109",168,0.7,0.6229,0.6675,0.6819
"9568",209056,"LEWIS & CLARK COLLEGE",1,0,2002,"23530","72.004744","213","303","503",309,194,339,"123",216,0.699,0.634,0.674,0.6024
"9569",209056,"LEWIS & CLARK COLLEGE",1,0,2003,"24486","75.758712","202","351","493",308,185,352,"127",225,0.7305,0.6865,0.714,0.712
"9570",209056,"LEWIS & CLARK COLLEGE",1,0,2004,"25938","81.975942","212","364","537",329,208,366,"143",223,0.6778,0.6875,0.6816,0.6778
"9571",209056,"Lewis & Clark College",1,0,2005,"27494","87.30022","205","339","490",294,196,324,"125",199,0.6769,0.6378,0.6612,0.6918
"9572",209056,"Lewis & Clark College",1,0,2006,"29556","92.010913","214","307","508",318,190,349,"129",220,0.6918,0.6789,0.687,0.6043
"9573",209056,"Lewis & Clark College",1,0,2007,"31624","97.40178","221","312","506",322,184,338,"108",230,0.7143,0.587,0.668,0.6166
"9574",209056,"Lewis & Clark College",1,0,2008,"33490","103.026393","222","295","534",323,211,381,"135",246,0.7616,0.6398,0.7135,0.5524
"9575",209056,"Lewis & Clark College",1,0,2009,"34995","109.84305","231","266","494",298,196,327,"122",205,0.6879,0.6224,0.6619,0.5385
"9576",209056,"Lewis & Clark College",1,0,2010,"36394","107.516621","230","311","491",306,185,364,"125",239,0.781,0.6757,0.7413,0.6334
"9577",209065,"LINFIELD COLLEGE",1,0,1991,"11150","25.274588","122","371","429",242,187,234,"89",145,0.5992,0.4759,0.5455,0.8648
"9578",209065,"LINFIELD COLLEGE",1,0,1992,"11870","30.756341","126","380","428",265,163,234,"68",166,0.6264,0.4172,0.5467,0.8879
"9579",209065,"LINFIELD COLLEGE",1,0,1993,"12700","33.140718","129","382","436",235,201,254,"110",144,0.6128,0.5473,0.5826,0.8761
"9580",209065,"LINFIELD COLLEGE",1,0,1995,"14300","37.299435","128","377","438",260,178,276,"105",171,0.6577,0.5899,0.6301,0.8607
"9581",209065,"LINFIELD COLLEGE",1,0,1996,"15096","39.289459","129","393","445",238,207,272,"109",163,0.6849,0.5266,0.6112,0.8831
"9582",209065,"LINFIELD COLLEGE",1,0,1997,"15994","30.674428","134","352","410",235,175,244,"91",153,0.6511,0.52,0.5951,0.8585
"9583",209065,"LINFIELD COLLEGE",1,0,1998,"16960","32.137334","125","356","415",232,183,238,"81",157,0.6767,0.4426,0.5735,0.8578
"9584",209065,"LINFIELD COLLEGE",1,0,1999,"17590","35.355129","94","314","397",227,170,227,"74",153,0.674,0.4353,0.5718,0.7909
"9585",209065,"LINFIELD COLLEGE",1,0,2000,"18450","29.885919","95","338","434",228,206,281,"113",168,0.7368,0.5485,0.6475,0.7788
"9586",209065,"LINFIELD COLLEGE",1,0,2001,"19380","32.638333","96","363","422",232,190,250,"89",161,0.694,0.4684,0.5924,0.8602
"9587",209065,"LINFIELD COLLEGE",1,0,2002,"20160","33.447778","100","361","425",245,180,258,"92",166,0.6776,0.5111,0.6071,0.8494
"9588",209065,"LINFIELD COLLEGE",1,0,2003,"20770","34.990722","104","372","448",243,205,286,"101",185,0.7613,0.4927,0.6384,0.8304
"9589",209065,"LINFIELD COLLEGE",1,0,2004,"21800","36.487379","103","333","432",222,210,249,"106",143,0.6441,0.5048,0.5764,0.7708
"9590",209065,"Linfield College",1,0,2005,"22790","46.515187","105","399","481",260,221,293,"113",180,0.6923,0.5113,0.6091,0.8295
"9591",209065,"Linfield College",1,0,2006,"23930","49.719138","103","346","445",243,202,265,"104",161,0.6626,0.5149,0.5955,0.7775
"9592",209065,"Linfield College",1,0,2007,"25390","52.510423","107","310","476",276,200,281,"96",185,0.6703,0.48,0.5903,0.6513
"9593",209065,"Linfield College",1,0,2008,"27150","54.114903","108","314","474",274,200,290,"106",184,0.6715,0.53,0.6118,0.6624
"9594",209065,"Linfield College",1,0,2009,"28760","55.359807","107","294","420",252,168,226,"76",150,0.5952,0.4524,0.5381,0.7
"9595",209065,"Linfield College",1,0,2010,"30300","57.006898","110","369","528",310,218,302,"117",185,0.5968,0.5367,0.572,0.6989
"9596",209542,"OREGON STATE UNIVERSITY",0,1,1991,"2505","290.438069","618","1224","1543",696,847,403,"184",219,0.3147,0.2172,0.2612,0.7933
"9597",209542,"OREGON STATE UNIVERSITY",0,1,1992,"2691","302.137369","607","1385","1703",771,932,442,"179",263,0.3411,0.1921,0.2595,0.8133
"9598",209542,"OREGON STATE UNIVERSITY",0,1,1993,"2877","319.76315","622","1269","1625",705,920,395,"169",226,0.3206,0.1837,0.2431,0.7809
"9599",209542,"OREGON STATE UNIVERSITY",0,1,1995,"3312","342.211959","603","1615","2018",965,1053,561,"194",367,0.3803,0.1842,0.278,0.8003
"9600",209542,"OREGON STATE UNIVERSITY",0,1,1996,"3447","366.327438","597","1450","1833",883,950,492,"181",311,0.3522,0.1905,0.2684,0.7911
"9601",209542,"OREGON STATE UNIVERSITY",0,1,1997,"3510","375.999794","592","1516","1869",860,1009,525,"212",313,0.364,0.2101,0.2809,0.8111
"9602",209542,"OREGON STATE UNIVERSITY",0,1,1998,"3549","370.254","601","1756","2229",1105,1124,615,"210",405,0.3665,0.1868,0.2759,0.7878
"9603",209542,"OREGON STATE UNIVERSITY",0,1,1999,"3561","392.011519","594","2188","2772",1319,1453,847,"333",514,0.3897,0.2292,0.3056,0.7893
"9604",209542,"OREGON STATE UNIVERSITY",0,1,2000,"2694","425.607755","613.5","2080","2652",1250,1402,770,"311",459,0.3672,0.2218,0.2903,0.7843
"9605",209542,"OREGON STATE UNIVERSITY",0,1,2001,"2802","457.112527","633","2374","2982",1467,1515,885,"356",529,0.3606,0.235,0.2968,0.7961
"9606",209542,"OREGON STATE UNIVERSITY",0,1,2002,"2886","500.799352","639","2249","2864",1437,1427,906,"319",587,0.4085,0.2235,0.3163,0.7853
"9607",209542,"OREGON STATE UNIVERSITY",0,1,2003,"3642","494.074464","591","2228","2862",1371,1491,811,"321",490,0.3574,0.2153,0.2834,0.7785
"9608",209542,"OREGON STATE UNIVERSITY",0,1,2004,"4113","510.101617","634","2199","2803",1367,1436,860,"320",540,0.395,0.2228,0.3068,0.7845
"9609",209542,"Oregon State University",0,1,2005,"4176","558.279453","676","2120","2817",1385,1432,819,"306",513,0.3704,0.2137,0.2907,0.7526
"9610",209542,"Oregon State University",0,1,2006,"4320","609.299545","685","2085","2898",1413,1485,872,"341",531,0.3758,0.2296,0.3009,0.7195
"9611",209542,"Oregon State University",0,1,2007,"4464","625.688474","689","2072","2974",1436,1538,879,"333",546,0.3802,0.2165,0.2956,0.6967
"9612",209542,"Oregon State University",0,1,2008,"4608","650.912044","699","2058","3006",1422,1584,922,"373",549,0.3861,0.2355,0.3067,0.6846
"9613",209542,"Oregon State University",0,1,2009,"5436","704.933093","713","2330","3314",1620,1694,1072,"400",672,0.4148,0.2361,0.3235,0.7031
"9614",209542,"Oregon State University",0,1,2010,"5760","698.912446","738","2467","3480",1677,1803,1145,"447",698,0.4162,0.2479,0.329,0.7089
"9615",209551,"UNIVERSITY OF OREGON",0,1,1991,"2598","205.291419","657","1540","1919",1068,851,683,"238",445,0.4167,0.2797,0.3559,0.8025
"9616",209551,"UNIVERSITY OF OREGON",0,1,1992,"2721","218.517654","643","1724","2279",1179,1100,808,"315",493,0.4182,0.2864,0.3545,0.7565
"9617",209551,"UNIVERSITY OF OREGON",0,1,1993,"2916","231.155304","671","1978","2513",1422,1091,951,"346",605,0.4255,0.3171,0.3784,0.7871
"9618",209551,"UNIVERSITY OF OREGON",0,1,1995,"3381","259.224207","680","2012","2583",1429,1154,950,"329",621,0.4346,0.2851,0.3678,0.7789
"9619",209551,"UNIVERSITY OF OREGON",0,1,1996,"3540","274.587867","620","2001","2580",1444,1136,958,"349",609,0.4217,0.3072,0.3713,0.7756
"9620",209551,"UNIVERSITY OF OREGON",0,1,1997,"3648","294.758607","686","1835","2384",1307,1077,856,"314",542,0.4147,0.2916,0.3591,0.7697
"9621",209551,"UNIVERSITY OF OREGON",0,1,1998,"3771","293.019126","636","1720","2304",1289,1015,839,"280",559,0.4337,0.2759,0.3641,0.7465
"9622",209551,"UNIVERSITY OF OREGON",0,1,1999,"2694","306.628438","668","1844","2453",1393,1060,931,"314",617,0.4429,0.2962,0.3795,0.7517
"9623",209551,"UNIVERSITY OF OREGON",0,1,2000,"2694","326.523465","665","2171","2809",1527,1282,1089,"384",705,0.4617,0.2995,0.3877,0.7729
"9624",209551,"UNIVERSITY OF OREGON",0,1,2001,"2802","345.653505","662","2386","3049",1687,1362,1244,"464",780,0.4624,0.3407,0.408,0.7826
"9625",209551,"UNIVERSITY OF OREGON",0,1,2002,"2907","389.440286","704","2565","3272",1834,1438,1353,"500",853,0.4651,0.3477,0.4135,0.7839
"9626",209551,"UNIVERSITY OF OREGON",0,1,2003,"3543","404.908979","706","2158","2826",1594,1232,1300,"519",781,0.49,0.4213,0.46,0.7636
"9627",209551,"UNIVERSITY OF OREGON",0,1,2004,"4077","430.660847","703","2466","3138",1734,1404,1377,"539",838,0.4833,0.3839,0.4388,0.7859
"9628",209551,"University of Oregon",0,1,2005,"4164","437.477773","734","2457","3138",1721,1417,1282,"506",776,0.4509,0.3571,0.4085,0.783
"9629",209551,"University of Oregon",0,1,2006,"4341","489.163056","713","2555","3349",1821,1528,1468,"575",893,0.4904,0.3763,0.4383,0.7629
"9630",209551,"University of Oregon",0,1,2007,"4494","513.742655","750","2622","3505",1839,1666,1528,"629",899,0.4889,0.3776,0.4359,0.7481
"9631",209551,"University of Oregon",0,1,2008,"5202","557.786807","761","3198","4191",2129,2062,1903,"824",1079,0.5068,0.3996,0.4541,0.7631
"9632",209551,"University of Oregon",0,1,2009,"6180","610.945331","782","2814","3788",2027,1761,1900,"778",1122,0.5535,0.4418,0.5016,0.7429
"9633",209551,"University of Oregon",0,1,2010,"6930","651.350814","836","2808","3911",2065,1846,1953,"790",1163,0.5632,0.428,0.4994,0.718
"9634",209612,"PACIFIC UNIVERSITY",1,0,1991,"11200","23.782608","101","220","261",154,107,93,"38",55,0.3571,0.3551,0.3563,0.8429
"9635",209612,"PACIFIC UNIVERSITY",1,0,1992,"12320","25.677355","101","170","226",142,84,103,"39",64,0.4507,0.4643,0.4558,0.7522
"9636",209612,"PACIFIC UNIVERSITY",1,0,1993,"13470","28.203176","108","195","280",164,116,126,"47",79,0.4817,0.4052,0.45,0.6964
"9637",209612,"PACIFIC UNIVERSITY",1,0,1995,"14920","32.335903","123","182","242",153,89,108,"33",75,0.4902,0.3708,0.4463,0.7521
"9638",209612,"PACIFIC UNIVERSITY",1,0,1996,"15654","34.036336","131","200","268",179,89,117,"36",81,0.4525,0.4045,0.4366,0.7463
"9639",209612,"PACIFIC UNIVERSITY",1,0,1997,"16220","30.430065","126","208","261",175,86,129,"39",90,0.5143,0.4535,0.4943,0.7969
"9640",209612,"PACIFIC UNIVERSITY",1,0,1998,"16694","31.077363","139","175","246",157,89,133,"39",94,0.5987,0.4382,0.5407,0.7114
"9641",209612,"PACIFIC UNIVERSITY",1,0,1999,"16800","32.334891","163","190","292",175,117,164,"70",94,0.5371,0.5983,0.5616,0.6507
"9642",209612,"PACIFIC UNIVERSITY",1,0,2000,"17305","37.571583","157","229","303",198,105,158,"58",100,0.5051,0.5524,0.5215,0.7558
"9643",209612,"PACIFIC UNIVERSITY",1,0,2001,"18000","41.014474","151","224","310",206,104,171,"47",124,0.6019,0.4519,0.5516,0.7226
"9644",209612,"PACIFIC UNIVERSITY",1,0,2002,"18766","42.259736","179","201","275",166,109,171,"64",107,0.6446,0.5872,0.6218,0.7309
"9645",209612,"PACIFIC UNIVERSITY",1,0,2003,"19330","42.992161","174","212","303",174,129,158,"58",100,0.5747,0.4496,0.5215,0.6997
"9646",209612,"PACIFIC UNIVERSITY",1,0,2004,"20104","44.541561","173","184","294",181,113,164,"62",102,0.5635,0.5487,0.5578,0.6259
"9647",209612,"Pacific University",1,0,2005,"20908","46.777169","175","223","324",204,120,165,"52",113,0.5539,0.4333,0.5093,0.6883
"9648",209612,"Pacific University",1,0,2006,"21954","54.365067","196","202","360",206,154,194,"72",122,0.5922,0.4675,0.5389,0.5611
"9649",209612,"Pacific University",1,0,2007,"25830","58.708951","201","233","372",242,130,194,"59",135,0.5579,0.4538,0.5215,0.6263
"9650",209612,"Pacific University",1,0,2008,"27604","68.314396","205","207","345",227,118,174,"60",114,0.5022,0.5085,0.5043,0.6
"9651",209612,"Pacific University",1,0,2009,"29290","77.237459","208","199","333",204,129,213,"82",131,0.6422,0.6357,0.6396,0.5976
"9652",209612,"Pacific University",1,0,2010,"30990","78.972576","216","259","474",231,243,229,"109",120,0.5195,0.4486,0.4831,0.5464
"9653",209807,"PORTLAND STATE UNIVERSITY",0,1,1991,"2538","99.591883","423","411","670",330,340,86,"34",52,0.1576,0.1,0.1284,0.6134
"9654",209807,"PORTLAND STATE UNIVERSITY",0,1,1992,"2658","106.172077","441","417","651",343,308,94,"42",52,0.1516,0.1364,0.1444,0.6406
"9655",209807,"PORTLAND STATE UNIVERSITY",0,1,1993,"2826","112.152691","411","430","684",330,354,74,"31",43,0.1303,0.0876,0.1082,0.6287
"9656",209807,"PORTLAND STATE UNIVERSITY",0,1,1995,"3183","127.223032","450","463","682",358,324,82,"29",53,0.148,0.0895,0.1202,0.6789
"9657",209807,"PORTLAND STATE UNIVERSITY",0,1,1996,"3342","135.686015","473","436","726",351,375,97,"34",63,0.1795,0.0907,0.1336,0.6006
"9658",209807,"PORTLAND STATE UNIVERSITY",0,1,1997,"3357","143.840258","468","481","743",368,375,96,"37",59,0.1603,0.0987,0.1292,0.6474
"9659",209807,"PORTLAND STATE UNIVERSITY",0,1,1998,"3438","152.736256","469","511","800",419,381,101,"28",73,0.1742,0.0735,0.1262,0.6388
"9660",209807,"PORTLAND STATE UNIVERSITY",0,1,1999,"2694","163.524622","462","581","896",496,400,118,"39",79,0.1593,0.0975,0.1317,0.6484
"9661",209807,"PORTLAND STATE UNIVERSITY",0,1,2000,"2694","185.502569","509.5","564","915",480,435,133,"50",83,0.1729,0.1149,0.1454,0.6164
"9662",209807,"PORTLAND STATE UNIVERSITY",0,1,2001,"2808","196.656614","557","622","1020",548,472,129,"42",87,0.1588,0.089,0.1265,0.6098
"9663",209807,"PORTLAND STATE UNIVERSITY",0,1,2002,"2892","215.92142","581","787","1177",632,545,153,"43",110,0.1741,0.0789,0.13,0.6686
"9664",209807,"PORTLAND STATE UNIVERSITY",0,1,2003,"3240","226.159015","518","799","1264",668,596,159,"55",104,0.1557,0.0923,0.1258,0.6321
"9665",209807,"PORTLAND STATE UNIVERSITY",0,1,2004,"3690","242.441717","551","778","1173",627,546,167,"51",116,0.185,0.0934,0.1424,0.6633
"9666",209807,"Portland State University",0,1,2005,"3810","263.196305","583","734","1200",636,564,172,"66",106,0.1667,0.117,0.1433,0.6117
"9667",209807,"Portland State University",0,1,2006,"3930","294.805442","627","828","1283",695,588,200,"67",133,0.1914,0.1139,0.1559,0.6454
"9668",209807,"Portland State University",0,1,2007,"4314","305.119957","644","904","1427",759,668,252,"93",159,0.2095,0.1392,0.1766,0.6335
"9669",209807,"Portland State University",0,1,2008,"4905","336.600912","687","982","1567",839,728,264,"105",159,0.1895,0.1442,0.1685,0.6267
"9670",209807,"Portland State University",0,1,2009,"5321","385.628548","680","957","1551",800,751,296,"109",187,0.2338,0.1451,0.1908,0.617
"9671",209807,"Portland State University",0,1,2010,"5648","397.947537","711","783","1366",733,633,288,"123",165,0.2251,0.1943,0.2108,0.5732
"9672",209922,"REED COLLEGE",1,0,1991,"16700","23.666794","113","226","292",146,146,139,"71",68,0.4658,0.4863,0.476,0.774
"9673",209922,"REED COLLEGE",1,0,1992,"18190","29.049486","109","218","310",173,137,148,"58",90,0.5202,0.4234,0.4774,0.7032
"9674",209922,"REED COLLEGE",1,0,1993,"19250","28.997688","96","251","328",171,157,148,"80",68,0.3977,0.5096,0.4512,0.7652
"9675",209922,"REED COLLEGE",1,0,1995,"20760","32.433654","111","249","352",188,164,166,"78",88,0.4681,0.4756,0.4716,0.7074
"9676",209922,"REED COLLEGE",1,0,1996,"21490","41.234334","108","252","357",200,157,159,"59",100,0.5,0.3758,0.4454,0.7059
"9677",209922,"REED COLLEGE",1,0,1997,"22340","34.892359","104","212","315",176,139,146,"59",87,0.4943,0.4245,0.4635,0.673
"9678",209922,"REED COLLEGE",1,0,1998,"23120","39.365754","111","220","338",164,174,165,"86",79,0.4817,0.4943,0.4882,0.6509
"9679",209922,"REED COLLEGE",1,0,1999,"23880","39.883738","111","254","331",182,149,172,"78",94,0.5165,0.5235,0.5196,0.7674
"9680",209922,"REED COLLEGE",1,0,2000,"24820","47.100528","116.5","234","358",202,156,204,"79",125,0.6188,0.5064,0.5698,0.6536
"9681",209922,"REED COLLEGE",1,0,2001,"26060","46.455805","122","229","349",198,151,203,"84",119,0.601,0.5563,0.5817,0.6562
"9682",209922,"REED COLLEGE",1,0,2002,"27360","55.141428","122","207","307",160,147,182,"79",103,0.6438,0.5374,0.5928,0.6743
"9683",209922,"REED COLLEGE",1,0,2003,"29000","61.213552","137","195","297",153,144,169,"74",95,0.6209,0.5139,0.569,0.6566
"9684",209922,"REED COLLEGE",1,0,2004,"30670","59.348643","122","192","333",186,147,199,"78",121,0.6505,0.5306,0.5976,0.5766
"9685",209922,"Reed College",1,0,2005,"32360","61.497745","135","222","348",197,151,204,"80",124,0.6294,0.5298,0.5862,0.6379
"9686",209922,"Reed College",1,0,2006,"34300","58.652791","140","229","371",207,164,222,"91",131,0.6329,0.5549,0.5984,0.6173
"9687",209922,"Reed College",1,0,2007,"36190","65.580304","149","189","337",187,150,236,"99",137,0.7326,0.66,0.7003,0.5608
"9688",209922,"Reed College",1,0,2008,"37960","69.553401","155","164","329",194,135,219,"88",131,0.6753,0.6519,0.6657,0.4985
"9689",209922,"Reed College",1,0,2009,"39440","71.715586","145","193","367",192,175,253,"122",131,0.6823,0.6971,0.6894,0.5259
"9690",209922,"Reed College",1,0,2010,"40940","72.588624","141","246","373",212,161,247,"105",142,0.6698,0.6522,0.6622,0.6595
"9691",210146,"SOUTHERN OREGON STATE COLLEGE",0,1,1991,"2415","40.539347","176","491","553",303,250,66,"26",40,0.132,0.104,0.1193,0.8879
"9692",210146,"SOUTHERN OREGON STATE COLLEGE",0,1,1992,"2487","41.984363","171","510","588",301,287,63,"24",39,0.1296,0.0836,0.1071,0.8673
"9693",210146,"SOUTHERN OREGON STATE COLLEGE",0,1,1993,"2667","44.496484","161","523","601",324,277,75,"19",56,0.1728,0.0686,0.1248,0.8702
"9694",210146,"SOUTHERN OREGON STATE COLLEGE",0,1,1995,"2949","45.797588","164","554","661",362,299,89,"33",56,0.1547,0.1104,0.1346,0.8381
"9695",210146,"SOUTHERN OREGON STATE COLLEGE",0,1,1996,"3147","50.818268","182","605","701",388,313,111,"48",63,0.1624,0.1534,0.1583,0.8631
"9696",210146,"SOUTHERN OREGON UNIVERSITY",0,1,1997,"3204","50.976969","170","631","759",426,333,142,"47",95,0.223,0.1411,0.1871,0.8314
"9697",210146,"SOUTHERN OREGON UNIVERSITY",0,1,1998,"3198","52.670135","165","554","670",403,267,124,"40",84,0.2084,0.1498,0.1851,0.8269
"9698",210146,"SOUTHERN OREGON UNIVERSITY",0,1,1999,"2520","57.178674","175","611","754",431,323,136,"46",90,0.2088,0.1424,0.1804,0.8103
"9699",210146,"SOUTHERN OREGON UNIVERSITY",0,1,2000,"2520","61.758442","182.5","565","681",390,291,130,"45",85,0.2179,0.1546,0.1909,0.8297
"9700",210146,"SOUTHERN OREGON UNIVERSITY",0,1,2001,"2628","64.302823","190","618","759",436,323,149,"47",102,0.2339,0.1455,0.1963,0.8142
"9701",210146,"SOUTHERN OREGON UNIVERSITY",0,1,2002,"2706","65.529489","190","646","787",412,375,166,"56",110,0.267,0.1493,0.2109,0.8208
"9702",210146,"SOUTHERN OREGON UNIVERSITY",0,1,2003,"3138","64.873874","182","734","896",497,399,158,"51",107,0.2153,0.1278,0.1763,0.8192
"9703",210146,"SOUTHERN OREGON UNIVERSITY",0,1,2004,"3609","70.206909","185","599","744",409,335,100,"30",70,0.1711,0.0896,0.1344,0.8051
"9704",210146,"Southern Oregon University",0,1,2005,"3720","67.341554","190","598","707",417,290,110,"30",80,0.1918,0.1034,0.1556,0.8458
"9705",210146,"Southern Oregon University",0,1,2006,"3831","73.819315","194","568","707",401,306,110,"31",79,0.197,0.1013,0.1556,0.8034
"9706",210146,"Southern Oregon University",0,1,2007,"3960","76.012157","185","571","703",405,298,127,"37",90,0.2222,0.1242,0.1807,0.8122
"9707",210146,"Southern Oregon University",0,1,2008,"4326","79.605748","185","517","675",407,268,147,"46",101,0.2482,0.1716,0.2178,0.7659
"9708",210146,"Southern Oregon University",0,1,2009,"4788","83.96418","196","516","652",378,274,131,"37",94,0.2487,0.135,0.2009,0.7914
"9709",210146,"Southern Oregon University",0,1,2010,"4914","82.111778","196","557","735",435,300,176,"55",121,0.2782,0.1833,0.2395,0.7578
"9710",210401,"WILLAMETTE UNIVERSITY",1,0,1991,"12480","36.96","145","304","390",221,169,253,"99",154,0.6968,0.5858,0.6487,0.7795
"9711",210401,"WILLAMETTE UNIVERSITY",1,0,1992,"13030","39.995","154","308","385",231,154,256,"103",153,0.6623,0.6688,0.6649,0.8
"9712",210401,"WILLAMETTE UNIVERSITY",1,0,1993,"13665","43.281","145","297","381",218,163,249,"101",148,0.6789,0.6196,0.6535,0.7795
"9713",210401,"WILLAMETTE UNIVERSITY",1,0,1995,"16400","50.011","164","349","432",248,184,330,"132",198,0.7984,0.7174,0.7639,0.8079
"9714",210401,"WILLAMETTE UNIVERSITY",1,0,1996,"18300","51.826715","153","321","419",241,178,304,"115",189,0.7842,0.6461,0.7255,0.7661
"9715",210401,"WILLAMETTE UNIVERSITY",1,0,1997,"20200","44.175","168","295","410",224,186,299,"131",168,0.75,0.7043,0.7293,0.7195
"9716",210401,"WILLAMETTE UNIVERSITY",1,0,1998,"21000","46.057796","170","293","406",236,170,263,"105",158,0.6695,0.6176,0.6478,0.7217
"9717",210401,"WILLAMETTE UNIVERSITY",1,0,1999,"21700","47.724214","172","224","363",190,173,242,"100",142,0.7474,0.578,0.6667,0.6171
"9718",210401,"WILLAMETTE UNIVERSITY",1,0,2000,"22700","49.857007","165","312","506",292,214,336,"124",212,0.726,0.5794,0.664,0.6166
"9719",210401,"WILLAMETTE UNIVERSITY",1,0,2001,"23150","54.182","158","328","476",261,215,345,"143",202,0.7739,0.6651,0.7248,0.6891
"9720",210401,"WILLAMETTE UNIVERSITY",1,0,2002,"24050","58.172","176","207","353",181,172,210,"92",118,0.6519,0.5349,0.5949,0.5864
"9721",210401,"WILLAMETTE UNIVERSITY",1,0,2003,"25300","58.483","185","330","541",312,229,383,"143",240,0.7692,0.6245,0.7079,0.61
"9722",210401,"WILLAMETTE UNIVERSITY",1,0,2004,"26690","63.145","193","315","510",284,226,361,"155",206,0.7254,0.6858,0.7078,0.6176
"9723",210401,"Willamette University",1,0,2005,"28250","66.125","210","270","440",240,200,307,"130",177,0.7375,0.65,0.6977,0.6136
"9724",210401,"Willamette University",1,0,2006,"29850","70.757","215","286","482",260,222,333,"139",194,0.7462,0.6261,0.6909,0.5934
"9725",210401,"Willamette University",1,0,2007,"31760","76.15","200","271","444",238,206,315,"130",185,0.7773,0.6311,0.7095,0.6104
"9726",210401,"Willamette University",1,0,2008,"33750","81.675","203","307","482",278,204,333,"129",204,0.7338,0.6324,0.6909,0.6369
"9727",210401,"Willamette University",1,0,2009,"35400","85.241","214","358","541",294,247,384,"165",219,0.7449,0.668,0.7098,0.6617
"9728",210401,"Willamette University",1,0,2010,"37150","88.634","226","300","427",235,192,301,"119",182,0.7745,0.6198,0.7049,0.7026
"9729",210429,"WESTERN OREGON STATE COLLEGE",0,1,1991,"2406","37.881271","146","519","576",367,209,98,"22",76,0.2071,0.1053,0.1701,0.901
"9730",210429,"WESTERN OREGON STATE COLLEGE",0,1,1992,"2481","38.995502","155","569","626",394,232,112,"36",76,0.1929,0.1552,0.1789,0.9089
"9731",210429,"WESTERN OREGON STATE COLLEGE",0,1,1993,"2637","41.232888","155","599","675",404,271,133,"31",102,0.2525,0.1144,0.197,0.8874
"9732",210429,"WESTERN OREGON STATE COLLEGE",0,1,1995,"2985","43.838863","148","563","641",380,261,95,"22",73,0.1921,0.0843,0.1482,0.8783
"9733",210429,"WESTERN OREGON STATE COLLEGE",0,1,1996,"3099","45.212526","160","640","742",448,294,107,"33",74,0.1652,0.1122,0.1442,0.8625
"9734",210429,"WESTERN OREGON UNIVERSITY",0,1,1997,"3153","46.360049","161","645","759",481,278,103,"35",68,0.1414,0.1259,0.1357,0.8498
"9735",210429,"WESTERN OREGON UNIVERSITY",0,1,1998,"3198","47.739252","158","609","700",425,275,116,"26",90,0.2118,0.0945,0.1657,0.87
"9736",210429,"WESTERN OREGON UNIVERSITY",0,1,1999,"2520","49.10405","159","664","770",460,310,141,"45",96,0.2087,0.1452,0.1831,0.8623
"9737",210429,"WESTERN OREGON UNIVERSITY",0,1,2000,"2520","53.496735","158.5","692","825",524,301,176,"55",121,0.2309,0.1827,0.2133,0.8388
"9738",210429,"WESTERN OREGON UNIVERSITY",0,1,2001,"2622","57.553903","158","653","811",536,275,144,"25",119,0.222,0.0909,0.1776,0.8052
"9739",210429,"WESTERN OREGON UNIVERSITY",0,1,2002,"2700","58.558125","162","649","769",466,303,142,"36",106,0.2275,0.1188,0.1847,0.844
"9740",210429,"WESTERN OREGON UNIVERSITY",0,1,2003,"3240","62.35002","156","771","903",555,348,144,"37",107,0.1928,0.1063,0.1595,0.8538
"9741",210429,"WESTERN OREGON UNIVERSITY",0,1,2004,"3240","63.827472","164","635","795",447,348,138,"55",83,0.1857,0.158,0.1736,0.7987
"9742",210429,"Western Oregon University",0,1,2005,"3366","69.378177","175","658","849",511,338,132,"36",96,0.1879,0.1065,0.1555,0.775
"9743",210429,"Western Oregon University",0,1,2006,"3510","70.509927","162","557","750",485,265,150,"40",110,0.2268,0.1509,0.2,0.7427
"9744",210429,"Western Oregon University",0,1,2007,"4500","70.646969","176","679","916",527,389,184,"54",130,0.2467,0.1388,0.2009,0.7413
"9745",210429,"Western Oregon University",0,1,2008,"5175","82.790303","189","658","882",524,358,197,"58",139,0.2653,0.162,0.2234,0.746
"9746",210429,"Western Oregon University",0,1,2009,"5640","87.111407","195","691","933",553,380,192,"39",153,0.2767,0.1026,0.2058,0.7406
"9747",210429,"Western Oregon University",0,1,2010,"6135","88.126802","190","722","1039",636,403,204,"45",159,0.25,0.1117,0.1963,0.6949
"9748",210571,"ALBRIGHT COLLEGE",1,0,1991,"13560","25.439109","89","199","236",120,116,143,"58",85,0.7083,0.5,0.6059,0.8432
"9749",210571,"ALBRIGHT COLLEGE",1,0,1992,"13960","26.543247","85","267","310",135,175,160,"81",79,0.5852,0.4629,0.5161,0.8613
"9750",210571,"ALBRIGHT COLLEGE",1,0,1993,"15010","27.616215","79","204","227",140,87,147,"50",97,0.6929,0.5747,0.6476,0.8987
"9751",210571,"ALBRIGHT COLLEGE",1,0,1995,"16575","25.658668","60","260","312",153,159,169,"66",103,0.6732,0.4151,0.5417,0.8333
"9752",210571,"ALBRIGHT COLLEGE",1,0,1996,"17395","28.796805","63","310","354",190,164,215,"77",138,0.7263,0.4695,0.6073,0.8757
"9753",210571,"ALBRIGHT COLLEGE",1,0,1997,"18310","23.41853","67","248","295",137,158,176,"83",93,0.6788,0.5253,0.5966,0.8407
"9754",210571,"ALBRIGHT COLLEGE",1,0,1998,"18890","25.094981","71","301","355",187,168,176,"71",105,0.5615,0.4226,0.4958,0.8479
"9755",210571,"ALBRIGHT COLLEGE",1,0,1999,"18910","27.508666","73","311","392",242,150,203,"61",142,0.5868,0.4067,0.5179,0.7934
"9756",210571,"ALBRIGHT COLLEGE",1,0,2000,"19760","30.531344","82","319","407",231,176,207,"84",123,0.5325,0.4773,0.5086,0.7838
"9757",210571,"ALBRIGHT COLLEGE",1,0,2001,"20750","33.50108","91","323","402",243,159,215,"75",140,0.5761,0.4717,0.5348,0.8035
"9758",210571,"ALBRIGHT COLLEGE",1,0,2002,"21790","35.571753","104","352","453",250,203,254,"104",150,0.6,0.5123,0.5607,0.777
"9759",210571,"ALBRIGHT COLLEGE",1,0,2003,"22880","39.083084","109","363","456",259,197,252,"96",156,0.6023,0.4873,0.5526,0.7961
"9760",210571,"ALBRIGHT COLLEGE",1,0,2004,"24030","42.142403","115","389","505",319,186,268,"86",182,0.5705,0.4624,0.5307,0.7703
"9761",210571,"Albright College",1,0,2005,"25232","43.134832","113","350","450",254,196,234,"85",149,0.5866,0.4337,0.52,0.7778
"9762",210571,"Albright College",1,0,2006,"26620","44.266076","118","347","458",233,225,210,"87",123,0.5279,0.3867,0.4585,0.7576
"9763",210571,"Albright College",1,0,2007,"28084","44.903314","114","412","512",307,205,247,"90",157,0.5114,0.439,0.4824,0.8047
"9764",210571,"Albright College",1,0,2008,"29770","46.491275","125","347","505",260,245,224,"86",138,0.5308,0.351,0.4436,0.6871
"9765",210571,"Albright College",1,0,2009,"30800","48.460602","121","376","541",317,224,268,"83",185,0.5836,0.3705,0.4954,0.695
"9766",210571,"Albright College",1,0,2010,"31940","49.294231","124","325","485",255,230,230,"90",140,0.549,0.3913,0.4742,0.6701
"9767",210669,"ALLEGHENY COLLEGE",1,0,1991,"14850","41.167828","139","545","606",289,317,354,"173",181,0.6263,0.5457,0.5842,0.8993
"9768",210669,"ALLEGHENY COLLEGE",1,0,1992,"15750","44.944225","137","428","471",251,220,295,"114",181,0.7211,0.5182,0.6263,0.9087
"9769",210669,"ALLEGHENY COLLEGE",1,0,1993,"16700","43.045117","144","446","481",247,234,301,"126",175,0.7085,0.5385,0.6258,0.9272
"9770",210669,"ALLEGHENY COLLEGE",1,0,1995,"18020","49.883995","141","516","564",284,280,353,"162",191,0.6725,0.5786,0.6259,0.9149
"9771",210669,"ALLEGHENY COLLEGE",1,0,1996,"18720","50.497422","142","505","523",311,212,346,"125",221,0.7106,0.5896,0.6616,0.9656
"9772",210669,"ALLEGHENY COLLEGE",1,0,1997,"19360","38.764089","133","510","541",289,252,328,"139",189,0.654,0.5516,0.6063,0.9427
"9773",210669,"ALLEGHENY COLLEGE",1,0,1998,"20020","41.880797","128","487","545",272,273,321,"144",177,0.6507,0.5275,0.589,0.8936
"9774",210669,"ALLEGHENY COLLEGE",1,0,1999,"20410","42.441535","131","521","562",284,278,374,"167",207,0.7289,0.6007,0.6655,0.927
"9775",210669,"ALLEGHENY COLLEGE",1,0,2000,"21290","42.500346","133","538","561",291,270,393,"175",218,0.7491,0.6481,0.7005,0.959
"9776",210669,"ALLEGHENY COLLEGE",1,0,2001,"22210","44.964829","135","443","486",271,215,312,"128",184,0.679,0.5953,0.642,0.9115
"9777",210669,"ALLEGHENY COLLEGE",1,0,2002,"23100","49.257628","137","500","536",271,265,374,"165",209,0.7712,0.6226,0.6978,0.9328
"9778",210669,"ALLEGHENY COLLEGE",1,0,2003,"24100","52.294981","139","434","478",234,244,317,"143",174,0.7436,0.5861,0.6632,0.9079
"9779",210669,"ALLEGHENY COLLEGE",1,0,2004,"25250","52.081504","145","604","647",341,306,465,"206",259,0.7595,0.6732,0.7187,0.9335
"9780",210669,"Allegheny College",1,0,2005,"26650","54.080233","143","515","561",311,250,424,"181",243,0.7814,0.724,0.7558,0.918
"9781",210669,"Allegheny College",1,0,2006,"28000","56.033467","149","528","570",322,248,398,"159",239,0.7422,0.6411,0.6982,0.9263
"9782",210669,"Allegheny College",1,0,2007,"29680","59.654849","157","517","581",351,230,431,"159",272,0.7749,0.6913,0.7418,0.8898
"9783",210669,"Allegheny College",1,0,2008,"31680","63.532193","163","481","562",306,256,412,"179",233,0.7614,0.6992,0.7331,0.8559
"9784",210669,"Allegheny College",1,0,2009,"33240","65.426963","160","493","580",299,281,395,"177",218,0.7291,0.6299,0.681,0.85
"9785",210669,"Allegheny College",1,0,2010,"34490","70.25703","166","489","594",332,262,415,"173",242,0.7289,0.6603,0.6987,0.8232
"9786",210775,"ALVERNIA COLLEGE",1,0,1991,"6935","7.537156","51","188","194",128,66,56,"16",40,0.3125,0.2424,0.2887,0.9691
"9787",210775,"ALVERNIA COLLEGE",1,0,1992,"7995","9.219578","57","172","182",103,79,26,"7",19,0.1845,0.0886,0.1429,0.9451
"9788",210775,"ALVERNIA COLLEGE",1,0,1993,"8419","11.115922","60","152","157",103,54,48,"14",34,0.3301,0.2593,0.3057,0.9682
"9789",210775,"ALVERNIA COLLEGE",1,0,1995,"9850","13.03452","62","133","150",76,74,46,"14",32,0.4211,0.1892,0.3067,0.8867
"9790",210775,"ALVERNIA COLLEGE",1,0,1996,"10700","14.27687","57","137","143",73,70,44,"16",28,0.3836,0.2286,0.3077,0.958
"9791",210775,"ALVERNIA COLLEGE",1,0,1997,"11320","11.956881","54","145","155",95,60,64,"26",38,0.4,0.4333,0.4129,0.9355
"9792",210775,"ALVERNIA COLLEGE",1,0,1998,"11680","12.377633","51","149","168",93,75,56,"16",40,0.4301,0.2133,0.3333,0.8869
"9793",210775,"ALVERNIA COLLEGE",1,0,1999,"11730","13.55882","52","169","204",101,103,79,"34",45,0.4455,0.3301,0.3873,0.8284
"9794",210775,"ALVERNIA COLLEGE",1,0,2000,"12950","15.228517","55","197","236",149,87,70,"22",48,0.3221,0.2529,0.2966,0.8347
"9795",210775,"ALVERNIA COLLEGE",1,0,2001,"14000","17.732927","58","213","248",159,89,90,"28",62,0.3899,0.3146,0.3629,0.8589
"9796",210775,"ALVERNIA COLLEGE",1,0,2002,"15000","18.754978","58","197","242",153,89,89,"29",60,0.3922,0.3258,0.3678,0.814
"9797",210775,"ALVERNIA COLLEGE",1,0,2003,"16200","22.916348","65","240","278",165,113,99,"32",67,0.4061,0.2832,0.3561,0.8633
"9798",210775,"ALVERNIA COLLEGE",1,0,2004,"17500","24.675033","69","242","310",197,113,123,"29",94,0.4772,0.2566,0.3968,0.7806
"9799",210775,"Alvernia College",1,0,2005,"18900","28.071997","74","213","262",149,113,100,"35",65,0.4362,0.3097,0.3817,0.813
"9800",210775,"Alvernia College",1,0,2006,"20220","31.81719","75","237","300",188,112,114,"43",71,0.3777,0.3839,0.38,0.79
"9801",210775,"Alvernia College",1,0,2007,"21400","35.320036","81","268","302",165,137,107,"48",59,0.3576,0.3504,0.3543,0.8874
"9802",210775,"Alvernia College",1,0,2008,"22800","36.959797","85","329","383",233,150,148,"44",104,0.4464,0.2933,0.3864,0.859
"9803",210775,"Alvernia University",1,0,2009,"23900","40.942323","85","264","328",188,140,124,"53",71,0.3777,0.3786,0.378,0.8049
"9804",210775,"Alvernia University",1,0,2010,"24980","41.517205","89","322","388",268,120,142,"39",103,0.3843,0.325,0.366,0.8299
"9805",211088,"BEAVER COLLEGE",1,0,1991,"10960","27.696513","72","117","140",110,30,92,"13",79,0.7182,0.4333,0.6571,0.8357
"9806",211088,"BEAVER COLLEGE",1,0,1992,"11710","30.139573","66","140","163",120,43,81,"15",66,0.55,0.3488,0.4969,0.8589
"9807",211088,"BEAVER COLLEGE",1,0,1993,"12510","30.297524","68","187","227",166,61,131,"35",96,0.5783,0.5738,0.5771,0.8238
"9808",211088,"BEAVER COLLEGE",1,0,1995,"13970","34.217332","73","213","257",186,71,145,"36",109,0.586,0.507,0.5642,0.8288
"9809",211088,"BEAVER COLLEGE",1,0,1996,"14870","37.519","83","217","292",219,73,131,"29",102,0.4658,0.3973,0.4486,0.7432
"9810",211088,"BEAVER COLLEGE",1,0,1997,"15840","36.616","78","203","260",191,69,142,"34",108,0.5654,0.4928,0.5462,0.7808
"9811",211088,"BEAVER COLLEGE",1,0,1998,"16520","39.676","88","272","334",248,86,189,"46",143,0.5766,0.5349,0.5659,0.8144
"9812",211088,"BEAVER COLLEGE",1,0,1999,"16880","28.845","95","262","307",238,69,154,"28",126,0.5294,0.4058,0.5016,0.8534
"9813",211088,"BEAVER COLLEGE",1,0,2000,"17550","32.027","91","228","294",228,66,147,"27",120,0.5263,0.4091,0.5,0.7755
"9814",211088,"ARCADIA UNIVERSITY",1,0,2001,"18390","34.567","87","244","293",203,90,158,"47",111,0.5468,0.5222,0.5392,0.8328
"9815",211088,"ARCADIA UNIVERSITY",1,0,2002,"19660","38.234","90","327","399",308,91,237,"55",182,0.5909,0.6044,0.594,0.8195
"9816",211088,"ARCADIA UNIVERSITY",1,0,2003,"20990","40.681","93","409","489",360,129,259,"77",182,0.5056,0.5969,0.5297,0.8364
"9817",211088,"ARCADIA UNIVERSITY",1,0,2004,"22440","45.242","107","398","476",343,133,247,"67",180,0.5248,0.5038,0.5189,0.8361
"9818",211088,"Arcadia University",1,0,2005,"23990","49.388","108","353","432",315,117,232,"59",173,0.5492,0.5043,0.537,0.8171
"9819",211088,"Arcadia University",1,0,2006,"25650","55.383","108","470","572",452,120,336,"72",264,0.5841,0.6,0.5874,0.8217
"9820",211088,"Arcadia University",1,0,2007,"27440","60.602","118","395","476",364,112,253,"53",200,0.5495,0.4732,0.5315,0.8298
"9821",211088,"Arcadia University",1,0,2008,"29340","64.555","125","302","593",434,159,294,"73",221,0.5092,0.4591,0.4958,0.5093
"9822",211088,"Arcadia University",1,0,2009,"30780","66.496","125","398","529",381,148,257,"70",187,0.4908,0.473,0.4858,0.7524
"9823",211088,"Arcadia University",1,0,2010,"32140","68.903","125","404","552",397,155,317,"75",242,0.6096,0.4839,0.5743,0.7319
"9824",211158,"BLOOMSBURG UNIVERSITY OF PENNSYLVANIA",1,0,1991,"2968","63.270594","339","1010","1080",664,416,443,"132",311,0.4684,0.3173,0.4102,0.9352
"9825",211158,"BLOOMSBURG UNIVERSITY OF PENNSYLVANIA",1,0,1992,"3068","67.237083","338","951","1047",696,351,423,"87",336,0.4828,0.2479,0.404,0.9083
"9826",211158,"BLOOMSBURG UNIVERSITY OF PENNSYLVANIA",1,0,1993,"3458","69.034099","348","925","1017",615,402,379,"115",264,0.4293,0.2861,0.3727,0.9095
"9827",211158,"BLOOMSBURG UNIVERSITY OF PENNSYLVANIA",1,0,1995,"3915","77.504511","338","974","1054",689,365,372,"88",284,0.4122,0.2411,0.3529,0.9241
"9828",211158,"BLOOMSBURG UNIVERSITY OF PENNSYLVANIA",1,0,1996,"4162","85.340435","330","1469","1556",994,562,567,"147",420,0.4225,0.2616,0.3644,0.9441
"9829",211158,"BLOOMSBURG UNIVERSITY OF PENNSYLVANIA",1,0,1997,"4277","84.247284","337","1242","1355",893,462,459,"125",334,0.374,0.2706,0.3387,0.9166
"9830",211158,"BLOOMSBURG UNIVERSITY OF PENNSYLVANIA",1,0,1998,"4277","90.873702","334","1261","1377",890,487,465,"102",363,0.4079,0.2094,0.3377,0.9158
"9831",211158,"BLOOMSBURG UNIVERSITY OF PENNSYLVANIA",1,0,1999,"3618","90.022184","325","1299","1402",891,511,527,"164",363,0.4074,0.3209,0.3759,0.9265
"9832",211158,"BLOOMSBURG UNIVERSITY OF PENNSYLVANIA",1,0,2000,"3792","100.310729","326","1325","1414",912,502,587,"153",434,0.4759,0.3048,0.4151,0.9371
"9833",211158,"BLOOMSBURG UNIVERSITY OF PENNSYLVANIA",1,0,2001,"4016","99.050708","327","1564","1684",1021,663,646,"183",463,0.4535,0.276,0.3836,0.9287
"9834",211158,"BLOOMSBURG UNIVERSITY OF PENNSYLVANIA",1,0,2002,"4378","100.175225","350","1337","1478",938,540,650,"169",481,0.5128,0.313,0.4398,0.9046
"9835",211158,"BLOOMSBURG UNIVERSITY OF PENNSYLVANIA",1,0,2003,"4598","104.071795","352","1481","1665",1000,665,677,"201",476,0.476,0.3023,0.4066,0.8895
"9836",211158,"BLOOMSBURG UNIVERSITY OF PENNSYLVANIA",1,0,2004,"4810","109.929509","350","1296","1533",947,586,631,"198",433,0.4572,0.3379,0.4116,0.8454
"9837",211158,"Bloomsburg University of Pennsylvania",1,0,2005,"4906","113.731592","357","1411","1690",1050,640,693,"207",486,0.4629,0.3234,0.4101,0.8349
"9838",211158,"Bloomsburg University of Pennsylvania",1,0,2006,"5038","119.043419","366","1329","1630",987,643,696,"221",475,0.4813,0.3437,0.427,0.8153
"9839",211158,"Bloomsburg University of Pennsylvania",1,0,2007,"5177","128.282483","379","1332","1679",969,710,710,"237",473,0.4881,0.3338,0.4229,0.7933
"9840",211158,"Bloomsburg University of Pennsylvania",1,0,2008,"5358","136.792528","378","1432","1805",1028,777,781,"263",518,0.5039,0.3385,0.4327,0.7934
"9841",211158,"Bloomsburg University of Pennsylvania",1,0,2009,"5554","143.407293","397","1554","2031",1221,810,772,"252",520,0.4259,0.3111,0.3801,0.7651
"9842",211158,"Bloomsburg University of Pennsylvania",1,0,2010,"5804","155.090392","403","1768","2136",1263,873,808,"251",557,0.441,0.2875,0.3783,0.8277
"9843",211291,"BUCKNELL UNIVERSITY",1,0,1991,"15650","79.155308","238","827","907",410,497,776,"408",368,0.8976,0.8209,0.8556,0.9118
"9844",211291,"BUCKNELL UNIVERSITY",1,0,1992,"16670","84.123199","239","835","890",426,464,739,"376",363,0.8521,0.8103,0.8303,0.9382
"9845",211291,"BUCKNELL UNIVERSITY",1,0,1993,"17730","88.589","243","785","854",454,400,717,"324",393,0.8656,0.81,0.8396,0.9192
"9846",211291,"BUCKNELL UNIVERSITY",1,0,1995,"19470","97.093155","253","788","910",474,436,736,"342",394,0.8312,0.7844,0.8088,0.8659
"9847",211291,"BUCKNELL UNIVERSITY",1,0,1996,"20360","104.139384","261","798","895",440,455,761,"365",396,0.9,0.8022,0.8503,0.8916
"9848",211291,"BUCKNELL UNIVERSITY",1,0,1997,"21210","89.695","261","788","898",426,472,752,"380",372,0.8732,0.8051,0.8374,0.8775
"9849",211291,"BUCKNELL UNIVERSITY",1,0,1998,"22005","93.223","270","829","954",468,486,840,"427",413,0.8825,0.8786,0.8805,0.869
"9850",211291,"BUCKNELL UNIVERSITY",1,0,1999,"22740","99.754","280","763","886",425,461,764,"396",368,0.8659,0.859,0.8623,0.8612
"9851",211291,"BUCKNELL UNIVERSITY",1,0,2000,"23698","103.44","284.5","774","914",454,460,773,"376",397,0.8744,0.8174,0.8457,0.8468
"9852",211291,"BUCKNELL UNIVERSITY",1,0,2001,"25144","109.98","289","787","913",468,445,784,"367",417,0.891,0.8247,0.8587,0.862
"9853",211291,"BUCKNELL UNIVERSITY",1,0,2002,"27340","116.799","323","772","914",455,459,764,"371",393,0.8637,0.8083,0.8359,0.8446
"9854",211291,"BUCKNELL UNIVERSITY",1,0,2003,"28764","122.964","319","752","906",462,444,794,"374",420,0.9091,0.8423,0.8764,0.83
"9855",211291,"BUCKNELL UNIVERSITY",1,0,2004,"30534","127.555","313","735","906",447,459,813,"397",416,0.9306,0.8649,0.8974,0.8113
"9856",211291,"Bucknell University",1,0,2005,"32592","136.399","323","727","920",504,416,804,"352",452,0.8968,0.8462,0.8739,0.7902
"9857",211291,"Bucknell University",1,0,2006,"34731","139.972","323","736","921",458,463,792,"383",409,0.893,0.8272,0.8599,0.7991
"9858",211291,"Bucknell University",1,0,2007,"37934","151.57","335","743","887",441,446,774,"373",401,0.9093,0.8363,0.8726,0.8377
"9859",211291,"Bucknell University",1,0,2008,"39434","166.761","369","789","956",529,427,814,"357",457,0.8639,0.8361,0.8515,0.8253
"9860",211291,"Bucknell University",1,0,2009,"40594","173.61","368","765","920",466,454,780,"371",409,0.8777,0.8172,0.8478,0.8315
"9861",211291,"Bucknell University",1,0,2010,"42112","172.663","371","741","929",491,438,782,"355",427,0.8697,0.8105,0.8418,0.7976
"9862",211352,"CABRINI COLLEGE",1,0,1991,"8830","13.059377","43","129","137",93,44,73,"19",54,0.5806,0.4318,0.5328,0.9416
"9863",211352,"CABRINI COLLEGE",1,0,1992,"9500","14.045635","43","145","161",115,46,91,"24",67,0.5826,0.5217,0.5652,0.9006
"9864",211352,"CABRINI COLLEGE",1,0,1993,"10232","15.697224","41","210","224",158,66,115,"29",86,0.5443,0.4394,0.5134,0.9375
"9865",211352,"CABRINI COLLEGE",1,0,1995,"11600","19.243284","42","183","218",150,68,110,"25",85,0.5667,0.3676,0.5046,0.8394
"9866",211352,"CABRINI COLLEGE",1,0,1996,"12160","22.460002","43","205","247",186,61,114,"23",91,0.4892,0.377,0.4615,0.83
"9867",211352,"CABRINI COLLEGE",1,0,1997,"12700","17.552244","49","301","339",231,108,160,"39",121,0.5238,0.3611,0.472,0.8879
"9868",211352,"CABRINI COLLEGE",1,0,1998,"14650","19.364918","54","261","304",209,95,152,"35",117,0.5598,0.3684,0.5,0.8586
"9869",211352,"CABRINI COLLEGE",1,0,1999,"15250","21.641219","58","183","248",163,85,124,"30",94,0.5767,0.3529,0.5,0.7379
"9870",211352,"CABRINI COLLEGE",1,0,2000,"16150","22.592412","54","298","359",221,138,161,"50",111,0.5023,0.3623,0.4485,0.8301
"9871",211352,"CABRINI COLLEGE",1,0,2001,"17340","25.93609","50","297","374",221,153,166,"50",116,0.5249,0.3268,0.4439,0.7941
"9872",211352,"CABRINI COLLEGE",1,0,2002,"18470","27.859807","59","329","408",277,131,191,"53",138,0.4982,0.4046,0.4681,0.8064
"9873",211352,"CABRINI COLLEGE",1,0,2003,"19670","30.144232","62","344","401",270,131,184,"55",129,0.4778,0.4198,0.4589,0.8579
"9874",211352,"CABRINI COLLEGE",1,0,2004,"21450","32.80822","63","303","390",257,133,155,"45",110,0.428,0.3383,0.3974,0.7769
"9875",211352,"Cabrini College",1,0,2005,"23200","34.600168","64","468","526",385,141,257,"60",197,0.5117,0.4255,0.4886,0.8897
"9876",211352,"Cabrini College",1,0,2006,"25120","38.7541","61","449","529",337,192,232,"63",169,0.5015,0.3281,0.4386,0.8488
"9877",211352,"Cabrini College",1,0,2007,"27200","42.239665","65","416","513",329,184,202,"66",136,0.4134,0.3587,0.3938,0.8109
"9878",211352,"Cabrini College",1,0,2008,"29100","49.445622","68","405","503",341,162,210,"62",148,0.434,0.3827,0.4175,0.8052
"9879",211352,"Cabrini College",1,0,2009,"30120","52.029802","70","245","357",237,120,178,"57",121,0.5105,0.475,0.4986,0.6863
"9880",211352,"Cabrini College",1,0,2010,"31174","48.87155","72","259","339",222,117,174,"47",127,0.5721,0.4017,0.5133,0.764
"9881",211361,"CALIFORNIA UNIVERSITY OF PENNSYLVANIA",1,0,1991,"3128","55.624037","389","1018","1107",565,542,141,"48",93,0.1646,0.0886,0.1274,0.9196
"9882",211361,"CALIFORNIA UNIVERSITY OF PENNSYLVANIA",1,0,1992,"3384","59.475612","325","888","962",436,526,139,"45",94,0.2156,0.0856,0.1445,0.9231
"9883",211361,"CALIFORNIA UNIVERSITY OF PENNSYLVANIA",1,0,1993,"3760","61.555104","309","893","951",401,550,145,"55",90,0.2244,0.1,0.1525,0.939
"9884",211361,"CALIFORNIA UNIVERSITY OF PENNSYLVANIA",1,0,1995,"4136","66.481098","317","825","892",465,427,124,"45",79,0.1699,0.1054,0.139,0.9249
"9885",211361,"CALIFORNIA UNIVERSITY OF PENNSYLVANIA",1,0,1996,"4304","67.892627","291","731","805",398,407,140,"47",93,0.2337,0.1155,0.1739,0.9081
"9886",211361,"CALIFORNIA UNIVERSITY OF PENNSYLVANIA",1,0,1997,"4475","67.498074","298","857","942",446,496,163,"64",99,0.222,0.129,0.173,0.9098
"9887",211361,"CALIFORNIA UNIVERSITY OF PENNSYLVANIA",1,0,1998,"4545","69.324566","302","868","931",480,451,180,"68",112,0.2333,0.1508,0.1933,0.9323
"9888",211361,"CALIFORNIA UNIVERSITY OF PENNSYLVANIA",1,0,1999,"3618","71.658569","278","869","924",484,440,162,"48",114,0.2355,0.1091,0.1753,0.9405
"9889",211361,"CALIFORNIA UNIVERSITY OF PENNSYLVANIA",1,0,2000,"3792","74.845086","279","789","840",398,442,187,"83",104,0.2613,0.1878,0.2226,0.9393
"9890",211361,"CALIFORNIA UNIVERSITY OF PENNSYLVANIA",1,0,2001,"4016","78.932475","280","754","817",413,404,208,"84",124,0.3002,0.2079,0.2546,0.9229
"9891",211361,"CALIFORNIA UNIVERSITY OF PENNSYLVANIA",1,0,2002,"4378","77.130347","259","622","893",464,429,224,"95",129,0.278,0.2214,0.2508,0.6965
"9892",211361,"CALIFORNIA UNIVERSITY OF PENNSYLVANIA",1,0,2003,"4598","82.896663","255","708","982",520,462,251,"105",146,0.2808,0.2273,0.2556,0.721
"9893",211361,"CALIFORNIA UNIVERSITY OF PENNSYLVANIA",1,0,2004,"4810","83.430748","255","780","1038",519,519,293,"127",166,0.3198,0.2447,0.2823,0.7514
"9894",211361,"California University of Pennsylvania",1,0,2005,"4906","84.830657","263","950","1247",640,607,298,"119",179,0.2797,0.196,0.239,0.7618
"9895",211361,"California University of Pennsylvania",1,0,2006,"5038","93.502731","276","897","1260",685,575,313,"124",189,0.2759,0.2157,0.2484,0.7119
"9896",211361,"California University of Pennsylvania",1,0,2007,"5178","106.675551","289","946","1250",622,628,281,"124",157,0.2524,0.1975,0.2248,0.7568
"9897",211361,"California University of Pennsylvania",1,0,2008,"5358","118.157497","292","1091","1363",748,615,355,"130",225,0.3008,0.2114,0.2605,0.8004
"9898",211361,"California University of Pennsylvania",1,0,2009,"5554","123.783111","287","1009","1373",679,694,323,"156",167,0.2459,0.2248,0.2353,0.7349
"9899",211361,"California University of Pennsylvania",1,0,2010,"5804","136.756928","278","1107","1351",711,640,332,"136",196,0.2757,0.2125,0.2457,0.8194
"9900",211431,"CARLOW COLLEGE",1,0,1991,"8752","11.714147","46","129","144",138,6,59,"2",57,0.413,0.3333,0.4097,0.8958
"9901",211431,"CARLOW COLLEGE",1,0,1992,"9190","12.97346","53","140","159",148,11,50,"2",48,0.3243,0.1818,0.3145,0.8805
"9902",211431,"CARLOW COLLEGE",1,0,1993,"9650","15.482338","53","151","169",158,11,80,"3",77,0.4873,0.2727,0.4734,0.8935
"9903",211431,"CARLOW COLLEGE",1,0,1995,"10588","20.32499","60","106","125",122,3,57,"2",55,0.4508,0.6667,0.456,0.848
"9904",211431,"CARLOW COLLEGE",1,0,1996,"11064","23.352957","68","119","148",145,3,65,"0",65,0.4483,0,0.4392,0.8041
"9905",211431,"CARLOW COLLEGE",1,0,1997,"11708","22.666597","66","117","142",139,3,50,"1",49,0.3525,0.3333,0.3521,0.8239
"9906",211431,"CARLOW COLLEGE",1,0,1998,"12332","20.709812","62","118","163",157,6,43,"3",40,0.2548,0.5,0.2638,0.7239
"9907",211431,"CARLOW COLLEGE",1,0,1999,"12450","21.987297","61","102","130",128,2,47,"0",47,0.3672,0,0.3615,0.7846
"9908",211431,"CARLOW COLLEGE",1,0,2000,"12950","21.404756","60","140","180",178,2,85,"0",85,0.4775,0,0.4722,0.7778
"9909",211431,"CARLOW COLLEGE",1,0,2001,"13468","22.112816","59","146","177",170,7,65,"0",65,0.3824,0,0.3672,0.8249
"9910",211431,"CARLOW COLLEGE",1,0,2002,"14006","23.431614","60","179","238",231,7,79,"0",79,0.342,0,0.3319,0.7521
"9911",211431,"CARLOW COLLEGE",1,0,2003,"14776","24.40597","69","183","236",229,7,71,"3",68,0.2969,0.4286,0.3008,0.7754
"9912",211431,"CARLOW UNIVERSITY",1,0,2004,"15806","25.720132","75","187","231",226,5,87,"1",86,0.3805,0.2,0.3766,0.8095
"9913",211431,"Carlow University",1,0,2005,"16754","27.469236","70","234","273",264,9,102,"3",99,0.375,0.3333,0.3736,0.8571
"9914",211431,"Carlow University",1,0,2006,"17760","29.945681","77","201","262",250,12,114,"3",111,0.444,0.25,0.4351,0.7672
"9915",211431,"Carlow University",1,0,2007,"18736","31.659216","84","149","199",194,5,93,"0",93,0.4794,0,0.4673,0.7487
"9916",211431,"Carlow University",1,0,2008,"19860","34.281432","93","153","226",215,11,99,"2",97,0.4512,0.1818,0.4381,0.677
"9917",211431,"Carlow University",1,0,2009,"20854","35.671876","96","183","250",245,5,100,"1",99,0.4041,0.2,0.4,0.732
"9918",211431,"Carlow University",1,0,2010,"22400","38.080915","98","103","189",181,8,76,"1",75,0.4144,0.125,0.4021,0.545
"9919",211440,"CARNEGIE MELLON UNIVERSITY",1,0,1991,"15350","302.574","507","721","1170",335,835,657,"464",193,0.5761,0.5557,0.5615,0.6162
"9920",211440,"CARNEGIE MELLON UNIVERSITY",1,0,1992,"16000","317.217","518","626","1141",354,787,666,"440",226,0.6384,0.5591,0.5837,0.5486
"9921",211440,"CARNEGIE MELLON UNIVERSITY",1,0,1993,"16960","329.318","523","590","1189",358,831,752,"510",242,0.676,0.6137,0.6325,0.4962
"9922",211440,"CARNEGIE MELLON UNIVERSITY",1,0,1995,"18600","358.864","513","605","1233",376,857,772,"515",257,0.6835,0.6009,0.6261,0.4907
"9923",211440,"CARNEGIE MELLON UNIVERSITY",1,0,1996,"19500","386.858","515","667","1386",472,914,903,"563",340,0.7203,0.616,0.6515,0.4812
"9924",211440,"CARNEGIE MELLON UNIVERSITY",1,0,1997,"20375","382.374728","527","597","1270",464,806,841,"522",319,0.6875,0.6476,0.6622,0.4701
"9925",211440,"CARNEGIE MELLON UNIVERSITY",1,0,1998,"21405","405.89821","527","574","1303",445,858,848,"539",309,0.6944,0.6282,0.6508,0.4405
"9926",211440,"CARNEGIE MELLON UNIVERSITY",1,0,1999,"22100","429.594574","546","564","1255",487,768,833,"491",342,0.7023,0.6393,0.6637,0.4494
"9927",211440,"CARNEGIE MELLON UNIVERSITY",1,0,2000,"24600","465.170512","556","548","1325",516,809,920,"537",383,0.7422,0.6638,0.6943,0.4136
"9928",211440,"CARNEGIE MELLON UNIVERSITY",1,0,2001,"25670","505.096839","566","565","1317",534,783,927,"526",401,0.7509,0.6718,0.7039,0.429
"9929",211440,"CARNEGIE MELLON UNIVERSITY",1,0,2002,"26910","574.839385","747","603","1364",542,822,957,"557",400,0.738,0.6776,0.7016,0.4421
"9930",211440,"CARNEGIE MELLON UNIVERSITY",1,0,2003,"28766","560.925046","783","563","1338",528,810,903,"532",371,0.7027,0.6568,0.6749,0.4208
"9931",211440,"CARNEGIE MELLON UNIVERSITY",1,0,2004,"30650","622.845896","797","562","1359",510,849,940,"579",361,0.7078,0.682,0.6917,0.4135
"9932",211440,"Carnegie Mellon University",1,0,2005,"31650","684.088857","810","600","1408",533,875,1000,"611",389,0.7298,0.6983,0.7102,0.4261
"9933",211440,"Carnegie Mellon University",1,0,2006,"33050","744.683151","826","567","1421",552,869,1033,"630",403,0.7301,0.725,0.727,0.399
"9934",211440,"Carnegie Mellon University",1,0,2007,"35580","762.099059","822","570","1407",554,853,1046,"612",434,0.7834,0.7175,0.7434,0.4051
"9935",211440,"Carnegie Mellon University",1,0,2008,"38430","822.24705","854","565","1462",625,837,1050,"580",470,0.752,0.693,0.7182,0.3865
"9936",211440,"Carnegie Mellon University",1,0,2009,"39470","867.481556","872","623","1423",611,812,1026,"558",468,0.766,0.6872,0.721,0.4378
"9937",211440,"Carnegie Mellon University",1,0,2010,"41500","890.058887","889","616","1484",619,865,1119,"630",489,0.79,0.7283,0.754,0.4151
"9938",211468,"CEDAR CREST COLLEGE",1,0,1991,"12210","12.00788","58","110","120",120,0,62,"0",62,0.5167,NA,0.5167,0.9167
"9939",211468,"CEDAR CREST COLLEGE",1,0,1992,"12940","13.718153","62","157","187",186,1,74,"0",74,0.3978,0,0.3957,0.8396
"9940",211468,"CEDAR CREST COLLEGE",1,0,1993,"13720","16.883736","60","177","198",196,2,83,"1",82,0.4184,0.5,0.4192,0.8939
"9941",211468,"CEDAR CREST COLLEGE",1,0,1995,"14770","21.455836","65","140","164",164,0,90,"0",90,0.5488,NA,0.5488,0.8537
"9942",211468,"CEDAR CREST COLLEGE",1,0,1996,"15210","21.34571","67","274","329",328,1,189,"0",189,0.5762,0,0.5745,0.8328
"9943",211468,"CEDAR CREST COLLEGE",1,0,1997,"15920","19.229003","63","155","195",194,1,122,"1",121,0.6237,1,0.6256,0.7949
"9944",211468,"CEDAR CREST COLLEGE",1,0,1998,"16550","19.820927","63","156","187",185,2,104,"1",103,0.5568,0.5,0.5561,0.8342
"9945",211468,"CEDAR CREST COLLEGE",1,0,1999,"17100","20.041854","67","166","218",218,0,115,"0",115,0.5275,NA,0.5275,0.7615
"9946",211468,"CEDAR CREST COLLEGE",1,0,2000,"17790","19.917393","69","141","200",198,2,109,"0",109,0.5505,0,0.545,0.705
"9947",211468,"CEDAR CREST COLLEGE",1,0,2001,"18680","20.998078","71","143","170",170,0,78,"0",78,0.4588,NA,0.4588,0.8412
"9948",211468,"CEDAR CREST COLLEGE",1,0,2002,"19615","21.481599","71","152","185",185,0,89,"0",89,0.4811,NA,0.4811,0.8216
"9949",211468,"CEDAR CREST COLLEGE",1,0,2003,"20596","21.884916","70","198","233",233,0,105,"0",105,0.4506,NA,0.4506,0.8498
"9950",211468,"CEDAR CREST COLLEGE",1,0,2004,"21630","23.626044","75","205","237",237,0,114,"0",114,0.481,NA,0.481,0.865
"9951",211468,"Cedar Crest College",1,0,2005,"22712","25.405867","79","179","203",202,1,82,"1",81,0.401,1,0.4039,0.8818
"9952",211468,"Cedar Crest College",1,0,2006,"23848","27.194998","84","220","254",251,3,124,"1",123,0.49,0.3333,0.4882,0.8661
"9953",211468,"Cedar Crest College",1,0,2007,"25040","29.521292","92","193","222",221,1,112,"0",112,0.5068,0,0.5045,0.8694
"9954",211468,"Cedar Crest College",1,0,2008,"26668","31.636314","90","156","194",194,0,114,"0",114,0.5876,NA,0.5876,0.8041
"9955",211468,"Cedar Crest College",1,0,2009,"27735","31.50808","87","157","195",194,1,84,"0",84,0.433,0,0.4308,0.8051
"9956",211468,"Cedar Crest College",1,0,2010,"28567","31.809012","87","62","91",90,1,36,"0",36,0.4,0,0.3956,0.6813
"9957",211556,"CHATHAM COLLEGE",1,0,1991,"11065","12.800836","45","80","100",100,0,52,"0",52,0.52,NA,0.52,0.8
"9958",211556,"CHATHAM COLLEGE",1,0,1992,"11990","14.167845","45","75","89",89,0,42,"0",42,0.4719,NA,0.4719,0.8427
"9959",211556,"CHATHAM COLLEGE",1,0,1993,"12630","14.942311","50","81","87",87,0,41,"0",41,0.4713,NA,0.4713,0.931
"9960",211556,"CHATHAM COLLEGE",1,0,1995,"14196","15.499626","50","94","109",109,0,48,"0",48,0.4404,NA,0.4404,0.8624
"9961",211556,"CHATHAM COLLEGE",1,0,1996,"14616","17.33389","54","87","102",102,0,60,"0",60,0.5882,NA,0.5882,0.8529
"9962",211556,"CHATHAM COLLEGE",1,0,1997,"15340","15.813393","55","79","92",92,0,51,"0",51,0.5543,NA,0.5543,0.8587
"9963",211556,"CHATHAM COLLEGE",1,0,1998,"16406","17.78816","54","118","142",142,0,63,"0",63,0.4437,NA,0.4437,0.831
"9964",211556,"CHATHAM COLLEGE",1,0,1999,"17388","20.076325","57","87","126",126,0,62,"0",62,0.4921,NA,0.4921,0.6905
"9965",211556,"CHATHAM COLLEGE",1,0,2000,"18080","21.969073","64","112","138",138,0,54,"0",54,0.3913,NA,0.3913,0.8116
"9966",211556,"CHATHAM COLLEGE",1,0,2001,"18804","22.761155","71","99","133",133,0,56,"0",56,0.4211,NA,0.4211,0.7444
"9967",211556,"CHATHAM COLLEGE",1,0,2002,"19576","24.045625","70","77","108",108,0,49,"0",49,0.4537,NA,0.4537,0.713
"9968",211556,"CHATHAM COLLEGE",1,0,2003,"20360","23.858163","71","58","74",74,0,38,"0",38,0.5135,NA,0.5135,0.7838
"9969",211556,"CHATHAM COLLEGE",1,0,2004,"21780","27.473179","71","52","90",90,0,50,"0",50,0.5556,NA,0.5556,0.5778
"9970",211556,"Chatham College",1,0,2005,"22870","28.408994","73","78","116",116,0,57,"0",57,0.4914,NA,0.4914,0.6724
"9971",211556,"Chatham University",1,0,2006,"24014","31.668868","78","100","147",147,0,75,"0",75,0.5102,NA,0.5102,0.6803
"9972",211556,"Chatham University",1,0,2007,"25216","35.743244","85","122","175",175,0,77,"0",77,0.44,NA,0.44,0.6971
"9973",211556,"Chatham University",1,0,2008,"26476","40.272352","88","104","176",176,0,82,"0",82,0.4659,NA,0.4659,0.5909
"9974",211556,"Chatham University",1,0,2009,"27270","43.802184","88","78","131",131,0,66,"0",66,0.5038,NA,0.5038,0.5954
"9975",211556,"Chatham University",1,0,2010,"28088","46.092897","90","73","150",150,0,72,"0",72,0.48,NA,0.48,0.4867
"9976",211583,"CHESTNUT HILL COLLEGE",1,0,1991,"8250","9.241343","33","71","111",111,0,54,"0",54,0.4865,NA,0.4865,0.6396
"9977",211583,"CHESTNUT HILL COLLEGE",1,0,1992,"8950","10.058123","35","116","145",145,0,76,"0",76,0.5241,NA,0.5241,0.8
"9978",211583,"CHESTNUT HILL COLLEGE",1,0,1993,"9525","11.214568","37","91","132",132,0,73,"0",73,0.553,NA,0.553,0.6894
"9979",211583,"CHESTNUT HILL COLLEGE",1,0,1995,"11865","13.117355","36","57","83",83,0,53,"0",53,0.6386,NA,0.6386,0.6867
"9980",211583,"CHESTNUT HILL COLLEGE",1,0,1996,"13148","15.657051","37","47","77",77,0,46,"0",46,0.5974,NA,0.5974,0.6104
"9981",211583,"CHESTNUT HILL COLLEGE",1,0,1997,"14585","13.649074","35","67","92",92,0,51,"0",51,0.5543,NA,0.5543,0.7283
"9982",211583,"CHESTNUT HILL COLLEGE",1,0,1998,"15198","12.013801","38","48","95",93,2,42,"0",42,0.4516,0,0.4421,0.5053
"9983",211583,"CHESTNUT HILL COLLEGE",1,0,1999,"15454","14.204428","34","63","102",101,1,45,"1",44,0.4356,1,0.4412,0.6176
"9984",211583,"CHESTNUT HILL COLLEGE",1,0,2000,"16200","15.197109","36.5","51","104",98,6,51,"1",50,0.5102,0.1667,0.4904,0.4904
"9985",211583,"CHESTNUT HILL COLLEGE",1,0,2001,"16990","16.060249","39","55","94",94,0,50,"0",50,0.5319,NA,0.5319,0.5851
"9986",211583,"CHESTNUT HILL COLLEGE",1,0,2002,"17500","16.912444","38","52","105",104,1,27,"0",27,0.2596,0,0.2571,0.4952
"9987",211583,"CHESTNUT HILL COLLEGE",1,0,2003,"18375","18.357924","43","122","188",125,63,66,"19",47,0.376,0.3016,0.3511,0.6489
"9988",211583,"CHESTNUT HILL COLLEGE",1,0,2004,"19660","20.420647","50","115","197",115,82,62,"24",38,0.3304,0.2927,0.3147,0.5838
"9989",211583,"Chestnut Hill College",1,0,2005,"20840","22.488228","50","124","219",150,69,73,"23",50,0.3333,0.3333,0.3333,0.5662
"9990",211583,"Chestnut Hill College",1,0,2006,"23600","24.4571","53","144","214",155,59,78,"22",56,0.3613,0.3729,0.3645,0.6729
"9991",211583,"Chestnut Hill College",1,0,2007,"24900","27.732949","52","154","234",128,106,63,"24",39,0.3047,0.2264,0.2692,0.6581
"9992",211583,"Chestnut Hill College",1,0,2008,"26000","30.425818","57","113","194",115,79,72,"24",48,0.4174,0.3038,0.3711,0.5825
"9993",211583,"Chestnut Hill College",1,0,2009,"27000","32.094712","57","155","273",164,109,101,"27",74,0.4512,0.2477,0.37,0.5678
"9994",211583,"Chestnut Hill College",1,0,2010,"28100","35.435987","64","145","219",125,94,82,"31",51,0.408,0.3298,0.3744,0.6621
"9995",211608,"CHEYNEY UNIVERSITY OF PENNSYLVANIA",1,0,1991,"2838","22.803845","82","7","324",139,185,33,"14",19,0.1367,0.0757,0.1019,0.0216
"9996",211608,"CHEYNEY UNIVERSITY OF PENNSYLVANIA",1,0,1992,"2938","24.027665","87","2","375",184,191,19,"2",17,0.0924,0.0105,0.0507,0.0053
"9997",211608,"CHEYNEY UNIVERSITY OF PENNSYLVANIA",1,0,1993,"3319","23.203009","96","2","287",128,159,23,"11",12,0.0938,0.0692,0.0801,0.007
"9998",211608,"CHEYNEY UNIVERSITY OF PENNSYLVANIA",1,0,1995,"3729","26.89955","93","1","256",131,125,20,"5",15,0.1145,0.04,0.0781,0.0039
"9999",211608,"CHEYNEY UNIVERSITY OF PENNSYLVANIA",1,0,1996,"3922","27.093749","93","0","236",124,112,16,"2",14,0.1129,0.0179,0.0678,0
"10000",211608,"CHEYNEY UNIVERSITY OF PENNSYLVANIA",1,0,1997,"4023","26.803761","86","2","236",122,114,18,"4",14,0.1148,0.0351,0.0763,0.0085
"10001",211608,"CHEYNEY UNIVERSITY OF PENNSYLVANIA",1,0,1998,"4023","28.557601","90","1","235",147,88,23,"3",20,0.1361,0.0341,0.0979,0.0043
"10002",211608,"CHEYNEY UNIVERSITY OF PENNSYLVANIA",1,0,1999,"3618","29.582948","92","0","254",152,102,37,"9",28,0.1842,0.0882,0.1457,0
"10003",211608,"CHEYNEY UNIVERSITY OF PENNSYLVANIA",1,0,2000,"3792","33.685209","91","0","291",151,140,34,"9",25,0.1656,0.0643,0.1168,0
"10004",211608,"CHEYNEY UNIVERSITY OF PENNSYLVANIA",1,0,2001,"4016","35.259155","90","0","292",146,146,32,"7",25,0.1712,0.0479,0.1096,0
"10005",211608,"CHEYNEY UNIVERSITY OF PENNSYLVANIA",1,0,2002,"4378","33.11067","94","1","247",132,115,25,"5",20,0.1515,0.0435,0.1012,0.004
"10006",211608,"CHEYNEY UNIVERSITY OF PENNSYLVANIA",1,0,2003,"4598","32.548337","86","1","378",208,170,51,"13",38,0.1827,0.0765,0.1349,0.0026
"10007",211608,"CHEYNEY UNIVERSITY OF PENNSYLVANIA",1,0,2004,"4810","34.3125","93","0","422",225,197,56,"20",36,0.16,0.1015,0.1327,0
"10008",211608,"Cheyney University of Pennsylvania",1,0,2005,"4906","37.29397","91","3","397",219,178,51,"21",30,0.137,0.118,0.1285,0.0076
"10009",211608,"Cheyney University of Pennsylvania",1,0,2006,"5038","42.214141","95","1","437",238,199,47,"15",32,0.1345,0.0754,0.1076,0.0023
"10010",211608,"Cheyney University of Pennsylvania",1,0,2007,"5177","42.989912","89","1","278",166,112,26,"5",21,0.1265,0.0446,0.0935,0.0036
"10011",211608,"Cheyney University of Pennsylvania",1,0,2008,"5358","46.236035","78","2","280",157,123,31,"6",25,0.1592,0.0488,0.1107,0.0071
"10012",211608,"Cheyney University of Pennsylvania",1,0,2009,"5554","46.359543","76","2","372",199,173,22,"7",15,0.0754,0.0405,0.0591,0.0054
"10013",211608,"Cheyney University of Pennsylvania",1,0,2010,"5804","44.745793","79","7","471",258,213,25,"5",20,0.0775,0.0235,0.0531,0.0149
"10014",211644,"CLARION UNIVERSITY OF PENNSYLVANIA",1,0,1991,"3147","57.66896","348","923","973",584,389,232,"64",168,0.2877,0.1645,0.2384,0.9486
"10015",211644,"CLARION UNIVERSITY OF PENNSYLVANIA",1,0,1992,"3328","60.857554","336","1037","1093",679,414,246,"60",186,0.2739,0.1449,0.2251,0.9488
"10016",211644,"CLARION UNIVERSITY OF PENNSYLVANIA",1,0,1993,"3710","61.980938","289","1035","1081",650,431,246,"70",176,0.2708,0.1624,0.2276,0.9574
"10017",211644,"CLARION UNIVERSITY OF PENNSYLVANIA",1,0,1995,"4054","68.347343","290","1156","1241",768,473,210,"46",164,0.2135,0.0973,0.1692,0.9315
"10018",211644,"CLARION UNIVERSITY OF PENNSYLVANIA",1,0,1996,"4268","72.579769","292","1141","1215",711,504,284,"79",205,0.2883,0.1567,0.2337,0.9391
"10019",211644,"CLARION UNIVERSITY OF PENNSYLVANIA",1,0,1997,"4378","73.735891","293","1145","1220",751,469,294,"84",210,0.2796,0.1791,0.241,0.9385
"10020",211644,"CLARION UNIVERSITY OF PENNSYLVANIA",1,0,1998,"4569","77.655159","280","1110","1191",717,474,250,"64",186,0.2594,0.135,0.2099,0.932
"10021",211644,"CLARION UNIVERSITY OF PENNSYLVANIA",1,0,1999,"3618","79.499863","280","1194","1286",806,480,295,"80",215,0.2667,0.1667,0.2294,0.9285
"10022",211644,"CLARION UNIVERSITY OF PENNSYLVANIA",1,0,2000,"3792","82.853325","286","1191","1305",813,492,330,"99",231,0.2841,0.2012,0.2529,0.9126
"10023",211644,"CLARION UNIVERSITY OF PENNSYLVANIA",1,0,2001,"4016","89.392043","292","1176","1286",814,472,313,"82",231,0.2838,0.1737,0.2434,0.9145
"10024",211644,"CLARION UNIVERSITY OF PENNSYLVANIA",1,0,2002,"4378","85.07957","289","1144","1249",745,504,367,"117",250,0.3356,0.2321,0.2938,0.9159
"10025",211644,"CLARION UNIVERSITY OF PENNSYLVANIA",1,0,2003,"4598","90.682946","290","1125","1219",729,490,366,"113",253,0.3471,0.2306,0.3002,0.9229
"10026",211644,"CLARION UNIVERSITY OF PENNSYLVANIA",1,0,2004,"4810","93.770353","285","1071","1203",683,520,296,"103",193,0.2826,0.1981,0.2461,0.8903
"10027",211644,"Clarion University of Pennsylvania",1,0,2005,"4906","92.120812","261","1066","1173",731,442,288,"92",196,0.2681,0.2081,0.2455,0.9088
"10028",211644,"Clarion University of Pennsylvania",1,0,2006,"5038","90.311901","253","1173","1295",758,537,323,"110",213,0.281,0.2048,0.2494,0.9058
"10029",211644,"Clarion University of Pennsylvania",1,0,2007,"5176","93.863502","242","1246","1381",799,582,417,"142",275,0.3442,0.244,0.302,0.9022
"10030",211644,"Clarion University of Pennsylvania",1,0,2008,"5358","97.956279","253","1134","1305",747,558,355,"116",239,0.3199,0.2079,0.272,0.869
"10031",211644,"Clarion University of Pennsylvania",1,0,2009,"5554","105.692515","254","1195","1384",805,579,395,"122",273,0.3391,0.2107,0.2854,0.8634
"10032",211644,"Clarion University of Pennsylvania",1,0,2010,"5804","105.61495","255","1117","1309",811,498,430,"127",303,0.3736,0.255,0.3285,0.8533
"10033",211981,"DELAWARE VALLEY COLLEGE OF SCIENCE AND AGRICULTURE",1,0,1991,"10126","16.223952","66","314","332",140,192,98,"43",55,0.3929,0.224,0.2952,0.9458
"10034",211981,"DELAWARE VALLEY COLLEGE OF SCIENCE AND AGRICULTURE",1,0,1992,"11090","17.959139","64","326","347",146,201,132,"61",71,0.4863,0.3035,0.3804,0.9395
"10035",211981,"DELAWARE VALLEY COLLEGE OF SCIENCE AND AGRICULTURE",1,0,1993,"11645","21.672266","73","413","435",212,223,142,"65",77,0.3632,0.2915,0.3264,0.9494
"10036",211981,"DELAWARE VALLEY COLLEGE",1,0,1995,"13208","27.694058","77","363","384",193,191,138,"45",93,0.4819,0.2356,0.3594,0.9453
"10037",211981,"DELAWARE VALLEY COLLEGE",1,0,1996,"13708","30.291545","82","353","385",177,208,149,"67",82,0.4633,0.3221,0.387,0.9169
"10038",211981,"DELAWARE VALLEY COLLEGE",1,0,1997,"14256","24.210194","78","372","407",185,222,149,"58",91,0.4919,0.2613,0.3661,0.914
"10039",211981,"DELAWARE VALLEY COLLEGE",1,0,1998,"14826","25.271253","77","380","400",203,197,172,"70",102,0.5025,0.3553,0.43,0.95
"10040",211981,"DELAWARE VALLEY COLLEGE",1,0,1999,"15300","26.60827","80","292","327",172,155,109,"41",68,0.3953,0.2645,0.3333,0.893
"10041",211981,"DELAWARE VALLEY COLLEGE",1,0,2000,"16148","27.433997","78.5","339","380",188,192,160,"63",97,0.516,0.3281,0.4211,0.8921
"10042",211981,"DELAWARE VALLEY COLLEGE",1,0,2001,"16874","28.684762","77","311","355",157,198,126,"53",73,0.465,0.2677,0.3549,0.8761
"10043",211981,"DELAWARE VALLEY COLLEGE",1,0,2002,"17680","29.465653","76","366","406",204,202,159,"59",100,0.4902,0.2921,0.3916,0.9015
"10044",211981,"DELAWARE VALLEY COLLEGE",1,0,2003,"18654","29.530863","76","316","438",198,240,164,"70",94,0.4747,0.2917,0.3744,0.7215
"10045",211981,"DELAWARE VALLEY COLLEGE",1,0,2004,"19588","30.726298","79","389","450",257,193,186,"48",138,0.537,0.2487,0.4133,0.8644
"10046",211981,"Delaware Valley College",1,0,2005,"20664","34.408936","78","384","448",271,177,206,"54",152,0.5609,0.3051,0.4598,0.8571
"10047",211981,"Delaware Valley College",1,0,2006,"21800","38.016078","81","389","447",264,183,220,"68",152,0.5758,0.3716,0.4922,0.8702
"10048",211981,"Delaware Valley College",1,0,2007,"23110","41.509849","83","433","475",270,205,221,"79",142,0.5259,0.3854,0.4653,0.9116
"10049",211981,"Delaware Valley College",1,0,2008,"24728","44.099792","84","380","429",253,176,220,"78",142,0.5613,0.4432,0.5128,0.8858
"10050",211981,"Delaware Valley College",1,0,2009,"25692","45.630737","82","395","452",252,200,227,"74",153,0.6071,0.37,0.5022,0.8739
"10051",211981,"Delaware Valley College",1,0,2010,"27234","46.303336","82","429","490",297,193,238,"66",172,0.5791,0.342,0.4857,0.8755
"10052",212009,"DICKINSON COLLEGE",1,0,1991,"15565","48.186764","143","513","557",317,240,433,"184",249,0.7855,0.7667,0.7774,0.921
"10053",212009,"DICKINSON COLLEGE",1,0,1992,"16760","52.422832","145","519","569",342,227,428,"178",250,0.731,0.7841,0.7522,0.9121
"10054",212009,"DICKINSON COLLEGE",1,0,1993,"17775","56.227271","144","441","482",277,205,330,"124",206,0.7437,0.6049,0.6846,0.9149
"10055",212009,"DICKINSON COLLEGE",1,0,1995,"19750","59.282322","147","468","520",286,234,393,"174",219,0.7657,0.7436,0.7558,0.9
"10056",212009,"DICKINSON COLLEGE",1,0,1996,"20750","61.093255","137","445","491",264,227,371,"168",203,0.7689,0.7401,0.7556,0.9063
"10057",212009,"DICKINSON COLLEGE",1,0,1997,"21600","62.724471","149","523","563",354,209,429,"148",281,0.7938,0.7081,0.762,0.929
"10058",212009,"DICKINSON COLLEGE",1,0,1998,"22600","72.049835","147","513","541",334,207,417,"155",262,0.7844,0.7488,0.7708,0.9482
"10059",212009,"DICKINSON COLLEGE",1,0,1999,"23120","57.483807","156","577","620",399,221,505,"178",327,0.8195,0.8054,0.8145,0.9306
"10060",212009,"DICKINSON COLLEGE",1,0,2000,"24050","63.554937","158","550","594",340,254,464,"188",276,0.8118,0.7402,0.7811,0.9259
"10061",212009,"DICKINSON COLLEGE",1,0,2001,"25250","67.960475","160","559","611",321,290,484,"218",266,0.8287,0.7517,0.7921,0.9149
"10062",212009,"DICKINSON COLLEGE",1,0,2002,"26400","72.233907","176","501","572",328,244,459,"185",274,0.8354,0.7582,0.8024,0.8759
"10063",212009,"DICKINSON COLLEGE",1,0,2003,"28380","78.612096","188","541","624",356,268,496,"205",291,0.8174,0.7649,0.7949,0.867
"10064",212009,"DICKINSON COLLEGE",1,0,2004,"30000","85.622104","196","489","605",329,276,472,"197",275,0.8359,0.7138,0.7802,0.8083
"10065",212009,"Dickinson College",1,0,2005,"31800","88.832986","192","511","647",359,288,530,"227",303,0.844,0.7882,0.8192,0.7898
"10066",212009,"Dickinson College",1,0,2006,"33470","92.022898","202","477","617",360,257,499,"199",300,0.8333,0.7743,0.8088,0.7731
"10067",212009,"Dickinson College",1,0,2007,"35450","96.337296","211","483","619",319,300,515,"237",278,0.8715,0.79,0.832,0.7803
"10068",212009,"Dickinson College",1,0,2008,"37900","102.150206","209","467","613",337,276,495,"204",291,0.8635,0.7391,0.8075,0.7618
"10069",212009,"Dickinson College",1,0,2009,"39780","108.63755","208","462","581",340,241,472,"191",281,0.8265,0.7925,0.8124,0.7952
"10070",212009,"Dickinson College",1,0,2010,"41170","107.49385","210","504","657",355,302,535,"240",295,0.831,0.7947,0.8143,0.7671
"10071",212054,"DREXEL UNIVERSITY",0,1,1991,"10860","132.805346","429","823","1207",364,843,115,"31",84,0.2308,0.0368,0.0953,0.6819
"10072",212054,"DREXEL UNIVERSITY",0,1,1992,"11635","135.361916","361","721","1054",340,714,94,"30",64,0.1882,0.042,0.0892,0.6841
"10073",212054,"DREXEL UNIVERSITY",0,1,1993,"12326","138.027167","286","709","1126",383,743,86,"27",59,0.154,0.0363,0.0764,0.6297
"10074",212054,"DREXEL UNIVERSITY",0,1,1995,"13844","137.142131","294","629","935",341,594,111,"40",71,0.2082,0.0673,0.1187,0.6727
"10075",212054,"DREXEL UNIVERSITY",0,1,1996,"14472","146.603784","285","894","1348",476,872,172,"76",96,0.2017,0.0872,0.1276,0.6632
"10076",212054,"DREXEL UNIVERSITY",0,1,1997,"14036","146.815","388","1027","1776",729,1047,231,"73",158,0.2167,0.0697,0.1301,0.5783
"10077",212054,"DREXEL UNIVERSITY",0,1,1998,"15574","164.662","395","1350","2087",792,1295,247,"73",174,0.2197,0.0564,0.1184,0.6469
"10078",212054,"DREXEL UNIVERSITY",0,1,1999,"15240","184.953","449","1257","1898",725,1173,269,"94",175,0.2414,0.0801,0.1417,0.6623
"10079",212054,"DREXEL UNIVERSITY",0,1,2000,"15927","198.639","467","1317","2125",810,1315,275,"97",178,0.2198,0.0738,0.1294,0.6198
"10080",212054,"DREXEL UNIVERSITY",0,1,2001,"16644","218.184","485","1117","1934",759,1175,313,"124",189,0.249,0.1055,0.1618,0.5776
"10081",212054,"DREXEL UNIVERSITY",0,1,2002,"17393","476.129","683","1394","1937",709,1228,374,"150",224,0.3159,0.1221,0.1931,0.7197
"10082",212054,"DREXEL UNIVERSITY",0,1,2003,"19700","513.171","656","1433","1980",768,1212,486,"176",310,0.4036,0.1452,0.2455,0.7237
"10083",212054,"DREXEL UNIVERSITY",0,1,2004,"20800","535.518","689","1514","2069",732,1337,477,"193",284,0.388,0.1444,0.2305,0.7318
"10084",212054,"Drexel University",0,1,2005,"21700","543.176","719","1530","2346",916,1430,663,"274",389,0.4247,0.1916,0.2826,0.6522
"10085",212054,"Drexel University",0,1,2006,"26000","584.131","778","1526","2256",930,1326,598,"219",379,0.4075,0.1652,0.2651,0.6764
"10086",212054,"Drexel University",0,1,2007,"27200","633.985","826","1461","2260",945,1315,640,"254",386,0.4085,0.1932,0.2832,0.6465
"10087",212054,"Drexel University",0,1,2008,"28500","687.148","870","1468","2402",992,1410,579,"206",373,0.376,0.1461,0.241,0.6112
"10088",212054,"Drexel University",0,1,2009,"29800","746.243","928","1253","2268",898,1370,516,"209",307,0.3419,0.1526,0.2275,0.5525
"10089",212054,"Drexel University",0,1,2010,"30900","782.34","977","1616","2696",1200,1496,735,"275",460,0.3833,0.1838,0.2726,0.5994
"10090",212106,"DUQUESNE UNIVERSITY",1,0,1991,"9750","78.305385","304","812","870",475,395,381,"166",215,0.4526,0.4203,0.4379,0.9333
"10091",212106,"DUQUESNE UNIVERSITY",1,0,1992,"10470","88.429303","323","925","1026",588,438,441,"165",276,0.4694,0.3767,0.4298,0.9016
"10092",212106,"DUQUESNE UNIVERSITY",1,0,1993,"11328","97.766243","336","848","971",547,424,418,"182",236,0.4314,0.4292,0.4305,0.8733
"10093",212106,"DUQUESNE UNIVERSITY",1,0,1995,"12578","119.829677","343","1055","1215",703,512,523,"193",330,0.4694,0.377,0.4305,0.8683
"10094",212106,"DUQUESNE UNIVERSITY",1,0,1996,"13396","137.387282","344","957","1196",690,506,558,"204",354,0.513,0.4032,0.4666,0.8002
"10095",212106,"DUQUESNE UNIVERSITY",1,0,1997,"14066","113.970722","379","951","1211",716,495,599,"225",374,0.5223,0.4545,0.4946,0.7853
"10096",212106,"DUQUESNE UNIVERSITY",1,0,1998,"14699","122.726786","369","1027","1253",771,482,615,"210",405,0.5253,0.4357,0.4908,0.8196
"10097",212106,"DUQUESNE UNIVERSITY",1,0,1999,"14378","135.167365","376","996","1211",686,525,590,"216",374,0.5452,0.4114,0.4872,0.8225
"10098",212106,"DUQUESNE UNIVERSITY",1,0,2000,"15169","143.12867","383","1091","1257",733,524,650,"243",407,0.5553,0.4637,0.5171,0.8679
"10099",212106,"DUQUESNE UNIVERSITY",1,0,2001,"16049","148.277682","390","1038","1176",684,492,596,"219",377,0.5512,0.4451,0.5068,0.8827
"10100",212106,"DUQUESNE UNIVERSITY",1,0,2002,"17012","157.039213","388","1253","1429",875,554,748,"253",495,0.5657,0.4567,0.5234,0.8768
"10101",212106,"DUQUESNE UNIVERSITY",1,0,2003,"17837","167.378085","407","1258","1485",899,586,774,"283",491,0.5462,0.4829,0.5212,0.8471
"10102",212106,"DUQUESNE UNIVERSITY",1,0,2004,"18693","177.691874","428","1017","1208",700,508,656,"251",405,0.5786,0.4941,0.543,0.8419
"10103",212106,"Duquesne University",1,0,2005,"19721","187.078","429","1156","1325",811,514,711,"244",467,0.5758,0.4747,0.5366,0.8725
"10104",212106,"Duquesne University",1,0,2006,"20855","202.593","442","1168","1321",779,542,700,"268",432,0.5546,0.4945,0.5299,0.8842
"10105",212106,"Duquesne University",1,0,2007,"22054","211.566","447","1204","1354",785,569,796,"307",489,0.6229,0.5395,0.5879,0.8892
"10106",212106,"Duquesne University",1,0,2008,"23470","224.271","463","1270","1425",838,587,801,"308",493,0.5883,0.5247,0.5621,0.8912
"10107",212106,"Duquesne University",1,0,2009,"24385","235.936","472","1221","1425",814,611,787,"296",491,0.6032,0.4845,0.5523,0.8568
"10108",212106,"Duquesne University",1,0,2010,"25336","239.43","480","1221","1411",821,590,834,"318",516,0.6285,0.539,0.5911,0.8653
"10109",212115,"EAST STROUDSBURG UNIVERSITY OF PENNSYLVANIA",1,0,1991,"3088","45.309173","249","636","699",382,317,129,"31",98,0.2565,0.0978,0.1845,0.9099
"10110",212115,"EAST STROUDSBURG UNIVERSITY OF PENNSYLVANIA",1,0,1992,"3352","48.857974","239","581","628",368,260,143,"39",104,0.2826,0.15,0.2277,0.9252
"10111",212115,"EAST STROUDSBURG UNIVERSITY OF PENNSYLVANIA",1,0,1993,"3664","51.856015","234","733","799",446,353,161,"39",122,0.2735,0.1105,0.2015,0.9174
"10112",212115,"EAST STROUDSBURG UNIVERSITY OF PENNSYLVANIA",1,0,1995,"4016","57.68591","233","776","820",457,363,169,"45",124,0.2713,0.124,0.2061,0.9463
"10113",212115,"EAST STROUDSBURG UNIVERSITY OF PENNSYLVANIA",1,0,1996,"4194","61.351417","233","808","872",499,373,198,"50",148,0.2966,0.134,0.2271,0.9266
"10114",212115,"EAST STROUDSBURG UNIVERSITY OF PENNSYLVANIA",1,0,1997,"4322","62.00042","227","799","886",532,354,166,"34",132,0.2481,0.096,0.1874,0.9018
"10115",212115,"EAST STROUDSBURG UNIVERSITY OF PENNSYLVANIA",1,0,1998,"4314","66.172851","235","767","856",475,381,182,"53",129,0.2716,0.1391,0.2126,0.896
"10116",212115,"EAST STROUDSBURG UNIVERSITY OF PENNSYLVANIA",1,0,1999,"3618","69.024874","237","744","843",522,321,163,"42",121,0.2318,0.1308,0.1934,0.8826
"10117",212115,"EAST STROUDSBURG UNIVERSITY OF PENNSYLVANIA",1,0,2000,"3792","72.119515","241.5","791","878",522,356,193,"57",136,0.2605,0.1601,0.2198,0.9009
"10118",212115,"EAST STROUDSBURG UNIVERSITY OF PENNSYLVANIA",1,0,2001,"4016","76.550314","246","880","969",564,405,259,"66",193,0.3422,0.163,0.2673,0.9082
"10119",212115,"EAST STROUDSBURG UNIVERSITY OF PENNSYLVANIA",1,0,2002,"4378","76.566622","249","1020","1123",587,536,314,"100",214,0.3646,0.1866,0.2796,0.9083
"10120",212115,"EAST STROUDSBURG UNIVERSITY OF PENNSYLVANIA",1,0,2003,"4598","83.459234","245","993","1076",650,426,394,"107",287,0.4415,0.2512,0.3662,0.9229
"10121",212115,"EAST STROUDSBURG UNIVERSITY OF PENNSYLVANIA",1,0,2004,"4810","84.814296","255","1059","1165",709,456,420,"122",298,0.4203,0.2675,0.3605,0.909
"10122",212115,"East Stroudsburg University of Pennsylvania",1,0,2005,"4906","84.973395","267","1001","1087",634,453,392,"110",282,0.4448,0.2428,0.3606,0.9209
"10123",212115,"East Stroudsburg University of Pennsylvania",1,0,2006,"5038","89.027104","280","975","1239",716,523,454,"147",307,0.4288,0.2811,0.3664,0.7869
"10124",212115,"East Stroudsburg University of Pennsylvania",1,0,2007,"5178","97.780874","285","922","1183",612,571,422,"156",266,0.4346,0.2732,0.3567,0.7794
"10125",212115,"East Stroudsburg University of Pennsylvania",1,0,2008,"5358","101.59092","306","945","1262",655,607,458,"167",291,0.4443,0.2751,0.3629,0.7488
"10126",212115,"East Stroudsburg University of Pennsylvania",1,0,2009,"5554","111.407727","305","955","1342",737,605,466,"167",299,0.4057,0.276,0.3472,0.7116
"10127",212115,"East Stroudsburg University of Pennsylvania",1,0,2010,"5804","116.238144","301","899","1144",658,486,422,"137",285,0.4331,0.2819,0.3689,0.7858
"10128",212133,"EASTERN COLLEGE",1,0,1991,"9525","12.763837","41","97","134",87,47,55,"16",39,0.4483,0.3404,0.4104,0.7239
"10129",212133,"EASTERN COLLEGE",1,0,1992,"9875","14.88565","48","146","183",130,53,82,"20",62,0.4769,0.3774,0.4481,0.7978
"10130",212133,"EASTERN COLLEGE",1,0,1993,"10620","17.745647","57","126","162",113,49,76,"22",54,0.4779,0.449,0.4691,0.7778
"10131",212133,"EASTERN COLLEGE",1,0,1995,"11780","22.781524","61","179","226",171,55,103,"21",82,0.4795,0.3818,0.4558,0.792
"10132",212133,"EASTERN COLLEGE",1,0,1996,"12250","24.97341","59","197","245",168,77,138,"34",104,0.619,0.4416,0.5633,0.8041
"10133",212133,"EASTERN COLLEGE",1,0,1997,"12735","25.363994","65","259","305",211,94,171,"40",131,0.6209,0.4255,0.5607,0.8492
"10134",212133,"EASTERN COLLEGE",1,0,1998,"13235","27.58869","70","254","317",220,97,168,"48",120,0.5455,0.4948,0.53,0.8013
"10135",212133,"EASTERN COLLEGE",1,0,1999,"13728","31.386164","74","346","379",274,105,190,"41",149,0.5438,0.3905,0.5013,0.9129
"10136",212133,"EASTERN COLLEGE",1,0,2000,"14560","35.904463","80.5","346","400",279,121,229,"60",169,0.6057,0.4959,0.5725,0.865
"10137",212133,"EASTERN UNIVERSITY",1,0,2001,"15150","42.52855","87","342","427",287,140,216,"69",147,0.5122,0.4929,0.5059,0.8009
"10138",212133,"EASTERN UNIVERSITY",1,0,2002,"15832","46.704196","85","322","405",288,117,211,"49",162,0.5625,0.4188,0.521,0.7951
"10139",212133,"EASTERN UNIVERSITY",1,0,2003,"16780","47.820759","82","355","438",298,140,242,"74",168,0.5638,0.5286,0.5525,0.8105
"10140",212133,"EASTERN UNIVERSITY",1,0,2004,"17700","49.223419","91","360","450",294,156,243,"82",161,0.5476,0.5256,0.54,0.8
"10141",212133,"Eastern University",1,0,2005,"18830","58.080766","114","350","445",300,145,239,"70",169,0.5633,0.4828,0.5371,0.7865
"10142",212133,"Eastern University",1,0,2006,"20030","64.523829","126","377","494",336,158,230,"70",160,0.4762,0.443,0.4656,0.7632
"10143",212133,"Eastern University",1,0,2007,"21350","70.481978","126","318","483",319,164,206,"58",148,0.4639,0.3537,0.4265,0.6584
"10144",212133,"Eastern University",1,0,2008,"22670","75.059963","128","342","550",367,183,233,"68",165,0.4496,0.3716,0.4236,0.6218
"10145",212133,"Eastern University",1,0,2009,"23770","82.232687","139","328","489",318,171,213,"61",152,0.478,0.3567,0.4356,0.6708
"10146",212133,"Eastern University",1,0,2010,"24550","85.318895","146","264","449",302,147,195,"67",128,0.4238,0.4558,0.4343,0.588
"10147",212160,"EDINBORO UNIVERSITY OF PENNSYLVANIA",1,0,1991,"3013","63.320188","416","1302","1456",853,603,243,"65",178,0.2087,0.1078,0.1669,0.8942
"10148",212160,"EDINBORO UNIVERSITY OF PENNSYLVANIA",1,0,1992,"3161","69.046635","399","1375","1500",857,643,257,"75",182,0.2124,0.1166,0.1713,0.9167
"10149",212160,"EDINBORO UNIVERSITY OF PENNSYLVANIA",1,0,1993,"3531","72.363493","392","1209","1315",763,552,221,"65",156,0.2045,0.1178,0.1681,0.9194
"10150",212160,"EDINBORO UNIVERSITY OF PENNSYLVANIA",1,0,1995,"3924","77.442966","390","1186","1332",763,569,213,"69",144,0.1887,0.1213,0.1599,0.8904
"10151",212160,"EDINBORO UNIVERSITY OF PENNSYLVANIA",1,0,1996,"4082","78.887483","391","1160","1250",707,543,214,"69",145,0.2051,0.1271,0.1712,0.928
"10152",212160,"EDINBORO UNIVERSITY OF PENNSYLVANIA",1,0,1997,"4192","79.956983","383","1143","1251",729,522,234,"63",171,0.2346,0.1207,0.1871,0.9137
"10153",212160,"EDINBORO UNIVERSITY OF PENNSYLVANIA",1,0,1998,"3468","84.684291","368","1107","1205",691,514,210,"54",156,0.2258,0.1051,0.1743,0.9187
"10154",212160,"EDINBORO UNIVERSITY OF PENNSYLVANIA",1,0,1999,"3618","86.914139","381","1139","1256",749,507,227,"48",179,0.239,0.0947,0.1807,0.9068
"10155",212160,"EDINBORO UNIVERSITY OF PENNSYLVANIA",1,0,2000,"3792","88.946681","365.5","1160","1304",731,573,297,"88",209,0.2859,0.1536,0.2278,0.8896
"10156",212160,"EDINBORO UNIVERSITY OF PENNSYLVANIA",1,0,2001,"4016","94.151855","350","1228","1409",831,578,323,"99",224,0.2696,0.1713,0.2292,0.8715
"10157",212160,"EDINBORO UNIVERSITY OF PENNSYLVANIA",1,0,2002,"4378","91.179481","351","1204","1372",788,584,297,"86",211,0.2678,0.1473,0.2165,0.8776
"10158",212160,"EDINBORO UNIVERSITY OF PENNSYLVANIA",1,0,2003,"4598","90.056976","343","1219","1392",818,574,304,"103",201,0.2457,0.1794,0.2184,0.8757
"10159",212160,"EDINBORO UNIVERSITY OF PENNSYLVANIA",1,0,2004,"4810","90.907135","356","1062","1232",712,520,272,"81",191,0.2683,0.1558,0.2208,0.862
"10160",212160,"Edinboro University of Pennsylvania",1,0,2005,"4906","92.17021","346","1104","1268",719,549,297,"82",215,0.299,0.1494,0.2342,0.8707
"10161",212160,"Edinboro University of Pennsylvania",1,0,2006,"5038","96.108368","346","1036","1212",671,541,230,"63",167,0.2489,0.1165,0.1898,0.8548
"10162",212160,"Edinboro University of Pennsylvania",1,0,2007,"5177","100.661254","322","1005","1243",707,536,239,"75",164,0.232,0.1399,0.1923,0.8085
"10163",212160,"Edinboro University of Pennsylvania",1,0,2008,"5358","106.688529","325","1041","1219",697,522,245,"77",168,0.241,0.1475,0.201,0.854
"10164",212160,"Edinboro University of Pennsylvania",1,0,2009,"5554","110.468281","336","1221","1407",803,604,266,"82",184,0.2291,0.1358,0.1891,0.8678
"10165",212160,"Edinboro University of Pennsylvania",1,0,2010,"5804","112.084642","341","1337","1551",927,624,340,"103",237,0.2557,0.1651,0.2192,0.862
"10166",212197,"ELIZABETHTOWN COLLEGE",1,0,1991,"11650","27.958524","110","427","455",309,146,265,"78",187,0.6052,0.5342,0.5824,0.9385
"10167",212197,"ELIZABETHTOWN COLLEGE",1,0,1992,"12550","29.279367","105","429","442",318,124,256,"52",204,0.6415,0.4194,0.5792,0.9706
"10168",212197,"ELIZABETHTOWN COLLEGE",1,0,1993,"13600","31.748361","105","412","424",276,148,270,"76",194,0.7029,0.5135,0.6368,0.9717
"10169",212197,"ELIZABETHTOWN COLLEGE",1,0,1995,"15490","36.279776","104","411","434",307,127,282,"72",210,0.684,0.5669,0.6498,0.947
"10170",212197,"ELIZABETHTOWN COLLEGE",1,0,1996,"15890","39.476166","100","403","429",295,134,263,"73",190,0.6441,0.5448,0.6131,0.9394
"10171",212197,"ELIZABETHTOWN COLLEGE",1,0,1997,"16680","30.544218","100","409","438",298,140,265,"74",191,0.6409,0.5286,0.605,0.9338
"10172",212197,"ELIZABETHTOWN COLLEGE",1,0,1998,"17500","32.217955","101","400","422",271,151,265,"87",178,0.6568,0.5762,0.628,0.9479
"10173",212197,"ELIZABETHTOWN COLLEGE",1,0,1999,"17770","33.468682","103","438","477",298,179,277,"102",175,0.5872,0.5698,0.5807,0.9182
"10174",212197,"ELIZABETHTOWN COLLEGE",1,0,2000,"19100","34.822643","108.5","436","474",318,156,310,"98",212,0.6667,0.6282,0.654,0.9198
"10175",212197,"ELIZABETHTOWN COLLEGE",1,0,2001,"20200","37.423347","114","482","514",319,195,326,"116",210,0.6583,0.5949,0.6342,0.9377
"10176",212197,"ELIZABETHTOWN COLLEGE",1,0,2002,"21350","39.521585","120","418","456",304,152,293,"85",208,0.6842,0.5592,0.6425,0.9167
"10177",212197,"ELIZABETHTOWN COLLEGE",1,0,2003,"22500","40.991427","118","458","495",326,169,328,"100",228,0.6994,0.5917,0.6626,0.9253
"10178",212197,"ELIZABETHTOWN COLLEGE",1,0,2004,"23710","44.770271","120","508","535",344,191,385,"125",260,0.7558,0.6545,0.7196,0.9495
"10179",212197,"Elizabethtown College",1,0,2005,"25200","48.270227","125","466","500",337,163,356,"104",252,0.7478,0.638,0.712,0.932
"10180",212197,"Elizabethtown College",1,0,2006,"26950","52.428187","126","497","528",345,183,372,"125",247,0.7159,0.6831,0.7045,0.9413
"10181",212197,"Elizabethtown College",1,0,2007,"29000","54.954734","130","446","487",324,163,344,"113",231,0.713,0.6933,0.7064,0.9158
"10182",212197,"Elizabethtown College",1,0,2008,"30650","58.477065","129","457","508",331,177,328,"114",214,0.6465,0.6441,0.6457,0.8996
"10183",212197,"Elizabethtown College",1,0,2009,"31800","60.99391","125","489","544",340,204,391,"133",258,0.7588,0.652,0.7188,0.8989
"10184",212197,"Elizabethtown College",1,0,2010,"33250","61.123369","130","426","491",303,188,339,"104",235,0.7756,0.5532,0.6904,0.8676
"10185",212577,"FRANKLIN AND MARSHALL COLLEGE",1,0,1991,"16385","44.490877","148","398","504",228,276,355,"173",182,0.7982,0.6268,0.7044,0.7897
"10186",212577,"FRANKLIN AND MARSHALL COLLEGE",1,0,1992,"22370","47.526756","146","385","486",222,264,351,"182",169,0.7613,0.6894,0.7222,0.7922
"10187",212577,"FRANKLIN AND MARSHALL COLLEGE",1,0,1993,"23655","51.173045","152","387","507",229,278,364,"190",174,0.7598,0.6835,0.7179,0.7633
"10188",212577,"FRANKLIN AND MARSHALL COLLEGE",1,0,1995,"21350","56.891658","160","406","498",234,264,372,"179",193,0.8248,0.678,0.747,0.8153
"10189",212577,"FRANKLIN AND MARSHALL COLLEGE",1,0,1996,"21990","67.258929","158","430","522",272,250,408,"175",233,0.8566,0.7,0.7816,0.8238
"10190",212577,"FRANKLIN AND MARSHALL COLLEGE",1,0,1997,"22714","47.441022","155","410","504",251,253,402,"202",200,0.7968,0.7984,0.7976,0.8135
"10191",212577,"FRANKLIN AND MARSHALL COLLEGE",1,0,1998,"23214","51.702","158","399","502",257,245,394,"175",219,0.8521,0.7143,0.7849,0.7948
"10192",212577,"FRANKLIN AND MARSHALL COLLEGE",1,0,1999,"23720","55.838","161","443","515",253,262,387,"181",206,0.8142,0.6908,0.7515,0.8602
"10193",212577,"FRANKLIN AND MARSHALL COLLEGE",1,0,2000,"24816","58.13","164.5","421","510",251,259,382,"179",203,0.8088,0.6911,0.749,0.8255
"10194",212577,"FRANKLIN AND MARSHALL COLLEGE",1,0,2001,"26060","61.682","168","410","510",248,262,401,"190",211,0.8508,0.7252,0.7863,0.8039
"10195",212577,"FRANKLIN AND MARSHALL COLLEGE",1,0,2002,"27230","62.536","184","403","534",248,286,388,"189",199,0.8024,0.6608,0.7266,0.7547
"10196",212577,"FRANKLIN AND MARSHALL COLLEGE",1,0,2003,"28810","68.34","183","379","503",233,270,398,"198",200,0.8584,0.7333,0.7913,0.7535
"10197",212577,"FRANKLIN AND MARSHALL COLLEGE",1,0,2004,"30390","71.607","180","422","529",241,288,424,"219",205,0.8506,0.7604,0.8015,0.7977
"10198",212577,"Franklin and Marshall College",1,0,2005,"32480","77.356159","194","447","581",298,283,468,"211",257,0.8624,0.7456,0.8055,0.7694
"10199",212577,"Franklin and Marshall College",1,0,2006,"34400","84.542549","200","321","523",274,249,413,"196",217,0.792,0.7871,0.7897,0.6138
"10200",212577,"Franklin and Marshall College",1,0,2007,"36430","88.480065","201","417","569",301,268,477,"214",263,0.8738,0.7985,0.8383,0.7329
"10201",212577,"Franklin and Marshall College",1,0,2008,"38580","96.086995","206","443","588",321,267,485,"210",275,0.8567,0.7865,0.8248,0.7534
"10202",212577,"Franklin and Marshall College",1,0,2009,"39930","105.471801","223","475","629",334,295,511,"229",282,0.8443,0.7763,0.8124,0.7552
"10203",212577,"Franklin and Marshall College",1,0,2010,"41090","106.053254","233","473","629",345,284,525,"227",298,0.8638,0.7993,0.8347,0.752
"10204",212601,"GANNON UNIVERSITY",1,0,1991,"8719","43.621844","185","440","465",264,201,186,"79",107,0.4053,0.393,0.4,0.9462
"10205",212601,"GANNON UNIVERSITY",1,0,1992,"9198","47.563","182","383","406",244,162,152,"54",98,0.4016,0.3333,0.3744,0.9433
"10206",212601,"GANNON UNIVERSITY",1,0,1993,"9842","48.109","171","427","450",257,193,177,"79",98,0.3813,0.4093,0.3933,0.9489
"10207",212601,"GANNON UNIVERSITY",1,0,1995,"11114","49.813","169","369","394",225,169,174,"73",101,0.4489,0.432,0.4416,0.9365
"10208",212601,"GANNON UNIVERSITY",1,0,1996,"11694","50.222","157","474","504",305,199,229,"72",157,0.5148,0.3618,0.4544,0.9405
"10209",212601,"GANNON UNIVERSITY",1,0,1997,"12264","35.777","146","503","533",318,215,244,"74",170,0.5346,0.3442,0.4578,0.9437
"10210",212601,"GANNON UNIVERSITY",1,0,1998,"12744","35.856","150","556","608",360,248,282,"95",187,0.5194,0.3831,0.4638,0.9145
"10211",212601,"GANNON UNIVERSITY",1,0,1999,"13820","38.409","157","476","503",314,189,246,"67",179,0.5701,0.3545,0.4891,0.9463
"10212",212601,"GANNON UNIVERSITY",1,0,2000,"13670","39.367","158.5","524","563",327,236,257,"87",170,0.5199,0.3686,0.4565,0.9307
"10213",212601,"GANNON UNIVERSITY",1,0,2001,"14490","45.192","160","479","525",313,212,244,"83",161,0.5144,0.3915,0.4648,0.9124
"10214",212601,"GANNON UNIVERSITY",1,0,2002,"15330","47.903","165","496","536",311,225,255,"80",175,0.5627,0.3556,0.4757,0.9254
"10215",212601,"GANNON UNIVERSITY",1,0,2003,"16220","49.439","164","539","587",339,248,246,"91",155,0.4572,0.3669,0.4191,0.9182
"10216",212601,"GANNON UNIVERSITY",1,0,2004,"17550","52.118","169","458","522",317,205,248,"84",164,0.5174,0.4098,0.4751,0.8774
"10217",212601,"Gannon University",1,0,2005,"18775","54.088","175","558","619",375,244,292,"104",188,0.5013,0.4262,0.4717,0.9015
"10218",212601,"Gannon University",1,0,2006,"20090","53.942","175","529","600",352,248,280,"97",183,0.5199,0.3911,0.4667,0.8817
"10219",212601,"Gannon University",1,0,2007,"21480","54.446","184","509","610",365,245,276,"96",180,0.4932,0.3918,0.4525,0.8344
"10220",212601,"Gannon University",1,0,2008,"22830","60.106","193","544","620",367,253,289,"106",183,0.4986,0.419,0.4661,0.8774
"10221",212601,"Gannon University",1,0,2009,"23745","64.142","196","523","648",382,266,310,"106",204,0.534,0.3985,0.4784,0.8071
"10222",212601,"Gannon University",1,0,2010,"24765","65.101","192","503","617",362,255,276,"100",176,0.4862,0.3922,0.4473,0.8152
"10223",212832,"GWYNEDD-MERCY COLLEGE",1,0,1991,"8600","12.328232","93","70","89",79,10,25,"1",24,0.3038,0.1,0.2809,0.7865
"10224",212832,"GWYNEDD-MERCY COLLEGE",1,0,1992,"10150","13.804689","96","77","89",72,17,34,"2",32,0.4444,0.1176,0.382,0.8652
"10225",212832,"GWYNEDD-MERCY COLLEGE",1,0,1993,"10960","14.960403","98","68","86",74,12,32,"2",30,0.4054,0.1667,0.3721,0.7907
"10226",212832,"GWYNEDD-MERCY COLLEGE",1,0,1995,"12017","17.24174","91","33","40",35,5,16,"0",16,0.4571,0,0.4,0.825
"10227",212832,"GWYNEDD-MERCY COLLEGE",1,0,1996,"12650","16.998864","91","36","44",32,12,16,"3",13,0.4062,0.25,0.3636,0.8182
"10228",212832,"GWYNEDD MERCY COLLEGE",1,0,1997,"13180","16.76453","85","50","65",54,11,26,"4",22,0.4074,0.3636,0.4,0.7692
"10229",212832,"GWYNEDD MERCY COLLEGE",1,0,1998,"13710","18.290759","78","129","143",100,43,44,"9",35,0.35,0.2093,0.3077,0.9021
"10230",212832,"GWYNEDD MERCY COLLEGE",1,0,1999,"13500","19.574056","74","131","146",114,32,56,"13",43,0.3772,0.4062,0.3836,0.8973
"10231",212832,"GWYNEDD MERCY COLLEGE",1,0,2000,"14400","21.374","69.5","156","179",141,38,70,"10",60,0.4255,0.2632,0.3911,0.8715
"10232",212832,"GWYNEDD MERCY COLLEGE",1,0,2001,"15100","22.16","65","158","176",140,36,85,"15",70,0.5,0.4167,0.483,0.8977
"10233",212832,"GWYNEDD MERCY COLLEGE",1,0,2002,"15600","21.069","72","215","261",211,50,62,"18",44,0.2085,0.36,0.2375,0.8238
"10234",212832,"GWYNEDD MERCY COLLEGE",1,0,2003,"16200","23.955","77","281","322",245,77,105,"26",79,0.3224,0.3377,0.3261,0.8727
"10235",212832,"GWYNEDD MERCY COLLEGE",1,0,2004,"16900","26.247","80","261","280",218,62,87,"23",64,0.2936,0.371,0.3107,0.9321
"10236",212832,"Gwynedd Mercy College",1,0,2005,"17580","28.206","78","226","280",210,70,21,"15",6,0.0286,0.2143,0.075,0.8071
"10237",212832,"Gwynedd Mercy College",1,0,2006,"18720","31.02","81","218","272",202,70,54,"19",35,0.1733,0.2714,0.1985,0.8015
"10238",212832,"Gwynedd Mercy College",1,0,2007,"20500","32.316","82","256","291",208,83,58,"23",35,0.1683,0.2771,0.1993,0.8797
"10239",212832,"Gwynedd Mercy College",1,0,2008,"22340","32.784","81","284","339",223,116,56,"23",33,0.148,0.1983,0.1652,0.8378
"10240",212832,"Gwynedd Mercy College",1,0,2009,"23730","32.755","75","224","313",214,99,47,"18",29,0.1355,0.1818,0.1502,0.7157
"10241",212832,"Gwynedd Mercy College",1,0,2010,"25160","33.89","76","218","284",190,94,38,"13",25,0.1316,0.1383,0.1338,0.7676
"10242",212911,"HAVERFORD COLLEGE",1,0,1991,"16150","31.86286","91","239","295",147,148,256,"124",132,0.898,0.8378,0.8678,0.8102
"10243",212911,"HAVERFORD COLLEGE",1,0,1992,"17125","33.499448","95","244","301",145,156,253,"132",121,0.8345,0.8462,0.8405,0.8106
"10244",212911,"HAVERFORD COLLEGE",1,0,1993,"18000","35.856411","95","247","292",143,149,243,"122",121,0.8462,0.8188,0.8322,0.8459
"10245",212911,"HAVERFORD COLLEGE",1,0,1995,"20075","39.966344","97","267","306",162,144,269,"126",143,0.8827,0.875,0.8791,0.8725
"10246",212911,"HAVERFORD COLLEGE",1,0,1996,"20890","42.972528","95","253","313",172,141,267,"116",151,0.8779,0.8227,0.853,0.8083
"10247",212911,"HAVERFORD COLLEGE",1,0,1997,"21740","39.534458","96","229","298",150,148,264,"127",137,0.9133,0.8581,0.8859,0.7685
"10248",212911,"HAVERFORD COLLEGE",1,0,1998,"22860","41.281997","97","267","322",170,152,277,"130",147,0.8647,0.8553,0.8602,0.8292
"10249",212911,"HAVERFORD COLLEGE",1,0,1999,"23556","43.101489","102","222","301",160,141,244,"113",131,0.8188,0.8014,0.8106,0.7375
"10250",212911,"HAVERFORD COLLEGE",1,0,2000,"24706","46.654981","102.5","237","334",181,153,305,"140",165,0.9116,0.915,0.9132,0.7096
"10251",212911,"HAVERFORD COLLEGE",1,0,2001,"25826","50.552701","103","199","296",154,142,256,"120",136,0.8831,0.8451,0.8649,0.6723
"10252",212911,"HAVERFORD COLLEGE",1,0,2002,"27006","55.516383","112","221","312",168,144,283,"128",155,0.9226,0.8889,0.9071,0.7083
"10253",212911,"HAVERFORD COLLEGE",1,0,2003,"28612","59.10875","108","236","313",164,149,275,"132",143,0.872,0.8859,0.8786,0.754
"10254",212911,"HAVERFORD COLLEGE",1,0,2004,"29990","61.868057","110","226","330",179,151,291,"130",161,0.8994,0.8609,0.8818,0.6848
"10255",212911,"Haverford College",1,0,2005,"31466","63.468719","111","225","316",168,148,287,"131",156,0.9286,0.8851,0.9082,0.712
"10256",212911,"Haverford College",1,0,2006,"33394","68.314037","123","214","314",174,140,281,"123",158,0.908,0.8786,0.8949,0.6815
"10257",212911,"Haverford College",1,0,2007,"35058","74.435475","121","215","315",169,146,287,"131",156,0.9231,0.8973,0.9111,0.6825
"10258",212911,"Haverford College",1,0,2008,"37175","77.997901","128","234","327",182,145,287,"124",163,0.8956,0.8552,0.8777,0.7156
"10259",212911,"Haverford College",1,0,2009,"38735","81.921556","127","232","323",186,137,275,"121",154,0.828,0.8832,0.8514,0.7183
"10260",212911,"Haverford College",1,0,2010,"40260","77.127023","139","215","325",166,159,281,"138",143,0.8614,0.8679,0.8646,0.6615
"10261",213020,"INDIANA UNIVERSITY OF PENNSYLVANIA",1,0,1991,"2980","133.983232","649","2181","2516",1452,1064,604,"180",424,0.292,0.1692,0.2401,0.8669
"10262",213020,"INDIANA UNIVERSITY OF PENNSYLVANIA",1,0,1992,"3157","146.446726","656","2123","2423",1423,1000,665,"197",468,0.3289,0.197,0.2745,0.8762
"10263",213020,"INDIANA UNIVERSITY OF PENNSYLVANIA",1,0,1993,"3539","144.920003","658","2131","2366",1365,1001,495,"154",341,0.2498,0.1538,0.2092,0.9007
"10264",213020,"INDIANA UNIVERSITY OF PENNSYLVANIA",1,0,1995,"3891","163.449089","675","2470","2661",1552,1109,652,"187",465,0.2996,0.1686,0.245,0.9282
"10265",213020,"INDIANA UNIVERSITY OF PENNSYLVANIA",1,0,1996,"4064","163.605644","680","2431","2617",1493,1124,613,"163",450,0.3014,0.145,0.2342,0.9289
"10266",213020,"INDIANA UNIVERSITY OF PENNSYLVANIA",1,0,1997,"4204","165.766205","692","2399","2620",1479,1141,618,"176",442,0.2989,0.1543,0.2359,0.9156
"10267",213020,"INDIANA UNIVERSITY OF PENNSYLVANIA",1,0,1998,"4244","173.255543","688","2484","2757",1643,1114,661,"161",500,0.3043,0.1445,0.2398,0.901
"10268",213020,"INDIANA UNIVERSITY OF PENNSYLVANIA-MAIN CAMPUS",1,0,1999,"3618","183.441444","671","2203","2552",1468,1084,561,"165",396,0.2698,0.1522,0.2198,0.8632
"10269",213020,"INDIANA UNIVERSITY OF PENNSYLVANIA-MAIN CAMPUS",1,0,2000,"3792","182.672786","660","2473","2776",1607,1169,605,"167",438,0.2726,0.1429,0.2179,0.8909
"10270",213020,"INDIANA UNIVERSITY OF PENNSYLVANIA-MAIN CAMPUS",1,0,2001,"4016","191.794757","649","2261","2557",1460,1097,624,"190",434,0.2973,0.1732,0.244,0.8842
"10271",213020,"INDIANA UNIVERSITY OF PENNSYLVANIA-MAIN CAMPUS",1,0,2002,"4378","192.265023","634","2338","2666",1536,1130,697,"207",490,0.319,0.1832,0.2614,0.877
"10272",213020,"INDIANA UNIVERSITY OF PENNSYLVANIA-MAIN CAMPUS",1,0,2003,"4598","193.461514","616","2380","2847",1669,1178,822,"242",580,0.3475,0.2054,0.2887,0.836
"10273",213020,"INDIANA UNIVERSITY OF PENNSYLVANIA-MAIN CAMPUS",1,0,2004,"4810","197.077048","628","2109","2645",1567,1078,768,"234",534,0.3408,0.2171,0.2904,0.7974
"10274",213020,"Indiana University of Pennsylvania-Main Campus",1,0,2005,"4906","200.958898","639","1888","2462",1335,1127,713,"245",468,0.3506,0.2174,0.2896,0.7669
"10275",213020,"Indiana University of Pennsylvania-Main Campus",1,0,2006,"5038","209.48173","641","2030","2538",1400,1138,726,"225",501,0.3579,0.1977,0.2861,0.7998
"10276",213020,"Indiana University of Pennsylvania-Main Campus",1,0,2007,"5178","221.49609","633","1886","2524",1450,1074,786,"257",529,0.3648,0.2393,0.3114,0.7472
"10277",213020,"Indiana University of Pennsylvania-Main Campus",1,0,2008,"5358","225.931951","616","2445","3065",1790,1275,1041,"323",718,0.4011,0.2533,0.3396,0.7977
"10278",213020,"Indiana University of Pennsylvania-Main Campus",1,0,2009,"5554","232.515303","608","2497","2993",1774,1219,1068,"329",739,0.4166,0.2699,0.3568,0.8343
"10279",213020,"Indiana University of Pennsylvania-Main Campus",1,0,2010,"5804","237.599566","625","2375","2984",1751,1233,1087,"333",754,0.4306,0.2701,0.3643,0.7959
"10280",213251,"JUNIATA COLLEGE",1,0,1991,"12570","22.456028","75","254","261",129,132,164,"78",86,0.6667,0.5909,0.6284,0.9732
"10281",213251,"JUNIATA COLLEGE",1,0,1992,"13350","23.479749","78","251","258",132,126,161,"68",93,0.7045,0.5397,0.624,0.9729
"10282",213251,"JUNIATA COLLEGE",1,0,1993,"14250","25.089594","74","266","301",166,135,198,"87",111,0.6687,0.6444,0.6578,0.8837
"10283",213251,"JUNIATA COLLEGE",1,0,1995,"16010","26.461943","73","252","282",175,107,196,"73",123,0.7029,0.6822,0.695,0.8936
"10284",213251,"JUNIATA COLLEGE",1,0,1996,"16750","27.860673","70","314","349",182,167,237,"100",137,0.7527,0.5988,0.6791,0.8997
"10285",213251,"JUNIATA COLLEGE",1,0,1997,"17300","21.633281","77","321","342",186,156,232,"89",143,0.7688,0.5705,0.6784,0.9386
"10286",213251,"JUNIATA COLLEGE",1,0,1998,"17820","22.296474","75","315","337",192,145,227,"88",139,0.724,0.6069,0.6736,0.9347
"10287",213251,"JUNIATA COLLEGE",1,0,1999,"18030","23.849309","83","302","324",184,140,217,"81",136,0.7391,0.5786,0.6698,0.9321
"10288",213251,"JUNIATA COLLEGE",1,0,2000,"18940","25.696013","84","342","359",207,152,265,"105",160,0.7729,0.6908,0.7382,0.9526
"10289",213251,"JUNIATA COLLEGE",1,0,2001,"20170","27.751569","85","327","340",205,135,242,"87",155,0.7561,0.6444,0.7118,0.9618
"10290",213251,"JUNIATA COLLEGE",1,0,2002,"21160","29.311843","90","354","375",215,160,285,"119",166,0.7721,0.7438,0.76,0.944
"10291",213251,"JUNIATA COLLEGE",1,0,2003,"22240","31.391815","94","357","381",200,181,284,"135",149,0.745,0.7459,0.7454,0.937
"10292",213251,"JUNIATA COLLEGE",1,0,2004,"23720","34.369498","88","362","390",213,177,273,"129",144,0.6761,0.7288,0.7,0.9282
"10293",213251,"Juniata College",1,0,2005,"25260","36.185069","95","358","387",212,175,279,"120",159,0.75,0.6857,0.7209,0.9251
"10294",213251,"Juniata College",1,0,2006,"26900","36.518823","95","338","362",195,167,257,"111",146,0.7487,0.6647,0.7099,0.9337
"10295",213251,"Juniata College",1,0,2007,"28250","41.534792","104","336","377",220,157,271,"104",167,0.7591,0.6624,0.7188,0.8912
"10296",213251,"Juniata College",1,0,2008,"29610","45.271242","98","402","461",260,201,332,"134",198,0.7615,0.6667,0.7202,0.872
"10297",213251,"Juniata College",1,0,2009,"30880","47.997545","99","315","366",207,159,246,"98",148,0.715,0.6164,0.6721,0.8607
"10298",213251,"Juniata College",1,0,2010,"32120","47.987841","97","345","421",227,194,303,"130",173,0.7621,0.6701,0.7197,0.8195
"10299",213321,"KING'S COLLEGE",1,0,1991,"8740","21.272423","92","343","359",164,195,232,"115",117,0.7134,0.5897,0.6462,0.9554
"10300",213321,"KING'S COLLEGE",1,0,1992,"9770","23.692873","96","438","467",213,254,310,"159",151,0.7089,0.626,0.6638,0.9379
"10301",213321,"KING'S COLLEGE",1,0,1993,"10600","26.73237","95","364","380",166,214,241,"127",114,0.6867,0.5935,0.6342,0.9579
"10302",213321,"KING'S COLLEGE",1,0,1995,"12260","30.84512","99","400","426",180,246,247,"126",121,0.6722,0.5122,0.5798,0.939
"10303",213321,"KING'S COLLEGE",1,0,1996,"12980","34.058893","96","398","432",236,196,284,"116",168,0.7119,0.5918,0.6574,0.9213
"10304",213321,"KINGS COLLEGE",1,0,1997,"14000","28.136947","93","403","435",195,240,260,"121",139,0.7128,0.5042,0.5977,0.9264
"10305",213321,"KINGS COLLEGE",1,0,1998,"14970","28.566826","106","371","396",189,207,240,"113",127,0.672,0.5459,0.6061,0.9369
"10306",213321,"KINGS COLLEGE",1,0,1999,"15240","28.853329","105","374","420",218,202,268,"112",156,0.7156,0.5545,0.6381,0.8905
"10307",213321,"KINGS COLLEGE",1,0,2000,"16000","30.67968","108.5","407","457",199,258,285,"133",152,0.7638,0.5155,0.6236,0.8906
"10308",213321,"KINGS COLLEGE",1,0,2001,"16720","32.028942","112","372","441",217,224,286,"121",165,0.7604,0.5402,0.6485,0.8435
"10309",213321,"KINGS COLLEGE",1,0,2002,"17390","34.659409","114","357","409",195,214,263,"125",138,0.7077,0.5841,0.643,0.8729
"10310",213321,"KINGS COLLEGE",1,0,2003,"18260","36.276983","114","371","448",166,282,284,"164",120,0.7229,0.5816,0.6339,0.8281
"10311",213321,"KINGS COLLEGE",1,0,2004,"19260","38.153013","108","377","449",178,271,268,"139",129,0.7247,0.5129,0.5969,0.8396
"10312",213321,"King's College",1,0,2005,"20320","36.767381","109","397","479",198,281,282,"149",133,0.6717,0.5302,0.5887,0.8288
"10313",213321,"King's College",1,0,2006,"22280","39.126443","116","414","478",202,276,295,"153",142,0.703,0.5543,0.6172,0.8661
"10314",213321,"King's College",1,0,2007,"23450","42.819595","121","467","555",268,287,338,"173",165,0.6157,0.6028,0.609,0.8414
"10315",213321,"King's College",1,0,2008,"24680","47.041151","129","441","559",295,264,315,"134",181,0.6136,0.5076,0.5635,0.7889
"10316",213321,"King's College",1,0,2009,"25644","50.512882","123","372","499",233,266,303,"142",161,0.691,0.5338,0.6072,0.7455
"10317",213321,"King's College",1,0,2010,"26644","52.699628","128","431","528",240,288,310,"150",160,0.6667,0.5208,0.5871,0.8163
"10318",213349,"KUTZTOWN UNIVERSITY OF PENNSYLVANIA",1,0,1991,"3022","57.900476","370","1272","1427",813,614,295,"59",236,0.2903,0.0961,0.2067,0.8914
"10319",213349,"KUTZTOWN UNIVERSITY OF PENNSYLVANIA",1,0,1992,"3160","62.133925","405","982","1131",632,499,188,"40",148,0.2342,0.0802,0.1662,0.8683
"10320",213349,"KUTZTOWN UNIVERSITY OF PENNSYLVANIA",1,0,1993,"3558","65.110045","383","1207","1309",771,538,236,"57",179,0.2322,0.1059,0.1803,0.9221
"10321",213349,"KUTZTOWN UNIVERSITY OF PENNSYLVANIA",1,0,1995,"3940","78.482156","395","1105","1229",715,514,192,"52",140,0.1958,0.1012,0.1562,0.8991
"10322",213349,"KUTZTOWN UNIVERSITY OF PENNSYLVANIA",1,0,1996,"4098","79.354885","406","1341","1440",883,557,245,"56",189,0.214,0.1005,0.1701,0.9312
"10323",213349,"KUTZTOWN UNIVERSITY OF PENNSYLVANIA",1,0,1997,"4219","81.956824","407","1380","1497",837,660,252,"72",180,0.2151,0.1091,0.1683,0.9218
"10324",213349,"KUTZTOWN UNIVERSITY OF PENNSYLVANIA",1,0,1998,"4251","85.136128","370","1320","1417",840,577,282,"70",212,0.2524,0.1213,0.199,0.9315
"10325",213349,"KUTZTOWN UNIVERSITY OF PENNSYLVANIA",1,0,1999,"3618","89.38435","401","1464","1550",922,628,374,"89",285,0.3091,0.1417,0.2413,0.9445
"10326",213349,"KUTZTOWN UNIVERSITY OF PENNSYLVANIA",1,0,2000,"3792","94.783876","381","1448","1528",925,603,422,"100",322,0.3481,0.1658,0.2762,0.9476
"10327",213349,"KUTZTOWN UNIVERSITY OF PENNSYLVANIA",1,0,2001,"4016","102.443802","361","1454","1630",957,673,474,"111",363,0.3793,0.1649,0.2908,0.892
"10328",213349,"KUTZTOWN UNIVERSITY OF PENNSYLVANIA",1,0,2002,"4378","96.907518","362","1437","1726",1027,699,498,"141",357,0.3476,0.2017,0.2885,0.8326
"10329",213349,"KUTZTOWN UNIVERSITY OF PENNSYLVANIA",1,0,2003,"4598","100.979063","381","1503","1825",1035,790,549,"158",391,0.3778,0.2,0.3008,0.8236
"10330",213349,"KUTZTOWN UNIVERSITY OF PENNSYLVANIA",1,0,2004,"4810","110.030822","396","1698","2049",1217,832,680,"191",489,0.4018,0.2296,0.3319,0.8287
"10331",213349,"Kutztown University of Pennsylvania",1,0,2005,"4906","118.368573","410","1596","1905",1105,800,621,"190",431,0.39,0.2375,0.326,0.8378
"10332",213349,"Kutztown University of Pennsylvania",1,0,2006,"5038","126.484877","412","1644","1930",1177,753,612,"163",449,0.3815,0.2165,0.3171,0.8518
"10333",213349,"Kutztown University of Pennsylvania",1,0,2007,"5177","138.665059","417","1577","1888",1111,777,645,"182",463,0.4167,0.2342,0.3416,0.8353
"10334",213349,"Kutztown University of Pennsylvania",1,0,2008,"5358","150.707776","432","1562","1812",1034,778,680,"206",474,0.4584,0.2648,0.3753,0.862
"10335",213349,"Kutztown University of Pennsylvania",1,0,2009,"5554","161.055805","448","1688","1985",1132,853,689,"221",468,0.4134,0.2591,0.3471,0.8504
"10336",213349,"Kutztown University of Pennsylvania",1,0,2010,"5804","164.16151","427","1663","2009",1175,834,677,"217",460,0.3915,0.2602,0.337,0.8278
"10337",213358,"LA ROCHE COLLEGE",1,0,1991,"7138","10.935348","43","106","120",76,44,34,"10",24,0.3158,0.2273,0.2833,0.8833
"10338",213358,"LA ROCHE COLLEGE",1,0,1992,"7780","11.77462","43","113","118",84,34,33,"6",27,0.3214,0.1765,0.2797,0.9576
"10339",213358,"LA ROCHE COLLEGE",1,0,1993,"8468","12.649661","44","124","181",85,96,61,"31",30,0.3529,0.3229,0.337,0.6851
"10340",213358,"LA ROCHE COLLEGE",1,0,1995,"9426","14.976321","46","132","147",85,62,37,"9",28,0.3294,0.1452,0.2517,0.898
"10341",213358,"LA ROCHE COLLEGE",1,0,1996,"9912","15.999393","43","137","152",106,46,57,"19",38,0.3585,0.413,0.375,0.9013
"10342",213358,"LA ROCHE COLLEGE",1,0,1997,"10360","13.240949","45","148","184",101,83,91,"44",47,0.4653,0.5301,0.4946,0.8043
"10343",213358,"LA ROCHE COLLEGE",1,0,1998,"10780","13.373657","45","178","204",127,77,82,"30",52,0.4094,0.3896,0.402,0.8725
"10344",213358,"LA ROCHE COLLEGE",1,0,1999,"11100","15.711683","45","202","306",170,136,133,"58",75,0.4412,0.4265,0.4346,0.6601
"10345",213358,"LA ROCHE COLLEGE",1,0,2000,"11600","18.933217","49.5","211","351",199,152,200,"98",102,0.5126,0.6447,0.5698,0.6011
"10346",213358,"LA ROCHE COLLEGE",1,0,2001,"12180","21.146674","54","178","214",133,81,91,"34",57,0.4286,0.4198,0.4252,0.8318
"10347",213358,"LA ROCHE COLLEGE",1,0,2002,"12790","23.770179","63","217","295",175,120,117,"43",74,0.4229,0.3583,0.3966,0.7356
"10348",213358,"LA ROCHE COLLEGE",1,0,2003,"15220","24.949823","68","159","174",124,50,58,"13",45,0.3629,0.26,0.3333,0.9138
"10349",213358,"LA ROCHE COLLEGE",1,0,2004,"15982","23.48","65","182","214",141,73,46,"10",36,0.2553,0.137,0.215,0.8505
"10350",213358,"La Roche College",1,0,2005,"16780","22.304509","64","212","302",203,99,103,"32",71,0.3498,0.3232,0.3411,0.702
"10351",213358,"La Roche College",1,0,2006,"17620","22.860063","64","158","259",164,95,92,"32",60,0.3659,0.3368,0.3552,0.61
"10352",213358,"La Roche College",1,0,2007,"18600","22.982677","64","177","294",192,102,93,"29",64,0.3333,0.2843,0.3163,0.602
"10353",213358,"La Roche College",1,0,2008,"19660","23.683738","63","130","227",148,79,60,"15",45,0.3041,0.1899,0.2643,0.5727
"10354",213358,"La Roche College",1,0,2009,"20740","24.014975","63","112","190",121,69,46,"15",31,0.2562,0.2174,0.2421,0.5895
"10355",213358,"La Roche College",1,0,2010,"21570","22.585877","62","183","269",151,118,93,"48",45,0.298,0.4068,0.3457,0.6803
"10356",213367,"LA SALLE UNIVERSITY",1,0,1991,"10300","56.398733","211","512","594",293,301,331,"152",179,0.6109,0.505,0.5572,0.862
"10357",213367,"LA SALLE UNIVERSITY",1,0,1992,"10970","60.174857","212","485","564",293,271,358,"159",199,0.6792,0.5867,0.6348,0.8599
"10358",213367,"LA SALLE UNIVERSITY",1,0,1993,"11560","61.062836","209","509","597",327,270,321,"125",196,0.5994,0.463,0.5377,0.8526
"10359",213367,"LA SALLE UNIVERSITY",1,0,1995,"13070","62.837209","187","649","741",438,303,404,"140",264,0.6027,0.462,0.5452,0.8758
"10360",213367,"LA SALLE UNIVERSITY",1,0,1996,"14090","67.070052","182","550","648",355,293,362,"146",216,0.6085,0.4983,0.5586,0.8488
"10361",213367,"LA SALLE UNIVERSITY",1,0,1997,"14850","58.139","179","714","834",479,355,476,"184",292,0.6096,0.5183,0.5707,0.8561
"10362",213367,"LA SALLE UNIVERSITY",1,0,1998,"15860","61.069","171","552","663",321,342,361,"161",200,0.6231,0.4708,0.5445,0.8326
"10363",213367,"LA SALLE UNIVERSITY",1,0,1999,"16880","59.76","182","681","801",426,375,446,"188",258,0.6056,0.5013,0.5568,0.8502
"10364",213367,"LA SALLE UNIVERSITY",1,0,2000,"18020","63.65","187.5","641","774",404,370,455,"203",252,0.6238,0.5486,0.5879,0.8282
"10365",213367,"LA SALLE UNIVERSITY",1,0,2001,"19740","72.182","193","696","849",476,373,514,"190",324,0.6807,0.5094,0.6054,0.8198
"10366",213367,"LA SALLE UNIVERSITY",1,0,2002,"21270","82.597","200","692","837",456,381,445,"173",272,0.5965,0.4541,0.5317,0.8268
"10367",213367,"LA SALLE UNIVERSITY",1,0,2003,"22760","83.723","207","584","809",423,386,461,"204",257,0.6076,0.5285,0.5698,0.7219
"10368",213367,"LA SALLE UNIVERSITY",1,0,2004,"24410","88.024","213","627","829",419,410,441,"195",246,0.5871,0.4756,0.532,0.7563
"10369",213367,"La Salle University",1,0,2005,"25880","96.922","210","543","803",440,363,400,"160",240,0.5455,0.4408,0.4981,0.6762
"10370",213367,"La Salle University",1,0,2006,"27500","104.144","225","609","884",512,372,467,"180",287,0.5605,0.4839,0.5283,0.6889
"10371",213367,"La Salle University",1,0,2007,"29200","112.133","228","538","804",472,332,424,"136",288,0.6102,0.4096,0.5274,0.6692
"10372",213367,"La Salle University",1,0,2008,"31000","126.864284","230","548","902",519,383,471,"190",281,0.5414,0.4961,0.5222,0.6075
"10373",213367,"La Salle University",1,0,2009,"32500","120.793892","231","618","1005",580,425,522,"209",313,0.5397,0.4918,0.5194,0.6149
"10374",213367,"La Salle University",1,0,2010,"33500","126.843697","226","602","982",605,377,524,"182",342,0.5653,0.4828,0.5336,0.613
"10375",213385,"LAFAYETTE COLLEGE",1,0,1991,"15475","55.93895","169","434","519",243,276,426,"212",214,0.8807,0.7681,0.8208,0.8362
"10376",213385,"LAFAYETTE COLLEGE",1,0,1992,"16795","55.123414","179","506","575",263,312,455,"231",224,0.8517,0.7404,0.7913,0.88
"10377",213385,"LAFAYETTE COLLEGE",1,0,1993,"17880","57.167058","179","481","570",252,318,443,"226",217,0.8611,0.7107,0.7772,0.8439
"10378",213385,"LAFAYETTE COLLEGE",1,0,1995,"19621","63.020461","182","457","525",241,284,415,"208",207,0.8589,0.7324,0.7905,0.8705
"10379",213385,"LAFAYETTE COLLEGE",1,0,1996,"20390","69.023561","180","522","572",281,291,460,"215",245,0.8719,0.7388,0.8042,0.9126
"10380",213385,"LAFAYETTE COLLEGE",1,0,1997,"21202","61.968249","182","498","568",263,305,456,"230",226,0.8593,0.7541,0.8028,0.8768
"10381",213385,"LAFAYETTE COLLEGE",1,0,1998,"22049","63.840814","180","517","597",281,316,480,"241",239,0.8505,0.7627,0.804,0.866
"10382",213385,"LAFAYETTE COLLEGE",1,0,1999,"22844","66.784199","178","506","583",316,267,505,"218",287,0.9082,0.8165,0.8662,0.8679
"10383",213385,"LAFAYETTE COLLEGE",1,0,2000,"23758","73.452413","178.5","482","558",280,278,490,"238",252,0.9,0.8561,0.8781,0.8638
"10384",213385,"LAFAYETTE COLLEGE",1,0,2001,"24828","78.953081","179","508","575",287,288,487,"238",249,0.8676,0.8264,0.847,0.8835
"10385",213385,"LAFAYETTE COLLEGE",1,0,2002,"25946","85.120254","184","486","580",267,313,498,"263",235,0.8801,0.8403,0.8586,0.8379
"10386",213385,"LAFAYETTE COLLEGE",1,0,2003,"27178","92.285179","198","475","584",268,316,502,"267",235,0.8769,0.8449,0.8596,0.8134
"10387",213385,"LAFAYETTE COLLEGE",1,0,2004,"28470","95.265821","200","516","609",315,294,529,"249",280,0.8889,0.8469,0.8686,0.8473
"10388",213385,"Lafayette College",1,0,2005,"29822","101.691037","196","438","596",275,321,508,"268",240,0.8727,0.8349,0.8523,0.7349
"10389",213385,"Lafayette College",1,0,2006,"31501","108.674553","198","445","629",290,339,561,"299",262,0.9034,0.882,0.8919,0.7075
"10390",213385,"Lafayette College",1,0,2007,"33634","118.029841","210","434","591",277,314,500,"253",247,0.8917,0.8057,0.846,0.7343
"10391",213385,"Lafayette College",1,0,2008,"35904","123.434285","208","396","600",270,330,530,"280",250,0.9259,0.8485,0.8833,0.66
"10392",213385,"Lafayette College",1,0,2009,"37520","125.843648","211","348","616",298,318,533,"263",270,0.906,0.827,0.8653,0.5649
"10393",213385,"Lafayette College",1,0,2010,"38810","125.98603","217","443","648",294,354,553,"279",274,0.932,0.7881,0.8534,0.6836
"10394",213507,"LEBANON VALLEY COLLEGE",1,0,1991,"11750","16.649743","67","166","180",77,103,98,"50",48,0.6234,0.4854,0.5444,0.9222
"10395",213507,"LEBANON VALLEY COLLEGE",1,0,1992,"12875","18.345861","67","263","280",123,157,161,"84",77,0.626,0.535,0.575,0.9393
"10396",213507,"LEBANON VALLEY COLLEGE",1,0,1993,"13700","19.727216","68","297","314",170,144,191,"77",114,0.6706,0.5347,0.6083,0.9459
"10397",213507,"LEBANON VALLEY COLLEGE",1,0,1995,"14785","26.106387","70","284","297",155,142,183,"79",104,0.671,0.5563,0.6162,0.9562
"10398",213507,"LEBANON VALLEY COLLEGE",1,0,1996,"15360","28.760638","70","269","287",172,115,165,"53",112,0.6512,0.4609,0.5749,0.9373
"10399",213507,"LEBANON VALLEY COLLEGE",1,0,1997,"15980","23.533455","73","276","303",174,129,185,"71",114,0.6552,0.5504,0.6106,0.9109
"10400",213507,"LEBANON VALLEY COLLEGE",1,0,1998,"16610","24.784403","76","389","422",208,214,247,"110",137,0.6587,0.514,0.5853,0.9218
"10401",213507,"LEBANON VALLEY COLLEGE",1,0,1999,"16730","26.0408","81","383","407",238,169,279,"102",177,0.7437,0.6036,0.6855,0.941
"10402",213507,"LEBANON VALLEY COLLEGE",1,0,2000,"17870","27.093853","84.5","358","388",225,163,242,"85",157,0.6978,0.5215,0.6237,0.9227
"10403",213507,"LEBANON VALLEY COLLEGE",1,0,2001,"19210","28.703866","88","389","416",229,187,266,"105",161,0.7031,0.5615,0.6394,0.9351
"10404",213507,"LEBANON VALLEY COLLEGE",1,0,2002,"20600","31.476723","95","390","422",234,188,266,"99",167,0.7137,0.5266,0.6303,0.9242
"10405",213507,"LEBANON VALLEY COLLEGE",1,0,2003,"21860","34.089547","99","387","429",231,198,292,"119",173,0.7489,0.601,0.6807,0.9021
"10406",213507,"LEBANON VALLEY COLLEGE",1,0,2004,"22950","35.087412","96","367","416",221,195,287,"121",166,0.7511,0.6205,0.6899,0.8822
"10407",213507,"Lebanon Valley College",1,0,2005,"24210","35.807046","100","391","454",223,231,304,"138",166,0.7444,0.5974,0.6696,0.8612
"10408",213507,"Lebanon Valley College",1,0,2006,"25710","37.598895","98","403","447",241,206,300,"114",186,0.7718,0.5534,0.6711,0.9016
"10409",213507,"Lebanon Valley College",1,0,2007,"27125","39.284029","100","392","450",261,189,308,"109",199,0.7625,0.5767,0.6844,0.8711
"10410",213507,"Lebanon Valley College",1,0,2008,"28650","42.29392","99","353","395",217,178,276,"110",166,0.765,0.618,0.6987,0.8937
"10411",213507,"Lebanon Valley College",1,0,2009,"29780","44.265341","100","339","378",205,173,258,"92",166,0.8098,0.5318,0.6825,0.8968
"10412",213507,"Lebanon Valley College",1,0,2010,"30910","47.656836","101","405","460",245,215,331,"152",179,0.7306,0.707,0.7196,0.8804
"10413",213543,"LEHIGH UNIVERSITY",1,0,1991,"15650","170.474","411","980","1117",411,706,749,"435",314,0.764,0.6161,0.6705,0.8774
"10414",213543,"LEHIGH UNIVERSITY",1,0,1992,"16700","185.361","418","958","1089",385,704,720,"430",290,0.7532,0.6108,0.6612,0.8797
"10415",213543,"LEHIGH UNIVERSITY",1,0,1993,"17750","182.466","416","941","1095",394,701,706,"404",302,0.7665,0.5763,0.6447,0.8594
"10416",213543,"LEHIGH UNIVERSITY",1,0,1995,"19650","199.225","385","828","1045",412,633,734,"404",330,0.801,0.6382,0.7024,0.7923
"10417",213543,"LEHIGH UNIVERSITY",1,0,1996,"20500","202.28","399","847","1101",409,692,768,"433",335,0.8191,0.6257,0.6975,0.7693
"10418",213543,"LEHIGH UNIVERSITY",1,0,1997,"21350","183.213","397","878","1097",442,655,803,"444",359,0.8122,0.6779,0.732,0.8004
"10419",213543,"LEHIGH UNIVERSITY",1,0,1998,"22300","190.611","393","857","1112",478,634,789,"397",392,0.8201,0.6262,0.7095,0.7707
"10420",213543,"LEHIGH UNIVERSITY",1,0,1999,"23150","198.04","391","790","1077",455,622,799,"437",362,0.7956,0.7026,0.7419,0.7335
"10421",213543,"LEHIGH UNIVERSITY",1,0,2000,"24000","199.791","392","843","1127",464,663,845,"473",372,0.8017,0.7134,0.7498,0.748
"10422",213543,"LEHIGH UNIVERSITY",1,0,2001,"24940","207.816","393","838","1109",435,674,798,"436",362,0.8322,0.6469,0.7196,0.7556
"10423",213543,"LEHIGH UNIVERSITY",1,0,2002,"25980","221.222","406","938","1143",442,701,822,"461",361,0.8167,0.6576,0.7192,0.8206
"10424",213543,"LEHIGH UNIVERSITY",1,0,2003,"27230","237.034","423","873","1124",448,676,854,"487",367,0.8192,0.7204,0.7598,0.7767
"10425",213543,"LEHIGH UNIVERSITY",1,0,2004,"29140","248.131","432","847","1054",463,591,814,"417",397,0.8575,0.7056,0.7723,0.8036
"10426",213543,"Lehigh University",1,0,2005,"31180","266.454","434","1036","1223",512,711,956,"521",435,0.8496,0.7328,0.7817,0.8471
"10427",213543,"Lehigh University",1,0,2006,"33470","269.002","443","874","1217",511,706,950,"523",427,0.8356,0.7408,0.7806,0.7182
"10428",213543,"Lehigh University",1,0,2007,"35310","297.879","440","850","1165",450,715,851,"485",366,0.8133,0.6783,0.7305,0.7296
"10429",213543,"Lehigh University",1,0,2008,"37250","318.378","443","803","1205",516,689,910,"484",426,0.8256,0.7025,0.7552,0.6664
"10430",213543,"Lehigh University",1,0,2009,"38330","318.249","464","839","1189",489,700,878,"469",409,0.8364,0.67,0.7384,0.7056
"10431",213543,"Lehigh University",1,0,2010,"39480","317.062","473","885","1208",516,692,932,"495",437,0.8469,0.7153,0.7715,0.7326
"10432",213613,"LOCK HAVEN UNIVERSITY",1,0,1991,"3020","32.876556","211","700","737",447,290,187,"52",135,0.302,0.1793,0.2537,0.9498
"10433",213613,"LOCK HAVEN UNIVERSITY",1,0,1992,"3261","37.603409","201","872","906",514,392,210,"61",149,0.2899,0.1556,0.2318,0.9625
"10434",213613,"LOCK HAVEN UNIVERSITY",1,0,1993,"3509","39.036953","197","720","758",402,356,157,"43",114,0.2836,0.1208,0.2071,0.9499
"10435",213613,"LOCK HAVEN UNIVERISTY OF PENNSYLVANIA",1,0,1995,"3822","41.401685","188","635","693",359,334,133,"43",90,0.2507,0.1287,0.1919,0.9163
"10436",213613,"LOCK HAVEN UNIVERISTY OF PENNSYLVANIA",1,0,1996,"3988","42.10703","183","723","780",419,361,179,"62",117,0.2792,0.1717,0.2295,0.9269
"10437",213613,"LOCK HAVEN UNIVERSITY OF PENNSYLVANIA",1,0,1997,"4062","45.356273","197","768","822",430,392,188,"67",121,0.2814,0.1709,0.2287,0.9343
"10438",213613,"LOCK HAVEN UNIVERSITY OF PENNSYLVANIA",1,0,1998,"4071","46.592399","207","754","813",463,350,159,"50",109,0.2354,0.1429,0.1956,0.9274
"10439",213613,"LOCK HAVEN UNIVERSITY OF PENNSYLVANIA",1,0,1999,"3618","49.507684","202","839","887",502,385,212,"65",147,0.2928,0.1688,0.239,0.9459
"10440",213613,"LOCK HAVEN UNIVERSITY OF PENNSYLVANIA",1,0,2000,"3792","52.67909","203.5","824","890",522,368,250,"68",182,0.3487,0.1848,0.2809,0.9258
"10441",213613,"LOCK HAVEN UNIVERSITY OF PENNSYLVANIA",1,0,2001,"4016","57.25521","205","917","978",581,397,286,"96",190,0.327,0.2418,0.2924,0.9376
"10442",213613,"LOCK HAVEN UNIVERSITY OF PENNSYLVANIA",1,0,2002,"4378","57.125078","213","941","1038",646,392,305,"89",216,0.3344,0.227,0.2938,0.9066
"10443",213613,"LOCK HAVEN UNIVERSITY OF PENNSYLVANIA",1,0,2003,"4598","61.646196","220","1033","1145",657,488,316,"104",212,0.3227,0.2131,0.276,0.9022
"10444",213613,"LOCK HAVEN UNIVERSITY OF PENNSYLVANIA",1,0,2004,"4810","66.354187","235","1051","1191",702,489,348,"129",219,0.312,0.2638,0.2922,0.8825
"10445",213613,"Lock Haven University of Pennsylvania",1,0,2005,"4906","70.743327","236","990","1215",695,520,314,"110",204,0.2935,0.2115,0.2584,0.8148
"10446",213613,"Lock Haven University of Pennsylvania",1,0,2006,"5038","74.591147","233","900","1079",608,471,266,"106",160,0.2632,0.2251,0.2465,0.8341
"10447",213613,"Lock Haven University of Pennsylvania",1,0,2007,"5178","76.138562","235","1035","1217",656,561,321,"144",177,0.2698,0.2567,0.2638,0.8505
"10448",213613,"Lock Haven University",1,0,2008,"5358","80.734613","235","1093","1269",731,538,340,"119",221,0.3023,0.2212,0.2679,0.8613
"10449",213613,"Lock Haven University",1,0,2009,"5554","81.390521","231","1020","1185",702,483,336,"117",219,0.312,0.2422,0.2835,0.8608
"10450",213613,"Lock Haven University",1,0,2010,"5804","86.682931","229","1030","1185",630,555,361,"158",203,0.3222,0.2847,0.3046,0.8692
"10451",213668,"LYCOMING COLLEGE",1,0,1991,"11100","20.504663","85","357","374",190,184,153,"67",86,0.4526,0.3641,0.4091,0.9545
"10452",213668,"LYCOMING COLLEGE",1,0,1992,"12000","23.368669","83","346","359",179,180,174,"72",102,0.5698,0.4,0.4847,0.9638
"10453",213668,"LYCOMING COLLEGE",1,0,1993,"13000","25.739984","86","345","361",203,158,191,"72",119,0.5862,0.4557,0.5291,0.9557
"10454",213668,"LYCOMING COLLEGE",1,0,1995,"14700","30.337999","87","347","366",210,156,237,"82",155,0.7381,0.5256,0.6475,0.9481
"10455",213668,"LYCOMING COLLEGE",1,0,1996,"15460","31.070396","86","372","386",186,200,226,"102",124,0.6667,0.51,0.5855,0.9637
"10456",213668,"LYCOMING COLLEGE",1,0,1997,"16130","21.445276","91","372","379",227,152,214,"65",149,0.6564,0.4276,0.5646,0.9815
"10457",213668,"LYCOMING COLLEGE",1,0,1998,"16810","21.936081","87","367","380",195,185,222,"85",137,0.7026,0.4595,0.5842,0.9658
"10458",213668,"LYCOMING COLLEGE",1,0,1999,"17440","22.653406","86","379","392",209,183,242,"99",143,0.6842,0.541,0.6173,0.9668
"10459",213668,"LYCOMING COLLEGE",1,0,2000,"18240","23.870354","84","332","337",177,160,199,"90",109,0.6158,0.5625,0.5905,0.9852
"10460",213668,"LYCOMING COLLEGE",1,0,2001,"19104","24.32376","82","385","407",218,189,249,"100",149,0.6835,0.5291,0.6118,0.9459
"10461",213668,"LYCOMING COLLEGE",1,0,2002,"20032","25.629505","82","357","373",195,178,234,"100",134,0.6872,0.5618,0.6273,0.9571
"10462",213668,"LYCOMING COLLEGE",1,0,2003,"21088","26.5795","84","360","381",226,155,254,"97",157,0.6947,0.6258,0.6667,0.9449
"10463",213668,"LYCOMING COLLEGE",1,0,2004,"22336","27.911799","81","376","399",217,182,249,"109",140,0.6452,0.5989,0.6241,0.9424
"10464",213668,"Lycoming College",1,0,2005,"23680","29.804376","84","328","357",219,138,216,"74",142,0.6484,0.5362,0.605,0.9188
"10465",213668,"Lycoming College",1,0,2006,"25120","30.949271","80","349","375",193,182,213,"87",126,0.6528,0.478,0.568,0.9307
"10466",213668,"Lycoming College",1,0,2007,"26624","31.483108","84","372","399",211,188,215,"84",131,0.6209,0.4468,0.5388,0.9323
"10467",213668,"Lycoming College",1,0,2008,"28224","32.560381","82","319","340",161,179,178,"77",101,0.6273,0.4302,0.5235,0.9382
"10468",213668,"Lycoming College",1,0,2009,"29344","31.856316","81","286","383",194,189,220,"89",131,0.6753,0.4709,0.5744,0.7467
"10469",213668,"Lycoming College",1,0,2010,"30240","32.275151","85","265","346",211,135,205,"67",138,0.654,0.4963,0.5925,0.7659
"10470",213783,"MANSFIELD UNIVERSITY OF PENNSYLVANIA",1,0,1991,"2947","31.745708","178","428","461",283,178,168,"50",118,0.417,0.2809,0.3644,0.9284
"10471",213783,"MANSFIELD UNIVERSITY OF PENNSYLVANIA",1,0,1992,"3168","34.195446","179","440","485",294,191,148,"44",104,0.3537,0.2304,0.3052,0.9072
"10472",213783,"MANSFIELD UNIVERSITY OF PENNSYLVANIA",1,0,1993,"3440","36.307032","179","539","590",350,240,189,"59",130,0.3714,0.2458,0.3203,0.9136
"10473",213783,"MANSFIELD UNIVERSITY OF PENNSYLVANIA",1,0,1995,"3804","38.771507","179","536","577",340,237,135,"41",94,0.2765,0.173,0.234,0.9289
"10474",213783,"MANSFIELD UNIVERSITY OF PENNSYLVANIA",1,0,1996,"4034","41.080085","171","533","590",316,274,154,"57",97,0.307,0.208,0.261,0.9034
"10475",213783,"MANSFIELD UNIVERSITY OF PENNSYLVANIA",1,0,1997,"4354","41.32383","168","550","597",329,268,141,"53",88,0.2675,0.1978,0.2362,0.9213
"10476",213783,"MANSFIELD UNIVERSITY OF PENNSYLVANIA",1,0,1998,"4410","42.813882","156","548","619",346,273,143,"64",79,0.2283,0.2344,0.231,0.8853
"10477",213783,"MANSFIELD UNIVERSITY OF PENNSYLVANIA",1,0,1999,"3618","45.011278","169","569","611",364,247,178,"53",125,0.3434,0.2146,0.2913,0.9313
"10478",213783,"MANSFIELD UNIVERSITY OF PENNSYLVANIA",1,0,2000,"3792","47.052983","168.5","589","639",363,276,183,"79",104,0.2865,0.2862,0.2864,0.9218
"10479",213783,"MANSFIELD UNIVERSITY OF PENNSYLVANIA",1,0,2001,"4016","49.408939","168","592","640",362,278,200,"77",123,0.3398,0.277,0.3125,0.925
"10480",213783,"MANSFIELD UNIVERSITY OF PENNSYLVANIA",1,0,2002,"4378","49.506777","155","589","654",381,273,171,"48",123,0.3228,0.1758,0.2615,0.9006
"10481",213783,"MANSFIELD UNIVERSITY OF PENNSYLVANIA",1,0,2003,"4598","50.273565","153","595","690",403,287,179,"74",105,0.2605,0.2578,0.2594,0.8623
"10482",213783,"MANSFIELD UNIVERSITY OF PENNSYLVANIA",1,0,2004,"4810","52.29731","155","571","689",402,287,168,"54",114,0.2836,0.1882,0.2438,0.8287
"10483",213783,"Mansfield University of Pennsylvania",1,0,2005,"4906","53.068077","147","534","662",406,256,216,"62",154,0.3793,0.2422,0.3263,0.8066
"10484",213783,"Mansfield University of Pennsylvania",1,0,2006,"5038","54.496988","148","503","603",356,247,172,"53",119,0.3343,0.2146,0.2852,0.8342
"10485",213783,"Mansfield University of Pennsylvania",1,0,2007,"5177","57.062555","147","526","661",397,264,198,"63",135,0.3401,0.2386,0.2995,0.7958
"10486",213783,"Mansfield University of Pennsylvania",1,0,2008,"5358","59.964855","158","516","665",410,255,203,"67",136,0.3317,0.2627,0.3053,0.7759
"10487",213783,"Mansfield University of Pennsylvania",1,0,2009,"5554","61.999222","156","532","704",397,307,189,"71",118,0.2972,0.2313,0.2685,0.7557
"10488",213783,"Mansfield University of Pennsylvania",1,0,2010,"5804","63.733642","152","503","631",346,285,162,"70",92,0.2659,0.2456,0.2567,0.7971
"10489",213826,"MARYWOOD COLLEGE",1,0,1991,"8500","25.88374","122","265","281",237,44,95,"12",83,0.3502,0.2727,0.3381,0.9431
"10490",213826,"MARYWOOD COLLEGE",1,0,1992,"9350","29.284921","121","233","239",193,46,81,"5",76,0.3938,0.1087,0.3389,0.9749
"10491",213826,"MARYWOOD COLLEGE",1,0,1993,"9950","30.368656","121","274","292",228,64,101,"17",84,0.3684,0.2656,0.3459,0.9384
"10492",213826,"MARYWOOD COLLEGE",1,0,1995,"11500","36.27492","120","227","245",193,52,99,"13",86,0.4456,0.25,0.4041,0.9265
"10493",213826,"MARYWOOD COLLEGE",1,0,1996,"12395","37.924349","114","230","251",191,60,103,"18",85,0.445,0.3,0.4104,0.9163
"10494",213826,"MARYWOOD UNIVERSITY",1,0,1997,"13165","30.773177","116","248","276",209,67,103,"18",85,0.4067,0.2687,0.3732,0.8986
"10495",213826,"MARYWOOD UNIVERSITY",1,0,1998,"14020","32.562135","118","220","241",186,55,102,"16",86,0.4624,0.2909,0.4232,0.9129
"10496",213826,"MARYWOOD UNIVERSITY",1,0,1999,"14070","33.249047","117","257","282",207,75,118,"25",93,0.4493,0.3333,0.4184,0.9113
"10497",213826,"MARYWOOD UNIVERSITY",1,0,2000,"14850","34.035922","119","242","257",188,69,100,"29",71,0.3777,0.4203,0.3891,0.9416
"10498",213826,"MARYWOOD UNIVERSITY",1,0,2001,"15600","37.09392","121","271","287",215,72,114,"23",91,0.4233,0.3194,0.3972,0.9443
"10499",213826,"MARYWOOD UNIVERSITY",1,0,2002,"17600","39.330028","123","276","310",238,72,164,"29",135,0.5672,0.4028,0.529,0.8903
"10500",213826,"MARYWOOD UNIVERSITY",1,0,2003,"18560","41.967204","122","252","277",199,78,152,"34",118,0.593,0.4359,0.5487,0.9097
"10501",213826,"MARYWOOD UNIVERSITY",1,0,2004,"19600","43.322602","121","292","332",262,70,149,"24",125,0.4771,0.3429,0.4488,0.8795
"10502",213826,"Marywood University",1,0,2005,"20700","45.995376","121","254","301",230,71,153,"30",123,0.5348,0.4225,0.5083,0.8439
"10503",213826,"Marywood University",1,0,2006,"21840","49.629647","121","321","383",278,105,197,"42",155,0.5576,0.4,0.5144,0.8381
"10504",213826,"Marywood University",1,0,2007,"23040","52.470055","123","360","407",297,110,218,"46",172,0.5791,0.4182,0.5356,0.8845
"10505",213826,"Marywood University",1,0,2008,"24300","56.922224","130","380","422",291,131,238,"62",176,0.6048,0.4733,0.564,0.9005
"10506",213826,"Marywood University",1,0,2009,"25150","61.31347","136","365","411",287,124,231,"54",177,0.6167,0.4355,0.562,0.8881
"10507",213826,"Marywood University",1,0,2010,"26000","62.981644","143","386","452",338,114,241,"44",197,0.5828,0.386,0.5332,0.854
"10508",213996,"MESSIAH COLLEGE",1,0,1991,"8700","35.156341","126","501","560",343,217,361,"136",225,0.656,0.6267,0.6446,0.8946
"10509",213996,"MESSIAH COLLEGE",1,0,1992,"9110","38.148778","126","525","568",357,211,376,"142",234,0.6555,0.673,0.662,0.9243
"10510",213996,"MESSIAH COLLEGE",1,0,1993,"9804","37.228384","131","569","606",376,230,400,"155",245,0.6516,0.6739,0.6601,0.9389
"10511",213996,"MESSIAH COLLEGE",1,0,1995,"10954","42.253067","128","629","671",416,255,428,"163",265,0.637,0.6392,0.6379,0.9374
"10512",213996,"MESSIAH COLLEGE",1,0,1996,"11888","37.286677","135","620","672",407,265,448,"168",280,0.688,0.634,0.6667,0.9226
"10513",213996,"MESSIAH COLLEGE",1,0,1997,"12990","43.407918","139","639","689",445,244,445,"165",280,0.6292,0.6762,0.6459,0.9274
"10514",213996,"MESSIAH COLLEGE",1,0,1998,"13880","44.167438","142","712","763",480,283,536,"205",331,0.6896,0.7244,0.7025,0.9332
"10515",213996,"MESSIAH COLLEGE",1,0,1999,"15000","47.749101","141","642","678",413,265,468,"168",300,0.7264,0.634,0.6903,0.9469
"10516",213996,"MESSIAH COLLEGE",1,0,2000,"15830","51.545943","149.5","675","741",451,290,500,"184",316,0.7007,0.6345,0.6748,0.9109
"10517",213996,"MESSIAH COLLEGE",1,0,2001,"16860","72.058136","158","635","702",425,277,472,"166",306,0.72,0.5993,0.6724,0.9046
"10518",213996,"MESSIAH COLLEGE",1,0,2002,"17730","61.918011","166","690","763",475,288,526,"168",358,0.7537,0.5833,0.6894,0.9043
"10519",213996,"MESSIAH COLLEGE",1,0,2003,"18880","65.083597","166","662","735",463,272,529,"189",340,0.7343,0.6949,0.7197,0.9007
"10520",213996,"MESSIAH COLLEGE",1,0,2004,"20120","69.089429","170","620","690",453,237,484,"159",325,0.7174,0.6709,0.7014,0.8986
"10521",213996,"Messiah College",1,0,2005,"21420","73.075308","170","629","707",439,268,500,"177",323,0.7358,0.6604,0.7072,0.8897
"10522",213996,"Messiah College",1,0,2006,"22600","74.358548","173","605","735",471,264,529,"179",350,0.7431,0.678,0.7197,0.8231
"10523",213996,"Messiah College",1,0,2007,"23710","76.946775","172","624","723",459,264,514,"185",329,0.7168,0.7008,0.7109,0.8631
"10524",213996,"Messiah College",1,0,2008,"24900","78.858164","173","585","709",448,261,529,"186",343,0.7656,0.7126,0.7461,0.8251
"10525",213996,"Messiah College",1,0,2009,"25900","81.279983","170","610","697",440,257,497,"173",324,0.7364,0.6732,0.7131,0.8752
"10526",213996,"Messiah College",1,0,2010,"26680","81.146541","175","604","721",433,288,523,"210",313,0.7229,0.7292,0.7254,0.8377
"10527",214041,"MILLERSVILLE UNIVERSITY OF PENNSYLVANIA",1,0,1991,"3100","64.921997","332","946","1089",672,417,429,"127",302,0.4494,0.3046,0.3939,0.8687
"10528",214041,"MILLERSVILLE UNIVERSITY OF PENNSYLVANIA",1,0,1992,"3488","70.388359","322","846","1002",635,367,375,"93",282,0.4441,0.2534,0.3743,0.8443
"10529",214041,"MILLERSVILLE UNIVERSITY OF PENNSYLVANIA",1,0,1993,"3750","73.607031","320","770","946",593,353,339,"86",253,0.4266,0.2436,0.3584,0.814
"10530",214041,"MILLERSVILLE UNIVERSITY OF PENNSYLVANIA",1,0,1995,"4100","85.317365","312","1018","1157",700,457,389,"132",257,0.3671,0.2888,0.3362,0.8799
"10531",214041,"MILLERSVILLE UNIVERSITY OF PENNSYLVANIA",1,0,1996,"4268","88.170697","309","848","979",587,392,327,"121",206,0.3509,0.3087,0.334,0.8662
"10532",214041,"MILLERSVILLE UNIVERSITY OF PENNSYLVANIA",1,0,1997,"4400","88.608597","300","899","1068",627,441,409,"132",277,0.4418,0.2993,0.383,0.8418
"10533",214041,"MILLERSVILLE UNIVERSITY OF PENNSYLVANIA",1,0,1998,"4429","92.614063","288","976","1110",651,459,383,"132",251,0.3856,0.2876,0.345,0.8793
"10534",214041,"MILLERSVILLE UNIVERSITY OF PENNSYLVANIA",1,0,1999,"3618","96.821575","286","1093","1239",746,493,424,"134",290,0.3887,0.2718,0.3422,0.8822
"10535",214041,"MILLERSVILLE UNIVERSITY OF PENNSYLVANIA",1,0,2000,"3792","97.9744","291","1133","1265",768,497,463,"163",300,0.3906,0.328,0.366,0.8957
"10536",214041,"MILLERSVILLE UNIVERSITY OF PENNSYLVANIA",1,0,2001,"4016","104.94697","296","1118","1245",758,487,518,"162",356,0.4697,0.3326,0.4161,0.898
"10537",214041,"MILLERSVILLE UNIVERSITY OF PENNSYLVANIA",1,0,2002,"4378","100.09772","292","1071","1270",748,522,463,"158",305,0.4078,0.3027,0.3646,0.8433
"10538",214041,"MILLERSVILLE UNIVERSITY OF PENNSYLVANIA",1,0,2003,"4598","105.005775","303","1062","1334",754,580,478,"159",319,0.4231,0.2741,0.3583,0.7961
"10539",214041,"MILLERSVILLE UNIVERSITY OF PENNSYLVANIA",1,0,2004,"4810","110.981374","298","1019","1396",791,605,512,"177",335,0.4235,0.2926,0.3668,0.7299
"10540",214041,"Millersville University of Pennsylvania",1,0,2005,"4906","111.855486","302","953","1306",774,532,501,"172",329,0.4251,0.3233,0.3836,0.7297
"10541",214041,"Millersville University of Pennsylvania",1,0,2006,"5038","116.836188","308","1069","1342",792,550,482,"154",328,0.4141,0.28,0.3592,0.7966
"10542",214041,"Millersville University of Pennsylvania",1,0,2007,"5177","126.192544","310","1051","1326",766,560,491,"161",330,0.4308,0.2875,0.3703,0.7926
"10543",214041,"Millersville University of Pennsylvania",1,0,2008,"5358","132.012491","300","1044","1311",729,582,503,"190",313,0.4294,0.3265,0.3837,0.7963
"10544",214041,"Millersville University of Pennsylvania",1,0,2009,"5554","136.936972","303","1065","1317",726,591,472,"179",293,0.4036,0.3029,0.3584,0.8087
"10545",214041,"Millersville University of Pennsylvania",1,0,2010,"5804","136.638979","298","1068","1315",728,587,494,"193",301,0.4135,0.3288,0.3757,0.8122
"10546",214069,"COLLEGE MISERICORDIA",1,0,1991,"7885","13.451226","66","240","246",187,59,86,"23",63,0.3369,0.3898,0.3496,0.9756
"10547",214069,"COLLEGE MISERICORDIA",1,0,1992,"9500","16.693277","79","283","292",228,64,88,"20",68,0.2982,0.3125,0.3014,0.9692
"10548",214069,"COLLEGE MISERICORDIA",1,0,1993,"10460","19.418875","84","308","316",231,85,88,"24",64,0.2771,0.2824,0.2785,0.9747
"10549",214069,"COLLEGE MISERICORDIA",1,0,1995,"12190","25.846453","92","270","280",204,76,88,"28",60,0.2941,0.3684,0.3143,0.9643
"10550",214069,"COLLEGE MISERICORDIA",1,0,1996,"12880","26.774914","91","246","251",186,65,59,"16",43,0.2312,0.2462,0.2351,0.9801
"10551",214069,"COLLEGE MISERICORDIA",1,0,1997,"13830","20.447206","95","237","240",174,66,162,"32",130,0.7471,0.4848,0.675,0.9875
"10552",214069,"COLLEGE MISERICORDIA",1,0,1998,"14520","21.371926","90","182","187",142,45,126,"31",95,0.669,0.6889,0.6738,0.9733
"10553",214069,"COLLEGE MISERICORDIA",1,0,1999,"14470","21.044533","86","241","249",173,76,165,"42",123,0.711,0.5526,0.6627,0.9679
"10554",214069,"COLLEGE MISERICORDIA",1,0,2000,"15190","21.620168","87","256","261",185,76,160,"39",121,0.6541,0.5132,0.613,0.9808
"10555",214069,"COLLEGE MISERICORDIA",1,0,2001,"15800","24.091688","88","249","260",188,72,157,"39",118,0.6277,0.5417,0.6038,0.9577
"10556",214069,"COLLEGE MISERICORDIA",1,0,2002,"16420","25.614147","88","329","347",239,108,201,"59",142,0.5941,0.5463,0.5793,0.9481
"10557",214069,"COLLEGE MISERICORDIA",1,0,2003,"17970","28.113813","90","297","313",233,80,206,"49",157,0.6738,0.6125,0.6581,0.9489
"10558",214069,"COLLEGE MISERICORDIA",1,0,2004,"17850","30.476814","93","301","317",225,92,171,"41",130,0.5778,0.4457,0.5394,0.9495
"10559",214069,"College Misericordia",1,0,2005,"18700","32.464061","90","299","324",222,102,181,"52",129,0.5811,0.5098,0.5586,0.9228
"10560",214069,"College Misericordia",1,0,2006,"19800","34.811644","94","287","308",192,116,165,"57",108,0.5625,0.4914,0.5357,0.9318
"10561",214069,"Misericordia University",1,0,2007,"20830","35.702691","94","343","364",273,91,234,"51",183,0.6703,0.5604,0.6429,0.9423
"10562",214069,"Misericordia University",1,0,2008,"21990","39.249618","95","364","378",248,130,238,"72",166,0.6694,0.5538,0.6296,0.963
"10563",214069,"Misericordia University",1,0,2009,"22850","41.408705","96","346","371",236,135,237,"78",159,0.6737,0.5778,0.6388,0.9326
"10564",214069,"Misericordia University",1,0,2010,"23750","44.227458","104","356","375",265,110,255,"62",193,0.7283,0.5636,0.68,0.9493
"10565",214157,"MORAVIAN COLLEGE",1,0,1991,"12698","23.553664","85","270","288",143,145,192,"92",100,0.6993,0.6345,0.6667,0.9375
"10566",214157,"MORAVIAN COLLEGE",1,0,1992,"13696","25.802116","86","281","296",142,154,187,"86",101,0.7113,0.5584,0.6318,0.9493
"10567",214157,"MORAVIAN COLLEGE",1,0,1993,"14490","26.735509","86","289","304",157,147,216,"102",114,0.7261,0.6939,0.7105,0.9507
"10568",214157,"MORAVIAN COLLEGE",1,0,1995,"15880","30.021121","86","304","319",169,150,217,"97",120,0.7101,0.6467,0.6803,0.953
"10569",214157,"MORAVIAN COLLEGE",1,0,1996,"16500","33.048377","89","275","284",138,146,194,"90",104,0.7536,0.6164,0.6831,0.9683
"10570",214157,"MORAVIAN COLLEGE",1,0,1997,"17276","27.062786","93","305","325",190,135,219,"86",133,0.7,0.637,0.6738,0.9385
"10571",214157,"MORAVIAN COLLEGE AND THEOLOGICAL SEMINARY",1,0,1998,"17841","28.731574","95","268","292",172,120,183,"69",114,0.6628,0.575,0.6267,0.9178
"10572",214157,"MORAVIAN COLLEGE AND THEOLOGICAL SEMINARY",1,0,1999,"18245","29.829511","98","289","318",162,156,213,"102",111,0.6852,0.6538,0.6698,0.9088
"10573",214157,"MORAVIAN COLLEGE AND THEOLOGICAL SEMINARY",1,0,2000,"19070","32.662925","100.5","357","378",236,142,246,"80",166,0.7034,0.5634,0.6508,0.9444
"10574",214157,"MORAVIAN COLLEGE AND THEOLOGICAL SEMINARY",1,0,2001,"20115","35.685877","103","295","315",200,115,219,"68",151,0.755,0.5913,0.6952,0.9365
"10575",214157,"MORAVIAN COLLEGE AND THEOLOGICAL SEMINARY",1,0,2002,"20925","36.734579","104","338","372",214,158,264,"102",162,0.757,0.6456,0.7097,0.9086
"10576",214157,"MORAVIAN COLLEGE AND THEOLOGICAL SEMINARY",1,0,2003,"21663","39.39932","108","339","379",239,140,270,"90",180,0.7531,0.6429,0.7124,0.8945
"10577",214157,"MORAVIAN COLLEGE AND THEOLOGICAL SEMINARY",1,0,2004,"23184","42.22732","110","348","382",215,167,261,"103",158,0.7349,0.6168,0.6832,0.911
"10578",214157,"Moravian College and Moravian Theological Seminary",1,0,2005,"24813","44.421741","113","350","382",204,178,280,"123",157,0.7696,0.691,0.733,0.9162
"10579",214157,"Moravian College and Moravian Theological Seminary",1,0,2006,"26300","46.438394","115","345","375",223,152,268,"108",160,0.7175,0.7105,0.7147,0.92
"10580",214157,"Moravian College and Moravian Theological Seminary",1,0,2007,"27873","47.17719","112","346","401",214,187,282,"130",152,0.7103,0.6952,0.7032,0.8628
"10581",214157,"Moravian College and Moravian Theological Seminary",1,0,2008,"29547","48.294867","116","345","387",226,161,253,"94",159,0.7035,0.5839,0.6537,0.8915
"10582",214157,"Moravian College and Moravian Theological Seminary",1,0,2009,"30735","51.986275","115","300","379",223,156,248,"97",151,0.6771,0.6218,0.6544,0.7916
"10583",214157,"Moravian College and Moravian Theological Seminary",1,0,2010,"31662","50.798147","106","318","373",216,157,245,"96",149,0.6898,0.6115,0.6568,0.8525
"10584",214175,"MUHLENBERG COLLEGE",1,0,1991,"15115","34.371126","113","427","463",258,205,336,"140",196,0.7597,0.6829,0.7257,0.9222
"10585",214175,"MUHLENBERG COLLEGE",1,0,1992,"15740","37.560408","109","427","466",244,222,334,"141",193,0.791,0.6351,0.7167,0.9163
"10586",214175,"MUHLENBERG COLLEGE",1,0,1993,"16385","39.146599","115","421","464",270,194,332,"131",201,0.7444,0.6753,0.7155,0.9073
"10587",214175,"MUHLENBERG COLLEGE",1,0,1995,"17550","43.865566","119","440","486",277,209,392,"161",231,0.8339,0.7703,0.8066,0.9053
"10588",214175,"MUHLENBERG COLLEGE",1,0,1996,"18100","46.843614","129","489","532",307,225,414,"161",253,0.8241,0.7156,0.7782,0.9192
"10589",214175,"MUHLENBERG COLLEGE",1,0,1997,"18660","37.560943","123","459","493",293,200,352,"135",217,0.7406,0.675,0.714,0.931
"10590",214175,"MUHLENBERG COLLEGE",1,0,1998,"19300","39.326177","127","532","577",344,233,438,"162",276,0.8023,0.6953,0.7591,0.922
"10591",214175,"MUHLENBERG COLLEGE",1,0,1999,"19910","40.619198","114","419","551",321,230,446,"179",267,0.8318,0.7783,0.8094,0.7604
"10592",214175,"MUHLENBERG COLLEGE",1,0,2000,"20865","43.5129","128","546","579",340,239,480,"196",284,0.8353,0.8201,0.829,0.943
"10593",214175,"MUHLENBERG COLLEGE",1,0,2001,"22015","46.420363","142","526","574",330,244,456,"184",272,0.8242,0.7541,0.7944,0.9164
"10594",214175,"MUHLENBERG COLLEGE",1,0,2002,"23250","51.393556","150","510","547",300,247,445,"191",254,0.8467,0.7733,0.8135,0.9324
"10595",214175,"MUHLENBERG COLLEGE",1,0,2003,"24730","58.209862","147","540","589",354,235,485,"179",306,0.8644,0.7617,0.8234,0.9168
"10596",214175,"MUHLENBERG COLLEGE",1,0,2004,"26570","58.13161","150","510","559",337,222,456,"178",278,0.8249,0.8018,0.8157,0.9123
"10597",214175,"Muhlenberg College",1,0,2005,"28550","63.959811","154","538","576",322,254,454,"180",274,0.8509,0.7087,0.7882,0.934
"10598",214175,"Muhlenberg College",1,0,2006,"30490","67.307436","164","558","615",376,239,503,"185",318,0.8457,0.7741,0.8179,0.9073
"10599",214175,"Muhlenberg College",1,0,2007,"32850","70.655105","165","504","551",304,247,445,"189",256,0.8421,0.7652,0.8076,0.9147
"10600",214175,"Muhlenberg College",1,0,2008,"35125","75.626593","172","542","597",344,253,484,"197",287,0.8343,0.7787,0.8107,0.9079
"10601",214175,"Muhlenberg College",1,0,2009,"36730","76.921265","167","522","576",337,239,475,"187",288,0.8546,0.7824,0.8247,0.9062
"10602",214175,"Muhlenberg College",1,0,2010,"38110","79.136147","171","504","603",341,262,485,"199",286,0.8387,0.7595,0.8043,0.8358
"10603",214272,"NEUMANN COLLEGE",1,0,1991,"8390","7.469778","41","79","84",58,26,30,"5",25,0.431,0.1923,0.3571,0.9405
"10604",214272,"NEUMANN COLLEGE",1,0,1992,"9166","8.24009","47","59","63",47,16,29,"8",21,0.4468,0.5,0.4603,0.9365
"10605",214272,"NEUMANN COLLEGE",1,0,1993,"10150","8.764541","44","82","84",64,20,33,"7",26,0.4062,0.35,0.3929,0.9762
"10606",214272,"NEUMANN COLLEGE",1,0,1995,"11090","10.920075","47","147","159",114,45,15,"5",10,0.0877,0.1111,0.0943,0.9245
"10607",214272,"NEUMANN COLLEGE",1,0,1996,"12140","12.028817","49","104","114",82,32,41,"11",30,0.3659,0.3438,0.3596,0.9123
"10608",214272,"NEUMANN COLLEGE",1,0,1997,"12400","11.400333","50","121","187",126,61,59,"15",44,0.3492,0.2459,0.3155,0.6471
"10609",214272,"NEUMANN COLLEGE",1,0,1998,"13520","13.53263","50","244","314",206,108,131,"42",89,0.432,0.3889,0.4172,0.7771
"10610",214272,"NEUMANN COLLEGE",1,0,1999,"13350","16.710296","52","267","324",179,145,108,"38",70,0.3911,0.2621,0.3333,0.8241
"10611",214272,"NEUMANN COLLEGE",1,0,2000,"13750","17.267767","53.5","241","299",164,135,87,"34",53,0.3232,0.2519,0.291,0.806
"10612",214272,"NEUMANN COLLEGE",1,0,2001,"14460","19.238588","55","265","345",217,128,115,"25",90,0.4147,0.1953,0.3333,0.7681
"10613",214272,"NEUMANN COLLEGE",1,0,2002,"15060","21.901107","67","286","363",228,135,114,"25",89,0.3904,0.1852,0.314,0.7879
"10614",214272,"NEUMANN COLLEGE",1,0,2003,"15820","25.080338","72","402","510",327,183,209,"72",137,0.419,0.3934,0.4098,0.7882
"10615",214272,"NEUMANN COLLEGE",1,0,2004,"16590","28.609407","78","322","462",304,158,135,"41",94,0.3092,0.2595,0.2922,0.697
"10616",214272,"Neumann College",1,0,2005,"17300","31.551793","84","306","522",334,188,163,"46",117,0.3503,0.2447,0.3123,0.5862
"10617",214272,"Neumann College",1,0,2006,"17992","33.965564","85","345","544",325,219,160,"46",114,0.3508,0.21,0.2941,0.6342
"10618",214272,"Neumann College",1,0,2007,"18846","36.420208","90","344","540",336,204,157,"44",113,0.3363,0.2157,0.2907,0.637
"10619",214272,"Neumann College",1,0,2008,"19742","37.988114","89","340","539",348,191,185,"51",134,0.3851,0.267,0.3432,0.6308
"10620",214272,"Neumann University",1,0,2009,"20290","40.284045","91","280","519",323,196,189,"57",132,0.4087,0.2908,0.3642,0.5395
"10621",214272,"Neumann University",1,0,2010,"21456","45.120682","93","261","547",350,197,166,"48",118,0.3371,0.2437,0.3035,0.4771
"10622",214777,"PENNSYLVANIA STATE UNIVERSITY MAIN CAMPUS",1,0,1991,"4402","722.21635","1778","3203","3615",1712,1903,2808,"1417",1391,0.8125,0.7446,0.7768,0.886
"10623",214777,"PENNSYLVANIA STATE UNIVERSITY MAIN CAMPUS",1,0,1992,"4618","739.09937","1796","3636","4227",1995,2232,2529,"1163",1366,0.6847,0.5211,0.5983,0.8602
"10624",214777,"PENNSYLVANIA STATE UNIVERSITY-MAIN CAMPUS",1,0,1993,"4822","755.887583","1799","3769","4265",2107,2158,1846,"741",1105,0.5244,0.3434,0.4328,0.8837
"10625",214777,"PENNSYLVANIA STATE UNIVERSITY-MAIN CAMPUS",1,0,1995,"5258","878.051085","1844","4656","5400",2712,2688,2410,"947",1463,0.5395,0.3523,0.4463,0.8622
"10626",214777,"PENNSYLVANIA STATE UNIVERSITY-MAIN CAMPUS",1,0,1996,"5624","923.50728","1836","3900","4701",2344,2357,2052,"837",1215,0.5183,0.3551,0.4365,0.8296
"10627",214777,"PENNSYLVANIA STATE UNIVERSITY-MAIN CAMPUS",1,0,1997,"5832","949.695076","1889","4384","5185",2686,2499,2497,"980",1517,0.5648,0.3922,0.4816,0.8455
"10628",214777,"PENNSYLVANIA STATE UNIVERSITY-MAIN CAMPUS",1,0,1998,"6092","950.616242","1934","4273","5117",2590,2527,2448,"959",1489,0.5749,0.3795,0.4784,0.8351
"10629",214777,"PENNSYLVANIA STATE UNIVERSITY-MAIN CAMPUS",1,0,1999,"6162","1055.2684","1983","4247","5058",2535,2523,2738,"1142",1596,0.6296,0.4526,0.5413,0.8397
"10630",214777,"PENNSYLVANIA STATE UNIVERSITY-MAIN CAMPUS",1,0,2000,"6546","1158.471601","2034","4666","5621",2866,2755,3127,"1277",1850,0.6455,0.4635,0.5563,0.8301
"10631",214777,"PENNSYLVANIA STATE UNIVERSITY-MAIN CAMPUS",1,0,2001,"7054","1253.997874","2085","5088","6146",2983,3163,3576,"1586",1990,0.6671,0.5014,0.5818,0.8279
"10632",214777,"PENNSYLVANIA STATE UNIVERSITY-MAIN CAMPUS",1,0,2002,"8008","2286.828","2125","4883","5935",2911,3024,3558,"1554",2004,0.6884,0.5139,0.5995,0.8227
"10633",214777,"PENNSYLVANIA STATE UNIVERSITY-MAIN CAMPUS",1,0,2003,"8796","2423.788","2181","4990","6035",3058,2977,3747,"1598",2149,0.7027,0.5368,0.6209,0.8268
"10634",214777,"PENNSYLVANIA STATE UNIVERSITY-MAIN CAMPUS",1,0,2004,"10408","2611.892","2201","4962","5905",2884,3021,3681,"1674",2007,0.6959,0.5541,0.6234,0.8403
"10635",214777,"Pennsylvania State University-Main Campus",1,0,2005,"11024","2802.159","2260","5455","6499",2976,3523,4096,"1969",2127,0.7147,0.5589,0.6303,0.8394
"10636",214777,"Pennsylvania State University-Penn State Main Campus",1,0,2006,"11646","2969.259","2283","6792","8016",3790,4226,5243,"2460",2783,0.7343,0.5821,0.6541,0.8473
"10637",214777,"Pennsylvania State University-Main Campus",1,0,2007,"12284","3103.787","2329","5328","6492",3121,3371,4191,"1943",2248,0.7203,0.5764,0.6456,0.8207
"10638",214777,"Pennsylvania State University-Main Campus",1,0,2008,"13014","3373.296","2377","5833","7241",3428,3813,4746,"2226",2520,0.7351,0.5838,0.6554,0.8056
"10639",214777,"Pennsylvania State University-Main Campus",1,0,2009,"13604","3627.649","2419","4878","6574",3217,3357,4226,"1910",2316,0.7199,0.569,0.6428,0.742
"10640",214777,"Pennsylvania State University-Main Campus",1,0,2010,"14412","3881.115","2435","5484","7321",3542,3779,4942,"2239",2703,0.7631,0.5925,0.675,0.7491
"10641",215062,"UNIVERSITY OF PENNSYLVANIA",1,0,1991,"15644","1230.674","1003","1414","2286",986,1300,1791,"981",810,0.8215,0.7546,0.7835,0.6185
"10642",215062,"UNIVERSITY OF PENNSYLVANIA",1,0,1992,"16838","1381.305","997","1374","2259",977,1282,1789,"972",817,0.8362,0.7582,0.7919,0.6082
"10643",215062,"UNIVERSITY OF PENNSYLVANIA",1,0,1993,"17838","1501.315","993","1453","2434",1086,1348,1923,"1008",915,0.8425,0.7478,0.7901,0.597
"10644",215062,"UNIVERSITY OF PENNSYLVANIA",1,0,1995,"19898","1803.529","989","1388","2349",1158,1191,1954,"952",1002,0.8653,0.7993,0.8318,0.5909
"10645",215062,"UNIVERSITY OF PENNSYLVANIA",1,0,1996,"21130","2247.785","949","1387","2307",1169,1138,1976,"924",1052,0.8999,0.812,0.8565,0.6012
"10646",215062,"UNIVERSITY OF PENNSYLVANIA",1,0,1997,"22250","2165.922","971","1369","2324",1132,1192,1928,"941",987,0.8719,0.7894,0.8296,0.5891
"10647",215062,"UNIVERSITY OF PENNSYLVANIA",1,0,1998,"23254","2629.389","970","1198","2301",1128,1173,1975,"969",1006,0.8918,0.8261,0.8583,0.5206
"10648",215062,"UNIVERSITY OF PENNSYLVANIA",1,0,1999,"21746","2959.95","979","1218","2402",1155,1247,2079,"1056",1023,0.8857,0.8468,0.8655,0.5071
"10649",215062,"UNIVERSITY OF PENNSYLVANIA",1,0,2000,"22682","3009.889","994.5","1224","2270",1125,1145,1986,"967",1019,0.9058,0.8445,0.8749,0.5392
"10650",215062,"UNIVERSITY OF PENNSYLVANIA",1,0,2001,"23998","3113.914","1010","1163","2316",1148,1168,2018,"997",1021,0.8894,0.8536,0.8713,0.5022
"10651",215062,"UNIVERSITY OF PENNSYLVANIA",1,0,2002,"25078","3310.93","1019","1201","2373",1183,1190,2096,"1030",1066,0.9011,0.8655,0.8833,0.5061
"10652",215062,"UNIVERSITY OF PENNSYLVANIA",1,0,2003,"26282","3562.752","1031","1211","2378",1221,1157,2082,"992",1090,0.8927,0.8574,0.8755,0.5093
"10653",215062,"UNIVERSITY OF PENNSYLVANIA",1,0,2004,"27544","3716.145","1055","1090","2359",1191,1168,2090,"999",1091,0.916,0.8553,0.886,0.4621
"10654",215062,"University of Pennsylvania",1,0,2005,"29030","3969.24","1051","1169","2479",1260,1219,2162,"1033",1129,0.896,0.8474,0.8721,0.4716
"10655",215062,"University of Pennsylvania",1,0,2006,"30598","4197.595","1065","1017","2334",1193,1141,2036,"952",1084,0.9086,0.8344,0.8723,0.4357
"10656",215062,"University of Pennsylvania",1,0,2007,"32160","4423.621","1081","1050","2342",1107,1235,2058,"1052",1006,0.9088,0.8518,0.8787,0.4483
"10657",215062,"University of Pennsylvania",1,0,2008,"33608","4730.825","1293","916","2392",1278,1114,2078,"943",1135,0.8881,0.8465,0.8687,0.3829
"10658",215062,"University of Pennsylvania",1,0,2009,"34868","5015.111","1297","870","2402",1232,1170,2091,"976",1115,0.905,0.8342,0.8705,0.3622
"10659",215062,"University of Pennsylvania",1,0,2010,"36208","5263.101","1257","1158","2363",1213,1150,1999,"917",1082,0.892,0.7974,0.846,0.4901
"10660",215743,"SAINT FRANCIS COLLEGE",1,0,1991,"9596","18.552249","57","265","279",144,135,97,"38",59,0.4097,0.2815,0.3477,0.9498
"10661",215743,"SAINT FRANCIS COLLEGE",1,0,1992,"10384","21.418054","62","287","297",145,152,121,"58",63,0.4345,0.3816,0.4074,0.9663
"10662",215743,"SAINT FRANCIS COLLEGE",1,0,1993,"10480","24.144336","66","266","285",136,149,115,"49",66,0.4853,0.3289,0.4035,0.9333
"10663",215743,"SAINT FRANCIS COLLEGE",1,0,1995,"11850","26.828385","74","320","334",145,189,135,"61",74,0.5103,0.3228,0.4042,0.9581
"10664",215743,"SAINT FRANCIS COLLEGE",1,0,1996,"12475","27.550852","74","311","346",205,141,95,"24",71,0.3463,0.1702,0.2746,0.8988
"10665",215743,"SAINT FRANCIS COLLEGE",1,0,1997,"13120","24.037755","76","314","354",200,154,79,"22",57,0.285,0.1429,0.2232,0.887
"10666",215743,"SAINT FRANCIS COLLEGE",1,0,1998,"13510","25.867437","78","298","335",182,153,90,"47",43,0.2363,0.3072,0.2687,0.8896
"10667",215743,"SAINT FRANCIS COLLEGE",1,0,1999,"14100","29.171375","81","285","333",215,118,147,"34",113,0.5256,0.2881,0.4414,0.8559
"10668",215743,"SAINT FRANCIS COLLEGE",1,0,2000,"15808","31.430208","83.5","263","355",210,145,159,"58",101,0.481,0.4,0.4479,0.7408
"10669",215743,"SAINT FRANCIS UNIVERSITY",1,0,2001,"16512","33.733029","86","272","342",187,155,163,"60",103,0.5508,0.3871,0.4766,0.7953
"10670",215743,"SAINT FRANCIS UNIVERSITY",1,0,2002,"17024","35.650547","90","224","281",154,127,122,"47",75,0.487,0.3701,0.4342,0.7972
"10671",215743,"SAINT FRANCIS UNIVERSITY",1,0,2003,"18292","39.67118","90","279","332",200,132,174,"63",111,0.555,0.4773,0.5241,0.8404
"10672",215743,"SAINT FRANCIS UNIVERSITY",1,0,2004,"19390","40.921724","87","271","321",198,123,175,"48",127,0.6414,0.3902,0.5452,0.8442
"10673",215743,"Saint Francis University",1,0,2005,"20360","40.439319","84","294","364",220,144,190,"59",131,0.5955,0.4097,0.522,0.8077
"10674",215743,"Saint Francis University",1,0,2006,"21174","40.724612","97","304","384",234,150,194,"66",128,0.547,0.44,0.5052,0.7917
"10675",215743,"Saint Francis University",1,0,2007,"22444","44.062132","99","356","403",258,145,230,"71",159,0.6163,0.4897,0.5707,0.8834
"10676",215743,"Saint Francis University",1,0,2008,"23790","48.156241","102","363","412",224,188,254,"99",155,0.692,0.5266,0.6165,0.8811
"10677",215743,"Saint Francis University",1,0,2009,"24504","52.097368","108","308","349",207,142,15,"3",12,0.058,0.0211,0.043,0.8825
"10678",215743,"Saint Francis University",1,0,2010,"25484","54.94286","113","353","429",258,171,243,"82",161,0.624,0.4795,0.5664,0.8228
"10679",215798,"SAINT VINCENT COLLEGE",1,0,1991,"8760","16.949047","61","214","228",118,110,129,"51",78,0.661,0.4636,0.5658,0.9386
"10680",215798,"SAINT VINCENT COLLEGE",1,0,1992,"9360","19.275711","59","260","267",152,115,148,"50",98,0.6447,0.4348,0.5543,0.9738
"10681",215798,"SAINT VINCENT COLLEGE",1,0,1993,"9900","20.48805","64","266","277",122,155,144,"74",70,0.5738,0.4774,0.5199,0.9603
"10682",215798,"SAINT VINCENT COLLEGE",1,0,1995,"11310","23.095907","60","247","260",129,131,161,"72",89,0.6899,0.5496,0.6192,0.95
"10683",215798,"SAINT VINCENT COLLEGE",1,0,1996,"12100","26.031017","60","259","271",136,135,168,"76",92,0.6765,0.563,0.6199,0.9557
"10684",215798,"SAINT VINCENT COLLEGE",1,0,1997,"13030","21.579042","59","264","272",129,143,159,"77",82,0.6357,0.5385,0.5846,0.9706
"10685",215798,"SAINT VINCENT COLLEGE",1,0,1998,"13780","22.87751","62","251","262",135,127,153,"73",80,0.5926,0.5748,0.584,0.958
"10686",215798,"SAINT VINCENT COLLEGE",1,0,1999,"14250","23.910802","65","251","272",138,134,162,"74",88,0.6377,0.5522,0.5956,0.9228
"10687",215798,"SAINT VINCENT COLLEGE",1,0,2000,"15531","25.099689","63","281","302",141,161,192,"99",93,0.6596,0.6149,0.6358,0.9305
"10688",215798,"SAINT VINCENT COLLEGE",1,0,2001,"16585","26.608151","61","241","262",128,134,161,"69",92,0.7188,0.5149,0.6145,0.9198
"10689",215798,"SAINT VINCENT COLLEGE",1,0,2002,"18080","27.310393","67","296","322",159,163,209,"102",107,0.673,0.6258,0.6491,0.9193
"10690",215798,"SAINT VINCENT COLLEGE",1,0,2003,"19000","30.906395","72","345","362",196,166,221,"91",130,0.6633,0.5482,0.6105,0.953
"10691",215798,"SAINT VINCENT COLLEGE",1,0,2004,"20312","37.549667","76","282","331",186,145,226,"93",133,0.7151,0.6414,0.6828,0.852
"10692",215798,"Saint Vincent College",1,0,2005,"21104","35.193908","84","430","481",254,227,308,"141",167,0.6575,0.6211,0.6403,0.894
"10693",215798,"Saint Vincent College",1,0,2006,"22350","38.779591","86","401","437",217,220,272,"133",139,0.6406,0.6045,0.6224,0.9176
"10694",215798,"Saint Vincent College",1,0,2007,"23459","42.204082","92","389","423",200,223,269,"130",139,0.695,0.583,0.6359,0.9196
"10695",215798,"Saint Vincent College",1,0,2008,"24620","45.967819","99","386","442",195,247,302,"167",135,0.6923,0.6761,0.6833,0.8733
"10696",215798,"Saint Vincent College",1,0,2009,"25350","48.147979","104","388","446",197,249,267,"125",142,0.7208,0.502,0.5987,0.87
"10697",215798,"Saint Vincent College",1,0,2010,"26350","48.865509","101","372","422",202,220,261,"113",148,0.7327,0.5136,0.6185,0.8815
"10698",215929,"UNIVERSITY OF SCRANTON",1,0,1991,"9530","60.182045","241","840","897",457,440,646,"294",352,0.7702,0.6682,0.7202,0.9365
"10699",215929,"UNIVERSITY OF SCRANTON",1,0,1992,"9920","72.641744","241","814","898",495,403,605,"262",343,0.6929,0.6501,0.6737,0.9065
"10700",215929,"UNIVERSITY OF SCRANTON",1,0,1993,"10820","70.234313","242","812","899",496,403,582,"239",343,0.6915,0.5931,0.6474,0.9032
"10701",215929,"UNIVERSITY OF SCRANTON",1,0,1995,"12570","81.591828","244","830","907",515,392,590,"261",329,0.6388,0.6658,0.6505,0.9151
"10702",215929,"UNIVERSITY OF SCRANTON",1,0,1996,"15000","85.780481","244","869","948",550,398,623,"254",369,0.6709,0.6382,0.6572,0.9167
"10703",215929,"UNIVERSITY OF SCRANTON",1,0,1997,"15880","73.285108","244","820","905",538,367,644,"247",397,0.7379,0.673,0.7116,0.9061
"10704",215929,"UNIVERSITY OF SCRANTON",1,0,1998,"16820","76.170671","246","804","873",527,346,607,"217",390,0.74,0.6272,0.6953,0.921
"10705",215929,"UNIVERSITY OF SCRANTON",1,0,1999,"17540","79.23623","243","876","958",550,408,675,"268",407,0.74,0.6569,0.7046,0.9144
"10706",215929,"UNIVERSITY OF SCRANTON",1,0,2000,"18460","84.609262","243.5","717","833",472,361,625,"259",366,0.7754,0.7175,0.7503,0.8607
"10707",215929,"UNIVERSITY OF SCRANTON",1,0,2001,"19330","87.714563","244","853","1013",578,435,674,"258",416,0.7197,0.5931,0.6654,0.8421
"10708",215929,"UNIVERSITY OF SCRANTON",1,0,2002,"20248","90.966793","243","795","958",569,389,702,"258",444,0.7803,0.6632,0.7328,0.8299
"10709",215929,"UNIVERSITY OF SCRANTON",1,0,2003,"21208","92.959015","247","832","974",538,436,716,"307",409,0.7602,0.7041,0.7351,0.8542
"10710",215929,"UNIVERSITY OF SCRANTON",1,0,2004,"22214","95.670609","242","769","965",559,406,658,"248",410,0.7335,0.6108,0.6819,0.7969
"10711",215929,"University of Scranton",1,0,2005,"23750","99.715169","245","768","943",551,392,629,"248",381,0.6915,0.6327,0.667,0.8144
"10712",215929,"University of Scranton",1,0,2006,"25638","101.901873","244","802","980",585,395,740,"289",451,0.7709,0.7316,0.7551,0.8184
"10713",215929,"University of Scranton",1,0,2007,"28458","113.097865","253","822","1025",574,451,771,"307",464,0.8084,0.6807,0.7522,0.802
"10714",215929,"University of Scranton",1,0,2008,"31276","115.449791","253","828","961",555,406,710,"274",436,0.7856,0.6749,0.7388,0.8616
"10715",215929,"University of Scranton",1,0,2009,"32824","124.154565","263","852","1027",578,449,747,"296",451,0.7803,0.6592,0.7274,0.8296
"10716",215929,"University of Scranton",1,0,2010,"34236","128.111906","271","745","950",508,442,688,"291",397,0.7815,0.6584,0.7242,0.7842
"10717",216010,"SHIPPENSBURG UNIVERSITY OF PENNSYLVANIA",1,0,1991,"3108","53.135533","298","1070","1163",631,532,474,"153",321,0.5087,0.2876,0.4076,0.92
"10718",216010,"SHIPPENSBURG UNIVERSITY OF PENNSYLVANIA",1,0,1992,"3388","60.419789","288","1173","1238",675,563,441,"156",285,0.4222,0.2771,0.3562,0.9475
"10719",216010,"SHIPPENSBURG UNIVERSITY OF PENNSYLVANIA",1,0,1993,"3710","64.89107","292","1039","1114",603,511,443,"162",281,0.466,0.317,0.3977,0.9327
"10720",216010,"SHIPPENSBURG UNIVERSITY OF PENNSYLVANIA",1,0,1995,"4010","74.360696","299","1182","1278",665,613,497,"188",309,0.4647,0.3067,0.3889,0.9249
"10721",216010,"SHIPPENSBURG UNIVERSITY OF PENNSYLVANIA",1,0,1996,"4230","76.119379","294","1168","1272",674,598,455,"168",287,0.4258,0.2809,0.3577,0.9182
"10722",216010,"SHIPPENSBURG UNIVERSITY OF PENNSYLVANIA",1,0,1997,"4344","77.075813","296","1193","1292",741,551,476,"178",298,0.4022,0.323,0.3684,0.9234
"10723",216010,"SHIPPENSBURG UNIVERSITY OF PENNSYLVANIA",1,0,1998,"4346","79.181426","288","1095","1211",654,557,480,"181",299,0.4572,0.325,0.3964,0.9042
"10724",216010,"SHIPPENSBURG UNIVERSITY OF PENNSYLVANIA",1,0,1999,"3618","84.324982","295","1291","1377",734,643,574,"231",343,0.4673,0.3593,0.4168,0.9375
"10725",216010,"SHIPPENSBURG UNIVERSITY OF PENNSYLVANIA",1,0,2000,"3792","89.97313","296","1421","1520",831,689,679,"233",446,0.5367,0.3382,0.4467,0.9349
"10726",216010,"SHIPPENSBURG UNIVERSITY OF PENNSYLVANIA",1,0,2001,"4016","96.953861","297","1353","1478",805,673,683,"239",444,0.5516,0.3551,0.4621,0.9154
"10727",216010,"SHIPPENSBURG UNIVERSITY OF PENNSYLVANIA",1,0,2002,"4378","91.407073","307","1336","1507",831,676,721,"270",451,0.5427,0.3994,0.4784,0.8865
"10728",216010,"SHIPPENSBURG UNIVERSITY OF PENNSYLVANIA",1,0,2003,"4598","96.901779","307","1292","1485",742,743,666,"271",395,0.5323,0.3647,0.4485,0.87
"10729",216010,"SHIPPENSBURG UNIVERSITY OF PENNSYLVANIA",1,0,2004,"4810","99.540732","333","1241","1458",748,710,629,"251",378,0.5053,0.3535,0.4314,0.8512
"10730",216010,"Shippensburg University of Pennsylvania",1,0,2005,"4906","102.37051","305","1261","1495",775,720,622,"233",389,0.5019,0.3236,0.4161,0.8435
"10731",216010,"Shippensburg University of Pennsylvania",1,0,2006,"5038","106.145348","321","1252","1496",778,718,601,"215",386,0.4961,0.2994,0.4017,0.8369
"10732",216010,"Shippensburg University of Pennsylvania",1,0,2007,"5178","112.288253","316","1412","1720",927,793,639,"251",388,0.4186,0.3165,0.3715,0.8209
"10733",216010,"Shippensburg University of Pennsylvania",1,0,2008,"5358","117.172362","319","1388","1716",871,845,638,"247",391,0.4489,0.2923,0.3718,0.8089
"10734",216010,"Shippensburg University of Pennsylvania",1,0,2009,"5554","121.921591","320","1370","1673",873,800,669,"273",396,0.4536,0.3412,0.3999,0.8189
"10735",216010,"Shippensburg University of Pennsylvania",1,0,2010,"5804","126.398882","328","1466","1706",888,818,693,"275",418,0.4707,0.3362,0.4062,0.8593
"10736",216038,"SLIPPERY ROCK UNIVERSITY OF PENNSYLVANIA",1,0,1991,"3045","66.048384","367","1100","1191",690,501,232,"76",156,0.2261,0.1517,0.1948,0.9236
"10737",216038,"SLIPPERY ROCK UNIVERSITY OF PENNSYLVANIA",1,0,1992,"3287","73.297245","380","1060","1164",658,506,242,"95",147,0.2234,0.1877,0.2079,0.9107
"10738",216038,"SLIPPERY ROCK UNIVERSITY OF PENNSYLVANIA",1,0,1993,"3547","75.057293","380","1110","1239",739,500,247,"77",170,0.23,0.154,0.1994,0.8959
"10739",216038,"SLIPPERY ROCK UNIVERSITY OF PENNSYLVANIA",1,0,1995,"4013","82.425817","379","1174","1279",715,564,254,"82",172,0.2406,0.1454,0.1986,0.9179
"10740",216038,"SLIPPERY ROCK UNIVERSITY OF PENNSYLVANIA",1,0,1996,"4179","85.001917","371","1079","1197",677,520,247,"85",162,0.2393,0.1635,0.2063,0.9014
"10741",216038,"SLIPPERY ROCK UNIVERSITY OF PENNSYLVANIA",1,0,1997,"4302","82.087382","371","1118","1193",684,509,248,"76",172,0.2515,0.1493,0.2079,0.9371
"10742",216038,"SLIPPERY ROCK UNIVERSITY OF PENNSYLVANIA",1,0,1998,"4311","84.223454","362","1189","1260",713,547,297,"95",202,0.2833,0.1737,0.2357,0.9437
"10743",216038,"SLIPPERY ROCK UNIVERSITY OF PENNSYLVANIA",1,0,1999,"3618","88.61933","349","1206","1302",742,560,334,"103",231,0.3113,0.1839,0.2565,0.9263
"10744",216038,"SLIPPERY ROCK UNIVERSITY OF PENNSYLVANIA",1,0,2000,"3792","90.731302","353.5","1229","1346",794,552,372,"105",267,0.3363,0.1902,0.2764,0.9131
"10745",216038,"SLIPPERY ROCK UNIVERSITY OF PENNSYLVANIA",1,0,2001,"4016","97.426983","358","1200","1314",751,563,378,"117",261,0.3475,0.2078,0.2877,0.9132
"10746",216038,"SLIPPERY ROCK UNIVERSITY OF PENNSYLVANIA",1,0,2002,"4378","92.95107","335","1273","1421",796,625,416,"139",277,0.348,0.2224,0.2928,0.8958
"10747",216038,"SLIPPERY ROCK UNIVERSITY OF PENNSYLVANIA",1,0,2003,"4598","102.479231","342","1311","1465",803,662,455,"158",297,0.3699,0.2387,0.3106,0.8949
"10748",216038,"SLIPPERY ROCK UNIVERSITY OF PENNSYLVANIA",1,0,2004,"4810","107.944947","340","1383","1530",890,640,551,"196",355,0.3989,0.3062,0.3601,0.9039
"10749",216038,"Slippery Rock University of Pennsylvania",1,0,2005,"4906","106.886506","340","1315","1457",800,657,556,"216",340,0.425,0.3288,0.3816,0.9025
"10750",216038,"Slippery Rock University of Pennsylvania",1,0,2006,"5038","108.752222","333","1228","1416",832,584,545,"185",360,0.4327,0.3168,0.3849,0.8672
"10751",216038,"Slippery Rock University of Pennsylvania",1,0,2007,"5178","119.727887","340","1272","1498",876,622,596,"185",411,0.4692,0.2974,0.3979,0.8491
"10752",216038,"Slippery Rock University of Pennsylvania",1,0,2008,"5358","124.462231","343","1262","1527",887,640,749,"272",477,0.5378,0.425,0.4905,0.8265
"10753",216038,"Slippery Rock University of Pennsylvania",1,0,2009,"5554","133.283479","352","1312","1534",915,619,795,"258",537,0.5869,0.4168,0.5183,0.8553
"10754",216038,"Slippery Rock University of Pennsylvania",1,0,2010,"5804","134.973824","354","1378","1562",969,593,808,"265",543,0.5604,0.4469,0.5173,0.8822
"10755",216287,"SWARTHMORE COLLEGE",1,0,1991,"16640","53.413154","155","247","319",148,171,266,"138",128,0.8649,0.807,0.8339,0.7743
"10756",216287,"SWARTHMORE COLLEGE",1,0,1992,"17646","62.067407","154","255","353",172,181,285,"143",142,0.8256,0.7901,0.8074,0.7224
"10757",216287,"SWARTHMORE COLLEGE",1,0,1993,"18482","57.840585","162","289","413",226,187,348,"149",199,0.8805,0.7968,0.8426,0.6998
"10758",216287,"SWARTHMORE COLLEGE",1,0,1995,"20186","66.457262","161","266","354",190,164,308,"134",174,0.9158,0.8171,0.8701,0.7514
"10759",216287,"SWARTHMORE COLLEGE",1,0,1996,"21054","70.672","157","243","412",217,195,354,"167",187,0.8618,0.8564,0.8592,0.5898
"10760",216287,"SWARTHMORE COLLEGE",1,0,1997,"22000","64.948","167","232","373",193,180,309,"136",173,0.8964,0.7556,0.8284,0.622
"10761",216287,"SWARTHMORE COLLEGE",1,0,1998,"23240","69.808","173","210","361",193,168,297,"132",165,0.8549,0.7857,0.8227,0.5817
"10762",216287,"SWARTHMORE COLLEGE",1,0,1999,"23964","73.137","174","222","368",192,176,315,"142",173,0.901,0.8068,0.856,0.6033
"10763",216287,"SWARTHMORE COLLEGE",1,0,2000,"24950","80.011","170.5","227","366",195,171,316,"141",175,0.8974,0.8246,0.8634,0.6202
"10764",216287,"SWARTHMORE COLLEGE",1,0,2001,"26098","87.885","167","218","380",193,187,346,"165",181,0.9378,0.8824,0.9105,0.5737
"10765",216287,"SWARTHMORE COLLEGE",1,0,2002,"27272","91.373","173","197","371",189,182,326,"155",171,0.9048,0.8516,0.8787,0.531
"10766",216287,"SWARTHMORE COLLEGE",1,0,2003,"28500","97.794","195","173","368",198,170,316,"141",175,0.8838,0.8294,0.8587,0.4701
"10767",216287,"SWARTHMORE COLLEGE",1,0,2004,"29782","99.861","192","151","365",189,176,324,"153",171,0.9048,0.8693,0.8877,0.4137
"10768",216287,"Swarthmore College",1,0,2005,"31196","100.219","194","170","389",198,191,355,"171",184,0.9293,0.8953,0.9126,0.437
"10769",216287,"Swarthmore College",1,0,2006,"32912","106.41","192","166","370",193,177,318,"143",175,0.9067,0.8079,0.8595,0.4486
"10770",216287,"Swarthmore College",1,0,2007,"34564","114.661","202","162","365",190,175,324,"152",172,0.9053,0.8686,0.8877,0.4438
"10771",216287,"Swarthmore College",1,0,2008,"36154","118.204","193","163","372",184,188,330,"159",171,0.9293,0.8457,0.8871,0.4382
"10772",216287,"Swarthmore College",1,0,2009,"37510","121.884","197","165","394",204,190,343,"159",184,0.902,0.8368,0.8706,0.4188
"10773",216287,"Swarthmore College",1,0,2010,"39260","118.902","189","183","387",195,192,339,"169",170,0.8718,0.8802,0.876,0.4729
"10774",216339,"TEMPLE UNIVERSITY",1,0,1991,"4756","634.387943","1130","1252","2084",1071,1013,287,"115",172,0.1606,0.1135,0.1377,0.6008
"10775",216339,"TEMPLE UNIVERSITY",1,0,1992,"5008","702.863","1156","1130","2029",1068,961,337,"124",213,0.1994,0.129,0.1661,0.5569
"10776",216339,"TEMPLE UNIVERSITY",1,0,1993,"5226","755.045","1147","1263","2186",1209,977,355,"141",214,0.177,0.1443,0.1624,0.5778
"10777",216339,"TEMPLE UNIVERSITY",1,0,1995,"5514","889.436","1119","1090","2302",1366,936,440,"143",297,0.2174,0.1528,0.1911,0.4735
"10778",216339,"TEMPLE UNIVERSITY",1,0,1996,"5828","1002.468","1119","1001","2155",1284,871,442,"138",304,0.2368,0.1584,0.2051,0.4645
"10779",216339,"TEMPLE UNIVERSITY",1,0,1997,"6150","1023.207","1090","1016","2149",1233,916,503,"176",327,0.2652,0.1921,0.2341,0.4728
"10780",216339,"TEMPLE UNIVERSITY",1,0,1998,"6378","1152.533","1071","1077","2150",1279,871,521,"171",350,0.2737,0.1963,0.2423,0.5009
"10781",216339,"TEMPLE UNIVERSITY",1,0,1999,"6332","1284.62","1066","1396","2747",1628,1119,721,"228",493,0.3028,0.2038,0.2625,0.5082
"10782",216339,"TEMPLE UNIVERSITY",1,0,2000,"6648","1430.454","1114","1536","3031",1767,1264,857,"318",539,0.305,0.2516,0.2827,0.5068
"10783",216339,"TEMPLE UNIVERSITY",1,0,2001,"6974","1429.655","1162","1694","3157",1826,1331,919,"319",600,0.3286,0.2397,0.2911,0.5366
"10784",216339,"TEMPLE UNIVERSITY",1,0,2002,"7602","1569.486","1196","2075","3467",2034,1433,1170,"394",776,0.3815,0.2749,0.3375,0.5985
"10785",216339,"TEMPLE UNIVERSITY",1,0,2003,"8134","1517.236","1220","2203","3590",2106,1484,1232,"459",773,0.367,0.3093,0.3432,0.6136
"10786",216339,"TEMPLE UNIVERSITY",1,0,2004,"8622","1645.339","1207","2290","3788",2184,1604,1216,"468",748,0.3425,0.2918,0.321,0.6045
"10787",216339,"Temple University",1,0,2005,"9140","1735.249","1225","2295","3841",2175,1666,1247,"483",764,0.3513,0.2899,0.3247,0.5975
"10788",216339,"Temple University",1,0,2006,"9680","1805.842","1245","2224","3848",2105,1743,1377,"578",799,0.3796,0.3316,0.3578,0.578
"10789",216339,"Temple University",1,0,2007,"10252","1804.521","1303","2607","4385",2478,1907,1705,"684",1021,0.412,0.3587,0.3888,0.5945
"10790",216339,"Temple University",1,0,2008,"10858","1984.796","1383","2511","4157",2260,1897,1718,"663",1055,0.4668,0.3495,0.4133,0.604
"10791",216339,"Temple University",1,0,2009,"11174","2072.166","1427","2575","4183",2320,1863,1808,"687",1121,0.4832,0.3688,0.4322,0.6156
"10792",216339,"Temple University",1,0,2010,"11834","2069.216","1462","2770","4305",2273,2032,1920,"783",1137,0.5002,0.3853,0.446,0.6434
"10793",216524,"URSINUS COLLEGE",1,0,1991,"12555","24.136108","89","205","234",124,110,155,"69",86,0.6935,0.6273,0.6624,0.8761
"10794",216524,"URSINUS COLLEGE",1,0,1992,"13330","24.709435","87","363","403",199,204,285,"131",154,0.7739,0.6422,0.7072,0.9007
"10795",216524,"URSINUS COLLEGE",1,0,1993,"14265","28.911973","92","281","308",159,149,226,"108",118,0.7421,0.7248,0.7338,0.9123
"10796",216524,"URSINUS COLLEGE",1,0,1995,"15840","31.519613","85","270","315",170,145,230,"106",124,0.7294,0.731,0.7302,0.8571
"10797",216524,"URSINUS COLLEGE",1,0,1996,"16600","34.450349","84","281","327",180,147,244,"105",139,0.7722,0.7143,0.7462,0.8593
"10798",216524,"URSINUS COLLEGE",1,0,1997,"17380","26.800167","87","260","314",162,152,236,"117",119,0.7346,0.7697,0.7516,0.828
"10799",216524,"URSINUS COLLEGE",1,0,1998,"18520","27.503463","86","280","336",189,147,249,"93",156,0.8254,0.6327,0.7411,0.8333
"10800",216524,"URSINUS COLLEGE",1,0,1999,"19950","29.20252","92","271","337",173,164,241,"106",135,0.7803,0.6463,0.7151,0.8042
"10801",216524,"URSINUS COLLEGE",1,0,2000,"21050","31.53743","94","313","376",214,162,287,"112",175,0.8178,0.6914,0.7633,0.8324
"10802",216524,"URSINUS COLLEGE",1,0,2001,"24850","34.190312","96","314","387",230,157,278,"114",164,0.713,0.7261,0.7183,0.8114
"10803",216524,"URSINUS COLLEGE",1,0,2002,"26200","36.634605","102","348","427",212,215,301,"134",167,0.7877,0.6233,0.7049,0.815
"10804",216524,"URSINUS COLLEGE",1,0,2003,"27500","38.171257","110","338","453",233,220,356,"163",193,0.8283,0.7409,0.7859,0.7461
"10805",216524,"URSINUS COLLEGE",1,0,2004,"29650","41.136641","114","305","393",200,193,303,"142",161,0.805,0.7358,0.771,0.7761
"10806",216524,"Ursinus College",1,0,2005,"31450","45.448528","115","294","411",222,189,309,"136",173,0.7793,0.7196,0.7518,0.7153
"10807",216524,"Ursinus College",1,0,2006,"33200","49.844008","120","300","405",217,188,287,"126",161,0.7419,0.6702,0.7086,0.7407
"10808",216524,"Ursinus College",1,0,2007,"35000","49.947246","120","354","468",242,226,353,"159",194,0.8017,0.7035,0.7543,0.7564
"10809",216524,"Ursinus College",1,0,2008,"36750","52.65444","122","376","543",304,239,428,"181",247,0.8125,0.7573,0.7882,0.6924
"10810",216524,"Ursinus College",1,0,2009,"38500","56.217555","125","406","509",260,249,379,"178",201,0.7731,0.7149,0.7446,0.7976
"10811",216524,"Ursinus College",1,0,2010,"39950","59.064241","127","332","441",236,205,323,"144",179,0.7585,0.7024,0.7324,0.7528
"10812",216694,"WAYNESBURG COLLEGE",1,0,1991,"7690","13.73906","64","294","317",185,132,112,"33",79,0.427,0.25,0.3533,0.9274
"10813",216694,"WAYNESBURG COLLEGE",1,0,1992,"8120","15.78179","67","333","346",178,168,158,"65",93,0.5225,0.3869,0.4566,0.9624
"10814",216694,"WAYNESBURG COLLEGE",1,0,1993,"8580","16.988336","67","293","325",180,145,132,"51",81,0.45,0.3517,0.4062,0.9015
"10815",216694,"WAYNESBURG COLLEGE",1,0,1995,"9600","19.135073","65","275","295",141,154,109,"46",63,0.4468,0.2987,0.3695,0.9322
"10816",216694,"WAYNESBURG COLLEGE",1,0,1996,"10040","19.64793","58","287","305",134,171,138,"59",79,0.5896,0.345,0.4525,0.941
"10817",216694,"WAYNESBURG COLLEGE",1,0,1997,"10550","18.393652","53","281","309",123,186,132,"72",60,0.4878,0.3871,0.4272,0.9094
"10818",216694,"WAYNESBURG COLLEGE",1,0,1998,"10970","15.0777","55","258","290",113,177,116,"60",56,0.4956,0.339,0.4,0.8897
"10819",216694,"WAYNESBURG COLLEGE",1,0,1999,"11160","16.0228","55","251","277",126,151,121,"64",57,0.4524,0.4238,0.4368,0.9061
"10820",216694,"WAYNESBURG COLLEGE",1,0,2000,"11670","22.511487","57","314","328",160,168,146,"57",89,0.5562,0.3393,0.4451,0.9573
"10821",216694,"WAYNESBURG COLLEGE",1,0,2001,"12250","26.092385","59","292","315",159,156,141,"56",85,0.5346,0.359,0.4476,0.927
"10822",216694,"WAYNESBURG COLLEGE",1,0,2002,"12870","26.904427","62","274","297",141,156,142,"50",92,0.6525,0.3205,0.4781,0.9226
"10823",216694,"WAYNESBURG COLLEGE",1,0,2003,"13520","25.131989","61","308","327",157,170,157,"70",87,0.5541,0.4118,0.4801,0.9419
"10824",216694,"WAYNESBURG COLLEGE",1,0,2004,"14200","25.324906","63","330","367",189,178,175,"70",105,0.5556,0.3933,0.4768,0.8992
"10825",216694,"Waynesburg College",1,0,2005,"14810","28.719771","62","294","340",208,132,171,"58",113,0.5433,0.4394,0.5029,0.8647
"10826",216694,"Waynesburg College",1,0,2006,"15440","31.686875","63","287","322",172,150,174,"69",105,0.6105,0.46,0.5404,0.8913
"10827",216694,"Waynesburg University",1,0,2007,"16080","29.161731","65","374","402",232,170,182,"67",115,0.4957,0.3941,0.4527,0.9303
"10828",216694,"Waynesburg University",1,0,2008,"16730","34.150351","67","351","376",218,158,195,"76",119,0.5459,0.481,0.5186,0.9335
"10829",216694,"Waynesburg University",1,0,2009,"17400","35.857288","72","353","380",221,159,211,"77",134,0.6063,0.4843,0.5553,0.9289
"10830",216694,"Waynesburg University",1,0,2010,"18050","37.628709","76","371","401",229,172,213,"77",136,0.5939,0.4477,0.5312,0.9252
"10831",216764,"WEST CHESTER UNIVERSITY OF PENNSYLVANIA",1,0,1991,"2918","88.423919","491","1275","1467",960,507,337,"79",258,0.2688,0.1558,0.2297,0.8691
"10832",216764,"WEST CHESTER UNIVERSITY OF PENNSYLVANIA",1,0,1992,"3158","93.833781","495","1209","1378",883,495,357,"90",267,0.3024,0.1818,0.2591,0.8774
"10833",216764,"WEST CHESTER UNIVERSITY OF PENNSYLVANIA",1,0,1993,"3504","93.637","483","1170","1386",876,510,346,"74",272,0.3105,0.1451,0.2496,0.8442
"10834",216764,"WEST CHESTER UNIVERSITY OF PENNSYLVANIA",1,0,1995,"3874","104.995468","478","1180","1384",873,511,363,"85",278,0.3184,0.1663,0.2623,0.8526
"10835",216764,"WEST CHESTER UNIVERSITY OF PENNSYLVANIA",1,0,1996,"4032","110.806218","464","1223","1454",943,511,376,"88",288,0.3054,0.1722,0.2586,0.8411
"10836",216764,"WEST CHESTER UNIVERSITY OF PENNSYLVANIA",1,0,1997,"4162","114.139198","463","1374","1581",1025,556,409,"93",316,0.3083,0.1673,0.2587,0.8691
"10837",216764,"WEST CHESTER UNIVERSITY OF PENNSYLVANIA",1,0,1998,"4248","121.217493","468","1418","1629",1031,598,474,"124",350,0.3395,0.2074,0.291,0.8705
"10838",216764,"WEST CHESTER UNIVERSITY OF PENNSYLVANIA",1,0,1999,"3618","126.574879","453","1513","1710",1069,641,444,"122",322,0.3012,0.1903,0.2596,0.8848
"10839",216764,"WEST CHESTER UNIVERSITY OF PENNSYLVANIA",1,0,2000,"3792","136.747116","467.5","1506","1715",1085,630,536,"127",409,0.377,0.2016,0.3125,0.8781
"10840",216764,"WEST CHESTER UNIVERSITY OF PENNSYLVANIA",1,0,2001,"4016","147.862401","482","1390","1626",1020,606,561,"144",417,0.4088,0.2376,0.345,0.8549
"10841",216764,"WEST CHESTER UNIVERSITY OF PENNSYLVANIA",1,0,2002,"4378","141.145952","537","1535","1766",1104,662,642,"168",474,0.4293,0.2538,0.3635,0.8692
"10842",216764,"WEST CHESTER UNIVERSITY OF PENNSYLVANIA",1,0,2003,"4598","149.15784","504","1441","1723",1119,604,685,"152",533,0.4763,0.2517,0.3976,0.8363
"10843",216764,"WEST CHESTER UNIVERSITY OF PENNSYLVANIA",1,0,2004,"4810","150.85294","512","1607","1870",1214,656,734,"177",557,0.4588,0.2698,0.3925,0.8594
"10844",216764,"West Chester University of Pennsylvania",1,0,2005,"4906","160.524294","527","1616","1898",1219,679,812,"216",596,0.4889,0.3181,0.4278,0.8514
"10845",216764,"West Chester University of Pennsylvania",1,0,2006,"5038","165.908418","520","1597","1883",1200,683,803,"196",607,0.5058,0.287,0.4264,0.8481
"10846",216764,"West Chester University of Pennsylvania",1,0,2007,"5177","176.98703","545","1655","1955",1215,740,857,"235",622,0.5119,0.3176,0.4384,0.8465
"10847",216764,"West Chester University of Pennsylvania",1,0,2008,"5358","190.342386","568","1644","1992",1231,761,872,"232",640,0.5199,0.3049,0.4378,0.8253
"10848",216764,"West Chester University of Pennsylvania",1,0,2009,"5554","196.108592","516","1908","2241",1353,888,954,"277",677,0.5004,0.3119,0.4257,0.8514
"10849",216764,"West Chester University of Pennsylvania",1,0,2010,"5804","204.87654","540","1643","2060",1295,765,946,"263",683,0.5274,0.3438,0.4592,0.7976
"10850",216807,"WESTMINSTER COLLEGE",1,0,1991,"10580","23.592705","92","312","319",175,144,223,"99",124,0.7086,0.6875,0.6991,0.9781
"10851",216807,"WESTMINSTER COLLEGE",1,0,1992,"11210","25.136586","91","350","362",213,149,227,"89",138,0.6479,0.5973,0.6271,0.9669
"10852",216807,"WESTMINSTER COLLEGE",1,0,1993,"11770","25.573738","93","362","375",216,159,250,"93",157,0.7269,0.5849,0.6667,0.9653
"10853",216807,"WESTMINSTER COLLEGE",1,0,1995,"13950","29.570364","100","364","376",230,146,250,"86",164,0.713,0.589,0.6649,0.9681
"10854",216807,"WESTMINSTER COLLEGE",1,0,1996,"14535","30.470646","98","293","304",176,128,208,"78",130,0.7386,0.6094,0.6842,0.9638
"10855",216807,"WESTMINSTER COLLEGE",1,0,1997,"14650","23.961079","97","383","394",239,155,259,"93",166,0.6946,0.6,0.6574,0.9721
"10856",216807,"WESTMINSTER COLLEGE",1,0,1998,"15510","24.075566","96","365","372",236,136,252,"79",173,0.7331,0.5809,0.6774,0.9812
"10857",216807,"WESTMINSTER COLLEGE",1,0,1999,"15485","23.521949","95","347","351",224,127,228,"69",159,0.7098,0.5433,0.6496,0.9886
"10858",216807,"WESTMINSTER COLLEGE",1,0,2000,"16180","24.955393","99","285","340",199,141,230,"87",143,0.7186,0.617,0.6765,0.8382
"10859",216807,"WESTMINSTER COLLEGE",1,0,2001,"16920","26.915112","103","286","375",219,156,224,"76",148,0.6758,0.4872,0.5973,0.7627
"10860",216807,"WESTMINSTER COLLEGE",1,0,2002,"18100","28.61816","101","272","350",235,115,208,"56",152,0.6468,0.487,0.5943,0.7771
"10861",216807,"WESTMINSTER COLLEGE",1,0,2003,"19370","29.09829","100","242","337",206,131,200,"61",139,0.6748,0.4656,0.5935,0.7181
"10862",216807,"WESTMINSTER COLLEGE",1,0,2004,"20530","31.027498","100","269","378",235,143,225,"72",153,0.6511,0.5035,0.5952,0.7116
"10863",216807,"Westminster College",1,0,2005,"21700","33.010016","103","301","360",231,129,223,"75",148,0.6407,0.5814,0.6194,0.8361
"10864",216807,"Westminster College",1,0,2006,"23220","33.954005","105","265","311",180,131,225,"87",138,0.7667,0.6641,0.7235,0.8521
"10865",216807,"Westminster College",1,0,2007,"24430","34.185046","104","258","311",179,132,195,"76",119,0.6648,0.5758,0.627,0.8296
"10866",216807,"Westminster College",1,0,2008,"25900","35.840087","101","381","441",246,195,313,"128",185,0.752,0.6564,0.7098,0.8639
"10867",216807,"Westminster College",1,0,2009,"26940","36.468606","110","377","451",277,174,313,"117",196,0.7076,0.6724,0.694,0.8359
"10868",216807,"Westminster College",1,0,2010,"28020","37.124562","109","341","402",248,154,274,"99",175,0.7056,0.6429,0.6816,0.8483
"10869",216852,"WIDENER UNIVERSITY PENNSYLVANIA CAMPUS",1,0,1991,"10500","76.026133","250","390","464",206,258,172,"81",91,0.4417,0.314,0.3707,0.8405
"10870",216852,"WIDENER UNIVERSITY PENNSYLVANIA CAMPUS",1,0,1992,"11120","79.529468","211","369","436",169,267,140,"66",74,0.4379,0.2472,0.3211,0.8463
"10871",216852,"WIDENER UNIVERSITY-MAIN CAMPUS",1,0,1993,"11740","84.200944","216","375","473",215,258,182,"79",103,0.4791,0.3062,0.3848,0.7928
"10872",216852,"WIDENER UNIVERSITY-MAIN CAMPUS",1,0,1995,"12950","95.190811","215","361","421",175,246,141,"64",77,0.44,0.2602,0.3349,0.8575
"10873",216852,"WIDENER UNIVERSITY-MAIN CAMPUS",1,0,1996,"13560","101.795243","218","365","462",217,245,172,"73",99,0.4562,0.298,0.3723,0.79
"10874",216852,"WIDENER UNIVERSITY-MAIN CAMPUS",1,0,1997,"14380","83.206112","218","318","391",174,217,145,"65",80,0.4598,0.2995,0.3708,0.8133
"10875",216852,"WIDENER UNIVERSITY-MAIN CAMPUS",1,0,1998,"15750","83.82089","219","427","490",207,283,204,"111",93,0.4493,0.3922,0.4163,0.8714
"10876",216852,"WIDENER UNIVERSITY-MAIN CAMPUS",1,0,1999,"16750","85.335764","220","460","548",250,298,213,"100",113,0.452,0.3356,0.3887,0.8394
"10877",216852,"WIDENER UNIVERSITY-MAIN CAMPUS",1,0,2000,"17950","89.009799","219","466","534",231,303,218,"96",122,0.5281,0.3168,0.4082,0.8727
"10878",216852,"WIDENER UNIVERSITY-MAIN CAMPUS",1,0,2001,"19300","90.564624","218","410","550",227,323,188,"78",110,0.4846,0.2415,0.3418,0.7455
"10879",216852,"WIDENER UNIVERSITY-MAIN CAMPUS",1,0,2002,"20450","95.723664","219","538","716",327,389,284,"119",165,0.5046,0.3059,0.3966,0.7514
"10880",216852,"WIDENER UNIVERSITY-MAIN CAMPUS",1,0,2003,"21400","101.649501","219","445","578",286,292,237,"90",147,0.514,0.3082,0.41,0.7699
"10881",216852,"WIDENER UNIVERSITY-MAIN CAMPUS",1,0,2004,"22800","108.830084","244","527","736",342,394,247,"97",150,0.4386,0.2462,0.3356,0.716
"10882",216852,"Widener University-Main Campus",1,0,2005,"24620","117.082366","248","449","646",332,314,258,"98",160,0.4819,0.3121,0.3994,0.695
"10883",216852,"Widener University-Main Campus",1,0,2006,"26350","124.303931","253","466","740",354,386,317,"135",182,0.5141,0.3497,0.4284,0.6297
"10884",216852,"Widener University-Main Campus",1,0,2007,"28180","129.447407","219","575","782",382,400,312,"133",179,0.4686,0.3325,0.399,0.7353
"10885",216852,"Widener University-Main Campus",1,0,2008,"29990","136.632097","220","547","718",337,381,266,"121",145,0.4303,0.3176,0.3705,0.7618
"10886",216852,"Widener University-Main Campus",1,0,2009,"31340","140.776582","226","505","710",372,338,304,"127",177,0.4758,0.3757,0.4282,0.7113
"10887",216852,"Widener University-Main Campus",1,0,2010,"32750","145.407277","228","512","718",371,347,298,"116",182,0.4906,0.3343,0.415,0.7131
"10888",216931,"WILKES UNIVERSITY",1,0,1991,"9275","33.077967","149","378","395",170,225,154,"71",83,0.4882,0.3156,0.3899,0.957
"10889",216931,"WILKES UNIVERSITY",1,0,1992,"9868","35.054347","140","383","404",164,240,153,"73",80,0.4878,0.3042,0.3787,0.948
"10890",216931,"WILKES UNIVERSITY",1,0,1993,"10898","35.4172","138","412","434",198,236,177,"85",92,0.4646,0.3602,0.4078,0.9493
"10891",216931,"WILKES UNIVERSITY",1,0,1995,"12473","41.399343","134","352","369",167,202,118,"60",58,0.3473,0.297,0.3198,0.9539
"10892",216931,"WILKES UNIVERSITY",1,0,1996,"13147","42.714374","134","415","448",181,267,154,"83",71,0.3923,0.3109,0.3438,0.9263
"10893",216931,"WILKES UNIVERSITY",1,0,1997,"15091","34.680206","125","331","355",168,187,161,"72",89,0.5298,0.385,0.4535,0.9324
"10894",216931,"WILKES UNIVERSITY",1,0,1998,"15702","32.429461","116","353","376",160,216,148,"70",78,0.4875,0.3241,0.3936,0.9388
"10895",216931,"WILKES UNIVERSITY",1,0,1999,"15652","34.098262","114","364","377",161,216,166,"88",78,0.4845,0.4074,0.4403,0.9655
"10896",216931,"WILKES UNIVERSITY",1,0,2000,"16388","33.500828","110","439","460",196,264,194,"93",101,0.5153,0.3523,0.4217,0.9543
"10897",216931,"WILKES UNIVERSITY",1,0,2001,"17142","36.304106","106","381","407",198,209,198,"99",99,0.5,0.4737,0.4865,0.9361
"10898",216931,"WILKES UNIVERSITY",1,0,2002,"17956","41.717851","106","444","471",239,232,224,"101",123,0.5146,0.4353,0.4756,0.9427
"10899",216931,"WILKES UNIVERSITY",1,0,2003,"18680","43.420688","112","481","509",235,274,254,"107",147,0.6255,0.3905,0.499,0.945
"10900",216931,"WILKES UNIVERSITY",1,0,2004,"19428","47.491483","120","507","550",296,254,287,"128",159,0.5372,0.5039,0.5218,0.9218
"10901",216931,"Wilkes University",1,0,2005,"20592","51.313287","131","501","562",297,265,270,"114",156,0.5253,0.4302,0.4804,0.8915
"10902",216931,"Wilkes University",1,0,2006,"21830","59.306549","133","510","570",285,285,279,"133",146,0.5123,0.4667,0.4895,0.8947
"10903",216931,"Wilkes University",1,0,2007,"22820","66.038321","136","530","620",299,321,291,"146",145,0.4849,0.4548,0.4694,0.8548
"10904",216931,"Wilkes University",1,0,2008,"23850","68.830161","146","443","559",290,269,249,"114",135,0.4655,0.4238,0.4454,0.7925
"10905",216931,"Wilkes University",1,0,2009,"24690","73.705994","148","437","527",243,284,250,"121",129,0.5309,0.4261,0.4744,0.8292
"10906",216931,"Wilkes University",1,0,2010,"25802","76.205741","157","337","499",249,250,240,"106",134,0.5382,0.424,0.481,0.6754
"10907",217059,"YORK COLLEGE PENNSYLVANIA",1,0,1991,"4380","19.522776","108","676","697",396,301,265,"88",177,0.447,0.2924,0.3802,0.9699
"10908",217059,"YORK COLLEGE PENNSYLVANIA",1,0,1992,"4645","21.867604","114","662","691",414,277,263,"87",176,0.4251,0.3141,0.3806,0.958
"10909",217059,"YORK COLLEGE PENNSYLVANIA",1,0,1993,"4995","23.689904","113","656","691",397,294,274,"102",172,0.4332,0.3469,0.3965,0.9493
"10910",217059,"YORK COLLEGE PENNSYLVANIA",1,0,1995,"5730","27.182783","115","819","851",483,368,350,"121",229,0.4741,0.3288,0.4113,0.9624
"10911",217059,"YORK COLLEGE PENNSYLVANIA",1,0,1996,"5790","28.902416","119","774","805",443,362,319,"122",197,0.4447,0.337,0.3963,0.9615
"10912",217059,"YORK COLLEGE PENNSYLVANIA",1,0,1997,"6100","28.571563","124","812","842",496,346,348,"128",220,0.4435,0.3699,0.4133,0.9644
"10913",217059,"YORK COLLEGE PENNSYLVANIA",1,0,1998,"6310","31.356988","128","809","853",462,391,370,"145",225,0.487,0.3708,0.4338,0.9484
"10914",217059,"YORK COLLEGE PENNSYLVANIA",1,0,1999,"6280","33.608423","130","880","909",511,398,372,"122",250,0.4892,0.3065,0.4092,0.9681
"10915",217059,"YORK COLLEGE PENNSYLVANIA",1,0,2000,"6600","36.088867","134","864","900",510,390,366,"129",237,0.4647,0.3308,0.4067,0.96
"10916",217059,"YORK COLLEGE PENNSYLVANIA",1,0,2001,"7000","38.865202","138","925","968",540,428,383,"137",246,0.4556,0.3201,0.3957,0.9556
"10917",217059,"YORK COLLEGE PENNSYLVANIA",1,0,2002,"7500","42.403985","134","878","921",521,400,373,"138",235,0.4511,0.345,0.405,0.9533
"10918",217059,"YORK COLLEGE PENNSYLVANIA",1,0,2003,"8000","45.162382","133","926","1013",541,472,425,"171",254,0.4695,0.3623,0.4195,0.9141
"10919",217059,"YORK COLLEGE PENNSYLVANIA",1,0,2004,"8600","49.6461","130","949","1037",612,425,423,"151",272,0.4444,0.3553,0.4079,0.9151
"10920",217059,"York College Pennsylvania",1,0,2005,"9350","53.216098","134","970","1078",591,487,442,"175",267,0.4518,0.3593,0.41,0.8998
"10921",217059,"York College Pennsylvania",1,0,2006,"10160","60.284253","145","945","1092",536,556,452,"207",245,0.4571,0.3723,0.4139,0.8654
"10922",217059,"York College Pennsylvania",1,0,2007,"11500","64.563289","147","1014","1177",597,580,437,"189",248,0.4154,0.3259,0.3713,0.8615
"10923",217059,"York College Pennsylvania",1,0,2008,"12320","74.610929","155","974","1097",580,517,427,"185",242,0.4172,0.3578,0.3892,0.8879
"10924",217059,"York College Pennsylvania",1,0,2009,"13000","78.16197","183","911","1092",595,497,431,"144",287,0.4824,0.2897,0.3947,0.8342
"10925",217059,"York College Pennsylvania",1,0,2010,"13640","86.066541","185","1053","1231",657,574,481,"182",299,0.4551,0.3171,0.3907,0.8554
"10926",217156,"BROWN UNIVERSITY",1,0,1991,"17224","244.332319","515","879","1358",658,700,1048,"543",505,0.7675,0.7757,0.7717,0.6473
"10927",217156,"BROWN UNIVERSITY",1,0,1992,"18392","254.995538","517","889","1406",711,695,1121,"553",568,0.7989,0.7957,0.7973,0.6323
"10928",217156,"BROWN UNIVERSITY",1,0,1993,"19556","270.950138","514","961","1424",770,654,1109,"494",615,0.7987,0.7554,0.7788,0.6749
"10929",217156,"BROWN UNIVERSITY",1,0,1995,"21727","303.676683","516","885","1370",739,631,1106,"492",614,0.8309,0.7797,0.8073,0.646
"10930",217156,"BROWN UNIVERSITY",1,0,1996,"22719","322.640712","531","960","1469",810,659,1220,"536",684,0.8444,0.8134,0.8305,0.6535
"10931",217156,"BROWN UNIVERSITY",1,0,1997,"23287","297.681","532","866","1368",722,646,1136,"527",609,0.8435,0.8158,0.8304,0.633
"10932",217156,"BROWN UNIVERSITY",1,0,1998,"23616","310.965","525","897","1417",772,645,1180,"520",660,0.8549,0.8062,0.8327,0.633
"10933",217156,"BROWN UNIVERSITY",1,0,1999,"24624","327.287","539","685","1376",729,647,1146,"539",607,0.8326,0.8331,0.8328,0.4978
"10934",217156,"BROWN UNIVERSITY",1,0,2000,"25600","353.497","567.5","667","1415",767,648,1177,"530",647,0.8435,0.8179,0.8318,0.4714
"10935",217156,"BROWN UNIVERSITY",1,0,2001,"26568","368.257","596","655","1375",760,615,1154,"506",648,0.8526,0.8228,0.8393,0.4764
"10936",217156,"BROWN UNIVERSITY",1,0,2002,"27856","401.232","621","777","1451",817,634,1213,"505",708,0.8666,0.7965,0.836,0.5355
"10937",217156,"BROWN UNIVERSITY",1,0,2003,"29200","443.342","657","719","1392",736,656,1192,"539",653,0.8872,0.8216,0.8563,0.5165
"10938",217156,"BROWN UNIVERSITY",1,0,2004,"30672","473.669","651","785","1429",744,685,1224,"580",644,0.8656,0.8467,0.8565,0.5493
"10939",217156,"Brown University",1,0,2005,"32264","523.444","643","742","1439",735,704,1197,"577",620,0.8435,0.8196,0.8318,0.5156
"10940",217156,"Brown University",1,0,2006,"33888","554.135","687","717","1464",740,724,1215,"590",625,0.8446,0.8149,0.8299,0.4898
"10941",217156,"Brown University",1,0,2007,"35584","570.838","714","687","1477",814,663,1246,"548",698,0.8575,0.8265,0.8436,0.4651
"10942",217156,"Brown University",1,0,2008,"36928","606.272","738","694","1546",813,733,1307,"612",695,0.8549,0.8349,0.8454,0.4489
"10943",217156,"Brown University",1,0,2009,"38048","636.547","728","728","1490",770,720,1238,"598",640,0.8312,0.8306,0.8309,0.4886
"10944",217156,"Brown University",1,0,2010,"39928","658.792","728","683","1495",784,711,1251,"599",652,0.8316,0.8425,0.8368,0.4569
"10945",217402,"PROVIDENCE COLLEGE",1,0,1991,"11840","69.026729","215","884","963",529,434,764,"330",434,0.8204,0.7604,0.7934,0.918
"10946",217402,"PROVIDENCE COLLEGE",1,0,1992,"12700","72.601303","221","837","931",523,408,734,"322",412,0.7878,0.7892,0.7884,0.899
"10947",217402,"PROVIDENCE COLLEGE",1,0,1993,"13625","74.275428","219","867","968",503,465,775,"368",407,0.8091,0.7914,0.8006,0.8957
"10948",217402,"PROVIDENCE COLLEGE",1,0,1995,"15380","84.029666","216","851","954",589,365,795,"297",498,0.8455,0.8137,0.8333,0.892
"10949",217402,"PROVIDENCE COLLEGE",1,0,1996,"15930","91.922549","216","826","938",556,382,786,"310",476,0.8561,0.8115,0.838,0.8806
"10950",217402,"PROVIDENCE COLLEGE",1,0,1997,"16480","72.150609","218","869","974",563,411,801,"326",475,0.8437,0.7932,0.8224,0.8922
"10951",217402,"PROVIDENCE COLLEGE",1,0,1998,"17285","75.50441","227","895","994",599,395,813,"323",490,0.818,0.8177,0.8179,0.9004
"10952",217402,"PROVIDENCE COLLEGE",1,0,1999,"17640","76.003195","234","860","973",556,417,838,"351",487,0.8759,0.8417,0.8613,0.8839
"10953",217402,"PROVIDENCE COLLEGE",1,0,2000,"18440","77.727059","240","816","930",527,403,775,"328",447,0.8482,0.8139,0.8333,0.8774
"10954",217402,"PROVIDENCE COLLEGE",1,0,2001,"19375","82.266491","246","809","933",531,402,795,"334",461,0.8682,0.8308,0.8521,0.8671
"10955",217402,"PROVIDENCE COLLEGE",1,0,2002,"20440","86.038926","264","711","877",540,337,734,"274",460,0.8519,0.8131,0.8369,0.8107
"10956",217402,"PROVIDENCE COLLEGE",1,0,2003,"21665","94.243365","251","821","975",561,414,823,"339",484,0.8627,0.8188,0.8441,0.8421
"10957",217402,"PROVIDENCE COLLEGE",1,0,2004,"23180","98.889185","256","865","1036",549,487,859,"406",453,0.8251,0.8337,0.8292,0.8349
"10958",217402,"Providence College",1,0,2005,"24800","101.967231","256","895","1064",593,471,857,"367",490,0.8263,0.7792,0.8055,0.8412
"10959",217402,"Providence College",1,0,2006,"26780","108.333726","260","848","1023",585,438,860,"351",509,0.8701,0.8014,0.8407,0.8289
"10960",217402,"Providence College",1,0,2007,"28920","114.564789","261","788","989",559,430,820,"361",459,0.8211,0.8395,0.8291,0.7968
"10961",217402,"Providence College",1,0,2008,"30800","127.60686","264","709","987",575,412,821,"336",485,0.8435,0.8155,0.8318,0.7183
"10962",217402,"Providence College",1,0,2009,"32320","130.394491","269","649","952",549,403,772,"324",448,0.816,0.804,0.8109,0.6817
"10963",217402,"Providence College",1,0,2010,"38610","136.755031","266","839","1102",633,469,888,"383",505,0.7978,0.8166,0.8058,0.7613
"10964",217536,"SALVE REGINA UNIVERSITY",1,0,1991,"11930","26.092","109","379","400",281,119,196,"49",147,0.5231,0.4118,0.49,0.9475
"10965",217536,"SALVE REGINA UNIVERSITY",1,0,1992,"13000","26.871","115","360","381",264,117,208,"58",150,0.5682,0.4957,0.5459,0.9449
"10966",217536,"SALVE REGINA UNIVERSITY",1,0,1993,"14200","27.616","124","328","345",235,110,181,"57",124,0.5277,0.5182,0.5246,0.9507
"10967",217536,"SALVE REGINA UNIVERSITY",1,0,1995,"14650","29.103","111","286","354",258,96,190,"49",141,0.5465,0.5104,0.5367,0.8079
"10968",217536,"SALVE REGINA UNIVERSITY",1,0,1996,"15190","28.938","107","372","393",271,122,209,"61",148,0.5461,0.5,0.5318,0.9466
"10969",217536,"SALVE REGINA UNIVERSITY",1,0,1997,"15650","24.92","105","442","479",318,161,219,"55",164,0.5157,0.3416,0.4572,0.9228
"10970",217536,"SALVE REGINA UNIVERSITY",1,0,1998,"16300","26.842","104","411","443",296,147,241,"69",172,0.5811,0.4694,0.544,0.9278
"10971",217536,"SALVE REGINA UNIVERSITY",1,0,1999,"16500","29.266","110","487","528",352,176,277,"69",208,0.5909,0.392,0.5246,0.9223
"10972",217536,"SALVE REGINA UNIVERSITY",1,0,2000,"17200","31.807","107.5","474","510",383,127,273,"63",210,0.5483,0.4961,0.5353,0.9294
"10973",217536,"SALVE REGINA UNIVERSITY",1,0,2001,"17950","34.295","105","498","551",396,155,321,"78",243,0.6136,0.5032,0.5826,0.9038
"10974",217536,"SALVE REGINA UNIVERSITY",1,0,2002,"19000","36.397","105","470","523",378,145,334,"93",241,0.6376,0.6414,0.6386,0.8987
"10975",217536,"SALVE REGINA UNIVERSITY",1,0,2003,"20100","39.404","106","492","571",401,170,361,"91",270,0.6733,0.5353,0.6322,0.8616
"10976",217536,"SALVE REGINA UNIVERSITY",1,0,2004,"21750","40.757","113","472","558",397,161,358,"99",259,0.6524,0.6149,0.6416,0.8459
"10977",217536,"Salve Regina University",1,0,2005,"23500","44.751","122","468","562",418,144,382,"82",300,0.7177,0.5694,0.6797,0.8327
"10978",217536,"Salve Regina University",1,0,2006,"24975","49.146","121","475","568",394,174,390,"113",277,0.703,0.6494,0.6866,0.8363
"10979",217536,"Salve Regina University",1,0,2007,"26750","53.337","122","461","556",353,203,338,"117",221,0.6261,0.5764,0.6079,0.8291
"10980",217536,"Salve Regina University",1,0,2008,"28950","57.057","119","423","556",382,174,355,"94",261,0.6832,0.5402,0.6385,0.7608
"10981",217536,"Salve Regina University",1,0,2009,"29800","59.323","117","375","501",346,155,343,"98",245,0.7081,0.6323,0.6846,0.7485
"10982",217536,"Salve Regina University",1,0,2010,"31250","58.215","110","473","592",423,169,380,"96",284,0.6714,0.568,0.6419,0.799
"10983",217776,"CENTRAL WESLEYAN COLLEGE",1,0,1991,"7090","6.579395","34","70","78",41,37,16,"6",10,0.2439,0.1622,0.2051,0.8974
"10984",217776,"CENTRAL WESLEYAN COLLEGE",1,0,1992,"7500","7.257534","38","80","88",54,34,26,"6",20,0.3704,0.1765,0.2955,0.9091
"10985",217776,"CENTRAL WESLEYAN COLLEGE",1,0,1993,"8100","7.756117","36","79","90",48,42,23,"8",15,0.3125,0.1905,0.2556,0.8778
"10986",217776,"SOUTHERN WESLEYAN UNIVERSITY",1,0,1995,"9081","8.804551","35","58","69",32,37,11,"3",8,0.25,0.0811,0.1594,0.8406
"10987",217776,"SOUTHERN WESLEYAN UNIVERSITY",1,0,1996,"9616","8.886734","38","64","73",36,37,19,"8",11,0.3056,0.2162,0.2603,0.8767
"10988",217776,"SOUTHERN WESLEYAN UNIVERSITY",1,0,1997,"10180","7.927444","38","86","101",51,50,27,"9",18,0.3529,0.18,0.2673,0.8515
"10989",217776,"SOUTHERN WESLEYAN UNIVERSITY",1,0,1998,"10840","8.467775","40","84","91",51,40,25,"11",14,0.2745,0.275,0.2747,0.9231
"10990",217776,"SOUTHERN WESLEYAN UNIVERSITY",1,0,1999,"11148","8.855634","41","91","99",47,52,35,"12",23,0.4894,0.2308,0.3535,0.9192
"10991",217776,"SOUTHERN WESLEYAN UNIVERSITY",1,0,2000,"11704","10.34855","42","81","92",51,41,33,"12",21,0.4118,0.2927,0.3587,0.8804
"10992",217776,"SOUTHERN WESLEYAN UNIVERSITY",1,0,2001,"12400","12.020548","43","103","139",78,61,46,"18",28,0.359,0.2951,0.3309,0.741
"10993",217776,"SOUTHERN WESLEYAN UNIVERSITY",1,0,2002,"13000","13.930975","47","105","141",76,65,36,"11",25,0.3289,0.1692,0.2553,0.7447
"10994",217776,"SOUTHERN WESLEYAN UNIVERSITY",1,0,2003,"13650","16.169009","47","129","160",100,60,41,"17",24,0.24,0.2833,0.2562,0.8062
"10995",217776,"SOUTHERN WESLEYAN UNIVERSITY",1,0,2004,"14300","18.600126","51","122","161",98,63,40,"15",25,0.2551,0.2381,0.2484,0.7578
"10996",217776,"Southern Wesleyan University",1,0,2005,"15000","19.726249","54","127","176",110,66,46,"18",28,0.2545,0.2727,0.2614,0.7216
"10997",217776,"Southern Wesleyan University",1,0,2006,"15700","21.476629","50","123","150",86,64,61,"28",33,0.3837,0.4375,0.4067,0.82
"10998",217776,"Southern Wesleyan University",1,0,2007,"16700","21.391437","52","135","183",114,69,49,"20",29,0.2544,0.2899,0.2678,0.7377
"10999",217776,"Southern Wesleyan University",1,0,2008,"17500","22.860033","53","114","142",84,58,52,"13",39,0.4643,0.2241,0.3662,0.8028
"11000",217776,"Southern Wesleyan University",1,0,2009,"18200","23.650565","52","133","168",100,68,67,"26",41,0.41,0.3824,0.3988,0.7917
"11001",217776,"Southern Wesleyan University",1,0,2010,"19000","24.965728","57","119","153",80,73,77,"40",37,0.4625,0.5479,0.5033,0.7778
"11002",217819,"COLLEGE OF CHARLESTON",1,0,1991,"2400","55.385543","267","1277","1434",943,491,483,"104",379,0.4019,0.2118,0.3368,0.8905
"11003",217819,"COLLEGE OF CHARLESTON",1,0,1992,"2650","58.908933","293","1171","1296",853,443,426,"100",326,0.3822,0.2257,0.3287,0.9035
"11004",217819,"COLLEGE OF CHARLESTON",1,0,1993,"2950","63.359238","320","1353","1519",1004,515,485,"123",362,0.3606,0.2388,0.3193,0.8907
"11005",217819,"COLLEGE OF CHARLESTON",1,0,1995,"3090","77.548214","347","1542","1748",1190,558,596,"136",460,0.3866,0.2437,0.341,0.8822
"11006",217819,"COLLEGE OF CHARLESTON",1,0,1996,"3190","81.794799","368","1641","1867",1236,631,624,"149",475,0.3843,0.2361,0.3342,0.879
"11007",217819,"COLLEGE OF CHARLESTON",1,0,1997,"3290","88.863027","378","1385","1568",1031,537,565,"130",435,0.4219,0.2421,0.3603,0.8833
"11008",217819,"COLLEGE OF CHARLESTON",1,0,1998,"3390","94.896099","394","1699","1937",1248,689,712,"179",533,0.4271,0.2598,0.3676,0.8771
"11009",217819,"COLLEGE OF CHARLESTON",1,0,1999,"206","108.112333","414","1784","2067",1399,668,850,"206",644,0.4603,0.3084,0.4112,0.8631
"11010",217819,"COLLEGE OF CHARLESTON",1,0,2000,"276","115.225391","425.5","1704","1985",1337,648,835,"215",620,0.4637,0.3318,0.4207,0.8584
"11011",217819,"COLLEGE OF CHARLESTON",1,0,2001,"276","122.10311","437","1631","1967",1295,672,868,"248",620,0.4788,0.369,0.4413,0.8292
"11012",217819,"COLLEGE OF CHARLESTON",1,0,2002,"386","121.107399","445","1693","1991",1333,658,941,"253",688,0.5161,0.3845,0.4726,0.8503
"11013",217819,"COLLEGE OF CHARLESTON",1,0,2003,"386","136.710043","469","1602","1868",1229,639,896,"251",645,0.5248,0.3928,0.4797,0.8576
"11014",217819,"COLLEGE OF CHARLESTON",1,0,2004,"456","139.466198","481","1664","1940",1323,617,1039,"268",771,0.5828,0.4344,0.5356,0.8577
"11015",217819,"College of Charleston",1,0,2005,"70","151.381694","495","1650","1984",1342,642,1031,"291",740,0.5514,0.4533,0.5197,0.8317
"11016",217819,"College of Charleston",1,0,2006,"70","159.541818","502","1671","1959",1332,627,1132,"315",817,0.6134,0.5024,0.5778,0.853
"11017",217819,"College of Charleston",1,0,2007,"70","167.401291","499","1722","2061",1352,709,1071,"302",769,0.5688,0.426,0.5197,0.8355
"11018",217819,"College of Charleston",1,0,2008,"70","188.11982","503","1663","1949",1296,653,1070,"318",752,0.5802,0.487,0.549,0.8533
"11019",217819,"College of Charleston",1,0,2009,"70","190.310704","504","1769","2136",1497,639,1203,"320",883,0.5898,0.5008,0.5632,0.8282
"11020",217819,"College of Charleston",1,0,2010,"70","199.252019","510","1699","2001",1329,672,1162,"325",837,0.6298,0.4836,0.5807,0.8491
"11021",217882,"CLEMSON UNIVERSITY",1,0,1991,"2630","291.344694","829","2151","2474",1120,1354,871,"321",550,0.4911,0.2371,0.3521,0.8694
"11022",217882,"CLEMSON UNIVERSITY",1,0,1992,"2762","308.759238","846","2186","2484",1179,1305,910,"330",580,0.4919,0.2529,0.3663,0.88
"11023",217882,"CLEMSON UNIVERSITY",1,0,1993,"2954","312.590382","801","2015","2300",1053,1247,872,"323",549,0.5214,0.259,0.3791,0.8761
"11024",217882,"CLEMSON UNIVERSITY",1,0,1995,"3112","331.488105","879","2259","2556",1255,1301,905,"319",586,0.4669,0.2452,0.3541,0.8838
"11025",217882,"CLEMSON UNIVERSITY",1,0,1996,"3112","323.312569","867","2288","2538",1234,1304,945,"327",618,0.5008,0.2508,0.3723,0.9015
"11026",217882,"CLEMSON UNIVERSITY",1,0,1997,"3252","345.424217","865","2285","2579",1265,1314,997,"341",656,0.5186,0.2595,0.3866,0.886
"11027",217882,"CLEMSON UNIVERSITY",1,0,1998,"3344","371.796792","923","2408","2699",1273,1426,1091,"396",695,0.546,0.2777,0.4042,0.8922
"11028",217882,"CLEMSON UNIVERSITY",1,0,1999,"2835","411.824968","935","2566","2886",1354,1532,1267,"490",777,0.5739,0.3198,0.439,0.8891
"11029",217882,"CLEMSON UNIVERSITY",1,0,2000,"3590","424.172268","907.5","2690","3028",1451,1577,1333,"496",837,0.5768,0.3145,0.4402,0.8884
"11030",217882,"CLEMSON UNIVERSITY",1,0,2001,"5090","454.287758","880","2069","2530",1184,1346,1166,"443",723,0.6106,0.3291,0.4609,0.8178
"11031",217882,"CLEMSON UNIVERSITY",1,0,2002,"5834","445.830142","964","2072","2463",1214,1249,1231,"462",769,0.6334,0.3699,0.4998,0.8413
"11032",217882,"CLEMSON UNIVERSITY",1,0,2003,"6934","479.797102","952","2205","2748",1293,1455,1379,"535",844,0.6527,0.3677,0.5018,0.8024
"11033",217882,"CLEMSON UNIVERSITY",1,0,2004,"7840","483.089497","942","2461","2994",1369,1625,1488,"597",891,0.6508,0.3674,0.497,0.822
"11034",217882,"Clemson University",1,0,2005,"8816","501.047888","1014","2420","2893",1426,1467,1565,"611",954,0.669,0.4165,0.541,0.8365
"11035",217882,"Clemson University",1,0,2006,"9056","536.594989","1061","2269","2755",1363,1392,1575,"604",971,0.7124,0.4339,0.5717,0.8236
"11036",217882,"Clemson University",1,0,2007,"9344","576.916523","1086","2232","2702",1304,1398,1598,"677",921,0.7063,0.4843,0.5914,0.8261
"11037",217882,"Clemson University",1,0,2008,"9886","647.471481","1094","2356","2866",1412,1454,1747,"737",1010,0.7153,0.5069,0.6096,0.8221
"11038",217882,"Clemson University",1,0,2009,"10298","626.929868","1052","2847","3336",1564,1772,1926,"853",1073,0.6861,0.4814,0.5773,0.8534
"11039",217882,"Clemson University",1,0,2010,"11128","629.036314","1043","2570","2977",1498,1479,1755,"707",1048,0.6996,0.478,0.5895,0.8633
"11040",217998,"ERSKINE COLLEGE AND SEMINARY",1,0,1991,"9565","8.883029","39","97","101",64,37,66,"21",45,0.7031,0.5676,0.6535,0.9604
"11041",217998,"ERSKINE COLLEGE AND SEMINARY",1,0,1992,"10125","10.343241","39","173","185",98,87,110,"52",58,0.5918,0.5977,0.5946,0.9351
"11042",217998,"ERSKINE COLLEGE AND SEMINARY",1,0,1993,"10630","10.819058","50","170","177",108,69,113,"36",77,0.713,0.5217,0.6384,0.9605
"11043",217998,"ERSKINE COLLEGE AND SEMINARY",1,0,1995,"11823","12.412164","51","140","143",77,66,93,"42",51,0.6623,0.6364,0.6503,0.979
"11044",217998,"ERSKINE COLLEGE AND SEMINARY",1,0,1996,"13087","12.718344","51","128","134",82,52,89,"34",55,0.6707,0.6538,0.6642,0.9552
"11045",217998,"ERSKINE COLLEGE AND SEMINARY",1,0,1997,"13902","13.863032","52","118","132",78,54,85,"31",54,0.6923,0.5741,0.6439,0.8939
"11046",217998,"ERSKINE COLLEGE AND SEMINARY",1,0,1998,"14893","13.768542","47","122","136",84,52,89,"28",61,0.7262,0.5385,0.6544,0.8971
"11047",217998,"ERSKINE COLLEGE AND SEMINARY",1,0,1999,"14269","12.057453","50","144","156",91,65,100,"33",67,0.7363,0.5077,0.641,0.9231
"11048",217998,"ERSKINE COLLEGE AND SEMINARY",1,0,2000,"14697","11.490837","55","122","138",79,59,89,"31",58,0.7342,0.5254,0.6449,0.8841
"11049",217998,"ERSKINE COLLEGE AND SEMINARY",1,0,2001,"15138","12.106033","60","197","217",127,90,125,"44",81,0.6378,0.4889,0.576,0.9078
"11050",217998,"ERSKINE COLLEGE AND SEMINARY",1,0,2002,"15700","16.655713","55","152","165",100,65,87,"25",62,0.62,0.3846,0.5273,0.9212
"11051",217998,"ERSKINE COLLEGE AND SEMINARY",1,0,2003,"16312","16.205801","53","154","176",102,74,111,"43",68,0.6667,0.5811,0.6307,0.875
"11052",217998,"ERSKINE COLLEGE AND SEMINARY",1,0,2004,"16948","16.029184","54","160","179",106,73,97,"39",58,0.5472,0.5342,0.5419,0.8939
"11053",217998,"Erskine College and Seminary",1,0,2005,"17700","16.954243","53","160","181",90,91,82,"33",49,0.5444,0.3626,0.453,0.884
"11054",217998,"Erskine College and Seminary",1,0,2006,"18840","17.211668","58","150","178",100,78,101,"34",67,0.67,0.4359,0.5674,0.8427
"11055",217998,"Erskine College and Seminary",1,0,2007,"20185","18.14053","59","145","163",94,69,84,"30",54,0.5745,0.4348,0.5153,0.8896
"11056",217998,"Erskine College and Seminary",1,0,2008,"21590","20.482355","62","106","163",83,80,72,"32",40,0.4819,0.4,0.4417,0.6503
"11057",217998,"Erskine College and Seminary",1,0,2009,"23000","19.931597","61","152","182",99,83,102,"45",57,0.5758,0.5422,0.5604,0.8352
"11058",217998,"Erskine College and Seminary",1,0,2010,"24750","20.910411","58","117","144",81,63,85,"34",51,0.6296,0.5397,0.5903,0.8125
"11059",218061,"FRANCIS MARION COLLEGE",1,0,1991,"2140","24.582035","157","587","735",388,347,79,"23",56,0.1443,0.0663,0.1075,0.7986
"11060",218061,"FRANCIS MARION UNIVERSITY",1,0,1992,"2440","27.281202","160","666","875",487,388,110,"42",68,0.1396,0.1082,0.1257,0.7611
"11061",218061,"FRANCIS MARION UNIVERSITY",1,0,1993,"2800","29.083781","166","583","807",435,372,130,"40",90,0.2069,0.1075,0.1611,0.7224
"11062",218061,"FRANCIS MARION UNIVERSITY",1,0,1995,"3010","31.789883","167","550","757",405,352,140,"43",97,0.2395,0.1222,0.1849,0.7266
"11063",218061,"FRANCIS MARION UNIVERSITY",1,0,1996,"3100","32.895807","154","442","636",365,271,119,"39",80,0.2192,0.1439,0.1871,0.695
"11064",218061,"FRANCIS MARION UNIVERSITY",1,0,1997,"3390","33.230886","161","425","582",336,246,99,"34",65,0.1935,0.1382,0.1701,0.7302
"11065",218061,"FRANCIS MARION UNIVERSITY",1,0,1998,"3350","34.158552","161","413","649",372,277,188,"57",131,0.3522,0.2058,0.2897,0.6364
"11066",218061,"FRANCIS MARION UNIVERSITY",1,0,1999,"3260","40.89668","159","371","570",332,238,104,"27",77,0.2319,0.1134,0.1825,0.6509
"11067",218061,"FRANCIS MARION UNIVERSITY",1,0,2000,"3410","38.384963","158.5","412","602",356,246,95,"33",62,0.1742,0.1341,0.1578,0.6844
"11068",218061,"FRANCIS MARION UNIVERSITY",1,0,2001,"3620","39.092475","158","403","634",377,257,127,"41",86,0.2281,0.1595,0.2003,0.6356
"11069",218061,"FRANCIS MARION UNIVERSITY",1,0,2002,"4190","34.605776","158","463","734",431,303,142,"48",94,0.2181,0.1584,0.1935,0.6308
"11070",218061,"FRANCIS MARION UNIVERSITY",1,0,2003,"4947","37.050866","164","445","765",447,318,153,"48",105,0.2349,0.1509,0.2,0.5817
"11071",218061,"FRANCIS MARION UNIVERSITY",1,0,2004,"5405","38.62782","170","395","745",463,282,139,"34",105,0.2268,0.1206,0.1866,0.5302
"11072",218061,"Francis Marion University",1,0,2005,"5849","39.783174","175","416","797",517,280,158,"40",118,0.2282,0.1429,0.1982,0.522
"11073",218061,"Francis Marion University",1,0,2006,"6327","44.129677","190","422","795",519,276,142,"34",108,0.2081,0.1232,0.1786,0.5308
"11074",218061,"Francis Marion University",1,0,2007,"6803","47.791315","200","419","776",493,283,127,"47",80,0.1623,0.1661,0.1637,0.5399
"11075",218061,"Francis Marion University",1,0,2008,"7347","53.019039","199","289","676",452,224,104,"34",70,0.1549,0.1518,0.1538,0.4275
"11076",218061,"Francis Marion University",1,0,2009,"7625","52.247293","199","355","791",533,258,142,"44",98,0.1839,0.1705,0.1795,0.4488
"11077",218061,"Francis Marion University",1,0,2010,"8145","53.642387","202","352","737",479,258,130,"40",90,0.1879,0.155,0.1764,0.4776
"11078",218229,"LANDER COLLEGE",1,0,1991,"2620","18.252179","120","343","421",286,135,83,"18",65,0.2273,0.1333,0.1971,0.8147
"11079",218229,"LANDER COLLEGE",1,0,1992,"2920","18.617032","115","332","402",273,129,65,"16",49,0.1795,0.124,0.1617,0.8259
"11080",218229,"LANDER UNIVERSITY",1,0,1993,"3220","20.738444","110","398","491",327,164,80,"21",59,0.1804,0.128,0.1629,0.8106
"11081",218229,"LANDER UNIVERSITY",1,0,1995,"3400","23.778917","116","389","477",301,176,155,"46",109,0.3621,0.2614,0.3249,0.8155
"11082",218229,"LANDER UNIVERSITY",1,0,1996,"3550","24.764903","120","342","437",273,164,134,"40",94,0.3443,0.2439,0.3066,0.7826
"11083",218229,"LANDER UNIVERSITY",1,0,1997,"5328","28.70194","120","353","434",288,146,94,"23",71,0.2465,0.1575,0.2166,0.8134
"11084",218229,"LANDER UNIVERSITY",1,0,1998,"5476","30.326064","121","396","488",322,166,92,"19",73,0.2267,0.1145,0.1885,0.8115
"11085",218229,"LANDER UNIVERSITY",1,0,1999,"5548","30.563263","122","417","494",313,181,107,"22",85,0.2716,0.1215,0.2166,0.8441
"11086",218229,"LANDER UNIVERSITY",1,0,2000,"5832","28.535033","116.5","414","509",321,188,88,"23",65,0.2025,0.1223,0.1729,0.8134
"11087",218229,"LANDER UNIVERSITY",1,0,2001,"4152","30.388411","111","401","488",291,197,118,"25",93,0.3196,0.1269,0.2418,0.8217
"11088",218229,"LANDER UNIVERSITY",1,0,2002,"4704","28.450057","114","439","526",335,191,117,"25",92,0.2746,0.1309,0.2224,0.8346
"11089",218229,"LANDER UNIVERSITY",1,0,2003,"5400","31.707595","124","439","541",356,185,139,"30",109,0.3062,0.1622,0.2569,0.8115
"11090",218229,"LANDER UNIVERSITY",1,0,2004,"5856","33.331582","118","471","647",440,207,140,"32",108,0.2455,0.1546,0.2164,0.728
"11091",218229,"Lander University",1,0,2005,"6588","34.925159","123","377","555",369,186,110,"34",76,0.206,0.1828,0.1982,0.6793
"11092",218229,"Lander University",1,0,2006,"6602","37.303726","136","395","578",379,199,127,"29",98,0.2586,0.1457,0.2197,0.6834
"11093",218229,"Lander University",1,0,2007,"7098","37.982974","128","315","433",296,137,139,"35",104,0.3514,0.2555,0.321,0.7275
"11094",218229,"Lander University",1,0,2008,"8380","39.482191","130","344","554",398,156,162,"39",123,0.309,0.25,0.2924,0.6209
"11095",218229,"Lander University",1,0,2009,"7980","40.939003","117","383","581",405,176,160,"46",114,0.2815,0.2614,0.2754,0.6592
"11096",218229,"Lander University",1,0,2010,"8374","42.739012","126","447","685",476,209,195,"44",151,0.3172,0.2105,0.2847,0.6526
"11097",218238,"LIMESTONE COLLEGE",1,0,1991,"6464","6.665409","27","118","232",126,106,17,"5",12,0.0952,0.0472,0.0733,0.5086
"11098",218238,"LIMESTONE COLLEGE",1,0,1992,"6878","8.286339","28","80","115",48,67,9,"4",5,0.1042,0.0597,0.0783,0.6957
"11099",218238,"LIMESTONE COLLEGE",1,0,1993,"7200","7.59851","28","143","214",88,126,43,"22",21,0.2386,0.1746,0.2009,0.6682
"11100",218238,"LIMESTONE COLLEGE",1,0,1995,"8000","9.200771","31","127","164",82,82,40,"18",22,0.2683,0.2195,0.2439,0.7744
"11101",218238,"LIMESTONE COLLEGE",1,0,1996,"8200","9.067723","32","73","87",38,49,16,"5",11,0.2895,0.102,0.1839,0.8391
"11102",218238,"LIMESTONE COLLEGE",1,0,1997,"8600","12.362317","33","141","193",92,101,4,"3",1,0.0109,0.0297,0.0207,0.7306
"11103",218238,"LIMESTONE COLLEGE",1,0,1998,"9100","13.881542","41","80","112",58,54,26,"8",18,0.3103,0.1481,0.2321,0.7143
"11104",218238,"LIMESTONE COLLEGE",1,0,1999,"9500","14.745461","50","105","136",58,78,27,"13",14,0.2414,0.1667,0.1985,0.7721
"11105",218238,"LIMESTONE COLLEGE",1,0,2000,"10100","16.982912","52","80","103",49,54,23,"6",17,0.3469,0.1111,0.2233,0.7767
"11106",218238,"LIMESTONE COLLEGE",1,0,2001,"10800","18.237246","54","107","136",69,67,31,"11",20,0.2899,0.1642,0.2279,0.7868
"11107",218238,"LIMESTONE COLLEGE",1,0,2002,"11500","23.591398","56","136","180",83,97,26,"12",14,0.1687,0.1237,0.1444,0.7556
"11108",218238,"LIMESTONE COLLEGE",1,0,2003,"12300","28.129554","65","112","176",98,78,35,"15",20,0.2041,0.1923,0.1989,0.6364
"11109",218238,"LIMESTONE COLLEGE",1,0,2004,"13200","33.58527","66","146","203",95,108,41,"15",26,0.2737,0.1389,0.202,0.7192
"11110",218238,"Limestone College",1,0,2005,"14040","41.379238","71","137","201",99,102,40,"10",30,0.303,0.098,0.199,0.6816
"11111",218238,"Limestone College",1,0,2006,"15000","22.931518","75","145","206",87,119,39,"17",22,0.2529,0.1429,0.1893,0.7039
"11112",218238,"Limestone College",1,0,2007,"15900","24.924136","76","163","225",92,133,42,"18",24,0.2609,0.1353,0.1867,0.7244
"11113",218238,"Limestone College",1,0,2008,"17300","27.362254","98","145","229",98,131,29,"8",21,0.2143,0.0611,0.1266,0.6332
"11114",218238,"Limestone College",1,0,2009,"18300","26.802978","91","179","288",133,155,63,"22",41,0.3083,0.1419,0.2188,0.6215
"11115",218238,"Limestone College",1,0,2010,"19200","30.073704","91","165","275",129,146,52,"19",33,0.2558,0.1301,0.1891,0.6
"11116",218399,"MORRIS COLLEGE",1,0,1991,"3939","9.095713","48","0","196",135,61,38,"6",32,0.237,0.0984,0.1939,0
"11117",218399,"MORRIS COLLEGE",1,0,1992,"4136","9.393012","44","0","293",177,116,40,"16",24,0.1356,0.1379,0.1365,0
"11118",218399,"MORRIS COLLEGE",1,0,1993,"4290","10.605843","46","1","327",213,114,33,"10",23,0.108,0.0877,0.1009,0.0031
"11119",218399,"MORRIS COLLEGE",1,0,1995,"4867","11.784711","51","0","241",167,74,35,"8",27,0.1617,0.1081,0.1452,0
"11120",218399,"MORRIS COLLEGE",1,0,1996,"5105","12.487797","48","0","246",145,101,45,"11",34,0.2345,0.1089,0.1829,0
"11121",218399,"MORRIS COLLEGE",1,0,1997,"5240","12.093826","48","0","262",180,82,68,"15",53,0.2944,0.1829,0.2595,0
"11122",218399,"MORRIS COLLEGE",1,0,1998,"5515","13.094891","48","0","204",123,81,37,"10",27,0.2195,0.1235,0.1814,0
"11123",218399,"MORRIS COLLEGE",1,0,1999,"5640","13.782421","48","0","263",173,90,53,"10",43,0.2486,0.1111,0.2015,0
"11124",218399,"MORRIS COLLEGE",1,0,2000,"5894","15.003864","47.5","0","265",167,98,48,"14",34,0.2036,0.1429,0.1811,0
"11125",218399,"MORRIS COLLEGE",1,0,2001,"6483","16.600557","47","0","268",167,101,56,"13",43,0.2575,0.1287,0.209,0
"11126",218399,"MORRIS COLLEGE",1,0,2002,"6783","17.536229","48","0","289",175,114,51,"11",40,0.2286,0.0965,0.1765,0
"11127",218399,"MORRIS COLLEGE",1,0,2003,"7190","18.024661","48","0","276",168,108,46,"9",37,0.2202,0.0833,0.1667,0
"11128",218399,"MORRIS COLLEGE",1,0,2004,"7550","18.490422","48","0","232",141,91,19,"3",16,0.1135,0.033,0.0819,0
"11129",218399,"Morris College",1,0,2005,"7828","19.152105","47","0","207",130,77,30,"9",21,0.1615,0.1169,0.1449,0
"11130",218399,"Morris College",1,0,2006,"8562","16.834307","46","0","249",144,105,39,"11",28,0.1944,0.1048,0.1566,0
"11131",218399,"Morris College",1,0,2007,"8990","16.325498","46","0","295",152,143,40,"14",26,0.1711,0.0979,0.1356,0
"11132",218399,"Morris College",1,0,2008,"9621","19.474695","44","1","292",162,130,37,"6",31,0.1914,0.0462,0.1267,0.0034
"11133",218399,"Morris College",1,0,2009,"9630","18.278418","48","0","300",166,134,37,"9",28,0.1687,0.0672,0.1233,0
"11134",218399,"Morris College",1,0,2010,"10015","19.649469","48","0","319",173,146,19,"6",13,0.0751,0.0411,0.0596,0
"11135",218414,"NEWBERRY COLLEGE",1,0,1991,"7400","9.040601","42","143","189",77,112,45,"21",24,0.3117,0.1875,0.2381,0.7566
"11136",218414,"NEWBERRY COLLEGE",1,0,1992,"7900","9.858377","46","136","177",82,95,36,"16",20,0.2439,0.1684,0.2034,0.7684
"11137",218414,"NEWBERRY COLLEGE",1,0,1993,"8594","10.116283","46","110","155",62,93,44,"24",20,0.3226,0.2581,0.2839,0.7097
"11138",218414,"NEWBERRY COLLEGE",1,0,1995,"10950","12.267861","50","125","166",70,96,50,"19",31,0.4429,0.1979,0.3012,0.753
"11139",218414,"NEWBERRY COLLEGE",1,0,1996,"11510","13.269608","47","197","234",103,131,91,"36",55,0.534,0.2748,0.3889,0.8419
"11140",218414,"NEWBERRY COLLEGE",1,0,1997,"12322","10.27345","46","130","161",52,109,41,"22",19,0.3654,0.2018,0.2547,0.8075
"11141",218414,"NEWBERRY COLLEGE",1,0,1998,"13062","9.98662","48","157","206",92,114,74,"27",47,0.5109,0.2368,0.3592,0.7621
"11142",218414,"NEWBERRY COLLEGE",1,0,1999,"13602","9.881399","48","139","179",70,109,59,"18",41,0.5857,0.1651,0.3296,0.7765
"11143",218414,"NEWBERRY COLLEGE",1,0,2000,"14282","10.289449","47","131","181",80,101,58,"25",33,0.4125,0.2475,0.3204,0.7238
"11144",218414,"NEWBERRY COLLEGE",1,0,2001,"15000","10.446321","46","129","178",70,108,55,"26",29,0.4143,0.2407,0.309,0.7247
"11145",218414,"NEWBERRY COLLEGE",1,0,2002,"15800","10.962781","44","168","250",94,156,70,"33",37,0.3936,0.2115,0.28,0.672
"11146",218414,"NEWBERRY COLLEGE",1,0,2003,"16640","11.810702","43","145","203",69,134,64,"36",28,0.4058,0.2687,0.3153,0.7143
"11147",218414,"NEWBERRY COLLEGE",1,0,2004,"17470","13.339797","48","152","231",90,141,73,"28",45,0.5,0.1986,0.316,0.658
"11148",218414,"Newberry College",1,0,2005,"18170","13.631159","51","178","275",96,179,67,"34",33,0.3438,0.1899,0.2436,0.6473
"11149",218414,"Newberry College",1,0,2006,"18900","15.950146","50","173","264",116,148,65,"24",41,0.3534,0.1622,0.2462,0.6553
"11150",218414,"Newberry College",1,0,2007,"19900","16.970595","55","227","323",122,201,88,"41",47,0.3852,0.204,0.2724,0.7028
"11151",218414,"Newberry College",1,0,2008,"20500","18.982963","54","211","297",118,179,78,"27",51,0.4322,0.1508,0.2626,0.7104
"11152",218414,"Newberry College",1,0,2009,"20500","19.127339","52","221","342",133,209,84,"32",52,0.391,0.1531,0.2456,0.6462
"11153",218414,"Newberry College",1,0,2010,"21500","21.041576","56","203","288",110,178,82,"41",41,0.3727,0.2303,0.2847,0.7049
"11154",218663,"UNIVERSITY OF SOUTH CAROLINA AT COLUMBIA",1,0,1991,"2686","304.347444","1077","1972","2591",1398,1193,643,"242",401,0.2868,0.2028,0.2482,0.7611
"11155",218663,"UNIVERSITY OF SOUTH CAROLINA AT COLUMBIA",1,0,1992,"2818","306.831877","1059","1768","2460",1312,1148,643,"257",386,0.2942,0.2239,0.2614,0.7187
"11156",218663,"UNIVERSITY OF SOUTH CAROLINA AT COLUMBIA",1,0,1993,"3090","331.48288","1034","1681","2298",1269,1029,681,"246",435,0.3428,0.2391,0.2963,0.7315
"11157",218663,"UNIVERSITY OF SOUTH CAROLINA AT COLUMBIA",1,0,1995,"3280","371.307023","1018","1945","2593",1477,1116,799,"282",517,0.35,0.2527,0.3081,0.7501
"11158",218663,"UNIVERSITY OF SOUTH CAROLINA AT COLUMBIA",1,0,1996,"3432","391.727705","1028","1921","2635",1518,1117,857,"289",568,0.3742,0.2587,0.3252,0.729
"11159",218663,"UNIVERSITY OF SOUTH CAROLINA AT COLUMBIA",1,0,1997,"3534","415.343829","1032","2220","2919",1596,1323,1065,"393",672,0.4211,0.2971,0.3649,0.7605
"11160",218663,"UNIVERSITY OF SOUTH CAROLINA AT COLUMBIA",1,0,1998,"3630","441.613792","1024","2038","2756",1553,1203,1098,"398",700,0.4507,0.3308,0.3984,0.7395
"11161",218663,"UNIVERSITY OF SOUTH CAROLINA AT COLUMBIA",1,0,1999,"3640","429.154031","1036","1915","2596",1511,1085,1073,"367",706,0.4672,0.3382,0.4133,0.7377
"11162",218663,"UNIVERSITY OF SOUTH CAROLINA AT COLUMBIA",1,0,2000,"3768","507.90256","1021","1852","2475",1394,1081,988,"351",637,0.457,0.3247,0.3992,0.7483
"11163",218663,"UNIVERSITY OF SOUTH CAROLINA AT COLUMBIA",1,0,2001,"3964","531.483778","1006","2415","3227",1770,1457,1304,"461",843,0.4763,0.3164,0.4041,0.7484
"11164",218663,"UNIVERSITY OF SOUTH CAROLINA AT COLUMBIA",1,0,2002,"4784","512.702836","1015","2632","3500",1909,1591,1557,"594",963,0.5045,0.3734,0.4449,0.752
"11165",218663,"UNIVERSITY OF SOUTH CAROLINA-COLUMBIA",1,0,2003,"5548","544.272676","1011","2580","3441",1949,1492,1578,"586",992,0.509,0.3928,0.4586,0.7498
"11166",218663,"UNIVERSITY OF SOUTH CAROLINA-COLUMBIA",1,0,2004,"6156","563.672484","1043","2319","3330",1841,1489,1524,"593",931,0.5057,0.3983,0.4577,0.6964
"11167",218663,"University of South Carolina-Columbia",1,0,2005,"6914","620.835159","1169","2769","3677",2087,1590,1881,"682",1199,0.5745,0.4289,0.5116,0.7531
"11168",218663,"University of South Carolina-Columbia",1,0,2006,"7408","665.256349","1163","2717","3646",2084,1562,1932,"702",1230,0.5902,0.4494,0.5299,0.7452
"11169",218663,"University of South Carolina-Columbia",1,0,2007,"7946","707.719872","1217","2995","3690",2117,1573,1999,"734",1265,0.5975,0.4666,0.5417,0.8117
"11170",218663,"University of South Carolina-Columbia",1,0,2008,"8438","751.506561","1201","2983","3826",2133,1693,2129,"812",1317,0.6174,0.4796,0.5565,0.7797
"11171",218663,"University of South Carolina-Columbia",1,0,2009,"8756","722.957692","1152","3232","3881",2089,1792,2132,"825",1307,0.6257,0.4604,0.5493,0.8328
"11172",218663,"University of South Carolina-Columbia",1,0,2010,"9386","728.956614","1178","3663","4421",2431,1990,2400,"911",1489,0.6125,0.4578,0.5429,0.8285
"11173",218724,"UNIVERSITY OF SOUTH CAROLINA AT COASTAL CAROLINA",1,0,1991,"2020","24.90627","142","518","584",328,256,84,"26",58,0.1768,0.1016,0.1438,0.887
"11174",218724,"UNIVERSITY OF SOUTH CAROLINA AT COASTAL CAROLINA",1,0,1992,"2170","25.854586","140","506","591",305,286,71,"17",54,0.177,0.0594,0.1201,0.8562
"11175",218724,"COASTAL CAROLINA UNIVERSITY",1,0,1993,"2470","27.831498","143","635","732",379,353,86,"26",60,0.1583,0.0737,0.1175,0.8675
"11176",218724,"COASTAL CAROLINA UNIVERSITY",1,0,1995,"2800","32.33959","160","648","734",411,323,117,"27",90,0.219,0.0836,0.1594,0.8828
"11177",218724,"COASTAL CAROLINA UNIVERSITY",1,0,1996,"2910","35.711497","164","713","823",408,415,120,"44",76,0.1863,0.106,0.1458,0.8663
"11178",218724,"COASTAL CAROLINA UNIVERSITY",1,0,1997,"3030","38.589002","179","725","826",443,383,121,"43",78,0.1761,0.1123,0.1465,0.8777
"11179",218724,"COASTAL CAROLINA UNIVERSITY",1,0,1998,"3150","42.51287","180","757","855",468,387,150,"53",97,0.2073,0.137,0.1754,0.8854
"11180",218724,"COASTAL CAROLINA UNIVERSITY",1,0,1999,"3270","45.609636","176","674","757",405,352,161,"60",101,0.2494,0.1705,0.2127,0.8904
"11181",218724,"COASTAL CAROLINA UNIVERSITY",1,0,2000,"3420","49.975779","178","687","784",434,350,157,"57",100,0.2304,0.1629,0.2003,0.8763
"11182",218724,"COASTAL CAROLINA UNIVERSITY",1,0,2001,"3690","54.176785","180","842","931",494,437,212,"60",152,0.3077,0.1373,0.2277,0.9044
"11183",218724,"COASTAL CAROLINA UNIVERSITY",1,0,2002,"4430","51.847725","200","932","1072",523,549,236,"104",132,0.2524,0.1894,0.2201,0.8694
"11184",218724,"COASTAL CAROLINA UNIVERSITY",1,0,2003,"5270","60.227632","208","1076","1266",618,648,283,"109",174,0.2816,0.1682,0.2235,0.8499
"11185",218724,"COASTAL CAROLINA UNIVERSITY",1,0,2004,"6100","68.994299","220","1115","1320",669,651,288,"104",184,0.275,0.1598,0.2182,0.8447
"11186",218724,"Coastal Carolina University",1,0,2005,"6780","75.804097","233","1284","1493",775,718,375,"130",245,0.3161,0.1811,0.2512,0.86
"11187",218724,"Coastal Carolina University",1,0,2006,"7420","86.418258","248","1241","1466",810,656,420,"144",276,0.3407,0.2195,0.2865,0.8465
"11188",218724,"Coastal Carolina University",1,0,2007,"7520","95.049759","264","1363","1647",886,761,443,"143",300,0.3386,0.1879,0.269,0.8276
"11189",218724,"Coastal Carolina University",1,0,2008,"8570","103.620388","299","1314","1641",835,806,422,"157",265,0.3174,0.1948,0.2572,0.8007
"11190",218724,"Coastal Carolina University",1,0,2009,"8870","112.246817","315","1353","1766",950,816,465,"142",323,0.34,0.174,0.2633,0.7661
"11191",218724,"Coastal Carolina University",1,0,2010,"9310","118.644429","346","1437","1996",1087,909,530,"181",349,0.3211,0.1991,0.2655,0.7199
"11192",218733,"SOUTH CAROLINA STATE COLLEGE",1,0,1991,"2050","48.554086","224","9","888",486,402,85,"17",68,0.1399,0.0423,0.0957,0.0101
"11193",218733,"SOUTH CAROLINA STATE UNIVERSITY",1,0,1992,"2200","51.212416","291","3","701",366,335,89,"25",64,0.1749,0.0746,0.127,0.0043
"11194",218733,"SOUTH CAROLINA STATE UNIVERSITY",1,0,1993,"2500","53.857807","255","3","613",329,284,80,"20",60,0.1824,0.0704,0.1305,0.0049
"11195",218733,"SOUTH CAROLINA STATE UNIVERSITY",1,0,1995,"2550","56.082588","257","10","859",447,412,279,"100",179,0.4004,0.2427,0.3248,0.0116
"11196",218733,"SOUTH CAROLINA STATE UNIVERSITY",1,0,1996,"2730","59.015469","249","3","801",452,349,159,"24",135,0.2987,0.0688,0.1985,0.0037
"11197",218733,"SOUTH CAROLINA STATE UNIVERSITY",1,0,1997,"2974","65.542049","236","3","601",320,281,169,"52",117,0.3656,0.1851,0.2812,0.005
"11198",218733,"SOUTH CAROLINA STATE UNIVERSITY",1,0,1998,"3184","66.657161","217","4","739",428,311,186,"50",136,0.3178,0.1608,0.2517,0.0054
"11199",218733,"SOUTH CAROLINA STATE UNIVERSITY",1,0,1999,"3410","67.914926","217","7","680",351,329,143,"37",106,0.302,0.1125,0.2103,0.0103
"11200",218733,"SOUTH CAROLINA STATE UNIVERSITY",1,0,2000,"3654","85.267453","218","2","571",307,264,170,"48",122,0.3974,0.1818,0.2977,0.0035
"11201",218733,"SOUTH CAROLINA STATE UNIVERSITY",1,0,2001,"4096","79.496293","219","2","615",358,257,135,"47",88,0.2458,0.1829,0.2195,0.0033
"11202",218733,"SOUTH CAROLINA STATE UNIVERSITY",1,0,2002,"2278","79.924171","218","4","717",401,316,174,"45",129,0.3217,0.1424,0.2427,0.0056
"11203",218733,"SOUTH CAROLINA STATE UNIVERSITY",1,0,2003,"5570","79.924171","190","8","794",453,341,106,"33",73,0.1611,0.0968,0.1335,0.0101
"11204",218733,"SOUTH CAROLINA STATE UNIVERSITY",1,0,2004,"6170","81.354199","211","5","945",523,422,164,"41",123,0.2352,0.0972,0.1735,0.0053
"11205",218733,"South Carolina State University",1,0,2005,"150","96.045622","202","4","1002",544,458,140,"50",90,0.1654,0.1092,0.1397,0.004
"11206",218733,"South Carolina State University",1,0,2006,"514","100.951965","212","8","870",458,412,134,"49",85,0.1856,0.1189,0.154,0.0092
"11207",218733,"South Carolina State University",1,0,2007,"550","111.901572","225","10","1292",652,640,177,"59",118,0.181,0.0922,0.137,0.0077
"11208",218733,"South Carolina State University",1,0,2008,"572","126.822841","228","9","923",484,439,138,"38",100,0.2066,0.0866,0.1495,0.0098
"11209",218733,"South Carolina State University",1,0,2009,"624","124.361561","229","14","713",358,355,106,"37",69,0.1927,0.1042,0.1487,0.0196
"11210",218733,"South Carolina State University",1,0,2010,"8328","119.568874","216","10","816",414,402,156,"58",98,0.2367,0.1443,0.1912,0.0123
"11211",218742,"UNIVERSITY OF SOUTH CAROLINA AT SPARTANBURG",1,0,1991,"2020","19.55213","133","416","485",277,208,58,"13",45,0.1625,0.0625,0.1196,0.8577
"11212",218742,"UNIVERSITY OF SOUTH CAROLINA AT SPARTANBURG",1,0,1992,"2120","20.217523","135","332","399",240,159,56,"16",40,0.1667,0.1006,0.1404,0.8321
"11213",218742,"UNIVERSITY OF SOUTH CAROLINA AT SPARTANBURG",1,0,1993,"2320","21.26048","132","258","327",216,111,46,"6",40,0.1852,0.0541,0.1407,0.789
"11214",218742,"UNIVERSITY OF SOUTH CAROLINA AT SPARTANBURG",1,0,1995,"2578","22.9267","130","338","427",264,163,66,"15",51,0.1932,0.092,0.1546,0.7916
"11215",218742,"UNIVERSITY OF SOUTH CAROLINA AT SPARTANBURG",1,0,1996,"2808","25.71645","133","327","438",284,154,75,"12",63,0.2218,0.0779,0.1712,0.7466
"11216",218742,"UNIVERSITY OF SOUTH CAROLINA AT SPARTANBURG",1,0,1997,"2974","26.772426","136","390","539",327,212,81,"18",63,0.1927,0.0849,0.1503,0.7236
"11217",218742,"UNIVERSITY OF SOUTH CAROLINA AT SPARTANBURG",1,0,1998,"3118","30.176588","137","369","547",362,185,106,"18",88,0.2431,0.0973,0.1938,0.6746
"11218",218742,"UNIVERSITY OF SOUTH CAROLINA AT SPARTANBURG",1,0,1999,"3250","32.923722","138","355","540",334,206,87,"24",63,0.1886,0.1165,0.1611,0.6574
"11219",218742,"UNIVERSITY OF SOUTH CAROLINA AT SPARTANBURG",1,0,2000,"3494","35.643837","142.5","348","546",358,188,94,"24",70,0.1955,0.1277,0.1722,0.6374
"11220",218742,"UNIVERSITY OF SOUTH CAROLINA AT SPARTANBURG",1,0,2001,"3738","37.92566","147","334","573",350,223,107,"36",71,0.2029,0.1614,0.1867,0.5829
"11221",218742,"UNIVERSITY OF SOUTH CAROLINA AT SPARTANBURG",1,0,2002,"4598","38.938578","165","410","647",414,233,119,"19",100,0.2415,0.0815,0.1839,0.6337
"11222",218742,"UNIVERSITY OF SOUTH CAROLINA-SPARTANBURG",1,0,2003,"5310","45.093689","179","409","684",450,234,139,"35",104,0.2311,0.1496,0.2032,0.598
"11223",218742,"UNIVERSITY OF SOUTH CAROLINA UPSTATE",1,0,2004,"5860","47.976008","180","408","643",398,245,145,"51",94,0.2362,0.2082,0.2255,0.6345
"11224",218742,"University of South Carolina-Upstate",1,0,2005,"6436","50.710835","183","382","718",469,249,153,"41",112,0.2388,0.1647,0.2131,0.532
"11225",218742,"University of South Carolina-Upstate",1,0,2006,"6958","52.748411","196","429","781",497,284,166,"42",124,0.2495,0.1479,0.2125,0.5493
"11226",218742,"University of South Carolina-Upstate",1,0,2007,"7480","59.458774","206","458","805",488,317,191,"54",137,0.2807,0.1703,0.2373,0.5689
"11227",218742,"University of South Carolina-Upstate",1,0,2008,"8062","65.150327","214","382","708",455,253,164,"47",117,0.2571,0.1858,0.2316,0.5395
"11228",218742,"University of South Carolina-Upstate",1,0,2009,"8362","64.228786","206","474","837",540,297,219,"63",156,0.2889,0.2121,0.2616,0.5663
"11229",218742,"University of South Carolina-Upstate",1,0,2010,"8792","66.358245","206","461","838",559,279,200,"54",146,0.2612,0.1935,0.2387,0.5501
"11230",218973,"WOFFORD COLLEGE",1,0,1991,"9790","17.909337","63","264","295",117,178,217,"124",93,0.7949,0.6966,0.7356,0.8949
"11231",218973,"WOFFORD COLLEGE",1,0,1992,"10490","20.01568","63","250","287",132,155,206,"113",93,0.7045,0.729,0.7178,0.8711
"11232",218973,"WOFFORD COLLEGE",1,0,1993,"11480","20.82517","64","248","273",109,164,210,"117",93,0.8532,0.7134,0.7692,0.9084
"11233",218973,"WOFFORD COLLEGE",1,0,1995,"13795","23.331698","65","263","286",140,146,219,"99",120,0.8571,0.6781,0.7657,0.9196
"11234",218973,"WOFFORD COLLEGE",1,0,1996,"14675","25.62907","67","266","291",132,159,204,"106",98,0.7424,0.6667,0.701,0.9141
"11235",218973,"WOFFORD COLLEGE",1,0,1997,"15390","22.502115","67","262","296",139,157,210,"102",108,0.777,0.6497,0.7095,0.8851
"11236",218973,"WOFFORD COLLEGE",1,0,1998,"16170","25.394237","68","263","298",145,153,224,"113",111,0.7655,0.7386,0.7517,0.8826
"11237",218973,"WOFFORD COLLEGE",1,0,1999,"16410","26.496739","72","269","307",154,153,226,"112",114,0.7403,0.732,0.7362,0.8762
"11238",218973,"WOFFORD COLLEGE",1,0,2000,"17030","30.747775","73.5","280","308",150,158,222,"104",118,0.7867,0.6582,0.7208,0.9091
"11239",218973,"WOFFORD COLLEGE",1,0,2001,"17760","28.466803","75","269","303",152,151,218,"100",118,0.7763,0.6623,0.7195,0.8878
"11240",218973,"WOFFORD COLLEGE",1,0,2002,"19415","38.234431","79","267","297",170,127,234,"95",139,0.8176,0.748,0.7879,0.899
"11241",218973,"WOFFORD COLLEGE",1,0,2003,"20610","37.554752","82","284","330",163,167,255,"127",128,0.7853,0.7605,0.7727,0.8606
"11242",218973,"WOFFORD COLLEGE",1,0,2004,"22300","38.019697","81","293","323",144,179,253,"129",124,0.8611,0.7207,0.7833,0.9071
"11243",218973,"Wofford College",1,0,2005,"24130","40.120314","91","280","320",144,176,241,"123",118,0.8194,0.6989,0.7531,0.875
"11244",218973,"Wofford College",1,0,2006,"26110","43.272977","99","329","377",191,186,299,"139",160,0.8377,0.7473,0.7931,0.8727
"11245",218973,"Wofford College",1,0,2007,"27830","43.461438","106","324","385",193,192,301,"141",160,0.829,0.7344,0.7818,0.8416
"11246",218973,"Wofford College",1,0,2008,"29465","44.870683","111","364","415",203,212,296,"140",156,0.7685,0.6604,0.7133,0.8771
"11247",218973,"Wofford College",1,0,2009,"29240","49.515867","117","318","391",203,188,302,"138",164,0.8079,0.734,0.7724,0.8133
"11248",218973,"Wofford College",1,0,2010,"30630","51.4535","116","357","429",202,227,334,"173",161,0.797,0.7621,0.7786,0.8322
"11249",219000,"AUGUSTANA COLLEGE",1,0,1991,"9330","24.12612","106","306","323",221,102,151,"41",110,0.4977,0.402,0.4675,0.9474
"11250",219000,"AUGUSTANA COLLEGE",1,0,1992,"9800","24.500595","109","334","347",228,119,162,"48",114,0.5,0.4034,0.4669,0.9625
"11251",219000,"AUGUSTANA COLLEGE",1,0,1993,"10180","26.167664","108","299","306",208,98,128,"25",103,0.4952,0.2551,0.4183,0.9771
"11252",219000,"AUGUSTANA COLLEGE",1,0,1995,"11780","26.522677","116","363","372",242,130,168,"52",116,0.4793,0.4,0.4516,0.9758
"11253",219000,"AUGUSTANA COLLEGE",1,0,1996,"12488","27.716925","121","374","383",244,139,190,"55",135,0.5533,0.3957,0.4961,0.9765
"11254",219000,"AUGUSTANA COLLEGE",1,0,1997,"12968","23.137652","119","318","326",209,117,171,"53",118,0.5646,0.453,0.5245,0.9755
"11255",219000,"AUGUSTANA COLLEGE",1,0,1998,"13490","24.079806","121","393","403",257,146,213,"61",152,0.5914,0.4178,0.5285,0.9752
"11256",219000,"AUGUSTANA COLLEGE",1,0,1999,"13960","25.445447","118","463","469",314,155,231,"65",166,0.5287,0.4194,0.4925,0.9872
"11257",219000,"AUGUSTANA COLLEGE",1,0,2000,"14592","26.637709","115.5","453","460",286,174,222,"76",146,0.5105,0.4368,0.4826,0.9848
"11258",219000,"AUGUSTANA COLLEGE",1,0,2001,"15280","27.549877","113","404","416",276,140,214,"58",156,0.5652,0.4143,0.5144,0.9712
"11259",219000,"AUGUSTANA COLLEGE",1,0,2002,"15892","29.279914","108","405","416",259,157,208,"74",134,0.5174,0.4713,0.5,0.9736
"11260",219000,"AUGUSTANA COLLEGE",1,0,2003,"16766","28.674608","106","409","424",281,143,217,"61",156,0.5552,0.4266,0.5118,0.9646
"11261",219000,"AUGUSTANA COLLEGE",1,0,2004,"17764","29.162617","109","377","392",231,161,197,"70",127,0.5498,0.4348,0.5026,0.9617
"11262",219000,"Augustana College",1,0,2005,"18634","30.312729","109","371","390",256,134,192,"54",138,0.5391,0.403,0.4923,0.9513
"11263",219000,"Augustana College",1,0,2006,"19750","31.010789","111","420","442",282,160,228,"64",164,0.5816,0.4,0.5158,0.9502
"11264",219000,"Augustana College",1,0,2007,"20932","34.224389","117","397","429",272,157,207,"54",153,0.5625,0.3439,0.4825,0.9254
"11265",219000,"Augustana College",1,0,2008,"22188","36.697729","119","396","426",292,134,211,"50",161,0.5514,0.3731,0.4953,0.9296
"11266",219000,"Augustana College",1,0,2009,"23276","38.733811","125","404","431",261,170,245,"80",165,0.6322,0.4706,0.5684,0.9374
"11267",219000,"Augustana College",1,0,2010,"24790","39.077763","132","371","418",276,142,226,"55",171,0.6196,0.3873,0.5407,0.8876
"11268",219046,"BLACK HILLS STATE UNIVERSITY",1,0,1991,"1770","17.515296","101","454","492",285,207,23,"5",18,0.0632,0.0242,0.0467,0.9228
"11269",219046,"BLACK HILLS STATE UNIVERSITY",1,0,1992,"2126","18.430457","106","986","1056",597,459,226,"79",147,0.2462,0.1721,0.214,0.9337
"11270",219046,"BLACK HILLS STATE UNIVERSITY",1,0,1993,"2220","20.080397","107","980","1078",586,492,243,"85",158,0.2696,0.1728,0.2254,0.9091
"11271",219046,"BLACK HILLS STATE UNIVERSITY",1,0,1995,"2458","20.212732","107","408","435",234,201,33,"8",25,0.1068,0.0398,0.0759,0.9379
"11272",219046,"BLACK HILLS STATE UNIVERSITY",1,0,1996,"2502","19.751866","110","423","452",260,192,58,"15",43,0.1654,0.0781,0.1283,0.9358
"11273",219046,"BLACK HILLS STATE UNIVERSITY",1,0,1997,"2698","20.223999","110","416","451",227,224,38,"8",30,0.1322,0.0357,0.0843,0.9224
"11274",219046,"BLACK HILLS STATE UNIVERSITY",1,0,1998,"2920","22.33186","115","594","632",381,251,48,"13",35,0.0919,0.0518,0.0759,0.9399
"11275",219046,"BLACK HILLS STATE UNIVERSITY",1,0,1999,"3115","25.149769","114","604","630",360,270,71,"17",54,0.15,0.063,0.1127,0.9587
"11276",219046,"BLACK HILLS STATE UNIVERSITY",1,0,2000,"3630","26.157765","116.5","525","586",361,225,48,"11",37,0.1025,0.0489,0.0819,0.8959
"11277",219046,"BLACK HILLS STATE UNIVERSITY",1,0,2001,"1997","27.790596","119","491","565",354,211,65,"27",38,0.1073,0.128,0.115,0.869
"11278",219046,"BLACK HILLS STATE UNIVERSITY",1,0,2002,"2080","28.020193","111","491","537",334,203,43,"11",32,0.0958,0.0542,0.0801,0.9143
"11279",219046,"BLACK HILLS STATE UNIVERSITY",1,0,2003,"2307","29.273203","114","580","653",409,244,62,"17",45,0.11,0.0697,0.0949,0.8882
"11280",219046,"BLACK HILLS STATE UNIVERSITY",1,0,2004,"2371","31.255442","123","517","581",350,231,46,"11",35,0.1,0.0476,0.0792,0.8898
"11281",219046,"Black Hills State University",1,0,2005,"2444","33.626103","124","477","584",353,231,74,"22",52,0.1473,0.0952,0.1267,0.8168
"11282",219046,"Black Hills State University",1,0,2006,"2540","34.568112","121","494","595",353,242,122,"28",94,0.2663,0.1157,0.205,0.8303
"11283",219046,"Black Hills State University",1,0,2007,"2643","38.551895","127","411","472",268,204,51,"14",37,0.1381,0.0686,0.1081,0.8708
"11284",219046,"Black Hills State University",1,0,2008,"2822","40.40985","133","455","545",345,200,64,"17",47,0.1362,0.085,0.1174,0.8349
"11285",219046,"Black Hills State University",1,0,2009,"2934","42.139467","134","473","540",308,232,85,"23",62,0.2013,0.0991,0.1574,0.8759
"11286",219046,"Black Hills State University",1,0,2010,"3194","42.877851","143","559","648",386,262,105,"30",75,0.1943,0.1145,0.162,0.8627
"11287",219082,"DAKOTA STATE UNIVERSITY",1,0,1991,"1582","9.129926","54","195","209",110,99,9,"2",7,0.0636,0.0202,0.0431,0.933
"11288",219082,"DAKOTA STATE UNIVERSITY",1,0,1992,"1653","10.207427","55","224","234",123,111,26,"12",14,0.1138,0.1081,0.1111,0.9573
"11289",219082,"DAKOTA STATE UNIVERSITY",1,0,1993,"1770","10.995956","59","200","208",116,92,14,"2",12,0.1034,0.0217,0.0673,0.9615
"11290",219082,"DAKOTA STATE UNIVERSITY",1,0,1995,"2585","11.210189","64","244","256",125,131,22,"5",17,0.136,0.0382,0.0859,0.9531
"11291",219082,"DAKOTA STATE UNIVERSITY",1,0,1996,"2607","12.250322","63","186","189",100,89,25,"5",20,0.2,0.0562,0.1323,0.9841
"11292",219082,"DAKOTA STATE UNIVERSITY",1,0,1997,"2838","12.320974","65","239","249",135,114,1,"1",0,0,0.0088,0.004,0.9598
"11293",219082,"DAKOTA STATE UNIVERSITY",1,0,1998,"3301","13.879996","62","223","231",110,121,45,"17",28,0.2545,0.1405,0.1948,0.9654
"11294",219082,"DAKOTA STATE UNIVERSITY",1,0,1999,"1867","14.759764","72","288","306",124,182,45,"21",24,0.1935,0.1154,0.1471,0.9412
"11295",219082,"DAKOTA STATE UNIVERSITY",1,0,2000,"1935","16.458575","79","306","351",149,202,51,"25",26,0.1745,0.1238,0.1453,0.8718
"11296",219082,"DAKOTA STATE UNIVERSITY",1,0,2001,"1997","18.95004","86","267","292",123,169,54,"28",26,0.2114,0.1657,0.1849,0.9144
"11297",219082,"DAKOTA STATE UNIVERSITY",1,0,2002,"2080","21.565458","82","260","273",111,162,45,"22",23,0.2072,0.1358,0.1648,0.9524
"11298",219082,"DAKOTA STATE UNIVERSITY",1,0,2003,"2163","21.387943","79","254","290",120,170,43,"18",25,0.2083,0.1059,0.1483,0.8759
"11299",219082,"DAKOTA STATE UNIVERSITY",1,0,2004,"2223","22.189127","81","221","249",114,135,44,"18",26,0.2281,0.1333,0.1767,0.8876
"11300",219082,"Dakota State University",1,0,2005,"2290","24.251108","77","265","280",135,145,29,"14",15,0.1111,0.0966,0.1036,0.9464
"11301",219082,"Dakota State University",1,0,2006,"2382","23.90253","80","276","295",137,158,41,"23",18,0.1314,0.1456,0.139,0.9356
"11302",219082,"Dakota State University",1,0,2007,"2478","24.974342","89","220","243",110,133,44,"23",21,0.1909,0.1729,0.1811,0.9053
"11303",219082,"Dakota State University",1,0,2008,"2646","26.479823","89","240","258",121,137,45,"18",27,0.2231,0.1314,0.1744,0.9302
"11304",219082,"Dakota State University",1,0,2009,"2751","28.661597","92","252","284",116,168,54,"28",26,0.2241,0.1667,0.1901,0.8873
"11305",219082,"Dakota State University",1,0,2010,"2994","31.858767","93","273","314",113,201,62,"43",19,0.1681,0.2139,0.1975,0.8694
"11306",219198,"MOUNT MARTY COLLEGE",1,0,1991,"6690","5.923169","40","114","126",95,31,38,"8",30,0.3158,0.2581,0.3016,0.9048
"11307",219198,"MOUNT MARTY COLLEGE",1,0,1992,"7078","6.979272","44","100","107",72,35,31,"9",22,0.3056,0.2571,0.2897,0.9346
"11308",219198,"MOUNT MARTY COLLEGE",1,0,1993,"7470","7.415085","39","112","117",96,21,39,"9",30,0.3125,0.4286,0.3333,0.9573
"11309",219198,"MOUNT MARTY COLLEGE",1,0,1995,"8196","8.576001","43","88","95",62,33,27,"11",16,0.2581,0.3333,0.2842,0.9263
"11310",219198,"MOUNT MARTY COLLEGE",1,0,1996,"8649","8.225183","39","108","117",77,40,42,"11",31,0.4026,0.275,0.359,0.9231
"11311",219198,"MOUNT MARTY COLLEGE",1,0,1997,"9168","8.19092","54","125","129",96,33,47,"12",35,0.3646,0.3636,0.3643,0.969
"11312",219198,"MOUNT MARTY COLLEGE",1,0,1998,"9628","8.822153","33","123","126",85,41,44,"13",31,0.3647,0.3171,0.3492,0.9762
"11313",219198,"MOUNT MARTY COLLEGE",1,0,1999,"9248","9.44689","31","119","121",84,37,34,"8",26,0.3095,0.2162,0.281,0.9835
"11314",219198,"MOUNT MARTY COLLEGE",1,0,2000,"9710","9.862531","34.5","146","154",97,57,46,"21",25,0.2577,0.3684,0.2987,0.9481
"11315",219198,"MOUNT MARTY COLLEGE",1,0,2001,"9942","11.405165","38","136","148",109,39,49,"10",39,0.3578,0.2564,0.3311,0.9189
"11316",219198,"MOUNT MARTY COLLEGE",1,0,2002,"11580","11.228505","45","134","137",104,33,44,"7",37,0.3558,0.2121,0.3212,0.9781
"11317",219198,"MOUNT MARTY COLLEGE",1,0,2003,"12506","12.679134","44","148","158",113,45,33,"11",22,0.1947,0.2444,0.2089,0.9367
"11318",219198,"MOUNT MARTY COLLEGE",1,0,2004,"13256","10.586617","50","138","150",111,39,51,"13",38,0.3423,0.3333,0.34,0.92
"11319",219198,"Mount Marty College",1,0,2005,"14050","11.221263","48","132","139",91,48,54,"15",39,0.4286,0.3125,0.3885,0.9496
"11320",219198,"Mount Marty College",1,0,2006,"14752","12.138248","49","119","127",92,35,57,"14",43,0.4674,0.4,0.4488,0.937
"11321",219198,"Mount Marty College",1,0,2007,"15638","12.620298","50","94","108",73,35,49,"14",35,0.4795,0.4,0.4537,0.8704
"11322",219198,"Mount Marty College",1,0,2008,"16420","13.007102","54","125","136",88,48,66,"20",46,0.5227,0.4167,0.4853,0.9191
"11323",219198,"Mount Marty College",1,0,2009,"17078","12.862567","43","96","109",66,43,47,"16",31,0.4697,0.3721,0.4312,0.8807
"11324",219198,"Mount Marty College",1,0,2010,"18102","12.83341","42","107","120",64,56,48,"17",31,0.4844,0.3036,0.4,0.8917
"11325",219259,"NORTHERN STATE UNIVERSITY",1,0,1991,"1835","18.031857","126","487","511",258,253,45,"15",30,0.1163,0.0593,0.0881,0.953
"11326",219259,"NORTHERN STATE UNIVERSITY",1,0,1992,"1978","18.841971","102","568","587",313,274,60,"20",40,0.1278,0.073,0.1022,0.9676
"11327",219259,"NORTHERN STATE UNIVERSITY",1,0,1993,"2120","19.991599","105","598","647",360,287,73,"14",59,0.1639,0.0488,0.1128,0.9243
"11328",219259,"NORTHERN STATE UNIVERSITY",1,0,1995,"2455","20.394184","123","544","574",343,231,75,"19",56,0.1633,0.0823,0.1307,0.9477
"11329",219259,"NORTHERN STATE UNIVERSITY",1,0,1996,"2526","20.661795","104","510","560",324,236,68,"24",44,0.1358,0.1017,0.1214,0.9107
"11330",219259,"NORTHERN STATE UNIVERSITY",1,0,1997,"2704","20.107814","105","502","539",321,218,83,"22",61,0.19,0.1009,0.154,0.9314
"11331",219259,"NORTHERN STATE UNIVERSITY",1,0,1998,"2842","21.263195","96","404","480",276,204,66,"16",50,0.1812,0.0784,0.1375,0.8417
"11332",219259,"NORTHERN STATE UNIVERSITY",1,0,1999,"1750","21.878032","90","440","523",303,220,69,"15",54,0.1782,0.0682,0.1319,0.8413
"11333",219259,"NORTHERN STATE UNIVERSITY",1,0,2000,"1812","23.681801","92.5","399","446",257,189,61,"10",51,0.1984,0.0529,0.1368,0.8946
"11334",219259,"NORTHERN STATE UNIVERSITY",1,0,2001,"1872","24.852053","95","363","409",244,165,61,"14",47,0.1926,0.0848,0.1491,0.8875
"11335",219259,"NORTHERN STATE UNIVERSITY",1,0,2002,"1950","26.440137","98","343","376",214,162,51,"12",39,0.1822,0.0741,0.1356,0.9122
"11336",219259,"NORTHERN STATE UNIVERSITY",1,0,2003,"2163","27.127744","98","297","380",210,170,59,"16",43,0.2048,0.0941,0.1553,0.7816
"11337",219259,"NORTHERN STATE UNIVERSITY",1,0,2004,"2223","27.613909","100","321","384",238,146,53,"12",41,0.1723,0.0822,0.138,0.8359
"11338",219259,"Northern State University",1,0,2005,"2290","28.638193","94","329","368",197,171,47,"13",34,0.1726,0.076,0.1277,0.894
"11339",219259,"Northern State University",1,0,2006,"2382","28.94993","93","315","367",178,189,50,"14",36,0.2022,0.0741,0.1362,0.8583
"11340",219259,"Northern State University",1,0,2007,"2478","30.035081","92","302","340",203,137,70,"15",55,0.2709,0.1095,0.2059,0.8882
"11341",219259,"Northern State University",1,0,2008,"2646","31.537527","91","347","389",204,185,67,"16",51,0.25,0.0865,0.1722,0.892
"11342",219259,"Northern State University",1,0,2009,"2751","34.580155","96","273","317",197,120,65,"16",49,0.2487,0.1333,0.205,0.8612
"11343",219259,"Northern State University",1,0,2010,"2994","35.577202","96","324","380",208,172,84,"25",59,0.2837,0.1453,0.2211,0.8526
"11344",219356,"SOUTH DAKOTA STATE UNIVERSITY",1,0,1991,"2045","79.856335","355","1278","1306",657,649,189,"77",112,0.1705,0.1186,0.1447,0.9786
"11345",219356,"SOUTH DAKOTA STATE UNIVERSITY",1,0,1992,"2146","87.839336","354","1458","1495",701,794,293,"112",181,0.2582,0.1411,0.196,0.9753
"11346",219356,"SOUTH DAKOTA STATE UNIVERSITY",1,0,1993,"2252","96.371273","367","1631","1670",831,839,320,"128",192,0.231,0.1526,0.1916,0.9766
"11347",219356,"SOUTH DAKOTA STATE UNIVERSITY",1,0,1995,"2705","96.107272","375","1615","1659",813,846,359,"135",224,0.2755,0.1596,0.2164,0.9735
"11348",219356,"SOUTH DAKOTA STATE UNIVERSITY",1,0,1996,"2784","101.291777","367","1437","1481",733,748,303,"129",174,0.2374,0.1725,0.2046,0.9703
"11349",219356,"SOUTH DAKOTA STATE UNIVERSITY",1,0,1997,"2912","103.145561","361","1444","1531",741,790,346,"130",216,0.2915,0.1646,0.226,0.9432
"11350",219356,"SOUTH DAKOTA STATE UNIVERSITY",1,0,1998,"3128","112.860757","371","1444","1510",766,744,384,"147",237,0.3094,0.1976,0.2543,0.9563
"11351",219356,"SOUTH DAKOTA STATE UNIVERSITY",1,0,1999,"1867","120.445632","355","1313","1457",714,743,342,"127",215,0.3011,0.1709,0.2347,0.9012
"11352",219356,"SOUTH DAKOTA STATE UNIVERSITY",1,0,2000,"1933","122.61015","350.5","1363","1446",740,706,327,"129",198,0.2676,0.1827,0.2261,0.9426
"11353",219356,"SOUTH DAKOTA STATE UNIVERSITY",1,0,2001,"1997","131.874849","346","1396","1495",751,744,316,"105",211,0.281,0.1411,0.2114,0.9338
"11354",219356,"SOUTH DAKOTA STATE UNIVERSITY",1,0,2002,"2080","136.88842","367","1671","1767",864,903,348,"140",208,0.2407,0.155,0.1969,0.9457
"11355",219356,"SOUTH DAKOTA STATE UNIVERSITY",1,0,2003,"2307","145.235732","397","1881","1993",957,1036,427,"176",251,0.2623,0.1699,0.2142,0.9438
"11356",219356,"SOUTH DAKOTA STATE UNIVERSITY",1,0,2004,"2371","157.470833","408","1824","1993",1011,982,485,"194",291,0.2878,0.1976,0.2434,0.9152
"11357",219356,"South Dakota State University",1,0,2005,"2443","170.118404","411","1646","1784",893,891,528,"213",315,0.3527,0.2391,0.296,0.9226
"11358",219356,"South Dakota State University",1,0,2006,"2382","173.985776","423","1688","1833",922,911,484,"173",311,0.3373,0.1899,0.264,0.9209
"11359",219356,"South Dakota State University",1,0,2007,"2478","188.308218","493","1764","1933",950,983,495,"183",312,0.3284,0.1862,0.2561,0.9126
"11360",219356,"South Dakota State University",1,0,2008,"2646","207.866695","478","1886","2008",987,1021,563,"237",326,0.3303,0.2321,0.2804,0.9392
"11361",219356,"South Dakota State University",1,0,2009,"2751","224.897436","476","1889","2043",1032,1011,602,"247",355,0.344,0.2443,0.2947,0.9246
"11362",219356,"South Dakota State University",1,0,2010,"2994","241.09201","479","1985","2157",1051,1106,613,"270",343,0.3264,0.2441,0.2842,0.9203
"11363",219471,"UNIVERSITY OF SOUTH DAKOTA",1,0,1991,"1977","63.500907","329","1110","1150",661,489,223,"78",145,0.2194,0.1595,0.1939,0.9652
"11364",219471,"UNIVERSITY OF SOUTH DAKOTA",1,0,1992,"2073","70.357188","345","1153","1228",686,542,239,"79",160,0.2332,0.1458,0.1946,0.9389
"11365",219471,"UNIVERSITY OF SOUTH DAKOTA",1,0,1993,"2294","76.307124","361","1166","1227",704,523,247,"79",168,0.2386,0.1511,0.2013,0.9503
"11366",219471,"UNIVERSITY OF SOUTH DAKOTA",1,0,1995,"2803","78.902286","339","1095","1160",660,500,224,"60",164,0.2485,0.12,0.1931,0.944
"11367",219471,"UNIVERSITY OF SOUTH DAKOTA",1,0,1996,"2885","83.019531","318","833","875",489,386,175,"62",113,0.2311,0.1606,0.2,0.952
"11368",219471,"UNIVERSITY OF SOUTH DAKOTA",1,0,1997,"2918","80.101903","328","842","896",503,393,213,"80",133,0.2644,0.2036,0.2377,0.9397
"11369",219471,"UNIVERSITY OF SOUTH DAKOTA",1,0,1998,"3216","86.745775","323","824","894",500,394,180,"58",122,0.244,0.1472,0.2013,0.9217
"11370",219471,"UNIVERSITY OF SOUTH DAKOTA",1,0,1999,"1867","89.187424","322","781","868",493,375,176,"53",123,0.2495,0.1413,0.2028,0.8998
"11371",219471,"UNIVERSITY OF SOUTH DAKOTA",1,0,2000,"1933","90.373426","297","811","918",504,414,199,"62",137,0.2718,0.1498,0.2168,0.8834
"11372",219471,"UNIVERSITY OF SOUTH DAKOTA",1,0,2001,"1997","96.471169","272","843","932",578,354,196,"45",151,0.2612,0.1271,0.2103,0.9045
"11373",219471,"UNIVERSITY OF SOUTH DAKOTA",1,0,2002,"2080","100.472528","312","876","976",544,432,186,"74",112,0.2059,0.1713,0.1906,0.8975
"11374",219471,"UNIVERSITY OF SOUTH DAKOTA",1,0,2003,"2307","109.739793","327","855","982",539,443,186,"76",110,0.2041,0.1716,0.1894,0.8707
"11375",219471,"UNIVERSITY OF SOUTH DAKOTA",1,0,2004,"2371","115.395513","336","841","945",538,407,220,"80",140,0.2602,0.1966,0.2328,0.8899
"11376",219471,"University of South Dakota",1,0,2005,"2443","123.355714","285","908","1030",621,409,236,"74",162,0.2609,0.1809,0.2291,0.8816
"11377",219471,"University of South Dakota",1,0,2006,"2541","126.192875","287","998","1109",674,435,237,"88",149,0.2211,0.2023,0.2137,0.8999
"11378",219471,"University of South Dakota",1,0,2007,"2643","145.156773","254","810","1030",612,418,282,"105",177,0.2892,0.2512,0.2738,0.7864
"11379",219471,"University of South Dakota",1,0,2008,"2646","151.72046","310","835","1023",597,426,295,"111",184,0.3082,0.2606,0.2884,0.8162
"11380",219471,"University of South Dakota",1,0,2009,"2751","153.248035","309","791","971",559,412,286,"91",195,0.3488,0.2209,0.2945,0.8146
"11381",219471,"University of South Dakota",1,0,2010,"2994","162.124744","299","840","1034",622,412,313,"114",199,0.3199,0.2767,0.3027,0.8124
"11382",219602,"AUSTIN PEAY STATE UNIVERSITY",1,0,1991,"1628","36.290052","208","563","771",492,279,70,"14",56,0.1138,0.0502,0.0908,0.7302
"11383",219602,"AUSTIN PEAY STATE UNIVERSITY",1,0,1992,"1726","37.591529","229","577","752",471,281,164,"46",118,0.2505,0.1637,0.2181,0.7673
"11384",219602,"AUSTIN PEAY STATE UNIVERSITY",1,0,1993,"1800","43.317422","253","587","788",474,314,152,"50",102,0.2152,0.1592,0.1929,0.7449
"11385",219602,"AUSTIN PEAY STATE UNIVERSITY",1,0,1995,"1946","49.310878","268","591","776",457,319,105,"26",79,0.1729,0.0815,0.1353,0.7616
"11386",219602,"AUSTIN PEAY STATE UNIVERSITY",1,0,1996,"2108","50.882681","276","609","777",498,279,156,"38",118,0.2369,0.1362,0.2008,0.7838
"11387",219602,"AUSTIN PEAY STATE UNIVERSITY",1,0,1997,"2280","51.86845","272","595","788",503,285,144,"40",104,0.2068,0.1404,0.1827,0.7551
"11388",219602,"AUSTIN PEAY STATE UNIVERSITY",1,0,1998,"2470","53.433232","267","612","846",518,328,76,"20",56,0.1081,0.061,0.0898,0.7234
"11389",219602,"AUSTIN PEAY STATE UNIVERSITY",1,0,1999,"2584","58.788625","269","506","715",432,283,66,"22",44,0.1019,0.0777,0.0923,0.7077
"11390",219602,"AUSTIN PEAY STATE UNIVERSITY",1,0,2000,"2222","61.06747","275","630","870",554,316,101,"29",72,0.13,0.0918,0.1161,0.7241
"11391",219602,"AUSTIN PEAY STATE UNIVERSITY",1,0,2001,"2556","63.052656","281","642","900",569,331,77,"20",57,0.1002,0.0604,0.0856,0.7133
"11392",219602,"AUSTIN PEAY STATE UNIVERSITY",1,0,2002,"2748","67.43336","269","662","986",636,350,126,"37",89,0.1399,0.1057,0.1278,0.6714
"11393",219602,"AUSTIN PEAY STATE UNIVERSITY",1,0,2003,"3132","67.785126","261","677","967",609,358,118,"33",85,0.1396,0.0922,0.122,0.7001
"11394",219602,"AUSTIN PEAY STATE UNIVERSITY",1,0,2004,"3352","70.348339","262","837","1196",714,482,173,"64",109,0.1527,0.1328,0.1446,0.6998
"11395",219602,"Austin Peay State University",1,0,2005,"3678","79.50216","290","869","1226",708,518,175,"70",105,0.1483,0.1351,0.1427,0.7088
"11396",219602,"Austin Peay State University",1,0,2006,"3828","85.589343","294","809","1210",731,479,188,"56",132,0.1806,0.1169,0.1554,0.6686
"11397",219602,"Austin Peay State University",1,0,2007,"4058","95.595163","286","739","1188",683,505,178,"55",123,0.1801,0.1089,0.1498,0.6221
"11398",219602,"Austin Peay State University",1,0,2008,"4302","106.999483","302","858","1326",806,520,208,"70",138,0.1712,0.1346,0.1569,0.6471
"11399",219602,"Austin Peay State University",1,0,2009,"4584","109.969629","310","1038","1465",897,568,214,"74",140,0.1561,0.1303,0.1461,0.7085
"11400",219602,"Austin Peay State University",1,0,2010,"4824","112.330096","327","981","1478",903,575,252,"88",164,0.1816,0.153,0.1705,0.6637
"11401",219709,"BELMONT UNIVERSITY",1,0,1991,"6100","20.657121","132","223","238",146,92,68,"21",47,0.3219,0.2283,0.2857,0.937
"11402",219709,"BELMONT UNIVERSITY",1,0,1992,"6480","24.326694","132","264","285",158,127,93,"41",52,0.3291,0.3228,0.3263,0.9263
"11403",219709,"BELMONT UNIVERSITY",1,0,1993,"7300","27.419394","150","307","328",182,146,137,"58",79,0.4341,0.3973,0.4177,0.936
"11404",219709,"BELMONT UNIVERSITY",1,0,1995,"8750","32.630225","154","313","347",221,126,14,"3",11,0.0498,0.0238,0.0403,0.902
"11405",219709,"BELMONT UNIVERSITY",1,0,1996,"9500","35.203853","158","389","418",262,156,185,"66",119,0.4542,0.4231,0.4426,0.9306
"11406",219709,"BELMONT UNIVERSITY",1,0,1997,"10300","40.278942","164","365","399",248,151,197,"67",130,0.5242,0.4437,0.4937,0.9148
"11407",219709,"BELMONT UNIVERSITY",1,0,1998,"11050","44.292064","187","377","413",254,159,201,"73",128,0.5039,0.4591,0.4867,0.9128
"11408",219709,"BELMONT UNIVERSITY",1,0,1999,"11300","43.672805","184","447","487",300,187,266,"91",175,0.5833,0.4866,0.5462,0.9179
"11409",219709,"BELMONT UNIVERSITY",1,0,2000,"11990","43.4297","175","479","516",309,207,278,"108",170,0.5502,0.5217,0.5388,0.9283
"11410",219709,"BELMONT UNIVERSITY",1,0,2001,"13040","47.852266","166","455","502",309,193,284,"121",163,0.5275,0.6269,0.5657,0.9064
"11411",219709,"BELMONT UNIVERSITY",1,0,2002,"13690","53.089186","195","476","524",320,204,264,"91",173,0.5406,0.4461,0.5038,0.9084
"11412",219709,"BELMONT UNIVERSITY",1,0,2003,"15164","55.105276","208","555","599",360,239,312,"110",202,0.5611,0.4603,0.5209,0.9265
"11413",219709,"BELMONT UNIVERSITY",1,0,2004,"15360","63.719038","203","661","727",442,285,429,"168",261,0.5905,0.5895,0.5901,0.9092
"11414",219709,"Belmont University",1,0,2005,"16360","69.638784","214","715","791",488,303,483,"180",303,0.6209,0.5941,0.6106,0.9039
"11415",219709,"Belmont University",1,0,2006,"17470","75.545161","227","679","763",439,324,422,"160",262,0.5968,0.4938,0.5531,0.8899
"11416",219709,"Belmont University",1,0,2007,"18780","79.768477","243","706","799",453,346,449,"187",262,0.5784,0.5405,0.562,0.8836
"11417",219709,"Belmont University",1,0,2008,"20070","93.622312","273","800","928",519,409,520,"217",303,0.5838,0.5306,0.5603,0.8621
"11418",219709,"Belmont University",1,0,2009,"21770","102.875904","276","870","986",558,428,561,"222",339,0.6075,0.5187,0.569,0.8824
"11419",219709,"Belmont University",1,0,2010,"22530","103.408923","290","877","1013",581,432,597,"247",350,0.6024,0.5718,0.5893,0.8657
"11420",219718,"BETHEL COLLEGE",1,0,1991,"4350","5.152243","25","98","107",68,39,12,"6",6,0.0882,0.1538,0.1121,0.9159
"11421",219718,"BETHEL COLLEGE",1,0,1992,"5250","5.205393","26","86","104",65,39,12,"6",6,0.0923,0.1538,0.1154,0.8269
"11422",219718,"BETHEL COLLEGE",1,0,1993,"6200","6.064687","27","97","125",43,82,15,"4",11,0.2558,0.0488,0.12,0.776
"11423",219718,"BETHEL COLLEGE",1,0,1995,"7000","6.302309","28","125","149",52,97,17,"5",12,0.2308,0.0515,0.1141,0.8389
"11424",219718,"BETHEL COLLEGE",1,0,1996,"6990","7.303909","29","156","180",82,98,24,"6",18,0.2195,0.0612,0.1333,0.8667
"11425",219718,"BETHEL COLLEGE",1,0,1997,"6990","7.005585","30","60","65",26,39,8,"2",6,0.2308,0.0513,0.1231,0.9231
"11426",219718,"BETHEL COLLEGE",1,0,1998,"6990","7.088196","35","70","82",29,53,16,"6",10,0.3448,0.1132,0.1951,0.8537
"11427",219718,"BETHEL COLLEGE",1,0,1999,"7800","8.598689","34","110","142",42,100,17,"10",7,0.1667,0.1,0.1197,0.7746
"11428",219718,"BETHEL COLLEGE",1,0,2000,"7860","9.969952","35.5","104","137",44,93,17,"7",10,0.2273,0.0753,0.1241,0.7591
"11429",219718,"BETHEL COLLEGE",1,0,2001,"8180","11.544378","37","103","141",63,78,21,"3",18,0.2857,0.0385,0.1489,0.7305
"11430",219718,"BETHEL COLLEGE",1,0,2002,"8180","13.819414","38","85","139",53,86,16,"5",11,0.2075,0.0581,0.1151,0.6115
"11431",219718,"BETHEL COLLEGE",1,0,2003,"9360","16.05358","36","90","129",59,70,27,"10",17,0.2881,0.1429,0.2093,0.6977
"11432",219718,"BETHEL COLLEGE",1,0,2004,"9360","18.618417","58","149","252",97,155,40,"15",25,0.2577,0.0968,0.1587,0.5913
"11433",219718,"Bethel College",1,0,2005,"10016","22.347585","66","139","234",108,126,29,"9",20,0.1852,0.0714,0.1239,0.594
"11434",219718,"Bethel College",1,0,2006,"10516","26.10079","61","144","243",94,149,26,"13",13,0.1383,0.0872,0.107,0.5926
"11435",219718,"Bethel College",1,0,2007,"11040","23.534141","84","145","255",115,140,27,"13",14,0.1217,0.0929,0.1059,0.5686
"11436",219718,"Bethel College",1,0,2008,"11592","26.119732","87","168","268",122,146,57,"19",38,0.3115,0.1301,0.2127,0.6269
"11437",219718,"Bethel University",1,0,2009,"11592","29.951844","97","195","351",151,200,90,"36",54,0.3576,0.18,0.2564,0.5556
"11438",219718,"Bethel University",1,0,2010,"12288","34.035022","110","265","377",133,244,51,"27",24,0.1805,0.1107,0.1353,0.7029
"11439",219949,"CUMBERLAND UNIVERSITY",1,0,1991,"4700","4.996815","31","153","165",88,77,26,"13",13,0.1477,0.1688,0.1576,0.9273
"11440",219949,"CUMBERLAND UNIVERSITY",1,0,1992,"5000","5.265942","32","147","173",80,93,40,"18",22,0.275,0.1935,0.2312,0.8497
"11441",219949,"CUMBERLAND UNIVERSITY",1,0,1993,"5500","6.082368","33","134","169",106,63,37,"6",31,0.2925,0.0952,0.2189,0.7929
"11442",219949,"CUMBERLAND UNIVERSITY",1,0,1995,"6950","7.916141","63","137","171",64,107,38,"17",21,0.3281,0.1589,0.2222,0.8012
"11443",219949,"CUMBERLAND UNIVERSITY",1,0,1996,"7440","9.235819","66","128","154",78,76,37,"10",27,0.3462,0.1316,0.2403,0.8312
"11444",219949,"CUMBERLAND UNIVERSITY",1,0,1997,"8590","10.993691","66","149","186",91,95,42,"10",32,0.3516,0.1053,0.2258,0.8011
"11445",219949,"CUMBERLAND UNIVERSITY",1,0,1998,"9000","12.842366","55","197","236",111,125,44,"8",36,0.3243,0.064,0.1864,0.8347
"11446",219949,"CUMBERLAND UNIVERSITY",1,0,1999,"9850","14.55596","52","141","174",67,107,36,"19",17,0.2537,0.1776,0.2069,0.8103
"11447",219949,"CUMBERLAND UNIVERSITY",1,0,2000,"10530","11.738123","58","145","189",78,111,28,"9",19,0.2436,0.0811,0.1481,0.7672
"11448",219949,"CUMBERLAND UNIVERSITY",1,0,2001,"10950","12.906791","64","164","200",92,108,39,"15",24,0.2609,0.1389,0.195,0.82
"11449",219949,"CUMBERLAND UNIVERSITY",1,0,2002,"11660","13.040698","70","128","164",74,90,35,"6",29,0.3919,0.0667,0.2134,0.7805
"11450",219949,"CUMBERLAND UNIVERSITY",1,0,2003,"12130","13.396581","63","113","149",76,73,24,"9",15,0.1974,0.1233,0.1611,0.7584
"11451",219949,"CUMBERLAND UNIVERSITY",1,0,2004,"12130","13.533703","54","159","203",104,99,37,"15",22,0.2115,0.1515,0.1823,0.7833
"11452",219949,"Cumberland University",1,0,2005,"13344","14.379162","50","178","217",107,110,44,"17",27,0.2523,0.1545,0.2028,0.8203
"11453",219949,"Cumberland University",1,0,2006,"14010","15.010919","48","138","189",75,114,34,"8",26,0.3467,0.0702,0.1799,0.7302
"11454",219949,"Cumberland University",1,0,2007,"14710","15.474511","40","158","210",75,135,43,"22",21,0.28,0.163,0.2048,0.7524
"11455",219949,"Cumberland University",1,0,2008,"15820","16.411147","36","154","194",82,112,43,"20",23,0.2805,0.1786,0.2216,0.7938
"11456",219949,"Cumberland University",1,0,2009,"16530","17.135262","39","160","200",101,99,62,"25",37,0.3663,0.2525,0.31,0.8
"11457",219949,"Cumberland University",1,0,2010,"17356","17.990519","48","130","163",67,96,56,"29",27,0.403,0.3021,0.3436,0.7975
"11458",220075,"EAST TENNESSEE STATE UNIVERSITY",1,0,1991,"1456","100.619274","450","1481","1599",950,649,149,"47",102,0.1074,0.0724,0.0932,0.9262
"11459",220075,"EAST TENNESSEE STATE UNIVERSITY",1,0,1992,"1554","106.13694","474","1450","1610",971,639,150,"37",113,0.1164,0.0579,0.0932,0.9006
"11460",220075,"EAST TENNESSEE STATE UNIVERSITY",1,0,1993,"1680","116.070983","486","1159","1289",757,532,128,"51",77,0.1017,0.0959,0.0993,0.8991
"11461",220075,"EAST TENNESSEE STATE UNIVERSITY",1,0,1995,"1878","135.472106","496","1371","1505",867,638,178,"59",119,0.1373,0.0925,0.1183,0.911
"11462",220075,"EAST TENNESSEE STATE UNIVERSITY",1,0,1996,"1928","146.474484","442","1392","1532",894,638,186,"62",124,0.1387,0.0972,0.1214,0.9086
"11463",220075,"EAST TENNESSEE STATE UNIVERSITY",1,0,1997,"2100","154.380282","481","1339","1487",853,634,192,"70",122,0.143,0.1104,0.1291,0.9005
"11464",220075,"EAST TENNESSEE STATE UNIVERSITY",1,0,1998,"2384","164.613607","482","1357","1507",880,627,204,"64",140,0.1591,0.1021,0.1354,0.9005
"11465",220075,"EAST TENNESSEE STATE UNIVERSITY",1,0,1999,"2020","177.652282","476","1313","1466",821,645,217,"62",155,0.1888,0.0961,0.148,0.8956
"11466",220075,"EAST TENNESSEE STATE UNIVERSITY",1,0,2000,"2222","174.512558","474.5","1321","1483",824,659,244,"73",171,0.2075,0.1108,0.1645,0.8908
"11467",220075,"EAST TENNESSEE STATE UNIVERSITY",1,0,2001,"2556","206.12221","473","1322","1472",838,634,255,"79",176,0.21,0.1246,0.1732,0.8981
"11468",220075,"EAST TENNESSEE STATE UNIVERSITY",1,0,2002,"2748","200.972045","490","1325","1473",831,642,262,"76",186,0.2238,0.1184,0.1779,0.8995
"11469",220075,"EAST TENNESSEE STATE UNIVERSITY",1,0,2003,"3132","205.584799","500","1433","1563",921,642,301,"99",202,0.2193,0.1542,0.1926,0.9168
"11470",220075,"EAST TENNESSEE STATE UNIVERSITY",1,0,2004,"3352","204.04297","462","1311","1479",846,633,259,"76",183,0.2163,0.1201,0.1751,0.8864
"11471",220075,"East Tennessee State University",1,0,2005,"3678","219.625382","469","1404","1565",897,668,308,"102",206,0.2297,0.1527,0.1968,0.8971
"11472",220075,"East Tennessee State University",1,0,2006,"3828","234.510343","479","1495","1712",966,746,279,"106",173,0.1791,0.1421,0.163,0.8732
"11473",220075,"East Tennessee State University",1,0,2007,"4058","247.158316","499","1669","1918",1063,855,330,"110",220,0.207,0.1287,0.1721,0.8702
"11474",220075,"East Tennessee State University",1,0,2008,"4302","276.595688","505","1665","1932",1069,863,380,"133",247,0.2311,0.1541,0.1967,0.8618
"11475",220075,"East Tennessee State University",1,0,2009,"4584","291.493653","516","1785","2063",1144,919,415,"146",269,0.2351,0.1589,0.2012,0.8652
"11476",220075,"East Tennessee State University",1,0,2010,"4824","297.431531","536","1714","2052",1165,887,406,"147",259,0.2223,0.1657,0.1979,0.8353
"11477",220215,"FREED-HARDEMAN UNIVERSITY",1,0,1991,"5040","14.260591","70","275","295",147,148,80,"38",42,0.2857,0.2568,0.2712,0.9322
"11478",220215,"FREED-HARDEMAN UNIVERSITY",1,0,1992,"5560","14.583932","65","269","286",156,130,92,"32",60,0.3846,0.2462,0.3217,0.9406
"11479",220215,"FREED-HARDEMAN UNIVERSITY",1,0,1993,"5605","15.372086","75","276","296",169,127,83,"31",52,0.3077,0.2441,0.2804,0.9324
"11480",220215,"FREED-HARDEMAN UNIVERSITY",1,0,1995,"6620","17.101661","79","279","294",170,124,90,"37",53,0.3118,0.2984,0.3061,0.949
"11481",220215,"FREED-HARDEMAN UNIVERSITY",1,0,1996,"7120","18.140125","83","298","314",194,120,107,"30",77,0.3969,0.25,0.3408,0.949
"11482",220215,"FREED-HARDEMAN UNIVERSITY",1,0,1997,"7524","15.274645","84","279","294",181,113,100,"40",60,0.3315,0.354,0.3401,0.949
"11483",220215,"FREED-HARDEMAN UNIVERSITY",1,0,1998,"7894","15.66514","87","339","358",199,159,116,"53",63,0.3166,0.3333,0.324,0.9469
"11484",220215,"FREED-HARDEMAN UNIVERSITY",1,0,1999,"7328","19.805562","95","287","322",187,135,125,"59",66,0.3529,0.437,0.3882,0.8913
"11485",220215,"FREED-HARDEMAN UNIVERSITY",1,0,2000,"7696","22.777371","94","336","357",198,159,132,"60",72,0.3636,0.3774,0.3697,0.9412
"11486",220215,"FREED-HARDEMAN UNIVERSITY",1,0,2001,"8080","23.783654","93","317","346",191,155,146,"58",88,0.4607,0.3742,0.422,0.9162
"11487",220215,"FREED-HARDEMAN UNIVERSITY",1,0,2002,"8568","25.144579","94","385","414",231,183,181,"73",108,0.4675,0.3989,0.4372,0.93
"11488",220215,"FREED-HARDEMAN UNIVERSITY",1,0,2003,"9300","26.745","97","347","374",211,163,138,"53",85,0.4028,0.3252,0.369,0.9278
"11489",220215,"FREED-HARDEMAN UNIVERSITY",1,0,2004,"10080","28.647074","99","342","371",205,166,145,"54",91,0.4439,0.3253,0.3908,0.9218
"11490",220215,"Freed-Hardeman University",1,0,2005,"10500","31.057661","106","340","373",203,170,139,"61",78,0.3842,0.3588,0.3727,0.9115
"11491",220215,"Freed-Hardeman University",1,0,2006,"11100","34.224788","112","331","358",206,152,145,"48",97,0.4709,0.3158,0.405,0.9246
"11492",220215,"Freed-Hardeman University",1,0,2007,"11100","35.027312","108","346","385",222,163,148,"58",90,0.4054,0.3558,0.3844,0.8987
"11493",220215,"Freed-Hardeman University",1,0,2008,"11700","36.19703","113","368","405",220,185,154,"61",93,0.4227,0.3297,0.3802,0.9086
"11494",220215,"Freed-Hardeman University",1,0,2009,"12060","37.149297","106","358","405",240,165,177,"72",105,0.4375,0.4364,0.437,0.884
"11495",220215,"Freed-Hardeman University",1,0,2010,"12840","34.897339","97","328","370",214,156,164,"62",102,0.4766,0.3974,0.4432,0.8865
"11496",220613,"LEE COLLEGE",1,0,1991,"4418","13.62484","73","336","368",185,183,62,"24",38,0.2054,0.1311,0.1685,0.913
"11497",220613,"LEE COLLEGE",1,0,1992,"4282","14.421178","75","278","359",207,152,63,"20",43,0.2077,0.1316,0.1755,0.7744
"11498",220613,"LEE COLLEGE",1,0,1993,"4560","15.881982","74","337","395",205,190,87,"37",50,0.2439,0.1947,0.2203,0.8532
"11499",220613,"LEE COLLEGE",1,0,1995,"5132","17.656985","94","479","493",287,206,115,"37",78,0.2718,0.1796,0.2333,0.9716
"11500",220613,"LEE COLLEGE",1,0,1996,"5472","20.304452","87","504","525",304,221,128,"45",83,0.273,0.2036,0.2438,0.96
"11501",220613,"LEE UNIVERSITY",1,0,1997,"5636","23.215392","94","627","655",379,276,149,"50",99,0.2612,0.1812,0.2275,0.9573
"11502",220613,"LEE UNIVERSITY",1,0,1998,"5966","24.896337","99","640","722",417,305,193,"62",131,0.3141,0.2033,0.2673,0.8864
"11503",220613,"LEE UNIVERSITY",1,0,1999,"6118","27.74747","119","626","690",400,290,213,"80",133,0.3325,0.2759,0.3087,0.9072
"11504",220613,"LEE UNIVERSITY",1,0,2000,"6700","31.771151","125.5","594","711",435,276,204,"72",132,0.3034,0.2609,0.2869,0.8354
"11505",220613,"LEE UNIVERSITY",1,0,2001,"7336","29.285298","132","588","663",405,258,204,"57",147,0.363,0.2209,0.3077,0.8869
"11506",220613,"LEE UNIVERSITY",1,0,2002,"8040","31.970058","133","610","705",423,282,195,"60",135,0.3191,0.2128,0.2766,0.8652
"11507",220613,"LEE UNIVERSITY",1,0,2003,"8520","35.345508","152","548","646",393,253,197,"66",131,0.3333,0.2609,0.305,0.8483
"11508",220613,"LEE UNIVERSITY",1,0,2004,"8950","38.473194","142","621","723",430,293,223,"67",156,0.3628,0.2287,0.3084,0.8589
"11509",220613,"Lee University",1,0,2005,"9400","40.047494","168","629","755",454,301,297,"99",198,0.4361,0.3289,0.3934,0.8331
"11510",220613,"Lee University",1,0,2006,"9888","44.124462","169","648","810",473,337,270,"77",193,0.408,0.2285,0.3333,0.8
"11511",220613,"Lee University",1,0,2007,"10392","47.141815","174","624","783",437,346,271,"88",183,0.4188,0.2543,0.3461,0.7969
"11512",220613,"Lee University",1,0,2008,"10824","49.241492","160","705","848",501,347,333,"103",230,0.4591,0.2968,0.3927,0.8314
"11513",220613,"Lee University",1,0,2009,"11100","50.610343","148","692","829",507,322,288,"80",208,0.4103,0.2484,0.3474,0.8347
"11514",220613,"Lee University",1,0,2010,"11660","51.085315","161","678","851",494,357,288,"93",195,0.3947,0.2605,0.3384,0.7967
"11515",220631,"LINCOLN MEMORIAL UNIVERSITY",1,0,1991,"4790","11.438653","55","290","311",209,102,126,"40",86,0.4115,0.3922,0.4051,0.9325
"11516",220631,"LINCOLN MEMORIAL UNIVERSITY",1,0,1992,"5250","12.426145","61","302","328",207,121,127,"47",80,0.3865,0.3884,0.3872,0.9207
"11517",220631,"LINCOLN MEMORIAL UNIVERSITY",1,0,1993,"5530","12.421374","69","197","217",134,83,59,"23",36,0.2687,0.2771,0.2719,0.9078
"11518",220631,"LINCOLN MEMORIAL UNIVERSITY",1,0,1995,"6550","12.876442","70","185","204",131,73,31,"9",22,0.1679,0.1233,0.152,0.9069
"11519",220631,"LINCOLN MEMORIAL UNIVERSITY",1,0,1996,"6950","12.873655","72","186","212",134,78,58,"23",35,0.2612,0.2949,0.2736,0.8774
"11520",220631,"LINCOLN MEMORIAL UNIVERSITY",1,0,1997,"7400","12.696345","72","110","134",88,46,39,"15",24,0.2727,0.3261,0.291,0.8209
"11521",220631,"LINCOLN MEMORIAL UNIVERSITY",1,0,1998,"8100","12.922259","77","156","179",122,57,31,"10",21,0.1721,0.1754,0.1732,0.8715
"11522",220631,"LINCOLN MEMORIAL UNIVERSITY",1,0,1999,"8520","13.770334","74","102","113",80,33,35,"9",26,0.325,0.2727,0.3097,0.9027
"11523",220631,"LINCOLN MEMORIAL UNIVERSITY",1,0,2000,"9600","14.188035","76.5","146","168",104,64,50,"21",29,0.2788,0.3281,0.2976,0.869
"11524",220631,"LINCOLN MEMORIAL UNIVERSITY",1,0,2001,"10800","15.281064","79","124","153",101,52,34,"12",22,0.2178,0.2308,0.2222,0.8105
"11525",220631,"LINCOLN MEMORIAL UNIVERSITY",1,0,2002,"11760","14.664559","80","135","151",109,42,33,"8",25,0.2294,0.1905,0.2185,0.894
"11526",220631,"LINCOLN MEMORIAL UNIVERSITY",1,0,2003,"11760","18.086463","91","160","183",129,54,33,"7",26,0.2016,0.1296,0.1803,0.8743
"11527",220631,"LINCOLN MEMORIAL UNIVERSITY",1,0,2004,"12600","19.458793","94","143","201",138,63,50,"18",32,0.2319,0.2857,0.2488,0.7114
"11528",220631,"Lincoln Memorial University",1,0,2005,"13104","21.963725","101","105","139",90,49,25,"6",19,0.2111,0.1224,0.1799,0.7554
"11529",220631,"Lincoln Memorial University",1,0,2006,"13752","25.115333","113","185","219",135,84,3,"0",3,0.0222,0,0.0137,0.8447
"11530",220631,"Lincoln Memorial University",1,0,2007,"14400","29.486288","116","198","230",159,71,23,"19",4,0.0252,0.2676,0.1,0.8609
"11531",220631,"Lincoln Memorial University",1,0,2008,"15120","37.139969","120","209","256",169,87,31,"10",21,0.1243,0.1149,0.1211,0.8164
"11532",220631,"Lincoln Memorial University",1,0,2009,"15120","53.419004","138","243","314",218,96,61,"15",46,0.211,0.1562,0.1943,0.7739
"11533",220631,"Lincoln Memorial University",1,0,2010,"16200","56.501941","150","254","352",232,120,115,"46",69,0.2974,0.3833,0.3267,0.7216
"11534",220710,"MARYVILLE COLLEGE",1,0,1991,"8400","10.319141","47","128","154",80,74,50,"16",34,0.425,0.2162,0.3247,0.8312
"11535",220710,"MARYVILLE COLLEGE",1,0,1992,"9580","11.249799","50","172","194",94,100,67,"23",44,0.4681,0.23,0.3454,0.8866
"11536",220710,"MARYVILLE COLLEGE",1,0,1993,"10428","12.895505","50","161","175",73,102,56,"28",28,0.3836,0.2745,0.32,0.92
"11537",220710,"MARYVILLE COLLEGE",1,0,1995,"12246","15.796479","51","197","217",106,111,86,"32",54,0.5094,0.2883,0.3963,0.9078
"11538",220710,"MARYVILLE COLLEGE",1,0,1996,"13030","18.183268","57","231","259",134,125,134,"54",80,0.597,0.432,0.5174,0.8919
"11539",220710,"MARYVILLE COLLEGE",1,0,1997,"14425","13.487322","61","227","245",117,128,99,"44",55,0.4701,0.3438,0.4041,0.9265
"11540",220710,"MARYVILLE COLLEGE",1,0,1998,"15425","14.341171","61","206","228",132,96,96,"35",61,0.4621,0.3646,0.4211,0.9035
"11541",220710,"MARYVILLE COLLEGE",1,0,1999,"15600","15.211762","58","285","313",174,139,141,"50",91,0.523,0.3597,0.4505,0.9105
"11542",220710,"MARYVILLE COLLEGE",1,0,2000,"16224","16.287094","58.5","244","269",132,137,135,"54",81,0.6136,0.3942,0.5019,0.9071
"11543",220710,"MARYVILLE COLLEGE",1,0,2001,"16985","17.406011","59","257","288",166,122,133,"35",98,0.5904,0.2869,0.4618,0.8924
"11544",220710,"MARYVILLE COLLEGE",1,0,2002,"18260","18.450827","64","208","246",127,119,103,"44",59,0.4646,0.3697,0.4187,0.8455
"11545",220710,"MARYVILLE COLLEGE",1,0,2003,"19180","19.848705","65","270","293",140,153,133,"51",82,0.5857,0.3333,0.4539,0.9215
"11546",220710,"MARYVILLE COLLEGE",1,0,2004,"20465","21.854631","66","292","317",169,148,155,"56",99,0.5858,0.3784,0.489,0.9211
"11547",220710,"Maryville College",1,0,2005,"21624","22.079983","67","292","333",163,170,158,"67",91,0.5583,0.3941,0.4745,0.8769
"11548",220710,"Maryville College",1,0,2006,"23125","23.873063","79","265","298",163,135,123,"49",74,0.454,0.363,0.4128,0.8893
"11549",220710,"Maryville College",1,0,2007,"24675","26.728965","80","271","317",158,159,148,"49",99,0.6266,0.3082,0.4669,0.8549
"11550",220710,"Maryville College",1,0,2008,"26272","28.385028","95","262","297",146,151,120,"50",70,0.4795,0.3311,0.404,0.8822
"11551",220710,"Maryville College",1,0,2009,"27296","28.072635","79","260","304",154,150,56,"46",10,0.0649,0.3067,0.1842,0.8553
"11552",220710,"Maryville College",1,0,2010,"28798","28.359496","79","226","277",126,151,129,"53",76,0.6032,0.351,0.4657,0.8159
"11553",221351,"RHODES COLLEGE",1,0,1991,"12958","30.782669","104","345","379",208,171,258,"108",150,0.7212,0.6316,0.6807,0.9103
"11554",221351,"RHODES COLLEGE",1,0,1992,"13950","33.046371","109","330","360",202,158,256,"113",143,0.7079,0.7152,0.7111,0.9167
"11555",221351,"RHODES COLLEGE",1,0,1993,"14916","34.922069","110","350","385",215,170,284,"124",160,0.7442,0.7294,0.7377,0.9091
"11556",221351,"RHODES COLLEGE",1,0,1995,"15920","35.905507","109","340","373",204,169,256,"105",151,0.7402,0.6213,0.6863,0.9115
"11557",221351,"RHODES COLLEGE",1,0,1996,"16550","40.214671","116","357","375",196,179,264,"128",136,0.6939,0.7151,0.704,0.952
"11558",221351,"RHODES COLLEGE",1,0,1997,"17518","32.224838","115","370","422",239,183,301,"128",173,0.7238,0.6995,0.7133,0.8768
"11559",221351,"RHODES COLLEGE",1,0,1998,"18196","35.568598","119","343","383",206,177,291,"128",163,0.7913,0.7232,0.7598,0.8956
"11560",221351,"RHODES COLLEGE",1,0,1999,"18561","37.215756","114","382","438",251,187,338,"143",195,0.7769,0.7647,0.7717,0.8721
"11561",221351,"RHODES COLLEGE",1,0,2000,"19303","38.215657","125.5","352","396",227,169,296,"125",171,0.7533,0.7396,0.7475,0.8889
"11562",221351,"RHODES COLLEGE",1,0,2001,"20366","41.270522","137","359","417",249,168,292,"107",185,0.743,0.6369,0.7002,0.8609
"11563",221351,"RHODES COLLEGE",1,0,2002,"21366","44.011755","139","379","439",238,201,306,"136",170,0.7143,0.6766,0.697,0.8633
"11564",221351,"RHODES COLLEGE",1,0,2003,"22628","46.725832","149","397","456",274,182,343,"140",203,0.7409,0.7692,0.7522,0.8706
"11565",221351,"RHODES COLLEGE",1,0,2004,"23964","48.40488","148","424","474",269,205,360,"144",216,0.803,0.7024,0.7595,0.8945
"11566",221351,"Rhodes College",1,0,2005,"26175","51.023346","157","375","440",255,185,313,"131",182,0.7137,0.7081,0.7114,0.8523
"11567",221351,"Rhodes College",1,0,2006,"27450","55.441308","147","375","451",272,179,363,"141",222,0.8162,0.7877,0.8049,0.8315
"11568",221351,"Rhodes College",1,0,2007,"30342","57.943836","149","357","452",252,200,335,"148",187,0.7421,0.74,0.7412,0.7898
"11569",221351,"Rhodes College",1,0,2008,"32136","59.573707","155","342","475",276,199,353,"143",210,0.7609,0.7186,0.7432,0.72
"11570",221351,"Rhodes College",1,0,2009,"33400","61.795049","159","297","427",236,191,320,"133",187,0.7924,0.6963,0.7494,0.6956
"11571",221351,"Rhodes College",1,0,2010,"34270","62.975442","164","390","500",307,193,382,"139",243,0.7915,0.7202,0.764,0.78
"11572",221519,"THE UNIVERSITY OF THE SOUTH",1,0,1991,"13505","31.052787","97","297","327",159,168,236,"118",118,0.7421,0.7024,0.7217,0.9083
"11573",221519,"UNIVERSITY OF THE SOUTH",1,0,1992,"14060","37.082047","95","317","338",171,167,230,"111",119,0.6959,0.6647,0.6805,0.9379
"11574",221519,"UNIVERSITY OF THE SOUTH",1,0,1993,"14910","41.009883","99","315","322",157,165,250,"131",119,0.758,0.7939,0.7764,0.9783
"11575",221519,"UNIVERSITY OF THE SOUTH",1,0,1995,"16140","41.230691","107","356","370",197,173,275,"120",155,0.7868,0.6936,0.7432,0.9622
"11576",221519,"UNIVERSITY OF THE SOUTH",1,0,1996,"16790","46.394898","111","339","365",205,160,264,"115",149,0.7268,0.7188,0.7233,0.9288
"11577",221519,"UNIVERSITY OF THE SOUTH",1,0,1997,"17555","46.40753","114","343","364",195,169,285,"130",155,0.7949,0.7692,0.783,0.9423
"11578",221519,"UNIVERSITY OF THE SOUTH",1,0,1998,"18350","50.317296","121","357","382",198,184,284,"124",160,0.8081,0.6739,0.7435,0.9346
"11579",221519,"UNIVERSITY OF THE SOUTH",1,0,1999,"18900","52.766575","122","358","391",227,164,308,"123",185,0.815,0.75,0.7877,0.9156
"11580",221519,"UNIVERSITY OF THE SOUTH",1,0,2000,"19940","54.318397","124","357","385",203,182,276,"126",150,0.7389,0.6923,0.7169,0.9273
"11581",221519,"UNIVERSITY OF THE SOUTH",1,0,2001,"21140","57.10397","126","319","353",185,168,259,"117",142,0.7676,0.6964,0.7337,0.9037
"11582",221519,"UNIVERSITY OF THE SOUTH",1,0,2002,"22370","58.130976","122","327","368",198,170,270,"116",154,0.7778,0.6824,0.7337,0.8886
"11583",221519,"SEWANEE-THE UNIVERSITY OF THE SOUTH",1,0,2003,"23930","58.817116","135","382","426",239,187,318,"142",176,0.7364,0.7594,0.7465,0.8967
"11584",221519,"SEWANEE: THE UNIVERSITY OF THE SOUTH",1,0,2004,"25374","60.797559","128","361","397",207,190,309,"142",167,0.8068,0.7474,0.7783,0.9093
"11585",221519,"Sewanee:  The University of the South",1,0,2005,"26874","64.087783","132","383","420",241,179,337,"144",193,0.8008,0.8045,0.8024,0.9119
"11586",221519,"Sewanee:  The University of the South",1,0,2006,"28528","66.395423","138","357","412",202,210,305,"150",155,0.7673,0.7143,0.7403,0.8665
"11587",221519,"Sewanee:  The University of the South",1,0,2007,"30438","72.56819","136","352","401",235,166,303,"115",188,0.8,0.6928,0.7556,0.8778
"11588",221519,"Sewanee:  The University of the South",1,0,2008,"32488","75.749062","129","354","409",199,210,310,"149",161,0.809,0.7095,0.7579,0.8655
"11589",221519,"Sewanee-The University of the South",1,0,2009,"33900","79.335297","133","331","401",203,198,296,"140",156,0.7685,0.7071,0.7382,0.8254
"11590",221519,"Sewanee-The University of the South",1,0,2010,"35590","77.182884","136","338","401",216,185,317,"138",179,0.8287,0.7459,0.7905,0.8429
"11591",221731,"TENNESSEE WESLEYAN COLLEGE",1,0,1991,"5564","6.368621","26","74","90",38,52,18,"6",12,0.3158,0.1154,0.2,0.8222
"11592",221731,"TENNESSEE WESLEYAN COLLEGE",1,0,1992,"5990","6.104527","32","54","74",20,54,13,"3",10,0.5,0.0556,0.1757,0.7297
"11593",221731,"TENNESSEE WESLEYAN COLLEGE",1,0,1993,"6430","5.757532","35","66","90",28,62,8,"2",6,0.2143,0.0323,0.0889,0.7333
"11594",221731,"TENNESSEE WESLEYAN COLLEGE",1,0,1995,"6100","5.457126","28","71","90",49,41,29,"7",22,0.449,0.1707,0.3222,0.7889
"11595",221731,"TENNESSEE WESLEYAN COLLEGE",1,0,1996,"6300","5.592372","30","132","145",98,47,2,"0",2,0.0204,0,0.0138,0.9103
"11596",221731,"TENNESSEE WESLEYAN COLLEGE",1,0,1997,"6500","4.704851","28","94","96",61,35,35,"12",23,0.377,0.3429,0.3646,0.9792
"11597",221731,"TENNESSEE WESLEYAN COLLEGE",1,0,1998,"6950","4.992975","31","102","105",61,44,28,"8",20,0.3279,0.1818,0.2667,0.9714
"11598",221731,"TENNESSEE WESLEYAN COLLEGE",1,0,1999,"7400","5.377397","40","130","140",93,47,22,"3",19,0.2043,0.0638,0.1571,0.9286
"11599",221731,"TENNESSEE WESLEYAN COLLEGE",1,0,2000,"7900","5.981054","41","121","134",72,62,35,"9",26,0.3611,0.1452,0.2612,0.903
"11600",221731,"TENNESSEE WESLEYAN COLLEGE",1,0,2001,"8500","6.909945","42","111","119",69,50,33,"9",24,0.3478,0.18,0.2773,0.9328
"11601",221731,"TENNESSEE WESLEYAN COLLEGE",1,0,2002,"10000","7.168694","43","112","128",79,49,34,"5",29,0.3671,0.102,0.2656,0.875
"11602",221731,"TENNESSEE WESLEYAN COLLEGE",1,0,2003,"11000","7.311993","44","86","106",63,43,33,"4",29,0.4603,0.093,0.3113,0.8113
"11603",221731,"TENNESSEE WESLEYAN COLLEGE",1,0,2004,"12000","7.903122","42","124","163",102,61,49,"11",38,0.3725,0.1803,0.3006,0.7607
"11604",221731,"Tennessee Wesleyan College",1,0,2005,"13000","8.611311","45","122","167",100,67,52,"14",38,0.38,0.209,0.3114,0.7305
"11605",221731,"Tennessee Wesleyan College",1,0,2006,"14000","9.529464","46","132","160",88,72,42,"10",32,0.3636,0.1389,0.2625,0.825
"11606",221731,"Tennessee Wesleyan College",1,0,2007,"15000","10.840119","49","138","153",86,67,49,"19",30,0.3488,0.2836,0.3203,0.902
"11607",221731,"Tennessee Wesleyan College",1,0,2008,"16500","12.748823","46","215","251",141,110,77,"30",47,0.3333,0.2727,0.3068,0.8566
"11608",221731,"Tennessee Wesleyan College",1,0,2009,"18000","13.352432","52","218","246",163,83,75,"22",53,0.3252,0.2651,0.3049,0.8862
"11609",221731,"Tennessee Wesleyan College",1,0,2010,"18500","14.694446","51","180","218",142,76,70,"20",50,0.3521,0.2632,0.3211,0.8257
"11610",221847,"TENNESSEE TECHNOLOGICAL UNIVERSITY",1,0,1991,"1485","69.347636","371","1288","1362",637,725,185,"57",128,0.2009,0.0786,0.1358,0.9457
"11611",221847,"TENNESSEE TECHNOLOGICAL UNIVERSITY",1,0,1992,"1634","70.59911","369","1294","1381",584,797,267,"113",154,0.2637,0.1418,0.1933,0.937
"11612",221847,"TENNESSEE TECHNOLOGICAL UNIVERSITY",1,0,1993,"1710","72.798527","376","1257","1330",608,722,172,"55",117,0.1924,0.0762,0.1293,0.9451
"11613",221847,"TENNESSEE TECHNOLOGICAL UNIVERSITY",1,0,1995,"1840","76.699321","386","1052","1113",513,600,130,"37",93,0.1813,0.0617,0.1168,0.9452
"11614",221847,"TENNESSEE TECHNOLOGICAL UNIVERSITY",1,0,1996,"1890","79.171431","371","1053","1130",497,633,134,"39",95,0.1911,0.0616,0.1186,0.9319
"11615",221847,"TENNESSEE TECHNOLOGICAL UNIVERSITY",1,0,1997,"2116","80.036948","362","1005","1089",466,623,100,"33",67,0.1438,0.053,0.0918,0.9229
"11616",221847,"TENNESSEE TECHNOLOGICAL UNIVERSITY",1,0,1998,"2306","80.597073","363","956","1044",460,584,124,"38",86,0.187,0.0651,0.1188,0.9157
"11617",221847,"TENNESSEE TECHNOLOGICAL UNIVERSITY",1,0,1999,"2020","86.644554","369","1087","1175",524,651,67,"63",4,0.0076,0.0968,0.057,0.9251
"11618",221847,"TENNESSEE TECHNOLOGICAL UNIVERSITY",1,0,2000,"2222","86.410696","365","1183","1305",609,696,241,"85",156,0.2562,0.1221,0.1847,0.9065
"11619",221847,"TENNESSEE TECHNOLOGICAL UNIVERSITY",1,0,2001,"2556","92.361251","361","1173","1289",529,760,230,"108",122,0.2306,0.1421,0.1784,0.91
"11620",221847,"TENNESSEE TECHNOLOGICAL UNIVERSITY",1,0,2002,"2748","94.800172","371","1228","1376",585,791,251,"99",152,0.2598,0.1252,0.1824,0.8924
"11621",221847,"TENNESSEE TECHNOLOGICAL UNIVERSITY",1,0,2003,"3132","101.931139","362","1221","1374",577,797,300,"133",167,0.2894,0.1669,0.2183,0.8886
"11622",221847,"TENNESSEE TECHNOLOGICAL UNIVERSITY",1,0,2004,"3352","102.459162","372","1258","1476",611,865,312,"122",190,0.311,0.141,0.2114,0.8523
"11623",221847,"Tennessee Technological University",1,0,2005,"3678","108.950224","358","1239","1409",623,786,321,"121",200,0.321,0.1539,0.2278,0.8793
"11624",221847,"Tennessee Technological University",1,0,2006,"3828","116.049869","372","1337","1515",653,862,301,"127",174,0.2665,0.1473,0.1987,0.8825
"11625",221847,"Tennessee Technological University",1,0,2007,"4058","122.712716","373","1469","1649",730,919,371,"157",214,0.2932,0.1708,0.225,0.8908
"11626",221847,"Tennessee Technological University",1,0,2008,"4302","132.966099","368","1414","1659",736,923,379,"165",214,0.2908,0.1788,0.2285,0.8523
"11627",221847,"Tennessee Technological University",1,0,2009,"4584","140.66403","371","1676","1879",884,995,476,"181",295,0.3337,0.1819,0.2533,0.892
"11628",221847,"Tennessee Technological University",1,0,2010,"4824","135.704657","380","1662","1898",846,1052,468,"177",291,0.344,0.1683,0.2466,0.8757
"11629",221892,"TREVECCA NAZARENE COLLEGE",1,0,1991,"5720","13.963307","86","154","193",113,80,46,"23",23,0.2035,0.2875,0.2383,0.7979
"11630",221892,"TREVECCA NAZARENE COLLEGE",1,0,1992,"6220","12.299799","53","158","180",96,84,27,"10",17,0.1771,0.119,0.15,0.8778
"11631",221892,"TREVECCA NAZARENE COLLEGE",1,0,1993,"6721","12.413736","57","125","139",84,55,25,"9",16,0.1905,0.1636,0.1799,0.8993
"11632",221892,"TREVECCA NAZARENE UNIVERSITY",1,0,1995,"7856","13.526449","64","196","214",113,101,43,"14",29,0.2566,0.1386,0.2009,0.9159
"11633",221892,"TREVECCA NAZARENE UNIVERSITY",1,0,1996,"8644","17.532893","65","166","189",108,81,37,"9",28,0.2593,0.1111,0.1958,0.8783
"11634",221892,"TREVECCA NAZARENE UNIVERSITY",1,0,1997,"8660","14.751769","64","164","179",100,79,30,"9",21,0.21,0.1139,0.1676,0.9162
"11635",221892,"TREVECCA NAZARENE UNIVERSITY",1,0,1998,"9536","16.302178","63","176","187",111,76,40,"16",24,0.2162,0.2105,0.2139,0.9412
"11636",221892,"TREVECCA NAZARENE UNIVERSITY",1,0,1999,"10016","17.786478","64","178","192",119,73,43,"14",29,0.2437,0.1918,0.224,0.9271
"11637",221892,"TREVECCA NAZARENE UNIVERSITY",1,0,2000,"10528","18.990876","67.5","198","220",130,90,80,"24",56,0.4308,0.2667,0.3636,0.9
"11638",221892,"TREVECCA NAZARENE UNIVERSITY",1,0,2001,"10848","19.16597","71","199","216",112,104,82,"36",46,0.4107,0.3462,0.3796,0.9213
"11639",221892,"TREVECCA NAZARENE UNIVERSITY",1,0,2002,"11390","22.17056","74","180","198",134,64,75,"24",51,0.3806,0.375,0.3788,0.9091
"11640",221892,"TREVECCA NAZARENE UNIVERSITY",1,0,2003,"11960","23.054288","77","195","219",126,93,82,"31",51,0.4048,0.3333,0.3744,0.8904
"11641",221892,"TREVECCA NAZARENE UNIVERSITY",1,0,2004,"12792","24.283195","77","208","237",119,118,84,"38",46,0.3866,0.322,0.3544,0.8776
"11642",221892,"Trevecca Nazarene University",1,0,2005,"13432","26.133735","73","207","239",124,115,95,"40",55,0.4435,0.3478,0.3975,0.8661
"11643",221892,"Trevecca Nazarene University",1,0,2006,"14774","28.956296","79","211","240",147,93,97,"32",65,0.4422,0.3441,0.4042,0.8792
"11644",221892,"Trevecca Nazarene University",1,0,2007,"15512","30.119911","76","209","238",139,99,85,"31",54,0.3885,0.3131,0.3571,0.8782
"11645",221892,"Trevecca Nazarene University",1,0,2008,"16288","33.0145","80","183","218",125,93,86,"31",55,0.44,0.3333,0.3945,0.8394
"11646",221892,"Trevecca Nazarene University",1,0,2009,"16776","34.965064","87","203","240",145,95,96,"35",61,0.4207,0.3684,0.4,0.8458
"11647",221892,"Trevecca Nazarene University",1,0,2010,"18318","36.703703","87","180","234",142,92,92,"33",59,0.4155,0.3587,0.3932,0.7692
"11648",222178,"ABILENE CHRISTIAN UNIVERSITY",1,0,1991,"6510","43.533076","175","546","656",338,318,176,"75",101,0.2988,0.2358,0.2683,0.8323
"11649",222178,"ABILENE CHRISTIAN UNIVERSITY",1,0,1992,"6900","43.503275","165","436","672",323,349,168,"66",102,0.3158,0.1891,0.25,0.6488
"11650",222178,"ABILENE CHRISTIAN UNIVERSITY",1,0,1993,"7170","45.915332","160","441","650",343,307,165,"66",99,0.2886,0.215,0.2538,0.6785
"11651",222178,"ABILENE CHRISTIAN UNIVERSITY",1,0,1995,"7800","48.996677","168","771","917",506,411,250,"93",157,0.3103,0.2263,0.2726,0.8408
"11652",222178,"ABILENE CHRISTIAN UNIVERSITY",1,0,1996,"8660","54.79","186","761","898",478,420,241,"97",144,0.3013,0.231,0.2684,0.8474
"11653",222178,"ABILENE CHRISTIAN UNIVERSITY",1,0,1997,"9180","51.636819","189","813","964",530,434,259,"97",162,0.3057,0.2235,0.2687,0.8434
"11654",222178,"ABILENE CHRISTIAN UNIVERSITY",1,0,1998,"9710","54.49255","201","857","988",541,447,280,"110",170,0.3142,0.2461,0.2834,0.8674
"11655",222178,"ABILENE CHRISTIAN UNIVERSITY",1,0,1999,"9810","58.781324","208","749","924",533,391,335,"120",215,0.4034,0.3069,0.3626,0.8106
"11656",222178,"ABILENE CHRISTIAN UNIVERSITY",1,0,2000,"10410","63.394052","218","856","1023",565,458,355,"139",216,0.3823,0.3035,0.347,0.8368
"11657",222178,"ABILENE CHRISTIAN UNIVERSITY",1,0,2001,"11130","67.786813","228","845","1031",598,433,387,"127",260,0.4348,0.2933,0.3754,0.8196
"11658",222178,"ABILENE CHRISTIAN UNIVERSITY",1,0,2002,"11910","69.288405","226","761","942",536,406,360,"112",248,0.4627,0.2759,0.3822,0.8079
"11659",222178,"ABILENE CHRISTIAN UNIVERSITY",1,0,2003,"12750","75.387557","227","763","948",489,459,369,"125",244,0.499,0.2723,0.3892,0.8049
"11660",222178,"ABILENE CHRISTIAN UNIVERSITY",1,0,2004,"13650","76.79275","216","808","1018",553,465,377,"127",250,0.4521,0.2731,0.3703,0.7937
"11661",222178,"Abilene Christian University",1,0,2005,"14610","82.289465","211","821","1030",560,470,393,"150",243,0.4339,0.3191,0.3816,0.7971
"11662",222178,"Abilene Christian University",1,0,2006,"15630","84.755981","216","777","961",526,435,394,"147",247,0.4696,0.3379,0.41,0.8085
"11663",222178,"Abilene Christian University",1,0,2007,"16710","94.725437","222","683","887",476,411,324,"113",211,0.4433,0.2749,0.3653,0.77
"11664",222178,"Abilene Christian University",1,0,2008,"17880","96.699114","221","761","971",518,453,434,"167",267,0.5154,0.3687,0.447,0.7837
"11665",222178,"Abilene Christian University",1,0,2009,"19200","105.210745","228","730","979",520,459,406,"136",270,0.5192,0.2963,0.4147,0.7457
"11666",222178,"Abilene Christian University",1,0,2010,"21510","105.447044","241","785","977",526,451,465,"194",271,0.5152,0.4302,0.4759,0.8035
"11667",222983,"AUSTIN COLLEGE",1,0,1991,"9465","21.179276","85","251","307",173,134,187,"77",110,0.6358,0.5746,0.6091,0.8176
"11668",222983,"AUSTIN COLLEGE",1,0,1992,"10085","21.034697","84","219","289",144,145,165,"76",89,0.6181,0.5241,0.5709,0.7578
"11669",222983,"AUSTIN COLLEGE",1,0,1993,"10740","21.673607","84","218","294",175,119,165,"57",108,0.6171,0.479,0.5612,0.7415
"11670",222983,"AUSTIN COLLEGE",1,0,1995,"12070","23.186011","87","215","293",155,138,195,"90",105,0.6774,0.6522,0.6655,0.7338
"11671",222983,"AUSTIN COLLEGE",1,0,1996,"12675","23.987153","87","289","344",181,163,254,"106",148,0.8177,0.6503,0.7384,0.8401
"11672",222983,"AUSTIN COLLEGE",1,0,1997,"13435","23.980161","83","246","317",150,167,215,"103",112,0.7467,0.6168,0.6782,0.776
"11673",222983,"AUSTIN COLLEGE",1,0,1998,"14205","25.577304","83","262","347",190,157,242,"97",145,0.7632,0.6178,0.6974,0.755
"11674",222983,"AUSTIN COLLEGE",1,0,1999,"14785","26.198158","79","254","324",188,136,222,"74",148,0.7872,0.5441,0.6852,0.784
"11675",222983,"AUSTIN COLLEGE",1,0,2000,"15177","29.149969","82","280","347",186,161,249,"106",143,0.7688,0.6584,0.7176,0.8069
"11676",222983,"AUSTIN COLLEGE",1,0,2001,"15792","31.706561","85","235","312",174,138,220,"91",129,0.7414,0.6594,0.7051,0.7532
"11677",222983,"AUSTIN COLLEGE",1,0,2002,"16392","32.305065","91","261","347",191,156,245,"104",141,0.7382,0.6667,0.7061,0.7522
"11678",222983,"AUSTIN COLLEGE",1,0,2003,"17740","33.837568","94","257","338",193,145,228,"86",142,0.7358,0.5931,0.6746,0.7604
"11679",222983,"AUSTIN COLLEGE",1,0,2004,"18980","34.789396","97","283","370",193,177,274,"121",153,0.7927,0.6836,0.7405,0.7649
"11680",222983,"Austin College",1,0,2005,"20310","34.323755","91","253","347",171,176,239,"103",136,0.7953,0.5852,0.6888,0.7291
"11681",222983,"Austin College",1,0,2006,"23355","37.696935","92","241","340",175,165,251,"113",138,0.7886,0.6848,0.7382,0.7088
"11682",222983,"Austin College",1,0,2007,"24760","41.484227","95","233","333",174,159,223,"91",132,0.7586,0.5723,0.6697,0.6997
"11683",222983,"Austin College",1,0,2008,"26370","42.41726","94","203","318",191,127,229,"88",141,0.7382,0.6929,0.7201,0.6384
"11684",222983,"Austin College",1,0,2009,"27690","42.820598","95","260","413",213,200,295,"129",166,0.7793,0.645,0.7143,0.6295
"11685",222983,"Austin College",1,0,2010,"29075","45.039125","93","195","318",173,145,220,"90",130,0.7514,0.6207,0.6918,0.6132
"11686",223232,"BAYLOR UNIVERSITY",1,0,1991,"6110","126.056325","598","1763","2150",1240,910,947,"347",600,0.4839,0.3813,0.4405,0.82
"11687",223232,"BAYLOR UNIVERSITY",1,0,1992,"6590","135.961964","589","1879","2363",1400,963,930,"336",594,0.4243,0.3489,0.3936,0.7952
"11688",223232,"BAYLOR UNIVERSITY",1,0,1993,"7070","141.750472","601","1958","2426",1420,1006,978,"350",628,0.4423,0.3479,0.4031,0.8071
"11689",223232,"BAYLOR UNIVERSITY",1,0,1995,"8444","155.565685","600","1796","2329",1390,939,1004,"337",667,0.4799,0.3589,0.4311,0.7711
"11690",223232,"BAYLOR UNIVERSITY",1,0,1996,"8806","170.90175","606","1895","2463",1444,1019,1062,"350",712,0.4931,0.3435,0.4312,0.7694
"11691",223232,"BAYLOR UNIVERSITY",1,0,1997,"9478","155.260528","606","1856","2404",1416,988,967,"300",667,0.471,0.3036,0.4022,0.772
"11692",223232,"BAYLOR UNIVERSITY",1,0,1998,"10316","165.708","629","2204","2933",1712,1221,1261,"405",856,0.5,0.3317,0.4299,0.7514
"11693",223232,"BAYLOR UNIVERSITY",1,0,1999,"9870","184.579","676","2107","2766",1668,1098,1272,"379",893,0.5354,0.3452,0.4599,0.7617
"11694",223232,"BAYLOR UNIVERSITY",1,0,2000,"10650","203.612","700.5","2229","2822",1666,1156,1388,"442",946,0.5678,0.3824,0.4918,0.7899
"11695",223232,"BAYLOR UNIVERSITY",1,0,2001,"11370","218.818","725","2198","2790",1664,1126,1340,"434",906,0.5445,0.3854,0.4803,0.7878
"11696",223232,"BAYLOR UNIVERSITY",1,0,2002,"15700","245.846","756","1992","2601",1558,1043,1323,"439",884,0.5674,0.4209,0.5087,0.7659
"11697",223232,"BAYLOR UNIVERSITY",1,0,2003,"16750","273.524","777","1945","2667",1673,994,1266,"347",919,0.5493,0.3491,0.4747,0.7293
"11698",223232,"BAYLOR UNIVERSITY",1,0,2004,"17900","286.458","770","1924","2772",1674,1098,1398,"488",910,0.5436,0.4444,0.5043,0.6941
"11699",223232,"Baylor University",1,0,2005,"19050","304.128","755","2156","3158",1867,1291,1641,"582",1059,0.5672,0.4508,0.5196,0.6827
"11700",223232,"Baylor University",1,0,2006,"20574","317.203","767","2065","2775",1713,1062,1550,"494",1056,0.6165,0.4652,0.5586,0.7441
"11701",223232,"Baylor University",1,0,2007,"22220","343.325","813","1897","2721",1618,1103,1556,"552",1004,0.6205,0.5005,0.5718,0.6972
"11702",223232,"Baylor University",1,0,2008,"23664","378.168","823","2041","3054",1801,1253,1669,"594",1075,0.5969,0.4741,0.5465,0.6683
"11703",223232,"Baylor University",1,0,2009,"25320","410.67","859","1947","3097",1825,1272,1672,"592",1080,0.5918,0.4654,0.5399,0.6287
"11704",223232,"Baylor University",1,0,2010,"26966","421.837","870","2050","3254",1913,1341,1897,"668",1229,0.6424,0.4981,0.583,0.63
"11705",224004,"CONCORDIA LUTHERAN COLLEGE",1,0,1991,"6090","6.118097","26","94","116",72,44,26,"7",19,0.2639,0.1591,0.2241,0.8103
"11706",224004,"CONCORDIA LUTHERAN COLLEGE",1,0,1992,"6360","6.806372","27","95","115",65,50,16,"2",14,0.2154,0.04,0.1391,0.8261
"11707",224004,"CONCORDIA LUTHERAN COLLEGE",1,0,1993,"6760","6.90863","31","87","107",62,45,26,"7",19,0.3065,0.1556,0.243,0.8131
"11708",224004,"CONCORDIA UNIVERSITY AT AUSTIN",1,0,1995,"7980","7.566046","33","73","90",55,35,18,"5",13,0.2364,0.1429,0.2,0.8111
"11709",224004,"CONCORDIA UNIVERSITY AT AUSTIN",1,0,1996,"8680","8.647886","33","101","121",74,47,42,"12",30,0.4054,0.2553,0.3471,0.8347
"11710",224004,"CONCORDIA UNIVERSITY AT AUSTIN",1,0,1997,"9500","7.54976","34","89","125",57,68,15,"7",8,0.1404,0.1029,0.12,0.712
"11711",224004,"CONCORDIA UNIVERSITY AT AUSTIN",1,0,1998,"10500","7.936158","38","99","127",75,52,23,"8",15,0.2,0.1538,0.1811,0.7795
"11712",224004,"CONCORDIA UNIVERSITY AT AUSTIN",1,0,1999,"11500","8.331781","43","93","134",66,68,15,"10",5,0.0758,0.1471,0.1119,0.694
"11713",224004,"CONCORDIA UNIVERSITY AT AUSTIN",1,0,2000,"12500","9.040809","40.5","88","130",73,57,24,"8",16,0.2192,0.1404,0.1846,0.6769
"11714",224004,"CONCORDIA UNIVERSITY AT AUSTIN",1,0,2001,"13120","10.218103","38","139","189",104,85,28,"10",18,0.1731,0.1176,0.1481,0.7354
"11715",224004,"CONCORDIA UNIVERSITY AT AUSTIN",1,0,2002,"14300","11.216787","40","120","166",85,81,12,"9",3,0.0353,0.1111,0.0723,0.7229
"11716",224004,"CONCORDIA UNIVERSITY AT AUSTIN",1,0,2003,"15300","12.088083","37","101","154",83,71,26,"13",13,0.1566,0.1831,0.1688,0.6558
"11717",224004,"CONCORDIA UNIVERSITY AT AUSTIN",1,0,2004,"16050","12.299804","44","98","149",84,65,21,"10",11,0.131,0.1538,0.1409,0.6577
"11718",224004,"Concordia University at Austin",1,0,2005,"16740","13.859297","37","136","196",96,100,40,"12",28,0.2917,0.12,0.2041,0.6939
"11719",224004,"Concordia University at Austin",1,0,2006,"17800","14.851804","38","133","191",89,102,37,"16",21,0.236,0.1569,0.1937,0.6963
"11720",224004,"Concordia University Texas",1,0,2007,"18600","17.466907","44","100","160",87,73,29,"9",20,0.2299,0.1233,0.1812,0.625
"11721",224004,"Concordia University Texas",1,0,2008,"20100","24.134473","51","144","229",129,100,44,"16",28,0.2171,0.16,0.1921,0.6288
"11722",224004,"Concordia University Texas",1,0,2009,"20800","26.027069","55","146","225",122,103,58,"22",36,0.2951,0.2136,0.2578,0.6489
"11723",224004,"Concordia University-Texas",1,0,2010,"21700","28.431989","55","137","235",157,78,54,"11",43,0.2739,0.141,0.2298,0.583
"11724",224323,"UNIVERSITY OF DALLAS",1,0,1991,"8600","24.655726","99","209","280",163,117,138,"50",88,0.5399,0.4274,0.4929,0.7464
"11725",224323,"UNIVERSITY OF DALLAS",1,0,1992,"9400","26.179295","102","169","251",137,114,114,"42",72,0.5255,0.3684,0.4542,0.6733
"11726",224323,"UNIVERSITY OF DALLAS",1,0,1993,"10200","30.603705","108","171","246",138,108,118,"56",62,0.4493,0.5185,0.4797,0.6951
"11727",224323,"UNIVERSITY OF DALLAS",1,0,1995,"11375","30.971836","104","183","244",146,98,134,"58",76,0.5205,0.5918,0.5492,0.75
"11728",224323,"UNIVERSITY OF DALLAS",1,0,1996,"12113","33.438779","104","190","251",157,94,141,"46",95,0.6051,0.4894,0.5618,0.757
"11729",224323,"UNIVERSITY OF DALLAS",1,0,1997,"12790","30.306025","106","175","261",160,101,136,"47",89,0.5562,0.4653,0.5211,0.6705
"11730",224323,"UNIVERSITY OF DALLAS",1,0,1998,"13672","33.886297","118","217","291",188,103,207,"67",140,0.7447,0.6505,0.7113,0.7457
"11731",224323,"UNIVERSITY OF DALLAS",1,0,1999,"14354","35.819746","125","206","309",191,118,188,"67",121,0.6335,0.5678,0.6084,0.6667
"11732",224323,"UNIVERSITY OF DALLAS",1,0,2000,"15028","38.748389","127","184","279",168,111,167,"59",108,0.6429,0.5315,0.5986,0.6595
"11733",224323,"UNIVERSITY OF DALLAS",1,0,2001,"15824","42.497034","129","192","310",180,130,170,"77",93,0.5167,0.5923,0.5484,0.6194
"11734",224323,"UNIVERSITY OF DALLAS",1,0,2002,"16694","44.320894","130","207","307",185,122,142,"52",90,0.4865,0.4262,0.4625,0.6743
"11735",224323,"UNIVERSITY OF DALLAS",1,0,2003,"17612","45.712515","125","190","299",189,110,185,"58",127,0.672,0.5273,0.6187,0.6355
"11736",224323,"UNIVERSITY OF DALLAS",1,0,2004,"18582","41.011022","121","158","243",126,117,153,"65",88,0.6984,0.5556,0.6296,0.6502
"11737",224323,"University of Dallas",1,0,2005,"19604","40.963345","116","200","256",165,91,160,"53",107,0.6485,0.5824,0.625,0.7812
"11738",224323,"University of Dallas",1,0,2006,"20780","44.019665","121","209","315",169,146,189,"82",107,0.6331,0.5616,0.6,0.6635
"11739",224323,"University of Dallas",1,0,2007,"21819","45.496865","125","245","362",200,162,201,"85",116,0.58,0.5247,0.5552,0.6768
"11740",224323,"University of Dallas",1,0,2008,"23250","47.737154","125","236","341",168,173,216,"104",112,0.6667,0.6012,0.6334,0.6921
"11741",224323,"University of Dallas",1,0,2009,"24646","50.720469","125","179","319",169,150,212,"96",116,0.6864,0.64,0.6646,0.5611
"11742",224323,"University of Dallas",1,0,2010,"27815","48.921015","135","257","375",207,168,223,"89",134,0.6473,0.5298,0.5947,0.6853
"11743",225432,"UNIVERSITY OF HOUSTON-DOWNTOWN",1,0,1991,"1150","29.205171","149","95","570",299,271,10,"6",4,0.0134,0.0221,0.0175,0.1667
"11744",225432,"UNIVERSITY OF HOUSTON-DOWNTOWN",1,0,1992,"1358","30.770811","153","85","540",275,265,3,"1",2,0.0073,0.0038,0.0056,0.1574
"11745",225432,"UNIVERSITY OF HOUSTON-DOWNTOWN",1,0,1993,"1506","31.859179","153","103","666",362,304,8,"2",6,0.0166,0.0066,0.012,0.1547
"11746",225432,"UNIVERSITY OF HOUSTON-DOWNTOWN",1,0,1995,"1646","33.899868","166","86","624",351,273,10,"3",7,0.0199,0.011,0.016,0.1378
"11747",225432,"UNIVERSITY OF HOUSTON-DOWNTOWN",1,0,1996,"1866","39.30493","166","69","638",385,253,13,"5",8,0.0208,0.0198,0.0204,0.1082
"11748",225432,"UNIVERSITY OF HOUSTON-DOWNTOWN",1,0,1997,"2046","39.937975","175","85","679",374,305,14,"2",12,0.0321,0.0066,0.0206,0.1252
"11749",225432,"UNIVERSITY OF HOUSTON-DOWNTOWN",1,0,1998,"2106","41.720776","181","89","696",406,290,8,"3",5,0.0123,0.0103,0.0115,0.1279
"11750",225432,"UNIVERSITY OF HOUSTON-DOWNTOWN",1,0,1999,"1140","48.974301","191","58","729",418,311,10,"3",7,0.0167,0.0096,0.0137,0.0796
"11751",225432,"UNIVERSITY OF HOUSTON-DOWNTOWN",1,0,2000,"1200","51.12873","205","94","794",437,357,16,"6",10,0.0229,0.0168,0.0202,0.1184
"11752",225432,"UNIVERSITY OF HOUSTON-DOWNTOWN",1,0,2001,"1200","63.802192","219","97","869",481,388,19,"5",14,0.0291,0.0129,0.0219,0.1116
"11753",225432,"UNIVERSITY OF HOUSTON-DOWNTOWN",1,0,2002,"2220","73.022216","243","76","905",498,407,14,"4",10,0.0201,0.0098,0.0155,0.084
"11754",225432,"UNIVERSITY OF HOUSTON-DOWNTOWN",1,0,2003,"2088","89.697386","236","115","1012",559,453,16,"5",11,0.0197,0.011,0.0158,0.1136
"11755",225432,"UNIVERSITY OF HOUSTON-DOWNTOWN",1,0,2004,"3170","75.117307","246","99","964",541,423,10,"5",5,0.0092,0.0118,0.0104,0.1027
"11756",225432,"University of Houston-Downtown",1,0,2005,"2700","81.865875","261","86","889",487,402,20,"8",12,0.0246,0.0199,0.0225,0.0967
"11757",225432,"University of Houston-Downtown",1,0,2006,"2898","88.147771","289","79","840",452,388,12,"7",5,0.0111,0.018,0.0143,0.094
"11758",225432,"University of Houston-Downtown",1,0,2007,"3240","91.616377","281","73","831",438,393,22,"7",15,0.0342,0.0178,0.0265,0.0878
"11759",225432,"University of Houston-Downtown",1,0,2008,"3240","102.228338","281","71","699",400,299,20,"9",11,0.0275,0.0301,0.0286,0.1016
"11760",225432,"University of Houston-Downtown",1,0,2009,"3360","112.063061","290","71","722",378,344,10,"6",4,0.0106,0.0174,0.0139,0.0983
"11761",225432,"University of Houston-Downtown",1,0,2010,"3552","131.239396","291","51","824",453,371,11,"3",8,0.0177,0.0081,0.0133,0.0619
"11762",225548,"HOWARD PAYNE UNIVERSITY",1,0,1991,"4160","10.858576","73","203","266",125,141,42,"14",28,0.224,0.0993,0.1579,0.7632
"11763",225548,"HOWARD PAYNE UNIVERSITY",1,0,1992,"4430","11.798349","70","219","265",123,142,60,"31",29,0.2358,0.2183,0.2264,0.8264
"11764",225548,"HOWARD PAYNE UNIVERSITY",1,0,1993,"5070","12.411483","84","259","322",133,189,56,"31",25,0.188,0.164,0.1739,0.8043
"11765",225548,"HOWARD PAYNE UNIVERSITY",1,0,1995,"5940","14.973776","90","267","325",170,155,82,"28",54,0.3176,0.1806,0.2523,0.8215
"11766",225548,"HOWARD PAYNE UNIVERSITY",1,0,1996,"6450","16.421124","93","265","335",151,184,83,"27",56,0.3709,0.1467,0.2478,0.791
"11767",225548,"HOWARD PAYNE UNIVERSITY",1,0,1997,"7109","14.064788","90","237","323",112,211,66,"32",34,0.3036,0.1517,0.2043,0.7337
"11768",225548,"HOWARD PAYNE UNIVERSITY",1,0,1998,"8460","14.628053","85","255","315",143,172,66,"25",41,0.2867,0.1453,0.2095,0.8095
"11769",225548,"HOWARD PAYNE UNIVERSITY",1,0,1999,"8400","16.06291","90","228","286",137,149,10,"3",7,0.0511,0.0201,0.035,0.7972
"11770",225548,"HOWARD PAYNE UNIVERSITY",1,0,2000,"8400","18.334931","82","301","355",175,180,82,"28",54,0.3086,0.1556,0.231,0.8479
"11771",225548,"HOWARD PAYNE UNIVERSITY",1,0,2001,"9200","20.363976","74","241","319",152,167,80,"34",46,0.3026,0.2036,0.2508,0.7555
"11772",225548,"HOWARD PAYNE UNIVERSITY",1,0,2002,"9700","19.825928","70","241","325",157,168,78,"24",54,0.3439,0.1429,0.24,0.7415
"11773",225548,"HOWARD PAYNE UNIVERSITY",1,0,2003,"10300","19.541644","71","217","293",136,157,76,"27",49,0.3603,0.172,0.2594,0.7406
"11774",225548,"HOWARD PAYNE UNIVERSITY",1,0,2004,"11000","19.337158","75","209","285",126,159,62,"29",33,0.2619,0.1824,0.2175,0.7333
"11775",225548,"Howard Payne University",1,0,2005,"11500","20.922996","72","206","281",146,135,104,"41",63,0.4315,0.3037,0.3701,0.7331
"11776",225548,"Howard Payne University",1,0,2006,"13440","21.367351","78","238","318",130,188,109,"46",63,0.4846,0.2447,0.3428,0.7484
"11777",225548,"Howard Payne University",1,0,2007,"15000","18.979312","78","159","255",103,152,77,"31",46,0.4466,0.2039,0.302,0.6235
"11778",225548,"Howard Payne University",1,0,2008,"16350","19.447741","76","222","304",128,176,107,"48",59,0.4609,0.2727,0.352,0.7303
"11779",225548,"Howard Payne University",1,0,2009,"17600","19.22712","77","126","209",84,125,74,"31",43,0.5119,0.248,0.3541,0.6029
"11780",225548,"Howard Payne University",1,0,2010,"18850","19.812044","82","224","318",149,169,88,"32",56,0.3758,0.1893,0.2767,0.7044
"11781",225627,"INCARNATE WORD COLLEGE",1,0,1991,"7200","21.509222","100","97","330",246,84,35,"4",31,0.126,0.0476,0.1061,0.2939
"11782",225627,"INCARNATE WORD COLLEGE",1,0,1992,"7800","21.621433","123","82","310",224,86,33,"4",29,0.1295,0.0465,0.1065,0.2645
"11783",225627,"INCARNATE WORD COLLEGE",1,0,1993,"8250","23.913648","136","81","297",202,95,29,"8",21,0.104,0.0842,0.0976,0.2727
"11784",225627,"UNIVERSITY OF THE INCARNATE WORD",1,0,1995,"9690","27.266249","134","101","370",259,111,50,"11",39,0.1506,0.0991,0.1351,0.273
"11785",225627,"UNIVERSITY OF THE INCARNATE WORD",1,0,1996,"10150","31.191369","124","106","404",288,116,46,"6",40,0.1389,0.0517,0.1139,0.2624
"11786",225627,"UNIVERSITY OF THE INCARNATE WORD",1,0,1997,"10600","27.209229","122","91","341",233,108,47,"10",37,0.1588,0.0926,0.1378,0.2669
"11787",225627,"UNIVERSITY OF THE INCARNATE WORD",1,0,1998,"11200","29.41042","129","101","375",265,110,59,"10",49,0.1849,0.0909,0.1573,0.2693
"11788",225627,"UNIVERSITY OF THE INCARNATE WORD",1,0,1999,"11850","33.633413","123","87","380",253,127,51,"9",42,0.166,0.0709,0.1342,0.2289
"11789",225627,"UNIVERSITY OF THE INCARNATE WORD",1,0,2000,"12470","36.181057","122.5","102","388",253,135,77,"20",57,0.2253,0.1481,0.1985,0.2629
"11790",225627,"UNIVERSITY OF THE INCARNATE WORD",1,0,2001,"13220","39.701936","122","93","416",285,131,66,"10",56,0.1965,0.0763,0.1587,0.2236
"11791",225627,"UNIVERSITY OF THE INCARNATE WORD",1,0,2002,"14000","45.163544","130","105","395",244,151,58,"18",40,0.1639,0.1192,0.1468,0.2658
"11792",225627,"UNIVERSITY OF THE INCARNATE WORD",1,0,2003,"14800","51.020422","138","95","396",280,116,70,"18",52,0.1857,0.1552,0.1768,0.2399
"11793",225627,"UNIVERSITY OF THE INCARNATE WORD",1,0,2004,"15600","48.814764","148","107","474",331,143,61,"12",49,0.148,0.0839,0.1287,0.2257
"11794",225627,"University of the Incarnate Word",1,0,2005,"16500","51.584776","160","131","571",394,177,114,"23",91,0.231,0.1299,0.1996,0.2294
"11795",225627,"University of the Incarnate Word",1,0,2006,"17400","56.296767","175","129","613",439,174,119,"23",96,0.2187,0.1322,0.1941,0.2104
"11796",225627,"University of the Incarnate Word",1,0,2007,"18400","63.826951","183","146","715",463,252,138,"41",97,0.2095,0.1627,0.193,0.2042
"11797",225627,"University of the Incarnate Word",1,0,2008,"19400","73.057044","200","193","880",553,327,157,"39",118,0.2134,0.1193,0.1784,0.2193
"11798",225627,"University of the Incarnate Word",1,0,2009,"20400","84.725638","219","156","717",469,248,178,"49",129,0.2751,0.1976,0.2483,0.2176
"11799",225627,"University of the Incarnate Word",1,0,2010,"21000","89.034955","245","169","871",571,300,257,"70",187,0.3275,0.2333,0.2951,0.194
"11800",226231,"LETOURNEAU UNIVERSITY",1,0,1991,"7350","11.48636","49","181","207",26,181,51,"44",7,0.2692,0.2431,0.2464,0.8744
"11801",226231,"LETOURNEAU UNIVERSITY",1,0,1992,"7940","16.113934","50","157","182",26,156,37,"30",7,0.2692,0.1923,0.2033,0.8626
"11802",226231,"LETOURNEAU UNIVERSITY",1,0,1993,"8460","16.278602","50","180","202",33,169,46,"36",10,0.303,0.213,0.2277,0.8911
"11803",226231,"LETOURNEAU UNIVERSITY",1,0,1995,"9430","21.97955","55","195","218",66,152,68,"42",26,0.3939,0.2763,0.3119,0.8945
"11804",226231,"LETOURNEAU UNIVERSITY",1,0,1996,"10220","23.479969","56","146","163",35,128,26,"19",7,0.2,0.1484,0.1595,0.8957
"11805",226231,"LETOURNEAU UNIVERSITY",1,0,1997,"10724","20.06613","52","182","209",50,159,65,"45",20,0.4,0.283,0.311,0.8708
"11806",226231,"LETOURNEAU UNIVERSITY",1,0,1998,"11264","21.455921","58","236","257",55,202,72,"48",24,0.4364,0.2376,0.2802,0.9183
"11807",226231,"LETOURNEAU UNIVERSITY",1,0,1999,"11570","26.020742","59","229","259",58,201,75,"52",23,0.3966,0.2587,0.2896,0.8842
"11808",226231,"LETOURNEAU UNIVERSITY",1,0,2000,"12090","27.923172","59","261","286",79,207,96,"58",38,0.481,0.2802,0.3357,0.9126
"11809",226231,"LETOURNEAU UNIVERSITY",1,0,2001,"12670","27.239022","59","211","242",66,176,74,"47",27,0.4091,0.267,0.3058,0.8719
"11810",226231,"LETOURNEAU UNIVERSITY",1,0,2002,"13240","31.920969","62","214","243",55,188,68,"46",22,0.4,0.2447,0.2798,0.8807
"11811",226231,"LETOURNEAU UNIVERSITY",1,0,2003,"14010","35.788155","66","294","333",94,239,93,"52",41,0.4362,0.2176,0.2793,0.8829
"11812",226231,"LETOURNEAU UNIVERSITY",1,0,2004,"14850","37.732591","70","272","327",92,235,98,"58",40,0.4348,0.2468,0.2997,0.8318
"11813",226231,"LeTourneau University",1,0,2005,"15710","39.762452","72","276","317",74,243,95,"66",29,0.3919,0.2716,0.2997,0.8707
"11814",226231,"LeTourneau University",1,0,2006,"16720","43.068589","72","271","309",88,221,130,"75",55,0.625,0.3394,0.4207,0.877
"11815",226231,"LeTourneau University",1,0,2007,"17710","47.509611","84","263","322",97,225,108,"71",37,0.3814,0.3156,0.3354,0.8168
"11816",226231,"LeTourneau University",1,0,2008,"18940","51.793415","85","283","340",106,234,118,"76",42,0.3962,0.3248,0.3471,0.8324
"11817",226231,"LeTourneau University",1,0,2009,"20100","52.27752","79","265","341",109,232,123,"83",40,0.367,0.3578,0.3607,0.7771
"11818",226231,"LeTourneau University",1,0,2010,"21510","49.428883","87","244","425",169,256,152,"85",67,0.3964,0.332,0.3576,0.5741
"11819",226833,"MIDWESTERN STATE UNIVERSITY",1,0,1991,"1359","26.955568","154","569","708",332,376,14,"8",6,0.0181,0.0213,0.0198,0.8037
"11820",226833,"MIDWESTERN STATE UNIVERSITY",1,0,1992,"1474","28.067093","155","509","641",313,328,43,"16",27,0.0863,0.0488,0.0671,0.7941
"11821",226833,"MIDWESTERN STATE UNIVERSITY",1,0,1993,"1666","30.874481","163","440","553",284,269,49,"23",26,0.0915,0.0855,0.0886,0.7957
"11822",226833,"MIDWESTERN STATE UNIVERSITY",1,0,1995,"1870","33.912458","178","458","578",276,302,49,"16",33,0.1196,0.053,0.0848,0.7924
"11823",226833,"MIDWESTERN STATE UNIVERSITY",1,0,1996,"1477","38.482073","180","482","602",312,290,52,"17",35,0.1122,0.0586,0.0864,0.8007
"11824",226833,"MIDWESTERN STATE UNIVERSITY",1,0,1997,"1498","42.5023","188","505","668",329,339,37,"13",24,0.0729,0.0383,0.0554,0.756
"11825",226833,"MIDWESTERN STATE UNIVERSITY",1,0,1998,"1789","43.715426","192","531","685",350,335,74,"26",48,0.1371,0.0776,0.108,0.7752
"11826",226833,"MIDWESTERN STATE UNIVERSITY",1,0,1999,"1140","46.293775","197","550","732",409,323,67,"21",46,0.1125,0.065,0.0915,0.7514
"11827",226833,"MIDWESTERN STATE UNIVERSITY",1,0,2000,"1200","53.216812","198","495","696",355,341,64,"33",31,0.0873,0.0968,0.092,0.7112
"11828",226833,"MIDWESTERN STATE UNIVERSITY",1,0,2001,"1260","52.00426","199","480","668",376,292,69,"22",47,0.125,0.0753,0.1033,0.7186
"11829",226833,"MIDWESTERN STATE UNIVERSITY",1,0,2002,"1320","52.289881","200","461","624",327,297,66,"23",43,0.1315,0.0774,0.1058,0.7388
"11830",226833,"MIDWESTERN STATE UNIVERSITY",1,0,2003,"1380","56.179928","200","438","613",302,311,41,"18",23,0.0762,0.0579,0.0669,0.7145
"11831",226833,"MIDWESTERN STATE UNIVERSITY",1,0,2004,"1152","55.905381","215","391","611",301,310,35,"13",22,0.0731,0.0419,0.0573,0.6399
"11832",226833,"Midwestern State University",1,0,2005,"1200","58.960245","203","544","818",447,371,100,"27",73,0.1633,0.0728,0.1222,0.665
"11833",226833,"Midwestern State University",1,0,2006,"1200","65.426356","216","481","657",355,302,108,"33",75,0.2113,0.1093,0.1644,0.7321
"11834",226833,"Midwestern State University",1,0,2007,"1200","69.988028","213","542","735",384,351,118,"43",75,0.1953,0.1225,0.1605,0.7374
"11835",226833,"Midwestern State University",1,0,2008,"1200","73.077027","212","490","706",405,301,119,"44",75,0.1852,0.1462,0.1686,0.6941
"11836",226833,"Midwestern State University",1,0,2009,"1200","76.396886","225","487","701",386,315,139,"40",99,0.2565,0.127,0.1983,0.6947
"11837",226833,"Midwestern State University",1,0,2010,"1200","86.464611","226","511","742",380,362,141,"39",102,0.2684,0.1077,0.19,0.6887
"11838",227216,"UNIVERSITY OF NORTH TEXAS",1,0,1991,"1046","172.947061","782","1655","2085",1169,916,210,"62",148,0.1266,0.0677,0.1007,0.7938
"11839",227216,"UNIVERSITY OF NORTH TEXAS",1,0,1992,"1196","183.753197","762","1382","1794",1014,780,191,"41",150,0.1479,0.0526,0.1065,0.7703
"11840",227216,"UNIVERSITY OF NORTH TEXAS",1,0,1993,"1273","197.91132","751","1457","1872",1045,827,211,"63",148,0.1416,0.0762,0.1127,0.7783
"11841",227216,"UNIVERSITY OF NORTH TEXAS",1,0,1995,"1439","203.698685","733","1597","2134",1180,954,201,"50",151,0.128,0.0524,0.0942,0.7484
"11842",227216,"UNIVERSITY OF NORTH TEXAS",1,0,1996,"1705","211.00219","735","1630","2268",1304,964,256,"70",186,0.1426,0.0726,0.1129,0.7187
"11843",227216,"UNIVERSITY OF NORTH TEXAS",1,0,1997,"1776","217.04399","725","1646","2292",1310,982,303,"83",220,0.1679,0.0845,0.1322,0.7182
"11844",227216,"UNIVERSITY OF NORTH TEXAS",1,0,1998,"2075","232.442596","729","1772","2449",1400,1049,363,"105",258,0.1843,0.1001,0.1482,0.7236
"11845",227216,"UNIVERSITY OF NORTH TEXAS",1,0,1999,"1656","245.743878","729","1903","2687",1550,1137,410,"111",299,0.1929,0.0976,0.1526,0.7082
"11846",227216,"UNIVERSITY OF NORTH TEXAS",1,0,2000,"1824","266.650173","752","2003","2841",1664,1177,515,"142",373,0.2242,0.1206,0.1813,0.705
"11847",227216,"UNIVERSITY OF NORTH TEXAS",1,0,2001,"2016","307.283688","775","2005","2803",1665,1138,466,"146",320,0.1922,0.1283,0.1663,0.7153
"11848",227216,"UNIVERSITY OF NORTH TEXAS",1,0,2002,"2288","324.81857","808","2044","2912",1683,1229,523,"147",376,0.2234,0.1196,0.1796,0.7019
"11849",227216,"UNIVERSITY OF NORTH TEXAS",1,0,2003,"2392","328.331659","786","2310","3320",1945,1375,632,"194",438,0.2252,0.1411,0.1904,0.6958
"11850",227216,"UNIVERSITY OF NORTH TEXAS",1,0,2004,"3444","339.440111","824","2234","3216",1872,1344,611,"180",431,0.2302,0.1339,0.19,0.6947
"11851",227216,"University of North Texas",1,0,2005,"3144","364.641039","838","2363","3557",2008,1549,760,"214",546,0.2719,0.1382,0.2137,0.6643
"11852",227216,"University of North Texas",1,0,2006,"3372","380.301742","836","2385","3599",2039,1560,784,"252",532,0.2609,0.1615,0.2178,0.6627
"11853",227216,"University of North Texas",1,0,2007,"4035","389.77723","871","2236","3495",1996,1499,862,"254",608,0.3046,0.1694,0.2466,0.6398
"11854",227216,"University of North Texas",1,0,2008,"4528","431.777404","898","2187","3442",1928,1514,891,"271",620,0.3216,0.179,0.2589,0.6354
"11855",227216,"University of North Texas",1,0,2009,"5060","476.020312","960","1888","3255",1832,1423,881,"271",610,0.333,0.1904,0.2707,0.58
"11856",227216,"University of North Texas",1,0,2010,"5363","537.279494","1004","1857","3534",1908,1626,1009,"345",664,0.348,0.2122,0.2855,0.5255
"11857",227331,"OUR LADY OF THE LAKE UNIVERSITY SAN ANTONIO",1,0,1991,"6472","19.243646","92","34","361",278,83,38,"6",32,0.1151,0.0723,0.1053,0.0942
"11858",227331,"OUR LADY OF THE LAKE UNIVERSITY SAN ANTONIO",1,0,1992,"7564","21.892542","95","39","315",241,74,40,"8",32,0.1328,0.1081,0.127,0.1238
"11859",227331,"OUR LADY OF THE LAKE UNIVERSITY-SAN ANTONIO",1,0,1993,"8160","24.409168","101","31","291",224,67,29,"0",29,0.1295,0,0.0997,0.1065
"11860",227331,"OUR LADY OF THE LAKE UNIVERSITY-SAN ANTONIO",1,0,1995,"9134","30.176842","102","24","258",189,69,34,"8",26,0.1376,0.1159,0.1318,0.093
"11861",227331,"OUR LADY OF THE LAKE UNIVERSITY-SAN ANTONIO",1,0,1996,"9674","30.668404","109","47","355",257,98,66,"12",54,0.2101,0.1224,0.1859,0.1324
"11862",227331,"OUR LADY OF THE LAKE UNIVERSITY-SAN ANTONIO",1,0,1997,"10366","27.132316","121","58","372",293,79,59,"10",49,0.1672,0.1266,0.1586,0.1559
"11863",227331,"OUR LADY OF THE LAKE UNIVERSITY-SAN ANTONIO",1,0,1998,"10872","30.333403","124","49","310",251,59,50,"2",48,0.1912,0.0339,0.1613,0.1581
"11864",227331,"OUR LADY OF THE LAKE UNIVERSITY-SAN ANTONIO",1,0,1999,"11150","32.008226","128","36","308",241,67,44,"10",34,0.1411,0.1493,0.1429,0.1169
"11865",227331,"OUR LADY OF THE LAKE UNIVERSITY-SAN ANTONIO",1,0,2000,"11708","34.494742","128","24","267",205,62,42,"7",35,0.1707,0.1129,0.1573,0.0899
"11866",227331,"OUR LADY OF THE LAKE UNIVERSITY-SAN ANTONIO",1,0,2001,"12528","37.820802","128","37","401",323,78,49,"7",42,0.13,0.0897,0.1222,0.0923
"11867",227331,"OUR LADY OF THE LAKE UNIVERSITY-SAN ANTONIO",1,0,2002,"13404","40.969279","129","27","331",241,90,55,"11",44,0.1826,0.1222,0.1662,0.0816
"11868",227331,"OUR LADY OF THE LAKE UNIVERSITY-SAN ANTONIO",1,0,2003,"14650","42.833219","83","53","322",238,84,60,"10",50,0.2101,0.119,0.1863,0.1646
"11869",227331,"OUR LADY OF THE LAKE UNIVERSITY-SAN ANTONIO",1,0,2004,"15594","44.987228","125","28","216",171,45,30,"3",27,0.1579,0.0667,0.1389,0.1296
"11870",227331,"Our Lady of the Lake University-San Antonio",1,0,2005,"17048","45.144969","118","28","269",204,65,1,"1",0,0,0.0154,0.0037,0.1041
"11871",227331,"Our Lady of the Lake University-San Antonio",1,0,2006,"17900","44.739842","97","24","262",195,67,27,"6",21,0.1077,0.0896,0.1031,0.0916
"11872",227331,"Our Lady of the Lake University-San Antonio",1,0,2007,"18616","44.541263","112","25","283",189,94,51,"13",38,0.2011,0.1383,0.1802,0.0883
"11873",227331,"Our Lady of the Lake University-San Antonio",1,0,2008,"19732","42.494973","111","30","306",213,93,67,"14",53,0.2488,0.1505,0.219,0.098
"11874",227331,"Our Lady of the Lake University-San Antonio",1,0,2009,"20324","42.753777","108","21","246",170,76,54,"14",40,0.2353,0.1842,0.2195,0.0854
"11875",227331,"Our Lady of the Lake University-San Antonio",1,0,2010,"21400","43.867877","112","46","299",219,80,77,"18",59,0.2694,0.225,0.2575,0.1538
"11876",227526,"PRAIRIE VIEW A & M UNIVERSITY",1,0,1991,"1148","57.222185","234","13","1116",534,582,91,"24",67,0.1255,0.0412,0.0815,0.0116
"11877",227526,"PRAIRIE VIEW A & M UNIVERSITY",1,0,1992,"1316","65.521054","245","24","1194",579,615,261,"97",164,0.2832,0.1577,0.2186,0.0201
"11878",227526,"PRAIRIE VIEW A & M UNIVERSITY",1,0,1993,"1537","71.62102","232","32","1208",610,598,110,"27",83,0.1361,0.0452,0.0911,0.0265
"11879",227526,"PRAIRIE VIEW A & M UNIVERSITY",1,0,1995,"1926","72.611315","235","20","1114",536,578,105,"29",76,0.1418,0.0502,0.0943,0.018
"11880",227526,"PRAIRIE VIEW A & M UNIVERSITY",1,0,1996,"2146","80.03708","234","21","1166",568,598,133,"48",85,0.1496,0.0803,0.1141,0.018
"11881",227526,"PRAIRIE VIEW A & M UNIVERSITY",1,0,1997,"2436","80.278261","235","10","1183",670,513,127,"34",93,0.1388,0.0663,0.1074,0.0085
"11882",227526,"PRAIRIE VIEW A & M UNIVERSITY",1,0,1998,"2496","82.621703","236","11","1197",626,571,132,"42",90,0.1438,0.0736,0.1103,0.0092
"11883",227526,"PRAIRIE VIEW A & M UNIVERSITY",1,0,1999,"1140","90.688011","289","5","967",504,463,113,"33",80,0.1587,0.0713,0.1169,0.0052
"11884",227526,"PRAIRIE VIEW A & M UNIVERSITY",1,0,2000,"1200","97.338866","273.5","21","1230",657,573,163,"46",117,0.1781,0.0803,0.1325,0.0171
"11885",227526,"PRAIRIE VIEW A & M UNIVERSITY",1,0,2001,"1260","102.038833","258","17","1380",771,609,182,"62",120,0.1556,0.1018,0.1319,0.0123
"11886",227526,"PRAIRIE VIEW A & M UNIVERSITY",1,0,2002,"1320","99.871231","280","22","1431",769,662,222,"74",148,0.1925,0.1118,0.1551,0.0154
"11887",227526,"PRAIRIE VIEW A & M UNIVERSITY",1,0,2003,"1380","114.213079","343","17","1553",820,733,175,"71",104,0.1268,0.0969,0.1127,0.0109
"11888",227526,"PRAIRIE VIEW A & M UNIVERSITY",1,0,2004,"1440","121.024856","334","17","1573",823,750,156,"56",100,0.1215,0.0747,0.0992,0.0108
"11889",227526,"Prairie View A & M University",1,0,2005,"1500","134.845367","327","18","1155",668,487,126,"39",87,0.1302,0.0801,0.1091,0.0156
"11890",227526,"Prairie View A & M University",1,0,2006,"3765","151.769792","341","11","1231",689,542,121,"28",93,0.135,0.0517,0.0983,0.0089
"11891",227526,"Prairie View A & M University",1,0,2007,"4350","153.728597","333","18","1391",784,607,155,"36",119,0.1518,0.0593,0.1114,0.0129
"11892",227526,"Prairie View A & M University",1,0,2008,"4590","172.439694","340","35","1290",761,529,355,"112",243,0.3193,0.2117,0.2752,0.0271
"11893",227526,"Prairie View A & M University",1,0,2009,"4884","180.428255","341","21","1638",957,681,180,"42",138,0.1442,0.0617,0.1099,0.0128
"11894",227526,"Prairie View A & M University",1,0,2010,"5077","186.491247","347","24","1731",1046,685,154,"43",111,0.1061,0.0628,0.089,0.0139
"11895",227757,"RICE UNIVERSITY",1,0,1991,"7700","159.911","421","416","625",257,368,437,"239",198,0.7704,0.6495,0.6992,0.6656
"11896",227757,"RICE UNIVERSITY",1,0,1992,"8500","169.541","416","416","598",266,332,437,"221",216,0.812,0.6657,0.7308,0.6957
"11897",227757,"RICE UNIVERSITY",1,0,1993,"9644","175.404","422","421","639",281,358,440,"228",212,0.7544,0.6369,0.6886,0.6588
"11898",227757,"RICE UNIVERSITY",1,0,1995,"11122","196.747","449","409","688",338,350,472,"213",259,0.7663,0.6086,0.686,0.5945
"11899",227757,"RICE UNIVERSITY",1,0,1996,"12031","206.849","435","354","668",314,354,499,"240",259,0.8248,0.678,0.747,0.5299
"11900",227757,"RICE UNIVERSITY",1,0,1997,"13094","197.401","436","451","703",334,369,516,"248",268,0.8024,0.6721,0.734,0.6415
"11901",227757,"RICE UNIVERSITY",1,0,1998,"14131","206.452","455","403","642",320,322,489,"228",261,0.8156,0.7081,0.7617,0.6277
"11902",227757,"RICE UNIVERSITY",1,0,1999,"15350","221.204","463","393","670",325,345,512,"251",261,0.8031,0.7275,0.7642,0.5866
"11903",227757,"RICE UNIVERSITY",1,0,2000,"15438","240.152614","467","423","628",290,338,498,"249",249,0.8586,0.7367,0.793,0.6736
"11904",227757,"RICE UNIVERSITY",1,0,2001,"16300","259.349905","471","343","657",326,331,509,"247",262,0.8037,0.7462,0.7747,0.5221
"11905",227757,"RICE UNIVERSITY",1,0,2002,"16925","287.789","503","388","700",318,382,570,"301",269,0.8459,0.788,0.8143,0.5543
"11906",227757,"RICE UNIVERSITY",1,0,2003,"17800","315.703","530","393","716",364,352,591,"279",312,0.8571,0.7926,0.8254,0.5489
"11907",227757,"RICE UNIVERSITY",1,0,2004,"18863","334.114","545","416","725",380,345,574,"259",315,0.8289,0.7507,0.7917,0.5738
"11908",227757,"Rice University",1,0,2005,"21203","350.287","567","386","722",337,385,571,"279",292,0.8665,0.7247,0.7909,0.5346
"11909",227757,"Rice University",1,0,2006,"23786","371.338","567","338","713",357,356,597,"282",315,0.8824,0.7921,0.8373,0.4741
"11910",227757,"Rice University",1,0,2007,"26633","396.099","583","340","742",346,396,585,"288",297,0.8584,0.7273,0.7884,0.4582
"11911",227757,"Rice University",1,0,2008,"29188","424.186","598","339","777",386,391,636,"307",329,0.8523,0.7852,0.8185,0.4363
"11912",227757,"Rice University",1,0,2009,"31303","467.279","619","355","887",427,460,710,"342",368,0.8618,0.7435,0.8005,0.4002
"11913",227757,"Rice University",1,0,2010,"33120","498.393","627","416","944",453,491,783,"376",407,0.8985,0.7658,0.8294,0.4407
"11914",227845,"SAINT EDWARD'S UNIVERSITY",1,0,1991,"7764","24.062579","81","168","347",198,149,67,"22",45,0.2273,0.1477,0.1931,0.4841
"11915",227845,"SAINT EDWARD'S UNIVERSITY",1,0,1992,"8376","26.352351","80","169","337",196,141,57,"27",30,0.1531,0.1915,0.1691,0.5015
"11916",227845,"SAINT EDWARDS UNIVERSITY",1,0,1993,"8902","28.640744","83","194","370",235,135,98,"32",66,0.2809,0.237,0.2649,0.5243
"11917",227845,"SAINT EDWARDS UNIVERSITY",1,0,1995,"9950","31.507383","91","199","387",230,157,119,"37",82,0.3565,0.2357,0.3075,0.5142
"11918",227845,"SAINT EDWARDS UNIVERSITY",1,0,1996,"10400","32.266361","93","197","373",239,134,107,"35",72,0.3013,0.2612,0.2869,0.5282
"11919",227845,"SAINT EDWARDS UNIVERSITY",1,0,1997,"10730","26.563479","92","197","359",216,143,98,"38",60,0.2778,0.2657,0.273,0.5487
"11920",227845,"SAINT EDWARDS UNIVERSITY",1,0,1998,"11160","28.126643","91","192","367",212,155,95,"34",61,0.2877,0.2194,0.2589,0.5232
"11921",227845,"SAINT EDWARDSS UNIVERSITY",1,0,1999,"11438","30.822459","99","182","357",184,173,101,"35",66,0.3587,0.2023,0.2829,0.5098
"11922",227845,"SAINT EDWARD'S UNIVERSITY",1,0,2000,"11896","34.151644","108.5","223","397",207,190,118,"42",76,0.3671,0.2211,0.2972,0.5617
"11923",227845,"SAINT EDWARD'S UNIVERSITY",1,0,2001,"12728","40.356858","118","220","413",254,159,131,"37",94,0.3701,0.2327,0.3172,0.5327
"11924",227845,"SAINT EDWARD'S UNIVERSITY",1,0,2002,"13620","48.037789","125","256","445",255,190,164,"60",104,0.4078,0.3158,0.3685,0.5753
"11925",227845,"SAINT EDWARD'S UNIVERSITY",1,0,2003,"14710","54.396344","139","296","544",327,217,239,"78",161,0.4924,0.3594,0.4393,0.5441
"11926",227845,"SAINT EDWARD'S UNIVERSITY",1,0,2004,"15960","58.933367","141","334","600",371,229,291,"97",194,0.5229,0.4236,0.485,0.5567
"11927",227845,"Saint Edward's University",1,0,2005,"17320","64.190115","155","341","646",401,245,333,"109",224,0.5586,0.4449,0.5155,0.5279
"11928",227845,"Saint Edward's University",1,0,2006,"18800","71.554008","169","387","698",423,275,372,"144",228,0.539,0.5236,0.533,0.5544
"11929",227845,"Saint Edward's University",1,0,2007,"20400","77.088343","182","413","725",437,288,372,"127",245,0.5606,0.441,0.5131,0.5697
"11930",227845,"Saint Edward's University",1,0,2008,"22150","83.413485","188","406","741",480,261,397,"121",276,0.575,0.4636,0.5358,0.5479
"11931",227845,"Saint Edward's University",1,0,2009,"24040","88.520278","187","400","755",470,285,383,"123",260,0.5532,0.4316,0.5073,0.5298
"11932",227845,"Saint Edward's University",1,0,2010,"26084","93.142107","198","361","770",505,265,403,"122",281,0.5564,0.4604,0.5234,0.4688
"11933",227863,"UNIVERSITY OF SAINT THOMAS",1,0,1991,"6830","11.561315","86","79","170",114,56,64,"22",42,0.3684,0.3929,0.3765,0.4647
"11934",227863,"UNIVERSITY OF SAINT THOMAS",1,0,1992,"7442","14.001532","88","79","173",123,50,2,"0",2,0.0163,0,0.0116,0.4566
"11935",227863,"UNIVERSITY OF SAINT THOMAS",1,0,1993,"8042","16.304907","91","90","192",129,63,53,"13",40,0.3101,0.2063,0.276,0.4688
"11936",227863,"UNIVERSITY OF SAINT THOMAS",1,0,1995,"9423","18.918664","97","102","232",145,87,58,"17",41,0.2828,0.1954,0.25,0.4397
"11937",227863,"UNIVERSITY OF SAINT THOMAS",1,0,1996,"9975","20.545759","114","102","222",136,86,55,"19",36,0.2647,0.2209,0.2477,0.4595
"11938",227863,"UNIVERSITY OF SAINT THOMAS",1,0,1997,"10577","19.770635","98","105","235",155,80,58,"19",39,0.2516,0.2375,0.2468,0.4468
"11939",227863,"UNIVERSITY OF SAINT THOMAS",1,0,1998,"11210","21.781016","101","93","231",153,78,65,"12",53,0.3464,0.1538,0.2814,0.4026
"11940",227863,"UNIVERSITY OF ST THOMAS",1,0,1999,"11700","23.589187","102","102","215",128,87,50,"16",34,0.2656,0.1839,0.2326,0.4744
"11941",227863,"UNIVERSITY OF ST THOMAS",1,0,2000,"12300","25.206606","107","98","303",207,96,72,"19",53,0.256,0.1979,0.2376,0.3234
"11942",227863,"UNIVERSITY OF ST THOMAS",1,0,2001,"13050","28.321685","112","102","272",166,106,68,"23",45,0.2711,0.217,0.25,0.375
"11943",227863,"UNIVERSITY OF ST THOMAS",1,0,2002,"13800","32.116735","117","98","276",174,102,65,"15",50,0.2874,0.1471,0.2355,0.3551
"11944",227863,"UNIVERSITY OF ST THOMAS",1,0,2003,"15000","32.231019","114","116","292",172,120,87,"33",54,0.314,0.275,0.2979,0.3973
"11945",227863,"UNIVERSITY OF ST THOMAS",1,0,2004,"16200","35.162072","117","116","297",189,108,80,"24",56,0.2963,0.2222,0.2694,0.3906
"11946",227863,"University of St Thomas",1,0,2005,"16950","37.158277","121","108","289",185,104,75,"27",48,0.2595,0.2596,0.2595,0.3737
"11947",227863,"University of St Thomas",1,0,2006,"17700","39.698104","129","103","291",187,104,93,"26",67,0.3583,0.25,0.3196,0.354
"11948",227863,"University of St Thomas",1,0,2007,"18900","43.870268","131","98","288",179,109,77,"25",52,0.2905,0.2294,0.2674,0.3403
"11949",227863,"University of St Thomas",1,0,2008,"20190","46.968129","132","86","293",187,106,101,"30",71,0.3797,0.283,0.3447,0.2935
"11950",227863,"University of St Thomas",1,0,2009,"21510","49.244191","125","104","284",181,103,106,"34",72,0.3978,0.3301,0.3732,0.3662
"11951",227863,"University of St Thomas",1,0,2010,"23160","48.314427","135","58","191",127,64,63,"14",49,0.3858,0.2188,0.3298,0.3037
"11952",228042,"SCHREINER COLLEGE",1,0,1991,"7385","8.576732","35","114","156",79,77,27,"15",12,0.1519,0.1948,0.1731,0.7308
"11953",228042,"SCHREINER COLLEGE",1,0,1992,"7975","8.862399","35","99","140",75,65,12,"3",9,0.12,0.0462,0.0857,0.7071
"11954",228042,"SCHREINER COLLEGE",1,0,1993,"8610","9.759594","40","98","134",77,57,26,"10",16,0.2078,0.1754,0.194,0.7313
"11955",228042,"SCHREINER COLLEGE",1,0,1995,"9335","10.540832","33","148","221",107,114,35,"15",20,0.1869,0.1316,0.1584,0.6697
"11956",228042,"SCHREINER COLLEGE",1,0,1996,"9735","11.726044","39","148","180",112,68,34,"10",24,0.2143,0.1471,0.1889,0.8222
"11957",228042,"SCHREINER COLLEGE",1,0,1997,"9900","9.331404","39","150","194",116,78,40,"16",24,0.2069,0.2051,0.2062,0.7732
"11958",228042,"SCHREINER COLLEGE",1,0,1998,"10490","9.54325","43","157","198",118,80,39,"17",22,0.1864,0.2125,0.197,0.7929
"11959",228042,"SCHREINER COLLEGE",1,0,1999,"10990","11.307096","41","174","225",148,77,44,"7",37,0.25,0.0909,0.1956,0.7733
"11960",228042,"SCHREINER COLLEGE",1,0,2000,"11540","12.26407","43","171","207",124,83,40,"16",24,0.1935,0.1928,0.1932,0.8261
"11961",228042,"SCHREINER UNIVERSITY",1,0,2001,"12118","17.470123","45","146","180",110,70,46,"12",34,0.3091,0.1714,0.2556,0.8111
"11962",228042,"SCHREINER UNIVERSITY",1,0,2002,"12118","16.780747","49","119","165",80,85,45,"18",27,0.3375,0.2118,0.2727,0.7212
"11963",228042,"SCHREINER UNIVERSITY",1,0,2003,"13240","16.899283","47","132","168",88,80,40,"14",26,0.2955,0.175,0.2381,0.7857
"11964",228042,"SCHREINER UNIVERSITY",1,0,2004,"14040","15.463017","53","154","204",122,82,53,"20",33,0.2705,0.2439,0.2598,0.7549
"11965",228042,"Schreiner University",1,0,2005,"14742","16.396678","51","105","167",92,75,50,"19",31,0.337,0.2533,0.2994,0.6287
"11966",228042,"Schreiner University",1,0,2006,"15479","17.975255","54","173","243",128,115,57,"20",37,0.2891,0.1739,0.2346,0.7119
"11967",228042,"Schreiner University",1,0,2007,"16408","17.435034","56","179","262",135,127,92,"36",56,0.4148,0.2835,0.3511,0.6832
"11968",228042,"Schreiner University",1,0,2008,"17392","18.731031","59","183","266",145,121,84,"34",50,0.3448,0.281,0.3158,0.688
"11969",228042,"Schreiner University",1,0,2009,"18132","19.864017","60","190","289",155,134,98,"44",54,0.3484,0.3284,0.3391,0.6574
"11970",228042,"Schreiner University",1,0,2010,"18948","21.552816","59","163","253",150,103,106,"40",66,0.44,0.3883,0.419,0.6443
"11971",228149,"SAINT MARY'S UNIVERSITY",1,0,1991,"7170","38.588757","159","103","429",260,169,131,"43",88,0.3385,0.2544,0.3054,0.2401
"11972",228149,"SAINT MARY'S UNIVERSITY",1,0,1992,"8000","42.430628","149","116","491",285,206,139,"43",96,0.3368,0.2087,0.2831,0.2363
"11973",228149,"SAINT MARYS UNIVERSITY",1,0,1993,"8276","45.105206","169","114","402",231,171,125,"34",91,0.3939,0.1988,0.3109,0.2836
"11974",228149,"SAINT MARYS UNIVERSITY",1,0,1995,"9527","53.204615","177","113","452",254,198,123,"34",89,0.3504,0.1717,0.2721,0.25
"11975",228149,"ST MARYS UNIVERSITY",1,0,1996,"9934","50.59905","180","122","507",312,195,177,"56",121,0.3878,0.2872,0.3491,0.2406
"11976",228149,"ST MARYS UNIVERSITY",1,0,1997,"10668","48.115461","182","105","507",311,196,170,"50",120,0.3859,0.2551,0.3353,0.2071
"11977",228149,"ST MARYS UNIVERSITY",1,0,1998,"11280","52.022283","178","114","499",313,186,147,"49",98,0.3131,0.2634,0.2946,0.2285
"11978",228149,"ST MARYS UNIVERSITY",1,0,1999,"11500","50.651917","191","101","485",277,208,165,"54",111,0.4007,0.2596,0.3402,0.2082
"11979",228149,"ST MARYS UNIVERSITY",1,0,2000,"12160","53.544885","187","143","656",399,257,201,"60",141,0.3534,0.2335,0.3064,0.218
"11980",228149,"ST MARYS UNIVERSITY",1,0,2001,"12980","57.856915","183","92","534",299,235,181,"72",109,0.3645,0.3064,0.339,0.1723
"11981",228149,"ST MARYS UNIVERSITY",1,0,2002,"14727","61.66982","185","136","667",397,270,214,"63",151,0.3804,0.2333,0.3208,0.2039
"11982",228149,"ST MARYS UNIVERSITY",1,0,2003,"15992","67.603298","189","107","470",292,178,147,"41",106,0.363,0.2303,0.3128,0.2277
"11983",228149,"ST MARYS UNIVERSITY",1,0,2004,"17256","69.720367","190","93","463",277,186,159,"51",108,0.3899,0.2742,0.3434,0.2009
"11984",228149,"St Marys University",1,0,2005,"18274","71.00437","184","73","494",314,180,147,"38",109,0.3471,0.2111,0.2976,0.1478
"11985",228149,"St Marys University",1,0,2006,"19334","71.982818","183","99","548",347,201,187,"39",148,0.4265,0.194,0.3412,0.1807
"11986",228149,"St Marys University",1,0,2007,"20300","73.452126","187","110","565",334,231,187,"54",133,0.3982,0.2338,0.331,0.1947
"11987",228149,"St Marys University",1,0,2008,"20600","78.363433","192","87","535",335,200,237,"63",174,0.5194,0.315,0.443,0.1626
"11988",228149,"St Marys University",1,0,2009,"21320","80.413342","197","99","530",335,195,270,"76",194,0.5791,0.3897,0.5094,0.1868
"11989",228149,"St Marys University",1,0,2010,"21980","84.772635","196","84","585",358,227,249,"85",164,0.4581,0.3744,0.4256,0.1436
"11990",228246,"SOUTHERN METHODIST UNIVERSITY",1,0,1991,"11768","150.722","490","1004","1229",652,577,671,"289",382,0.5859,0.5009,0.546,0.8169
"11991",228246,"SOUTHERN METHODIST UNIVERSITY",1,0,1992,"12688","159.447","484","961","1221",634,587,663,"274",389,0.6136,0.4668,0.543,0.7871
"11992",228246,"SOUTHERN METHODIST UNIVERSITY",1,0,1993,"13580","165.979","483","861","1161",630,531,657,"265",392,0.6222,0.4991,0.5659,0.7416
"11993",228246,"SOUTHERN METHODIST UNIVERSITY",1,0,1995,"15228","180.395","485","963","1228",662,566,743,"287",456,0.6888,0.5071,0.605,0.7842
"11994",228246,"SOUTHERN METHODIST UNIVERSITY",1,0,1996,"15990","186.298","493","936","1217",663,554,687,"270",417,0.629,0.4874,0.5645,0.7691
"11995",228246,"SOUTHERN METHODIST UNIVERSITY",1,0,1997,"16790","181.058","502","977","1247",686,561,702,"282",420,0.6122,0.5027,0.563,0.7835
"11996",228246,"SOUTHERN METHODIST UNIVERSITY",1,0,1998,"17628","200.242","500","975","1306",720,586,689,"249",440,0.6111,0.4249,0.5276,0.7466
"11997",228246,"SOUTHERN METHODIST UNIVERSITY",1,0,1999,"16422","225.03","519","1002","1331",688,643,656,"262",394,0.5727,0.4075,0.4929,0.7528
"11998",228246,"SOUTHERN METHODIST UNIVERSITY",1,0,2000,"17406","248.689","519.5","981","1276",713,563,736,"280",456,0.6396,0.4973,0.5768,0.7688
"11999",228246,"SOUTHERN METHODIST UNIVERSITY",1,0,2001,"18450","253.317","520","1073","1353",713,640,751,"297",454,0.6367,0.4641,0.5551,0.7931
"12000",228246,"SOUTHERN METHODIST UNIVERSITY",1,0,2002,"19466","254.145","535","1080","1380",764,616,811,"315",496,0.6492,0.5114,0.5877,0.7826
"12001",228246,"SOUTHERN METHODIST UNIVERSITY",1,0,2003,"20926","265.405","563","1049","1383",772,611,853,"324",529,0.6852,0.5303,0.6168,0.7585
"12002",228246,"SOUTHERN METHODIST UNIVERSITY",1,0,2004,"22496","281.996","575","1015","1313",717,596,789,"310",479,0.6681,0.5201,0.6009,0.773
"12003",228246,"Southern Methodist University",1,0,2005,"23846","299.859","603","1120","1401",754,647,846,"345",501,0.6645,0.5332,0.6039,0.7994
"12004",228246,"Southern Methodist University",1,0,2006,"25400","315.857","609","1069","1369",753,616,937,"377",560,0.7437,0.612,0.6844,0.7809
"12005",228246,"Southern Methodist University",1,0,2007,"27400","346.441","633","1042","1306",697,609,870,"359",511,0.7331,0.5895,0.6662,0.7979
"12006",228246,"Southern Methodist University",1,0,2008,"29430","367.195","656","1050","1397",751,646,941,"404",537,0.715,0.6254,0.6736,0.7516
"12007",228246,"Southern Methodist University",1,0,2009,"31200","406.929","660","958","1325",702,623,886,"374",512,0.7293,0.6003,0.6687,0.723
"12008",228246,"Southern Methodist University",1,0,2010,"33040","394.227","668","1003","1476",786,690,1008,"429",579,0.7366,0.6217,0.6829,0.6795
"12009",228343,"SOUTHWESTERN UNIVERSITY",1,0,1991,"9400","22.624494","81","269","324",173,151,191,"89",102,0.5896,0.5894,0.5895,0.8302
"12010",228343,"SOUTHWESTERN UNIVERSITY",1,0,1992,"10300","23.732846","81","249","317",176,141,175,"62",113,0.642,0.4397,0.5521,0.7855
"12011",228343,"SOUTHWESTERN UNIVERSITY",1,0,1993,"11000","24.472185","87","275","351",207,144,218,"79",139,0.6715,0.5486,0.6211,0.7835
"12012",228343,"SOUTHWESTERN UNIVERSITY",1,0,1995,"12700","27.397451","85","257","326",188,138,188,"69",119,0.633,0.5,0.5767,0.7883
"12013",228343,"SOUTHWESTERN UNIVERSITY",1,0,1996,"13400","28.685911","92","245","310",198,112,179,"60",119,0.601,0.5357,0.5774,0.7903
"12014",228343,"SOUTHWESTERN UNIVERSITY",1,0,1997,"14000","29.667457","91","278","332",177,155,201,"85",116,0.6554,0.5484,0.6054,0.8373
"12015",228343,"SOUTHWESTERN UNIVERSITY",1,0,1998,"14600","32.191399","95","331","378",218,160,227,"74",153,0.7018,0.4625,0.6005,0.8757
"12016",228343,"SOUTHWESTERN UNIVERSITY",1,0,1999,"15000","35.325304","97","288","354",210,144,236,"83",153,0.7286,0.5764,0.6667,0.8136
"12017",228343,"SOUTHWESTERN UNIVERSITY",1,0,2000,"15750","39.255034","103.5","270","355",195,160,230,"91",139,0.7128,0.5688,0.6479,0.7606
"12018",228343,"SOUTHWESTERN UNIVERSITY",1,0,2001,"16650","41.894349","110","260","327",174,153,196,"77",119,0.6839,0.5033,0.5994,0.7951
"12019",228343,"SOUTHWESTERN UNIVERSITY",1,0,2002,"17570","44.023485","115","244","342",217,125,227,"76",151,0.6959,0.608,0.6637,0.7135
"12020",228343,"SOUTHWESTERN UNIVERSITY",1,0,2003,"18870","44.274879","114","261","343",196,147,234,"80",154,0.7857,0.5442,0.6822,0.7609
"12021",228343,"SOUTHWESTERN UNIVERSITY",1,0,2004,"20220","44.724206","121","283","366",221,145,228,"68",160,0.724,0.469,0.623,0.7732
"12022",228343,"Southwestern University",1,0,2005,"21900","48.006533","118","262","327",192,135,223,"87",136,0.7083,0.6444,0.682,0.8012
"12023",228343,"Southwestern University",1,0,2006,"23650","51.346535","120","267","345",221,124,231,"74",157,0.7104,0.5968,0.6696,0.7739
"12024",228343,"Southwestern University",1,0,2007,"25740","52.696159","122","286","371",232,139,242,"84",158,0.681,0.6043,0.6523,0.7709
"12025",228343,"Southwestern University",1,0,2008,"27940","53.644745","121","252","349",216,133,227,"78",149,0.6898,0.5865,0.6504,0.7221
"12026",228343,"Southwestern University",1,0,2009,"30220","55.130102","125","284","375",231,144,257,"88",169,0.7316,0.6111,0.6853,0.7573
"12027",228343,"Southwestern University",1,0,2010,"31630","58.887234","124","268","383",224,159,252,"98",154,0.6875,0.6164,0.658,0.6997
"12028",228431,"STEPHEN F AUSTIN STATE UNIVERSITY",1,0,1991,"1042","81.893182","403","1841","2047",1234,813,353,"74",279,0.2261,0.091,0.1724,0.8994
"12029",228431,"STEPHEN F AUSTIN STATE UNIVERSITY",1,0,1992,"1338","85.61685","408","1923","2183",1255,928,332,"95",237,0.1888,0.1024,0.1521,0.8809
"12030",228431,"STEPHEN F AUSTIN STATE UNIVERSITY",1,0,1993,"1515","92.487124","391","1946","2247",1255,992,308,"81",227,0.1809,0.0817,0.1371,0.866
"12031",228431,"STEPHEN F AUSTIN STATE UNIVERSITY",1,0,1995,"1907","98.017166","378","1481","1714",986,728,275,"69",206,0.2089,0.0948,0.1604,0.8641
"12032",228431,"STEPHEN F AUSTIN STATE UNIVERSITY",1,0,1996,"2127","99.049077","383","1632","2007",1188,819,332,"71",261,0.2197,0.0867,0.1654,0.8132
"12033",228431,"STEPHEN F AUSTIN STATE UNIVERSITY",1,0,1997,"2247","103.833622","402","1854","2360",1422,938,358,"71",287,0.2018,0.0757,0.1517,0.7856
"12034",228431,"STEPHEN F AUSTIN STATE UNIVERSITY",1,0,1998,"2408","109.577554","406","1830","2348",1432,916,388,"69",319,0.2228,0.0753,0.1652,0.7794
"12035",228431,"STEPHEN F AUSTIN STATE UNIVERSITY",1,0,1999,"1140","119.77498","412","1719","2255",1353,902,339,"92",247,0.1826,0.102,0.1503,0.7623
"12036",228431,"STEPHEN F AUSTIN STATE UNIVERSITY",1,0,2000,"960","121.068522","411.5","1624","2210",1371,839,370,"88",282,0.2057,0.1049,0.1674,0.7348
"12037",228431,"STEPHEN F AUSTIN STATE UNIVERSITY",1,0,2001,"1728","124.909658","411","1521","2191",1370,821,360,"90",270,0.1971,0.1096,0.1643,0.6942
"12038",228431,"STEPHEN F AUSTIN STATE UNIVERSITY",1,0,2002,"1848","128.089814","442","1452","2006",1229,777,314,"83",231,0.188,0.1068,0.1565,0.7238
"12039",228431,"STEPHEN F AUSTIN STATE UNIVERSITY",1,0,2003,"2088","134.207608","430","1322","1839",1148,691,348,"88",260,0.2265,0.1274,0.1892,0.7189
"12040",228431,"STEPHEN F AUSTIN STATE UNIVERSITY",1,0,2004,"2688","132.385124","417","1257","1736",1091,645,381,"95",286,0.2621,0.1473,0.2195,0.7241
"12041",228431,"Stephen F Austin State University",1,0,2005,"3024","132.558081","431","1343","1967",1199,768,441,"125",316,0.2636,0.1628,0.2242,0.6828
"12042",228431,"Stephen F Austin State University",1,0,2006,"3240","147.781955","432","1515","2305",1420,885,538,"132",406,0.2859,0.1492,0.2334,0.6573
"12043",228431,"Stephen F Austin State University",1,0,2007,"3528","165.056073","429","1421","2268",1375,893,521,"156",365,0.2655,0.1747,0.2297,0.6265
"12044",228431,"Stephen F Austin State University",1,0,2008,"3744","177.039213","432","1416","2480",1545,935,590,"131",459,0.2971,0.1401,0.2379,0.571
"12045",228431,"Stephen F Austin State University",1,0,2009,"3864","186.147103","451","1440","2553",1613,940,576,"135",441,0.2734,0.1436,0.2256,0.564
"12046",228431,"Stephen F Austin State University",1,0,2010,"4076","198.398044","447","1192","2280",1473,807,556,"128",428,0.2906,0.1586,0.2439,0.5228
"12047",228459,"SOUTHWEST TEXAS STATE UNIVERSITY",1,0,1991,"1130","130.468332","625","2010","2916",1634,1282,201,"61",140,0.0857,0.0476,0.0689,0.6893
"12048",228459,"SOUTHWEST TEXAS STATE UNIVERSITY",1,0,1992,"1406","141.567888","608","1690","2310",1372,938,229,"59",170,0.1239,0.0629,0.0991,0.7316
"12049",228459,"SOUTHWEST TEXAS STATE UNIVERSITY",1,0,1993,"1578","151.307807","641","1647","2281",1358,923,248,"62",186,0.137,0.0672,0.1087,0.7221
"12050",228459,"SOUTHWEST TEXAS STATE UNIVERSITY",1,0,1995,"1588","160.430316","625","1802","2426",1461,965,309,"80",229,0.1567,0.0829,0.1274,0.7428
"12051",228459,"SOUTHWEST TEXAS STATE UNIVERSITY",1,0,1996,"2022","164.208432","625","1753","2396",1472,924,408,"88",320,0.2174,0.0952,0.1703,0.7316
"12052",228459,"SOUTHWEST TEXAS STATE UNIVERSITY",1,0,1997,"2214","172.908365","607","1737","2331",1399,932,413,"107",306,0.2187,0.1148,0.1772,0.7452
"12053",228459,"SOUTHWEST TEXAS STATE UNIVERSITY",1,0,1998,"2388","184.818455","616","1923","2592",1546,1046,458,"127",331,0.2141,0.1214,0.1767,0.7419
"12054",228459,"SOUTHWEST TEXAS STATE UNIVERSITY",1,0,1999,"1140","196.082904","635","1806","2447",1479,968,504,"130",374,0.2529,0.1343,0.206,0.738
"12055",228459,"SOUTHWEST TEXAS STATE UNIVERSITY",1,0,2000,"1200","215.742093","661.5","1873","2531",1553,978,522,"122",400,0.2576,0.1247,0.2062,0.74
"12056",228459,"SOUTHWEST TEXAS STATE UNIVERSITY",1,0,2001,"1260","237.370082","688","1872","2469",1508,961,553,"134",419,0.2779,0.1394,0.224,0.7582
"12057",228459,"SOUTHWEST TEXAS STATE UNIVERSITY",1,0,2002,"2640","243.934789","693","1997","2674",1665,1009,587,"140",447,0.2685,0.1388,0.2195,0.7468
"12058",228459,"TEXAS STATE UNIVERSITY-SAN MARCOS",1,0,2003,"2208","279.646155","707","2104","2818",1681,1137,667,"195",472,0.2808,0.1715,0.2367,0.7466
"12059",228459,"TEXAS STATE UNIVERSITY-SAN MARCOS",1,0,2004,"2616","281.844471","736","2067","2783",1616,1167,691,"187",504,0.3119,0.1602,0.2483,0.7427
"12060",228459,"Texas State University-San Marcos",1,0,2005,"3024","299.589753","779","2172","3053",1786,1267,825,"235",590,0.3303,0.1855,0.2702,0.7114
"12061",228459,"Texas State University-San Marcos",1,0,2006,"3312","308.573489","833","2038","2975",1746,1229,815,"250",565,0.3236,0.2034,0.2739,0.685
"12062",228459,"Texas State University-San Marcos",1,0,2007,"3840","367.634779","870","2148","3237",1900,1337,983,"288",695,0.3658,0.2154,0.3037,0.6636
"12063",228459,"Texas State University-San Marcos",1,0,2008,"4080","376.312167","934","2253","3444",2051,1393,916,"289",627,0.3057,0.2075,0.266,0.6542
"12064",228459,"Texas State University-San Marcos",1,0,2009,"4368","430.605309","983","2371","3804",2260,1544,985,"271",714,0.3159,0.1755,0.2589,0.6233
"12065",228459,"Texas State University-San Marcos",1,0,2010,"4584","463.135262","1053","2323","4033",2403,1630,1091,"306",785,0.3267,0.1877,0.2705,0.576
"12066",228501,"SUL ROSS STATE UNIVERSITY",1,0,1991,"946","16.143323","91","154","335",123,212,19,"9",10,0.0813,0.0425,0.0567,0.4597
"12067",228501,"SUL ROSS STATE UNIVERSITY",1,0,1992,"1108","17.09829","90","130","278",124,154,17,"6",11,0.0887,0.039,0.0612,0.4676
"12068",228501,"SUL ROSS STATE UNIVERSITY",1,0,1993,"1224","20.444199","95","145","317",107,210,23,"9",14,0.1308,0.0429,0.0726,0.4574
"12069",228501,"SUL ROSS STATE UNIVERSITY",1,0,1995,"1508","22.830552","102","205","393",140,253,34,"16",18,0.1286,0.0632,0.0865,0.5216
"12070",228501,"SUL ROSS STATE UNIVERSITY",1,0,1996,"1642","26.476051","106","175","355",135,220,22,"8",14,0.1037,0.0364,0.062,0.493
"12071",228501,"SUL ROSS STATE UNIVERSITY",1,0,1997,"1750","32.924034","117","138","280",113,167,20,"12",8,0.0708,0.0719,0.0714,0.4929
"12072",228501,"SUL ROSS STATE UNIVERSITY",1,0,1998,"1834","31.410202","118","148","316",113,203,26,"10",16,0.1416,0.0493,0.0823,0.4684
"12073",228501,"SUL ROSS STATE UNIVERSITY",1,0,1999,"912","30.107775","121","117","227",95,132,25,"11",14,0.1474,0.0833,0.1101,0.5154
"12074",228501,"SUL ROSS STATE UNIVERSITY",1,0,2000,"960","33.202508","116","130","263",105,158,13,"7",6,0.0571,0.0443,0.0494,0.4943
"12075",228501,"SUL ROSS STATE UNIVERSITY",1,0,2001,"1536","35.00788","111","139","333",124,209,28,"7",21,0.1694,0.0335,0.0841,0.4174
"12076",228501,"SUL ROSS STATE UNIVERSITY",1,0,2002,"1632","40.864015","117","98","315",130,185,14,"3",11,0.0846,0.0162,0.0444,0.3111
"12077",228501,"SUL ROSS STATE UNIVERSITY",1,0,2003,"1824","40.655116","118","127","357",163,194,30,"11",19,0.1166,0.0567,0.084,0.3557
"12078",228501,"SUL ROSS STATE UNIVERSITY",1,0,2004,"2064","41.944331","118","115","275",113,162,25,"11",14,0.1239,0.0679,0.0909,0.4182
"12079",228501,"Sul Ross State University",1,0,2005,"2256","43.711019","121","132","329",127,202,31,"19",12,0.0945,0.0941,0.0942,0.4012
"12080",228501,"Sul Ross State University",1,0,2006,"2400","50.340754","125","81","192",73,119,22,"8",14,0.1918,0.0672,0.1146,0.4219
"12081",228501,"Sul Ross State University",1,0,2007,"2688","50.282332","123","84","242",92,150,34,"6",28,0.3043,0.04,0.1405,0.3471
"12082",228501,"Sul Ross State University",1,0,2008,"2784","53.331359","128","109","315",124,191,43,"18",25,0.2016,0.0942,0.1365,0.346
"12083",228501,"Sul Ross State University",1,0,2009,"2928","53.907277","128","112","374",135,239,36,"15",21,0.1556,0.0628,0.0963,0.2995
"12084",228501,"Sul Ross State University",1,0,2010,"3072","57.673374","127","95","322",146,176,42,"17",25,0.1712,0.0966,0.1304,0.295
"12085",228529,"TARLETON STATE UNIVERSITY",1,0,1991,"992","34.591335","196","806","924",421,503,88,"35",53,0.1259,0.0696,0.0952,0.8723
"12086",228529,"TARLETON STATE UNIVERSITY",1,0,1992,"1104","37.391181","198","833","942",428,514,69,"28",41,0.0958,0.0545,0.0732,0.8843
"12087",228529,"TARLETON STATE UNIVERSITY",1,0,1993,"1184","41.897391","204","829","923",432,491,82,"24",58,0.1343,0.0489,0.0888,0.8982
"12088",228529,"TARLETON STATE UNIVERSITY",1,0,1995,"1566","41.781675","221","935","1021",531,490,140,"52",88,0.1657,0.1061,0.1371,0.9158
"12089",228529,"TARLETON STATE UNIVERSITY",1,0,1996,"1774","43.688228","203","850","919",455,464,117,"35",82,0.1802,0.0754,0.1273,0.9249
"12090",228529,"TARLETON STATE UNIVERSITY",1,0,1997,"2331","45.852405","228","546","595",306,289,98,"38",60,0.1961,0.1315,0.1647,0.9176
"12091",228529,"TARLETON STATE UNIVERSITY",1,0,1998,"2412","52.001336","234","562","605",296,309,102,"44",58,0.1959,0.1424,0.1686,0.9289
"12092",228529,"TARLETON STATE UNIVERSITY",1,0,1999,"1488","53.278517","255","547","585",303,282,109,"45",64,0.2112,0.1596,0.1863,0.935
"12093",228529,"TARLETON STATE UNIVERSITY",1,0,2000,"1608","66.696154","274.5","421","475",238,237,100,"40",60,0.2521,0.1688,0.2105,0.8863
"12094",228529,"TARLETON STATE UNIVERSITY",1,0,2001,"1728","74.596926","294","701","783",411,372,126,"37",89,0.2165,0.0995,0.1609,0.8953
"12095",228529,"TARLETON STATE UNIVERSITY",1,0,2002,"1920","81.138437","278","862","974",507,467,148,"46",102,0.2012,0.0985,0.152,0.885
"12096",228529,"TARLETON STATE UNIVERSITY",1,0,2003,"2136","83.993663","281","1118","1277",686,591,201,"62",139,0.2026,0.1049,0.1574,0.8755
"12097",228529,"TARLETON STATE UNIVERSITY",1,0,2004,"2400","86.677793","284","1041","1178",655,523,200,"59",141,0.2153,0.1128,0.1698,0.8837
"12098",228529,"Tarleton State University",1,0,2005,"2640","91.914897","304","1013","1188",678,510,212,"65",147,0.2168,0.1275,0.1785,0.8527
"12099",228529,"Tarleton State University",1,0,2006,"2880","100.277431","315","1066","1256",667,589,230,"94",136,0.2039,0.1596,0.1831,0.8487
"12100",228529,"Tarleton State University",1,0,2007,"3120","109.010891","320","1011","1190",685,505,259,"86",173,0.2526,0.1703,0.2176,0.8496
"12101",228529,"Tarleton State University",1,0,2008,"3324","118.275543","359","1053","1274",722,552,276,"92",184,0.2548,0.1667,0.2166,0.8265
"12102",228529,"Tarleton State University",1,0,2009,"3324","133.205162","345","991","1207",668,539,293,"96",197,0.2949,0.1781,0.2428,0.821
"12103",228529,"Tarleton State University",1,0,2010,"3455","142.869434","344","1129","1435",858,577,339,"98",241,0.2809,0.1698,0.2362,0.7868
"12104",228705,"TEXAS A & I UNIVERSITY",1,0,1991,"882","42.780583","188","224","979",465,514,49,"16",33,0.071,0.0311,0.0501,0.2288
"12105",228705,"TEXAS A & I UNIVERSITY",1,0,1992,"882","45.864114","188","234","987",484,503,72,"20",52,0.1074,0.0398,0.0729,0.2371
"12106",228705,"TEXAS A & I UNIVERSITY",1,0,1993,"882","49.837504","192","268","1012",481,531,50,"19",31,0.0644,0.0358,0.0494,0.2648
"12107",228705,"TEXAS A & M UNIVERSITY-KINGSVILLE",1,0,1995,"1418","53.63955","198","210","893",420,473,40,"17",23,0.0548,0.0359,0.0448,0.2352
"12108",228705,"TEXAS A & M UNIVERSITY-KINGSVILLE",1,0,1996,"1634","56.377022","186","253","916",406,510,55,"22",33,0.0813,0.0431,0.06,0.2762
"12109",228705,"TEXAS A & M UNIVERSITY-KINGSVILLE",1,0,1997,"1774","63.690333","204","193","898",402,496,47,"15",32,0.0796,0.0302,0.0523,0.2149
"12110",228705,"TEXAS A & M UNIVERSITY-KINGSVILLE",1,0,1998,"1822","69.242104","202","225","872",375,497,73,"34",39,0.104,0.0684,0.0837,0.258
"12111",228705,"TEXAS A & M UNIVERSITY-KINGSVILLE",1,0,1999,"1140","70.485661","202","176","736",293,443,53,"24",29,0.099,0.0542,0.072,0.2391
"12112",228705,"TEXAS A & M UNIVERSITY-KINGSVILLE",1,0,2000,"1200","78.834019","245.5","224","819",332,487,79,"33",46,0.1386,0.0678,0.0965,0.2735
"12113",228705,"TEXAS A & M UNIVERSITY-KINGSVILLE",1,0,2001,"1260","70.877576","289","233","820",388,432,66,"28",38,0.0979,0.0648,0.0805,0.2841
"12114",228705,"TEXAS A & M UNIVERSITY-KINGSVILLE",1,0,2002,"1320","89.40907","209","226","962",401,561,135,"75",60,0.1496,0.1337,0.1403,0.2349
"12115",228705,"TEXAS A & M UNIVERSITY-KINGSVILLE",1,0,2003,"1104","90.476637","214","200","828",370,458,60,"24",36,0.0973,0.0524,0.0725,0.2415
"12116",228705,"TEXAS A & M UNIVERSITY-KINGSVILLE",1,0,2004,"1440","90.668003","211","171","741",328,413,80,"29",51,0.1555,0.0702,0.108,0.2308
"12117",228705,"Texas A & M University-Kingsville",1,0,2005,"2448","94.882289","284","155","606",244,362,83,"40",43,0.1762,0.1105,0.137,0.2558
"12118",228705,"Texas A & M University-Kingsville",1,0,2006,"2640","98.185915","294","189","731",297,434,95,"32",63,0.2121,0.0737,0.13,0.2585
"12119",228705,"Texas A & M University-Kingsville",1,0,2007,"2800","102.595181","300","140","651",251,400,115,"58",57,0.2271,0.145,0.1767,0.2151
"12120",228705,"Texas A & M University-Kingsville",1,0,2008,"3104","112.837549","302","194","737",310,427,124,"70",54,0.1742,0.1639,0.1682,0.2632
"12121",228705,"Texas A & M University-Kingsville",1,0,2009,"3104","130.460266","340","193","971",414,557,165,"75",90,0.2174,0.1346,0.1699,0.1988
"12122",228705,"Texas A & M University-Kingsville",1,0,2010,"4066","153.478201","360","213","1287",539,748,196,"70",126,0.2338,0.0936,0.1523,0.1655
"12123",228723,"TEXAS A & M UNIVERSITY",1,0,1991,"1224","741.236563","1540","4915","6034",2816,3218,1454,"510",944,0.3352,0.1585,0.241,0.8146
"12124",228723,"TEXAS A & M UNIVERSITY",1,0,1992,"1488","763.395591","1550","4745","5968",2872,3096,2475,"953",1522,0.5299,0.3078,0.4147,0.7951
"12125",228723,"TEXAS A & M UNIVERSITY",1,0,1993,"1646","801.734928","1546","4975","6341",3083,3258,1631,"524",1107,0.3591,0.1608,0.2572,0.7846
"12126",228723,"TEXAS A & M UNIVERSITY",1,0,1995,"1988","871.462949","1505","4602","5985",2986,2999,1643,"498",1145,0.3835,0.1661,0.2745,0.7689
"12127",228723,"TEXAS A & M UNIVERSITY",1,0,1996,"1948","911.3475","1496","5154","6326",3218,3108,1931,"625",1306,0.4058,0.2011,0.3052,0.8147
"12128",228723,"TEXAS A & M UNIVERSITY",1,0,1997,"2740","965.338774","1637","5098","6169",3158,3011,1953,"619",1334,0.4224,0.2056,0.3166,0.8264
"12129",228723,"TEXAS A & M UNIVERSITY",1,0,1998,"2897","1025.992332","1651","6011","7322",3701,3621,2350,"782",1568,0.4237,0.216,0.321,0.821
"12130",228723,"TEXAS A & M UNIVERSITY",1,0,1999,"2280","1084.891928","1753","5529","6659",3419,3240,2359,"722",1637,0.4788,0.2228,0.3543,0.8303
"12131",228723,"TEXAS A & M UNIVERSITY",1,0,2000,"2400","1202.553467","1667.5","5346","6591",3453,3138,2409,"774",1635,0.4735,0.2467,0.3655,0.8111
"12132",228723,"TEXAS A & M UNIVERSITY",1,0,2001,"2520","1159.092725","1582","5149","6271",3265,3006,2408,"815",1593,0.4879,0.2711,0.384,0.8211
"12133",228723,"TEXAS A & M UNIVERSITY",1,0,2002,"2640","1383.198324","1775","5445","6589",3528,3061,2734,"863",1871,0.5303,0.2819,0.4149,0.8264
"12134",228723,"TEXAS A & M UNIVERSITY",1,0,2003,"2895","1430.61488","1813","5236","6389",3358,3031,2898,"981",1917,0.5709,0.3237,0.4536,0.8195
"12135",228723,"TEXAS A & M UNIVERSITY",1,0,2004,"3675","1418.058537","1898","5276","6645",3465,3180,3071,"1049",2022,0.5835,0.3299,0.4622,0.794
"12136",228723,"Texas A & M University",1,0,2005,"4110","1561.220143","1907","5099","6713",3406,3307,3352,"1259",2093,0.6145,0.3807,0.4993,0.7596
"12137",228723,"Texas A & M University",1,0,2006,"4371","1557.884423","2116","5620","7472",3774,3698,3636,"1358",2278,0.6036,0.3672,0.4866,0.7521
"12138",228723,"Texas A & M University",1,0,2007,"4680","1621.981725","2179","6107","8025",4074,3951,3968,"1491",2477,0.608,0.3774,0.4945,0.761
"12139",228723,"Texas A & M University",1,0,2008,"4898","1917.767483","2648","5754","8038",3940,4098,3989,"1575",2414,0.6127,0.3843,0.4963,0.7158
"12140",228723,"Texas A & M University",1,0,2009,"5152","1992.292362","2316","5630","7933",3908,4025,4017,"1602",2415,0.618,0.398,0.5064,0.7097
"12141",228723,"Texas A & M University-College Station",1,0,2010,"5297","2042.499187","2625","5544","8033",3862,4171,4175,"1709",2466,0.6385,0.4097,0.5197,0.6902
"12142",228769,"UNIVERSITY OF TEXAS AT ARLINGTON",1,0,1991,"1054","139.673249","602","1077","1608",759,849,116,"45",71,0.0935,0.053,0.0721,0.6698
"12143",228769,"UNIVERSITY OF TEXAS AT ARLINGTON",1,0,1992,"1236","144.962868","613","1010","1523",724,799,105,"39",66,0.0912,0.0488,0.0689,0.6632
"12144",228769,"THE UNIVERSITY OF TEXAS AT ARLINGTON",1,0,1993,"1159","153.453601","608","832","1314",638,676,81,"34",47,0.0737,0.0503,0.0616,0.6332
"12145",228769,"THE UNIVERSITY OF TEXAS AT ARLINGTON",1,0,1995,"1560","167.190503","655","777","1243",623,620,117,"47",70,0.1124,0.0758,0.0941,0.6251
"12146",228769,"THE UNIVERSITY OF TEXAS AT ARLINGTON",1,0,1996,"1859","181.349432","673","707","1208",617,591,235,"90",145,0.235,0.1523,0.1945,0.5853
"12147",228769,"THE UNIVERSITY OF TEXAS AT ARLINGTON",1,0,1997,"2106","182.310532","618","716","1270",644,626,250,"105",145,0.2252,0.1677,0.1969,0.5638
"12148",228769,"THE UNIVERSITY OF TEXAS AT ARLINGTON",1,0,1998,"2398","190.205593","665","723","1241",568,673,155,"64",91,0.1602,0.0951,0.1249,0.5826
"12149",228769,"THE UNIVERSITY OF TEXAS AT ARLINGTON",1,0,1999,"1824","188.91149","636","775","1402",714,688,214,"95",119,0.1667,0.1381,0.1526,0.5528
"12150",228769,"THE UNIVERSITY OF TEXAS AT ARLINGTON",1,0,2000,"1920","201.126757","642.5","866","1589",801,788,225,"102",123,0.1536,0.1294,0.1416,0.545
"12151",228769,"THE UNIVERSITY OF TEXAS AT ARLINGTON",1,0,2001,"2016","222.908472","649","1001","1838",914,924,271,"104",167,0.1827,0.1126,0.1474,0.5446
"12152",228769,"THE UNIVERSITY OF TEXAS AT ARLINGTON",1,0,2002,"2112","227.300316","678","1193","2126",1070,1056,269,"112",157,0.1467,0.1061,0.1265,0.5611
"12153",228769,"THE UNIVERSITY OF TEXAS AT ARLINGTON",1,0,2003,"2208","235.752367","743","1399","2431",1182,1249,364,"144",220,0.1861,0.1153,0.1497,0.5755
"12154",228769,"THE UNIVERSITY OF TEXAS AT ARLINGTON",1,0,2004,"2904","245.138386","735","993","2009",1068,941,325,"115",210,0.1966,0.1222,0.1618,0.4943
"12155",228769,"The University of Texas at Arlington",1,0,2005,"3306","280.671415","769","973","2075",1069,1006,347,"130",217,0.203,0.1292,0.1672,0.4689
"12156",228769,"The University of Texas at Arlington",1,0,2006,"5930","303.739012","784","979","1974",984,990,340,"124",216,0.2195,0.1253,0.1722,0.4959
"12157",228769,"The University of Texas at Arlington",1,0,2007,"6464","324.675801","812","963","2096",1041,1055,354,"130",224,0.2152,0.1232,0.1689,0.4594
"12158",228769,"The University of Texas at Arlington",1,0,2008,"7780","354.947908","825","942","2254",1106,1148,396,"151",245,0.2215,0.1315,0.1757,0.4179
"12159",228769,"The University of Texas at Arlington",1,0,2009,"8186","368.102175","821","987","2435",1261,1174,502,"206",296,0.2347,0.1755,0.2062,0.4053
"12160",228769,"The University of Texas at Arlington",1,0,2010,"8500","410.32791","864","920","2585",1319,1266,549,"228",321,0.2434,0.1801,0.2124,0.3559
"12161",228778,"UNIVERSITY OF TEXAS AT AUSTIN",1,0,1991,"1189","756.078928","2060","3881","5850",2743,3107,1722,"723",999,0.3642,0.2327,0.2944,0.6634
"12162",228778,"UNIVERSITY OF TEXAS AT AUSTIN",1,0,1992,"1372","784.635408","2062","3696","5633",2670,2963,1696,"691",1005,0.3764,0.2332,0.3011,0.6561
"12163",228778,"THE UNIVERSITY OF TEXAS AT AUSTIN",1,0,1993,"1691","849.761808","2099","3737","5872",2810,3062,1776,"741",1035,0.3683,0.242,0.3025,0.6364
"12164",228778,"THE UNIVERSITY OF TEXAS AT AUSTIN",1,0,1995,"2208","876.497407","2115","4001","6212",3139,3073,2207,"865",1342,0.4275,0.2815,0.3553,0.6441
"12165",228778,"THE UNIVERSITY OF TEXAS AT AUSTIN",1,0,1996,"2612","934.576356","2056","4071","6281",3087,3194,2420,"985",1435,0.4649,0.3084,0.3853,0.6481
"12166",228778,"THE UNIVERSITY OF TEXAS AT AUSTIN",1,0,1997,"2866","984.178962","2163","4638","6945",3568,3377,2531,"990",1541,0.4319,0.2932,0.3644,0.6678
"12167",228778,"THE UNIVERSITY OF TEXAS AT AUSTIN",1,0,1998,"3004","1016.463627","2134","4305","6598",3388,3210,2590,"1036",1554,0.4587,0.3227,0.3925,0.6525
"12168",228778,"THE UNIVERSITY OF TEXAS AT AUSTIN",1,0,1999,"2280","1065.003213","2158","4370","6925",3508,3417,2888,"1186",1702,0.4852,0.3471,0.417,0.631
"12169",228778,"THE UNIVERSITY OF TEXAS AT AUSTIN",1,0,2000,"2400","1202.578024","2193","4727","7551",3857,3694,3447,"1403",2044,0.5299,0.3798,0.4565,0.626
"12170",228778,"THE UNIVERSITY OF TEXAS AT AUSTIN",1,0,2001,"2520","1283.460962","2228","4383","7198",3742,3456,3385,"1392",1993,0.5326,0.4028,0.4703,0.6089
"12171",228778,"THE UNIVERSITY OF TEXAS AT AUSTIN",1,0,2002,"2640","1379.835805","2324","4828","7842",4111,3731,3769,"1531",2238,0.5444,0.4103,0.4806,0.6157
"12172",228778,"THE UNIVERSITY OF TEXAS AT AUSTIN",1,0,2003,"2760","1409.858902","2265","3831","6477",3537,2940,3300,"1309",1991,0.5629,0.4452,0.5095,0.5915
"12173",228778,"THE UNIVERSITY OF TEXAS AT AUSTIN",1,0,2004,"4260","1502.213159","2320","3874","6741",3693,3048,3540,"1426",2114,0.5724,0.4678,0.5251,0.5747
"12174",228778,"The University of Texas at Austin",1,0,2005,"6972","1545.502649","2450","3764","6783",3630,3153,3572,"1419",2153,0.5931,0.45,0.5266,0.5549
"12175",228778,"The University of Texas at Austin",1,0,2006,"7630","1738.10835","2522","4001","7369",4008,3361,3731,"1482",2249,0.5611,0.4409,0.5063,0.543
"12176",228778,"The University of Texas at Austin",1,0,2007,"7670","1807.343419","2448","3807","7419",3973,3446,3776,"1472",2304,0.5799,0.4272,0.509,0.5131
"12177",228778,"The University of Texas at Austin",1,0,2008,"8532","2006.191894","2509","3491","6679",3679,3000,3487,"1358",2129,0.5787,0.4527,0.5221,0.5227
"12178",228778,"The University of Texas at Austin",1,0,2009,"8936","2126.069423","2593","3675","7198",3853,3345,3746,"1514",2232,0.5793,0.4526,0.5204,0.5106
"12179",228778,"The University of Texas at Austin",1,0,2010,"9416","2239.482204","2495","3445","7232",3869,3363,3986,"1608",2378,0.6146,0.4781,0.5512,0.4764
"12180",228787,"UNIVERSITY OF TEXAS AT DALLAS",1,0,1991,"1070","62.064277","199","54","99",50,49,21,"10",11,0.22,0.2041,0.2121,0.5455
"12181",228787,"UNIVERSITY OF TEXAS AT DALLAS",1,0,1992,"1096","77.749523","205","62","93",34,59,21,"9",12,0.3529,0.1525,0.2258,0.6667
"12182",228787,"THE UNIVERSITY OF TEXAS AT DALLAS",1,0,1993,"1450","75.722163","207","297","414",156,258,125,"76",49,0.3141,0.2946,0.3019,0.7174
"12183",228787,"THE UNIVERSITY OF TEXAS AT DALLAS",1,0,1995,"2033","79.665493","207","211","351",154,197,113,"45",68,0.4416,0.2284,0.3219,0.6011
"12184",228787,"THE UNIVERSITY OF TEXAS AT DALLAS",1,0,1996,"2333","82.929927","218","300","451",199,252,138,"59",79,0.397,0.2341,0.306,0.6652
"12185",228787,"THE UNIVERSITY OF TEXAS AT DALLAS",1,0,1997,"2788","94.509851","230","279","444",183,261,143,"77",66,0.3607,0.295,0.3221,0.6284
"12186",228787,"THE UNIVERSITY OF TEXAS AT DALLAS",1,0,1998,"3117","105.527847","244","308","494",213,281,187,"98",89,0.4178,0.3488,0.3785,0.6235
"12187",228787,"THE UNIVERSITY OF TEXAS AT DALLAS",1,0,1999,"1140","111.488294","256","376","603",242,361,180,"88",92,0.3802,0.2438,0.2985,0.6235
"12188",228787,"THE UNIVERSITY OF TEXAS AT DALLAS",1,0,2000,"960","126.09913","271.5","469","801",303,498,248,"127",121,0.3993,0.255,0.3096,0.5855
"12189",228787,"THE UNIVERSITY OF TEXAS AT DALLAS",1,0,2001,"1008","142.228625","287","563","984",402,582,304,"145",159,0.3955,0.2491,0.3089,0.5722
"12190",228787,"THE UNIVERSITY OF TEXAS AT DALLAS",1,0,2002,"1056","179.832112","315","537","903",405,498,325,"141",184,0.4543,0.2831,0.3599,0.5947
"12191",228787,"THE UNIVERSITY OF TEXAS AT DALLAS",1,0,2003,"1104","183.908913","453","647","1043",420,623,446,"242",204,0.4857,0.3884,0.4276,0.6203
"12192",228787,"THE UNIVERSITY OF TEXAS AT DALLAS",1,0,2004,"1152","289.044287","410","669","1129",429,700,473,"255",218,0.5082,0.3643,0.419,0.5926
"12193",228787,"The University of Texas at Dallas",1,0,2005,"5904","215.695406","464","636","1058",403,655,433,"235",198,0.4913,0.3588,0.4093,0.6011
"12194",228787,"The University of Texas at Dallas",1,0,2006,"6940","237.863895","451","640","1053",394,659,470,"252",218,0.5533,0.3824,0.4463,0.6078
"12195",228787,"The University of Texas at Dallas",1,0,2007,"7356","278.067394","472","563","1030",421,609,472,"237",235,0.5582,0.3892,0.4583,0.5466
"12196",228787,"The University of Texas at Dallas",1,0,2008,"9050","281.907069","480","550","1090",434,656,553,"280",273,0.629,0.4268,0.5073,0.5046
"12197",228787,"The University of Texas at Dallas",1,0,2009,"9510","308.980922","536","606","1293",560,733,615,"304",311,0.5554,0.4147,0.4756,0.4687
"12198",228787,"The University of Texas at Dallas",1,0,2010,"9886","361.018544","590","559","1346",544,802,680,"362",318,0.5846,0.4514,0.5052,0.4153
"12199",228796,"UNIVERSITY OF TEXAS AT EL PASO",1,0,1991,"990","97.207738","398","352","1897",1005,892,45,"16",29,0.0289,0.0179,0.0237,0.1856
"12200",228796,"UNIVERSITY OF TEXAS AT EL PASO",1,0,1992,"1318","106.492163","415","296","1846",989,857,38,"18",20,0.0202,0.021,0.0206,0.1603
"12201",228796,"THE UNIVERSITY OF TEXAS AT EL PASO",1,0,1993,"1480","119.979307","423","291","1948",1023,925,59,"22",37,0.0362,0.0238,0.0303,0.1494
"12202",228796,"THE UNIVERSITY OF TEXAS AT EL PASO",1,0,1995,"1897","137.105362","480","192","1618",887,731,36,"12",24,0.0271,0.0164,0.0222,0.1187
"12203",228796,"THE UNIVERSITY OF TEXAS AT EL PASO",1,0,1996,"1981","138.878999","453","189","1393",728,665,38,"13",25,0.0343,0.0195,0.0273,0.1357
"12204",228796,"THE UNIVERSITY OF TEXAS AT EL PASO",1,0,1997,"2272","151.613121","510","158","1482",750,732,36,"15",21,0.028,0.0205,0.0243,0.1066
"12205",228796,"THE UNIVERSITY OF TEXAS AT EL PASO",1,0,1998,"2336","161.221931","481","158","1639",847,792,58,"21",37,0.0437,0.0265,0.0354,0.0964
"12206",228796,"THE UNIVERSITY OF TEXAS AT EL PASO",1,0,1999,"2040","170.374165","471","194","1662",874,788,79,"22",57,0.0652,0.0279,0.0475,0.1167
"12207",228796,"THE UNIVERSITY OF TEXAS AT EL PASO",1,0,2000,"1776","192.329703","515","202","2018",1046,972,85,"30",55,0.0526,0.0309,0.0421,0.1001
"12208",228796,"THE UNIVERSITY OF TEXAS AT EL PASO",1,0,2001,"1920","208.38221","559","208","2156",1156,1000,89,"30",59,0.051,0.03,0.0413,0.0965
"12209",228796,"THE UNIVERSITY OF TEXAS AT EL PASO",1,0,2002,"2064","218.888199","590","190","2279",1202,1077,101,"41",60,0.0499,0.0381,0.0443,0.0834
"12210",228796,"THE UNIVERSITY OF TEXAS AT EL PASO",1,0,2003,"2208","228.469731","577","179","2386",1237,1149,111,"46",65,0.0525,0.04,0.0465,0.075
"12211",228796,"THE UNIVERSITY OF TEXAS AT EL PASO",1,0,2004,"3780","228.070419","612","170","2296",1205,1091,174,"58",116,0.0963,0.0532,0.0758,0.074
"12212",228796,"The University of Texas at El Paso",1,0,2005,"3930","252.116884","645","175","2154",1085,1069,210,"74",136,0.1253,0.0692,0.0975,0.0812
"12213",228796,"The University of Texas at El Paso",1,0,2006,"4065","272.801768","643","161","2446",1256,1190,269,"95",174,0.1385,0.0798,0.11,0.0658
"12214",228796,"The University of Texas at El Paso",1,0,2007,"4311","323.356816","632","152","2017",1046,971,245,"94",151,0.1444,0.0968,0.1215,0.0754
"12215",228796,"The University of Texas at El Paso",1,0,2008,"4551","303.41581","654","132","2060",1006,1054,251,"83",168,0.167,0.0787,0.1218,0.0641
"12216",228796,"The University of Texas at El Paso",1,0,2009,"4806","324.883306","675","142","2281",1153,1128,274,"95",179,0.1552,0.0842,0.1201,0.0623
"12217",228796,"The University of Texas at El Paso",1,0,2010,"5063","354.66976","676","207","2450",1262,1188,363,"134",229,0.1815,0.1128,0.1482,0.0845
"12218",228875,"TEXAS CHRISTIAN UNIVERSITY",1,0,1991,"8166","108.819643","321","1068","1212",745,467,417,"128",289,0.3879,0.2741,0.3441,0.8812
"12219",228875,"TEXAS CHRISTIAN UNIVERSITY",1,0,1992,"8570","104.157072","329","1085","1261",746,515,506,"161",345,0.4625,0.3126,0.4013,0.8604
"12220",228875,"TEXAS CHRISTIAN UNIVERSITY",1,0,1993,"8970","108.942","336","991","1189",690,499,467,"162",305,0.442,0.3246,0.3928,0.8335
"12221",228875,"TEXAS CHRISTIAN UNIVERSITY",1,0,1995,"10040","113.214","338","1099","1325",813,512,511,"146",365,0.449,0.2852,0.3857,0.8294
"12222",228875,"TEXAS CHRISTIAN UNIVERSITY",1,0,1996,"10510","127.096","347","1008","1238",735,503,502,"181",321,0.4367,0.3598,0.4055,0.8142
"12223",228875,"TEXAS CHRISTIAN UNIVERSITY",1,0,1997,"11090","129.262","351","1204","1463",885,578,563,"167",396,0.4475,0.2889,0.3848,0.823
"12224",228875,"TEXAS CHRISTIAN UNIVERSITY",1,0,1998,"11590","138.155","355","1211","1397",839,558,587,"177",410,0.4887,0.3172,0.4202,0.8669
"12225",228875,"TEXAS CHRISTIAN UNIVERSITY",1,0,1999,"10950","149.108","371","1202","1427",869,558,678,"208",470,0.5409,0.3728,0.4751,0.8423
"12226",228875,"TEXAS CHRISTIAN UNIVERSITY",1,0,2000,"11700","167.249","381.5","1219","1493",902,591,671,"210",461,0.5111,0.3553,0.4494,0.8165
"12227",228875,"TEXAS CHRISTIAN UNIVERSITY",1,0,2001,"15000","183.957","392","1241","1514",894,620,761,"251",510,0.5705,0.4048,0.5026,0.8197
"12228",228875,"TEXAS CHRISTIAN UNIVERSITY",1,0,2002,"16300","203.199","415","1172","1450",904,546,719,"207",512,0.5664,0.3791,0.4959,0.8083
"12229",228875,"TEXAS CHRISTIAN UNIVERSITY",1,0,2003,"17590","217.208","420","1269","1598",1005,593,877,"273",604,0.601,0.4604,0.5488,0.7941
"12230",228875,"TEXAS CHRISTIAN UNIVERSITY",1,0,2004,"19700","236.45","442","1319","1605",988,617,866,"276",590,0.5972,0.4473,0.5396,0.8218
"12231",228875,"Texas Christian University",1,0,2005,"21280","216.059","463","1268","1610",977,633,875,"284",591,0.6049,0.4487,0.5435,0.7876
"12232",228875,"Texas Christian University",1,0,2006,"22980","233.566","479","1264","1654",985,669,950,"328",622,0.6315,0.4903,0.5744,0.7642
"12233",228875,"Texas Christian University",1,0,2007,"24820","236.737","487","1244","1642",965,677,961,"348",613,0.6352,0.514,0.5853,0.7576
"12234",228875,"Texas Christian University",1,0,2008,"26900","265.458","505","1222","1628",996,632,954,"309",645,0.6476,0.4889,0.586,0.7506
"12235",228875,"Texas Christian University",1,0,2009,"28250","274.071","521","1381","1818",1142,676,1068,"348",720,0.6305,0.5148,0.5875,0.7596
"12236",228875,"Texas Christian University",1,0,2010,"30000","291.417","532","1400","1824",1104,720,1141,"397",744,0.6739,0.5514,0.6255,0.7675
"12237",228981,"TEXAS LUTHERAN COLLEGE",1,0,1991,"6340","12.785411","60","171","241",156,85,63,"20",43,0.2756,0.2353,0.2614,0.7095
"12238",228981,"TEXAS LUTHERAN COLLEGE",1,0,1992,"6840","13.698454","63","190","251",148,103,65,"22",43,0.2905,0.2136,0.259,0.757
"12239",228981,"TEXAS LUTHERAN COLLEGE",1,0,1993,"7460","14.506908","60","163","213",134,79,65,"24",41,0.306,0.3038,0.3052,0.7653
"12240",228981,"TEXAS LUTHERAN COLLEGE",1,0,1995,"8626","15.139082","55","165","213",142,71,78,"20",58,0.4085,0.2817,0.3662,0.7746
"12241",228981,"TEXAS LUTHERAN COLLEGE",1,0,1996,"9450","16.341777","57","156","210",132,78,79,"23",56,0.4242,0.2949,0.3762,0.7429
"12242",228981,"TEXAS LUTHERAN UNIVERSITY",1,0,1997,"10370","16.720991","56","228","312",186,126,118,"38",80,0.4301,0.3016,0.3782,0.7308
"12243",228981,"TEXAS LUTHERAN UNIVERSITY",1,0,1998,"10876","18.379152","59","250","366",180,186,101,"34",67,0.3722,0.1828,0.276,0.6831
"12244",228981,"TEXAS LUTHERAN UNIVERSITY",1,0,1999,"11374","20.699299","63","275","383",170,213,112,"45",67,0.3941,0.2113,0.2924,0.718
"12245",228981,"TEXAS LUTHERAN UNIVERSITY",1,0,2000,"12500","21.265827","63","242","330",175,155,125,"48",77,0.44,0.3097,0.3788,0.7333
"12246",228981,"TEXAS LUTHERAN UNIVERSITY",1,0,2001,"13440","21.881232","63","282","376",208,168,133,"42",91,0.4375,0.25,0.3537,0.75
"12247",228981,"TEXAS LUTHERAN UNIVERSITY",1,0,2002,"14450","21.590454","74","267","371",181,190,111,"34",77,0.4254,0.1789,0.2992,0.7197
"12248",228981,"TEXAS LUTHERAN UNIVERSITY",1,0,2003,"15470","22.93581","68","256","375",212,163,117,"38",79,0.3726,0.2331,0.312,0.6827
"12249",228981,"TEXAS LUTHERAN UNIVERSITY",1,0,2004,"16480","24.255502","74","270","399",202,197,105,"40",65,0.3218,0.203,0.2632,0.6767
"12250",228981,"Texas Lutheran University",1,0,2005,"17600","26.050317","66","275","379",182,197,106,"35",71,0.3901,0.1777,0.2797,0.7256
"12251",228981,"Texas Lutheran University",1,0,2006,"18720","26.990147","77","261","387",197,190,105,"39",66,0.335,0.2053,0.2713,0.6744
"12252",228981,"Texas Lutheran University",1,0,2007,"19940","27.956393","73","228","365",177,188,114,"39",75,0.4237,0.2074,0.3123,0.6247
"12253",228981,"Texas Lutheran University",1,0,2008,"20840","28.574998","76","233","396",191,205,123,"44",79,0.4136,0.2146,0.3106,0.5884
"12254",228981,"Texas Lutheran University",1,0,2009,"21780","31.31882","68","198","345",171,174,104,"43",61,0.3567,0.2471,0.3014,0.5739
"12255",228981,"Texas Lutheran University",1,0,2010,"22760","30.371336","72","173","338",159,179,102,"39",63,0.3962,0.2179,0.3018,0.5118
"12256",229018,"UNIVERSITY OF TEXAS OF THE PERMIAN BASIN",1,0,1991,"1311","11.052697","65","34","46",26,20,5,"4",1,0.0385,0.2,0.1087,0.7391
"12257",229018,"UNIVERSITY OF TEXAS OF THE PERMIAN BASIN",1,0,1992,"1275","11.894439","73","43","71",46,25,6,"3",3,0.0652,0.12,0.0845,0.6056
"12258",229018,"THE UNIVERSITY OF TEXAS OF THE PERMIAN BASIN",1,0,1993,"1462","12.830006","76","49","78",41,37,8,"3",5,0.122,0.0811,0.1026,0.6282
"12259",229018,"THE UNIVERSITY OF TEXAS OF THE PERMIAN BASIN",1,0,1995,"1830","15.460415","74","56","100",61,39,10,"3",7,0.1148,0.0769,0.1,0.56
"12260",229018,"THE UNIVERSITY OF TEXAS OF THE PERMIAN BASIN",1,0,1996,"1638","16.805295","80","56","108",58,50,10,"6",4,0.069,0.12,0.0926,0.5185
"12261",229018,"THE UNIVERSITY OF TEXAS OF THE PERMIAN BASIN",1,0,1997,"2106","16.939567","78","66","113",60,53,17,"2",15,0.25,0.0377,0.1504,0.5841
"12262",229018,"THE UNIVERSITY OF TEXAS OF THE PERMIAN BASIN",1,0,1998,"2280","17.606593","77","54","112",69,43,19,"7",12,0.1739,0.1628,0.1696,0.4821
"12263",229018,"THE UNIVERSITY OF TEXAS OF THE PERMIAN BASIN",1,0,1999,"912","19.559503","75","62","97",65,32,15,"5",10,0.1538,0.1562,0.1546,0.6392
"12264",229018,"THE UNIVERSITY OF TEXAS OF THE PERMIAN BASIN",1,0,2000,"960","23.863035","79.5","67","144",86,58,23,"8",15,0.1744,0.1379,0.1597,0.4653
"12265",229018,"THE UNIVERSITY OF TEXAS OF THE PERMIAN BASIN",1,0,2001,"1800","26.323926","84","88","165",104,61,36,"9",27,0.2596,0.1475,0.2182,0.5333
"12266",229018,"THE UNIVERSITY OF TEXAS OF THE PERMIAN BASIN",1,0,2002,"1920","24.825531","88","123","216",126,90,31,"9",22,0.1746,0.1,0.1435,0.5694
"12267",229018,"THE UNIVERSITY OF TEXAS OF THE PERMIAN BASIN",1,0,2003,"2064","29.048991","96","145","292",160,132,52,"19",33,0.2062,0.1439,0.1781,0.4966
"12268",229018,"THE UNIVERSITY OF TEXAS OF THE PERMIAN BASIN",1,0,2004,"2400","32.98583","106","147","258",136,122,39,"16",23,0.1691,0.1311,0.1512,0.5698
"12269",229018,"The University of Texas of the Permian Basin",1,0,2005,"2616","33.275192","110","134","300",173,127,53,"18",35,0.2023,0.1417,0.1767,0.4467
"12270",229018,"The University of Texas of the Permian Basin",1,0,2006,"2832","38.794712","117","144","315",178,137,55,"18",37,0.2079,0.1314,0.1746,0.4571
"12271",229018,"The University of Texas of the Permian Basin",1,0,2007,"3096","37.274665","117","170","372",198,174,48,"15",33,0.1667,0.0862,0.129,0.457
"12272",229018,"The University of Texas of the Permian Basin",1,0,2008,"3264","44.16263","116","158","332",176,156,65,"19",46,0.2614,0.1218,0.1958,0.4759
"12273",229018,"The University of Texas of the Permian Basin",1,0,2009,"3504","46.64588","119","135","326",176,150,72,"29",43,0.2443,0.1933,0.2209,0.4141
"12274",229018,"The University of Texas of the Permian Basin",1,0,2010,"3600","56.685378","137","156","341",180,161,71,"29",42,0.2333,0.1801,0.2082,0.4575
"12275",229027,"UNIVERSITY OF TEXAS AT SAN ANTONIO",1,0,1991,"1482","74.233375","302","817","1479",799,680,69,"27",42,0.0526,0.0397,0.0467,0.5524
"12276",229027,"UNIVERSITY OF TEXAS AT SAN ANTONIO",1,0,1992,"2086","78.45373","303","872","1558",834,724,120,"38",82,0.0983,0.0525,0.077,0.5597
"12277",229027,"THE UNIVERSITY OF TEXAS AT SAN ANTONIO",1,0,1993,"2298","88.407535","286","823","1591",855,736,84,"43",41,0.048,0.0584,0.0528,0.5173
"12278",229027,"THE UNIVERSITY OF TEXAS AT SAN ANTONIO",1,0,1995,"2542","102.40724","323","750","1528",821,707,79,"20",59,0.0719,0.0283,0.0517,0.4908
"12279",229027,"THE UNIVERSITY OF TEXAS AT SAN ANTONIO",1,0,1996,"2393","108.384033","365","740","1679",852,827,93,"39",54,0.0634,0.0472,0.0554,0.4407
"12280",229027,"THE UNIVERSITY OF TEXAS AT SAN ANTONIO",1,0,1997,"2110","115.094036","370","740","1749",938,811,109,"30",79,0.0842,0.037,0.0623,0.4231
"12281",229027,"THE UNIVERSITY OF TEXAS AT SAN ANTONIO",1,0,1998,"2336","132.399803","379","881","2067",1099,968,152,"38",114,0.1037,0.0393,0.0735,0.4262
"12282",229027,"THE UNIVERSITY OF TEXAS AT SAN ANTONIO",1,0,1999,"1728","143.284703","478","615","1665",882,783,105,"32",73,0.0828,0.0409,0.0631,0.3694
"12283",229027,"THE UNIVERSITY OF TEXAS AT SAN ANTONIO",1,0,2000,"1920","175.789176","496","710","1727",894,833,121,"47",74,0.0828,0.0564,0.0701,0.4111
"12284",229027,"THE UNIVERSITY OF TEXAS AT SAN ANTONIO",1,0,2001,"2016","177.361616","514","751","1910",977,933,137,"60",77,0.0788,0.0643,0.0717,0.3932
"12285",229027,"THE UNIVERSITY OF TEXAS AT SAN ANTONIO",1,0,2002,"2112","213.011335","433","1153","3001",1619,1382,234,"76",158,0.0976,0.055,0.078,0.3842
"12286",229027,"THE UNIVERSITY OF TEXAS AT SAN ANTONIO",1,0,2003,"2208","220.969657","512","1697","4091",2070,2021,310,"107",203,0.0981,0.0529,0.0758,0.4148
"12287",229027,"THE UNIVERSITY OF TEXAS AT SAN ANTONIO",1,0,2004,"2976","240.725295","740","1723","4193",2129,2064,315,"103",212,0.0996,0.0499,0.0751,0.4109
"12288",229027,"The University of Texas at San Antonio",1,0,2005,"3174","285.612424","548","1735","4360",2240,2120,348,"127",221,0.0987,0.0599,0.0798,0.3979
"12289",229027,"The University of Texas at San Antonio",1,0,2006,"3414","311.409896","563","2054","4687",2389,2298,424,"155",269,0.1126,0.0674,0.0905,0.4382
"12290",229027,"The University of Texas at San Antonio",1,0,2007,"3624","336.806994","582","2043","4833",2309,2524,465,"179",286,0.1239,0.0709,0.0962,0.4227
"12291",229027,"The University of Texas at San Antonio",1,0,2008,"3840","378.651369","586","1885","4758",2432,2326,512,"198",314,0.1291,0.0851,0.1076,0.3962
"12292",229027,"The University of Texas at San Antonio",1,0,2009,"4100","422.876983","665","1684","4559",2281,2278,507,"180",327,0.1434,0.079,0.1112,0.3694
"12293",229027,"The University of Texas at San Antonio",1,0,2010,"4362","461.956539","848","1562","4811",2243,2568,610,"248",362,0.1614,0.0966,0.1268,0.3247
"12294",229115,"TEXAS TECH UNIVERSITY",1,0,1991,"1498","247.860861","799","2356","2838",1439,1399,468,"167",301,0.2092,0.1194,0.1649,0.8302
"12295",229115,"TEXAS TECH UNIVERSITY",1,0,1992,"1489","217.802778","747","2326","2823",1418,1405,528,"195",333,0.2348,0.1388,0.187,0.8239
"12296",229115,"TEXAS TECH UNIVERSITY",1,0,1993,"1550","232.356246","731","2567","3073",1525,1548,520,"196",324,0.2125,0.1266,0.1692,0.8353
"12297",229115,"TEXAS TECH UNIVERSITY",1,0,1995,"2200","261.920412","773","2876","3461",1764,1697,747,"260",487,0.2761,0.1532,0.2158,0.831
"12298",229115,"TEXAS TECH UNIVERSITY",1,0,1996,"2496","283.191756","787","3037","3632",1860,1772,746,"252",494,0.2656,0.1422,0.2054,0.8362
"12299",229115,"TEXAS TECH UNIVERSITY",1,0,1997,"2747","296.28339","817","2749","3221",1625,1596,764,"302",462,0.2843,0.1892,0.2372,0.8535
"12300",229115,"TEXAS TECH UNIVERSITY",1,0,1998,"2971","322.356511","827","2674","3149",1581,1568,804,"283",521,0.3295,0.1805,0.2553,0.8492
"12301",229115,"TEXAS TECH UNIVERSITY",1,0,1999,"1140","355.114271","831","2892","3403",1725,1678,785,"248",537,0.3113,0.1478,0.2307,0.8498
"12302",229115,"TEXAS TECH UNIVERSITY",1,0,2000,"2400","392.938191","854","3346","3998",1982,2016,1005,"359",646,0.3259,0.1781,0.2514,0.8369
"12303",229115,"TEXAS TECH UNIVERSITY",1,0,2001,"2520","413.913518","877","3450","4075",1967,2108,1133,"438",695,0.3533,0.2078,0.278,0.8466
"12304",229115,"TEXAS TECH UNIVERSITY",1,0,2002,"2640","449.581832","950","3560","4283",2066,2217,1302,"551",751,0.3635,0.2485,0.304,0.8312
"12305",229115,"TEXAS TECH UNIVERSITY",1,0,2003,"2208","445.647733","979","3597","4312",2039,2273,1372,"547",825,0.4046,0.2407,0.3182,0.8342
"12306",229115,"TEXAS TECH UNIVERSITY",1,0,2004,"2976","450.873158","1005","3137","3833",1894,1939,1419,"554",865,0.4567,0.2857,0.3702,0.8184
"12307",229115,"Texas Tech University",1,0,2005,"3096","474.989315","1046","3021","3743",1829,1914,1323,"530",793,0.4336,0.2769,0.3535,0.8071
"12308",229115,"Texas Tech University",1,0,2006,"3240","520.995844","1078","3076","3862",1844,2018,1427,"601",826,0.4479,0.2978,0.3695,0.7965
"12309",229115,"Texas Tech University",1,0,2007,"3448","536.049017","1078","3430","4439",2065,2374,1455,"600",855,0.414,0.2527,0.3278,0.7727
"12310",229115,"Texas Tech University",1,0,2008,"3448","574.924323","1099","3251","4338",2056,2282,1413,"560",853,0.4149,0.2454,0.3257,0.7494
"12311",229115,"Texas Tech University",1,0,2009,"3900","619.281343","1148","3234","4514",2185,2329,1582,"641",941,0.4307,0.2752,0.3505,0.7164
"12312",229115,"Texas Tech University",1,0,2010,"4296","641.95763","1176","3198","4759",2290,2469,1623,"645",978,0.4271,0.2612,0.341,0.672
"12313",229780,"WAYLAND BAPTIST UNIVERSITY",1,0,1991,"5464","12.68912","59","95","133",79,54,28,"9",19,0.2405,0.1667,0.2105,0.7143
"12314",229780,"WAYLAND BAPTIST UNIVERSITY",1,0,1992,"5626","14.807776","60","100","133",84,49,20,"7",13,0.1548,0.1429,0.1504,0.7519
"12315",229780,"WAYLAND BAPTIST UNIVERSITY",1,0,1993,"5626","14.976652","66","105","166",106,60,26,"10",16,0.1509,0.1667,0.1566,0.6325
"12316",229780,"WAYLAND BAPTIST UNIVERSITY",1,0,1995,"6110","18.816759","70","100","167",102,65,26,"7",19,0.1863,0.1077,0.1557,0.5988
"12317",229780,"WAYLAND BAPTIST UNIVERSITY",1,0,1996,"6395","20.109964","76","159","228",134,94,41,"10",31,0.2313,0.1064,0.1798,0.6974
"12318",229780,"WAYLAND BAPTIST UNIVERSITY",1,0,1997,"6674","17.307782","82","185","241",132,109,58,"21",37,0.2803,0.1927,0.2407,0.7676
"12319",229780,"WAYLAND BAPTIST UNIVERSITY",1,0,1998,"7108","18.473288","87","169","244",120,124,37,"9",28,0.2333,0.0726,0.1516,0.6926
"12320",229780,"WAYLAND BAPTIST UNIVERSITY",1,0,1999,"7050","19.446794","86","105","210",108,102,39,"15",24,0.2222,0.1471,0.1857,0.5
"12321",229780,"WAYLAND BAPTIST UNIVERSITY",1,0,2000,"7500","22.977034","89","156","216",120,96,30,"6",24,0.2,0.0625,0.1389,0.7222
"12322",229780,"WAYLAND BAPTIST UNIVERSITY",1,0,2001,"7800","25.359499","92","62","204",111,93,50,"17",33,0.2973,0.1828,0.2451,0.3039
"12323",229780,"WAYLAND BAPTIST UNIVERSITY",1,0,2002,"8100","29.325357","93","79","182",104,78,41,"13",28,0.2692,0.1667,0.2253,0.4341
"12324",229780,"WAYLAND BAPTIST UNIVERSITY",1,0,2003,"8100","31.956521","104","105","205",112,93,41,"13",28,0.25,0.1398,0.2,0.5122
"12325",229780,"WAYLAND BAPTIST UNIVERSITY",1,0,2004,"8850","35.898204","107","131","212",109,103,59,"26",33,0.3028,0.2524,0.2783,0.6179
"12326",229780,"Wayland Baptist University",1,0,2005,"9450","36.008672","110","148","222",124,98,44,"11",33,0.2661,0.1122,0.1982,0.6667
"12327",229780,"Wayland Baptist University",1,0,2006,"10200","38.973027","109","149","211",103,108,46,"21",25,0.2427,0.1944,0.218,0.7062
"12328",229780,"Wayland Baptist University",1,0,2007,"10650","40.705766","118","137","247",129,118,53,"20",33,0.2558,0.1695,0.2146,0.5547
"12329",229780,"Wayland Baptist University",1,0,2008,"11400","44.568593","130","115","197",88,109,23,"9",14,0.1591,0.0826,0.1168,0.5838
"12330",229780,"Wayland Baptist University",1,0,2009,"9480","47.469614","141","110","214",103,111,38,"11",27,0.2621,0.0991,0.1776,0.514
"12331",229780,"Wayland Baptist University",1,0,2010,"9960","50.575203","142","106","242",112,130,25,"10",15,0.1339,0.0769,0.1033,0.438
"12332",229814,"WEST TEXAS STATE UNIVERSITY",1,0,1991,"1154","35.677073","182","625","767",434,333,76,"16",60,0.1382,0.048,0.0991,0.8149
"12333",229814,"WEST TEXAS STATE UNIVERSITY",1,0,1992,"1353","38.54356","182","714","848",421,427,98,"27",71,0.1686,0.0632,0.1156,0.842
"12334",229814,"WEST TEXAS STATE UNIVERSITY",1,0,1993,"1444","43.048193","185","776","986",472,514,93,"25",68,0.1441,0.0486,0.0943,0.787
"12335",229814,"WEST TEXAS A & M UNIVERSITY",1,0,1995,"1645","46.508579","202","749","901",506,395,108,"35",73,0.1443,0.0886,0.1199,0.8313
"12336",229814,"WEST TEXAS A & M UNIVERSITY",1,0,1996,"1853","49.707997","201","702","849",411,438,167,"69",98,0.2384,0.1575,0.1967,0.8269
"12337",229814,"WEST TEXAS A & M UNIVERSITY",1,0,1997,"2068","51.277048","199","709","854",414,440,105,"33",72,0.1739,0.075,0.123,0.8302
"12338",229814,"WEST TEXAS A & M UNIVERSITY",1,0,1998,"2205","59.287551","202","742","884",465,419,140,"42",98,0.2108,0.1002,0.1584,0.8394
"12339",229814,"WEST TEXAS A & M UNIVERSITY",1,0,1999,"1755","61.426041","203","797","986",506,480,126,"34",92,0.1818,0.0708,0.1278,0.8083
"12340",229814,"WEST TEXAS A & M UNIVERSITY",1,0,2000,"1875","68.407206","206","661","867",471,396,121,"40",81,0.172,0.101,0.1396,0.7624
"12341",229814,"WEST TEXAS A & M UNIVERSITY",1,0,2001,"1668","73.709789","209","594","759",419,340,109,"24",85,0.2029,0.0706,0.1436,0.7826
"12342",229814,"WEST TEXAS A & M UNIVERSITY",1,0,2002,"1740","77.981575","222","606","798",425,373,138,"38",100,0.2353,0.1019,0.1729,0.7594
"12343",229814,"WEST TEXAS A & M UNIVERSITY",1,0,2003,"1956","80.21007","218","595","774",404,370,125,"31",94,0.2327,0.0838,0.1615,0.7687
"12344",229814,"WEST TEXAS A & M UNIVERSITY",1,0,2004,"2064","82.358343","229","589","790",424,366,151,"42",109,0.2571,0.1148,0.1911,0.7456
"12345",229814,"West Texas A & M University",1,0,2005,"2208","84.942177","234","530","768",409,359,171,"66",105,0.2567,0.1838,0.2227,0.6901
"12346",229814,"West Texas A & M University",1,0,2006,"2568","92.968353","237","624","920",489,431,223,"73",150,0.3067,0.1694,0.2424,0.6783
"12347",229814,"West Texas A & M University",1,0,2007,"3216","96.578064","236","617","923",480,443,227,"79",148,0.3083,0.1783,0.2459,0.6685
"12348",229814,"West Texas A & M University",1,0,2008,"3636","114.357646","250","792","1149",599,550,259,"83",176,0.2938,0.1509,0.2254,0.6893
"12349",229814,"West Texas A & M University",1,0,2009,"4028","120.028275","251","772","1193",603,590,260,"78",182,0.3018,0.1322,0.2179,0.6471
"12350",229814,"West Texas A & M University",1,0,2010,"4070","120.878252","262","764","1227",637,590,336,"102",234,0.3673,0.1729,0.2738,0.6227
"12351",230603,"SOUTHERN UTAH UNIVERSITY",0,1,1991,"1419","29.388481","128","523","550",370,180,59,"11",48,0.1297,0.0611,0.1073,0.9509
"12352",230603,"SOUTHERN UTAH UNIVERSITY",0,1,1992,"1497","32.289","135","617","649",421,228,84,"18",66,0.1568,0.0789,0.1294,0.9507
"12353",230603,"SOUTHERN UTAH UNIVERSITY",0,1,1993,"1599","36.524688","147","569","588",416,172,83,"11",72,0.1731,0.064,0.1412,0.9677
"12354",230603,"SOUTHERN UTAH UNIVERSITY",0,1,1995,"1779","43.447502","183","620","643",471,172,90,"16",74,0.1571,0.093,0.14,0.9642
"12355",230603,"SOUTHERN UTAH UNIVERSITY",0,1,1996,"1800","46.004786","172","595","626",443,183,69,"19",50,0.1129,0.1038,0.1102,0.9505
"12356",230603,"SOUTHERN UTAH UNIVERSITY",0,1,1997,"1854","49.542369","187","681","717",530,187,113,"18",95,0.1792,0.0963,0.1576,0.9498
"12357",230603,"SOUTHERN UTAH UNIVERSITY",1,0,1998,"1909","52.909257","200","631","667",487,180,113,"7",106,0.2177,0.0389,0.1694,0.946
"12358",230603,"SOUTHERN UTAH UNIVERSITY",1,0,1999,"1524","59.409995","205","598","629",456,173,103,"9",94,0.2061,0.052,0.1638,0.9507
"12359",230603,"SOUTHERN UTAH UNIVERSITY",1,0,2000,"1612","62.446688","209","468","513",414,99,98,"12",86,0.2077,0.1212,0.191,0.9123
"12360",230603,"SOUTHERN UTAH UNIVERSITY",1,0,2001,"1732","66.28232","213","509","562",443,119,113,"18",95,0.2144,0.1513,0.2011,0.9057
"12361",230603,"SOUTHERN UTAH UNIVERSITY",1,0,2002,"1888","69.667418","205","478","528",383,145,106,"12",94,0.2454,0.0828,0.2008,0.9053
"12362",230603,"SOUTHERN UTAH UNIVERSITY",1,0,2003,"2332","70.483988","205","429","478",338,140,103,"17",86,0.2544,0.1214,0.2155,0.8975
"12363",230603,"SOUTHERN UTAH UNIVERSITY",1,0,2004,"2588","72.041991","213","581","656",445,211,130,"18",112,0.2517,0.0853,0.1982,0.8857
"12364",230603,"Southern Utah University",1,0,2005,"2834","75.289204","211","666","784",527,257,137,"30",107,0.203,0.1167,0.1747,0.8495
"12365",230603,"Southern Utah University",1,0,2006,"3060","77.970422","218","713","832",594,238,164,"23",141,0.2374,0.0966,0.1971,0.857
"12366",230603,"Southern Utah University",1,0,2007,"3274","86.196151","222","724","865",579,286,185,"39",146,0.2522,0.1364,0.2139,0.837
"12367",230603,"Southern Utah University",1,0,2008,"3502","93.382572","229","733","836",574,262,169,"29",140,0.2439,0.1107,0.2022,0.8768
"12368",230603,"Southern Utah University",1,0,2009,"3730","97.540706","216","921","1101",742,359,193,"42",151,0.2035,0.117,0.1753,0.8365
"12369",230603,"Southern Utah University",1,0,2010,"4196","99.33355","231","928","1103",768,335,232,"43",189,0.2461,0.1284,0.2103,0.8413
"12370",230728,"UTAH STATE UNIVERSITY",0,1,1991,"1680","212.740584","509","1210","1359",857,502,1,"1",0,0,0.002,7e-04,0.8904
"12371",230728,"UTAH STATE UNIVERSITY",0,1,1992,"1821","231.618822","569","1088","1237",847,390,186,"31",155,0.183,0.0795,0.1504,0.8795
"12372",230728,"UTAH STATE UNIVERSITY",0,1,1993,"1896","231.298155","583","1162","1321",850,471,212,"42",170,0.2,0.0892,0.1605,0.8796
"12373",230728,"UTAH STATE UNIVERSITY",0,1,1995,"1992","262.385553","738","1091","1175",803,372,251,"43",208,0.259,0.1156,0.2136,0.9285
"12374",230728,"UTAH STATE UNIVERSITY",0,1,1996,"1971","271.719758","716","882","967",685,282,267,"41",226,0.3299,0.1454,0.2761,0.9121
"12375",230728,"UTAH STATE UNIVERSITY",0,1,1997,"2174","281.818181","654","1364","1465",1029,436,304,"60",244,0.2371,0.1376,0.2075,0.9311
"12376",230728,"UTAH STATE UNIVERSITY",1,0,1998,"2245","302.823239","648","1589","1764",1229,535,328,"43",285,0.2319,0.0804,0.1859,0.9008
"12377",230728,"UTAH STATE UNIVERSITY",1,0,1999,"1871","316.988997","640","1381","1521",1047,474,320,"67",253,0.2416,0.1414,0.2104,0.908
"12378",230728,"UTAH STATE UNIVERSITY",1,0,2000,"1947","340.487147","642.5","1418","1632",1116,516,357,"76",281,0.2518,0.1473,0.2188,0.8689
"12379",230728,"UTAH STATE UNIVERSITY",1,0,2001,"2123","364.45864","645","1639","1892",1270,622,384,"72",312,0.2457,0.1158,0.203,0.8663
"12380",230728,"UTAH STATE UNIVERSITY",1,0,2002,"2388","376.943508","719","1359","1497",1010,487,423,"81",342,0.3386,0.1663,0.2826,0.9078
"12381",230728,"UTAH STATE UNIVERSITY",1,0,2003,"2615","392.875166","705","1647","1829",1229,600,491,"86",405,0.3295,0.1433,0.2685,0.9005
"12382",230728,"UTAH STATE UNIVERSITY",1,0,2004,"2850","418.591981","727","1448","1591",1048,543,433,"70",363,0.3464,0.1289,0.2722,0.9101
"12383",230728,"Utah State University",1,0,2005,"3128","388.718531","727","1365","1618",1065,553,415,"75",340,0.3192,0.1356,0.2565,0.8436
"12384",230728,"Utah State University",1,0,2006,"3378","407.525388","692","2064","2429",1574,855,498,"102",396,0.2516,0.1193,0.205,0.8497
"12385",230728,"Utah State University",1,0,2007,"3615","423.317075","714","2176","2654",1697,957,544,"113",431,0.254,0.1181,0.205,0.8199
"12386",230728,"Utah State University",1,0,2008,"3832","435.451351","744","2110","2580",1646,934,484,"83",401,0.2436,0.0889,0.1876,0.8178
"12387",230728,"Utah State University",1,0,2009,"4043","462.652473","708","2176","2664",1663,1001,508,"100",408,0.2453,0.0999,0.1907,0.8168
"12388",230728,"Utah State University",1,0,2010,"4047","475.41985","702","2439","2941",1882,1059,548,"113",435,0.2311,0.1067,0.1863,0.8293
"12389",230764,"UNIVERSITY OF UTAH",0,1,1991,"1981","595.104207","818","1664","1924",914,1010,268,"107",161,0.1761,0.1059,0.1393,0.8649
"12390",230764,"UNIVERSITY OF UTAH",0,1,1992,"2104","683.066109","833","1728","2026",996,1030,304,"119",185,0.1857,0.1155,0.15,0.8529
"12391",230764,"UNIVERSITY OF UTAH",0,1,1993,"2298","722.061","860","1447","1794",1004,790,202,"59",143,0.1424,0.0747,0.1126,0.8066
"12392",230764,"UNIVERSITY OF UTAH",0,1,1995,"2508","813.801","920","1156","1356",837,519,284,"73",211,0.2521,0.1407,0.2094,0.8525
"12393",230764,"UNIVERSITY OF UTAH",0,1,1996,"2514","864.062","913","1486","1800",1019,781,436,"155",281,0.2758,0.1985,0.2422,0.8256
"12394",230764,"UNIVERSITY OF UTAH",0,1,1997,"2601","944.835","967","1633","1962",1039,923,407,"133",274,0.2637,0.1441,0.2074,0.8323
"12395",230764,"UNIVERSITY OF UTAH",1,0,1998,"2711","1018.258","927","1370","1702",991,711,363,"116",247,0.2492,0.1632,0.2133,0.8049
"12396",230764,"UNIVERSITY OF UTAH",1,0,1999,"2278","1167.717","886","1526","1921",921,1000,295,"109",186,0.202,0.109,0.1536,0.7944
"12397",230764,"UNIVERSITY OF UTAH",1,0,2000,"2371","1220.579","903","1686","2067",1029,1038,441,"155",286,0.2779,0.1493,0.2134,0.8157
"12398",230764,"UNIVERSITY OF UTAH",1,0,2001,"2517","1292.469","920","1480","1877",1038,839,390,"135",255,0.2457,0.1609,0.2078,0.7885
"12399",230764,"UNIVERSITY OF UTAH",1,0,2002,"2742","1627.257","927","1610","1962",1109,853,391,"127",264,0.2381,0.1489,0.1993,0.8206
"12400",230764,"UNIVERSITY OF UTAH",1,0,2003,"3057","1657.328","928","1453","1870",1073,797,405,"129",276,0.2572,0.1619,0.2166,0.777
"12401",230764,"UNIVERSITY OF UTAH",1,0,2004,"3364","1707.576","1162","1559","1997",1133,864,453,"152",301,0.2657,0.1759,0.2268,0.7807
"12402",230764,"University of Utah",1,0,2005,"3628","1826.662","1175","1572","1997",1106,891,415,"138",277,0.2505,0.1549,0.2078,0.7872
"12403",230764,"University of Utah",1,0,2006,"3972","1966.266","1214","1575","2037",1167,870,457,"149",308,0.2639,0.1713,0.2243,0.7732
"12404",230764,"University of Utah",1,0,2007,"4270","2123.266","1248","1488","1953",1082,871,469,"170",299,0.2763,0.1952,0.2401,0.7619
"12405",230764,"University of Utah",1,0,2008,"4525","2310.805","1275","1427","1908",1054,854,465,"171",294,0.2789,0.2002,0.2437,0.7479
"12406",230764,"University of Utah",1,0,2009,"4956","2485.491","1259","1583","2102",1177,925,597,"205",392,0.3331,0.2216,0.284,0.7531
"12407",230764,"University of Utah",1,0,2010,"5426","2604.2","1287","1629","2269",1217,1052,663,"237",426,0.35,0.2253,0.2922,0.7179
"12408",230782,"WEBER STATE UNIVERSITY",0,1,1991,"1458","79.083787","428","1264","1403",810,593,100,"32",68,0.084,0.054,0.0713,0.9009
"12409",230782,"WEBER STATE UNIVERSITY",0,1,1992,"1542","85.996748","438","1050","1211",729,482,52,"15",37,0.0508,0.0311,0.0429,0.8671
"12410",230782,"WEBER STATE UNIVERSITY",0,1,1993,"1638","91.155776","459","1070","1219",829,390,81,"23",58,0.07,0.059,0.0664,0.8778
"12411",230782,"WEBER STATE UNIVERSITY",0,1,1995,"1854","92.350687","441","1142","1338",889,449,109,"23",86,0.0967,0.0512,0.0815,0.8535
"12412",230782,"WEBER STATE UNIVERSITY",0,1,1996,"1863","98.861364","427","1078","1237",833,404,136,"25",111,0.1333,0.0619,0.1099,0.8715
"12413",230782,"WEBER STATE UNIVERSITY",0,1,1997,"1935","99.933799","417","1298","1503",978,525,152,"37",115,0.1176,0.0705,0.1011,0.8636
"12414",230782,"WEBER STATE UNIVERSITY",1,0,1998,"1986","106.244692","391","854","1453",935,518,147,"36",111,0.1187,0.0695,0.1012,0.5877
"12415",230782,"WEBER STATE UNIVERSITY",1,0,1999,"1606","107.119589","430","1220","1619",1001,618,158,"47",111,0.1109,0.0761,0.0976,0.7536
"12416",230782,"WEBER STATE UNIVERSITY",1,0,2000,"1670","113.851543","442.5","1214","1663",1000,663,135,"39",96,0.096,0.0588,0.0812,0.73
"12417",230782,"WEBER STATE UNIVERSITY",1,0,2001,"1786","121.083293","455","1136","1509",897,612,47,"18",29,0.0323,0.0294,0.0311,0.7528
"12418",230782,"WEBER STATE UNIVERSITY",1,0,2002,"1946","130.258652","450","1321","1675",1019,656,79,"16",63,0.0618,0.0244,0.0472,0.7887
"12419",230782,"WEBER STATE UNIVERSITY",1,0,2003,"2130","131.035207","450","1225","1688",944,744,90,"31",59,0.0625,0.0417,0.0533,0.7257
"12420",230782,"WEBER STATE UNIVERSITY",1,0,2004,"2344","141.631409","452","749","1559",882,677,94,"28",66,0.0748,0.0414,0.0603,0.4804
"12421",230782,"Weber State University",1,0,2005,"2573","143.193992","472","962","1626",879,747,68,"23",45,0.0512,0.0308,0.0418,0.5916
"12422",230782,"Weber State University",1,0,2006,"2793","148.513604","485","792","1289",755,534,114,"28",86,0.1139,0.0524,0.0884,0.6144
"12423",230782,"Weber State University",1,0,2007,"2988","158.307634","496","881","1364",783,581,110,"27",83,0.106,0.0465,0.0806,0.6459
"12424",230782,"Weber State University",1,0,2008,"3153","167.799507","499","1044","1549",853,696,136,"41",95,0.1114,0.0589,0.0878,0.674
"12425",230782,"Weber State University",1,0,2009,"3365","176.958077","481","1243","1845",1011,834,140,"43",97,0.0959,0.0516,0.0759,0.6737
"12426",230782,"Weber State University",1,0,2010,"3559","180.087239","463","1431","2041",1193,848,196,"64",132,0.1106,0.0755,0.096,0.7011
"12427",231059,"SAINT MICHAEL'S COLLEGE",1,0,1991,"11165","34.760755","116","467","485",253,232,329,"145",184,0.7273,0.625,0.6784,0.9629
"12428",231059,"SAINT MICHAEL'S COLLEGE",1,0,1992,"11900","35.281472","120","390","414",211,203,277,"121",156,0.7393,0.5961,0.6691,0.942
"12429",231059,"SAINT MICHAELS COLLEGE",1,0,1993,"12430","36.477992","122","442","454",238,216,291,"128",163,0.6849,0.5926,0.641,0.9736
"12430",231059,"SAINT MICHAELS COLLEGE",1,0,1995,"13810","42.668896","125","507","529",301,228,383,"160",223,0.7409,0.7018,0.724,0.9584
"12431",231059,"SAINT MICHAELS COLLEGE",1,0,1996,"14640","45.229095","138","461","486",284,202,335,"138",197,0.6937,0.6832,0.6893,0.9486
"12432",231059,"SAINT MICHAELS COLLEGE",1,0,1997,"15744","40.664531","133","509","528",279,249,358,"158",200,0.7168,0.6345,0.678,0.964
"12433",231059,"SAINT MICHAELS COLLEGE",1,0,1998,"16310","43.320595","132","503","518",278,240,378,"166",212,0.7626,0.6917,0.7297,0.971
"12434",231059,"SAINT MICHAELS COLLEGE",1,0,1999,"17500","44.047343","140","481","501",269,232,342,"145",197,0.7323,0.625,0.6826,0.9601
"12435",231059,"SAINT MICHAELS COLLEGE",1,0,2000,"18615","46.632764","140.5","500","521",283,238,366,"149",217,0.7668,0.6261,0.7025,0.9597
"12436",231059,"SAINT MICHAELS COLLEGE",1,0,2001,"19500","50.146799","141","486","518",286,232,380,"150",230,0.8042,0.6466,0.7336,0.9382
"12437",231059,"SAINT MICHAELS COLLEGE",1,0,2002,"21010","49.945575","144","498","527",301,226,406,"172",234,0.7774,0.7611,0.7704,0.945
"12438",231059,"SAINT MICHAELS COLLEGE",1,0,2003,"22220","55.874843","147","481","512",263,249,362,"158",204,0.7757,0.6345,0.707,0.9395
"12439",231059,"SAINT MICHAELS COLLEGE",1,0,2004,"25325","56.181768","136","497","518",280,238,378,"165",213,0.7607,0.6933,0.7297,0.9595
"12440",231059,"Saint Michaels College",1,0,2005,"26550","59.842","141","562","592",331,261,454,"188",266,0.8036,0.7203,0.7669,0.9493
"12441",231059,"Saint Michaels College",1,0,2006,"28280","63.755","147","546","576",333,243,446,"192",254,0.7628,0.7901,0.7743,0.9479
"12442",231059,"Saint Michaels College",1,0,2007,"29695","67.191","143","493","524",280,244,364,"154",210,0.75,0.6311,0.6947,0.9408
"12443",231059,"Saint Michaels College",1,0,2008,"31675","69.627188","141","516","543",277,266,396,"180",216,0.7798,0.6767,0.7293,0.9503
"12444",231059,"Saint Michael's College",1,0,2009,"32940","76.296918","141","431","470",230,240,322,"146",176,0.7652,0.6083,0.6851,0.917
"12445",231059,"Saint Michael's College",1,0,2010,"34555","75.567648","138","490","546",294,252,401,"168",233,0.7925,0.6667,0.7344,0.8974
"12446",231174,"UNIVERSITY OF VERMONT",1,0,1991,"5312","222.658","560","1715","1821",929,892,884,"385",499,0.5371,0.4316,0.4854,0.9418
"12447",231174,"UNIVERSITY OF VERMONT AND ST AGRICULTURAL COLLEGE",1,0,1992,"6166","236.01","561","1721","1796",978,818,944,"378",566,0.5787,0.4621,0.5256,0.9582
"12448",231174,"UNIVERSITY OF VERMONT AND STATE AGRICULTURAL COLL",1,0,1993,"6400","237.752","555","1612","1706",955,751,828,"319",509,0.533,0.4248,0.4853,0.9449
"12449",231174,"UNIVERSITY OF VERMONT AND STATE AGRICULTURAL COLL",1,0,1995,"6909","256.071","539","1749","1853",1037,816,853,"338",515,0.4966,0.4142,0.4603,0.9439
"12450",231174,"UNIVERSITY OF VERMONT AND STATE AGRICULTURAL COLL",1,0,1996,"7726","260.204","545","1690","1779",971,808,915,"374",541,0.5572,0.4629,0.5143,0.95
"12451",231174,"UNIVERSITY OF VERMONT AND STATE AGRICULTURAL COLL",1,0,1997,"7550","274.113","531","1733","1823",1005,818,959,"381",578,0.5751,0.4658,0.5261,0.9506
"12452",231174,"UNIVERSITY OF VERMONT AND STATE AGRICULTURAL COLL",1,0,1998,"7888","283.951","535","1656","1758",994,764,872,"336",536,0.5392,0.4398,0.496,0.942
"12453",231174,"UNIVERSITY OF VERMONT AND STATE AGRICULTURAL COLL",1,0,1999,"7464","302.591","554","1713","1808",984,824,875,"351",524,0.5325,0.426,0.484,0.9475
"12454",231174,"UNIVERSITY OF VERMONT AND STATE AGRICULTURAL COLL",1,0,2000,"7692","328.46","541","1654","1765",988,777,917,"344",573,0.58,0.4427,0.5195,0.9371
"12455",231174,"UNIVERSITY OF VERMONT AND STATE AGRICULTURAL COLL",1,0,2001,"8040","323.328","528","1694","1835",1052,783,1017,"381",636,0.6046,0.4866,0.5542,0.9232
"12456",231174,"UNIVERSITY OF VERMONT AND STATE AGRICULTURAL COLL",1,0,2002,"8320","345.61","549","1709","1828",1005,823,1000,"415",585,0.5821,0.5043,0.547,0.9349
"12457",231174,"UNIVERSITY OF VERMONT AND STATE AGRICULTURAL COLL",1,0,2003,"8696","379.503","538","1773","1916",1089,827,1087,"439",648,0.595,0.5308,0.5673,0.9254
"12458",231174,"UNIVERSITY OF VERMONT AND STATE AGRICULTURAL COLL",1,0,2004,"9088","406.661","551","1792","1953",1079,874,1188,"476",712,0.6599,0.5446,0.6083,0.9176
"12459",231174,"University of Vermont",1,0,2005,"9452","423.317","560","2193","2378",1287,1091,1367,"568",799,0.6208,0.5206,0.5749,0.9222
"12460",231174,"University of Vermont",1,0,2006,"9832","453.127","566","2024","2175",1251,924,1417,"551",866,0.6922,0.5963,0.6515,0.9306
"12461",231174,"University of Vermont",1,0,2007,"10422","505.403","583","2259","2432",1346,1086,1577,"650",927,0.6887,0.5985,0.6484,0.9289
"12462",231174,"University of Vermont",1,0,2008,"11048","559.961","606","2233","2453",1457,996,1611,"617",994,0.6822,0.6195,0.6567,0.9103
"12463",231174,"University of Vermont",1,0,2009,"11712","577.357","599","2281","2607",1482,1125,1733,"691",1042,0.7031,0.6142,0.6647,0.875
"12464",231174,"University of Vermont",1,0,2010,"12180","581.9","611","2145","2452",1425,1027,1523,"576",947,0.6646,0.5609,0.6211,0.8748
"12465",231420,"AVERETT COLLEGE",1,0,1991,"8750","11.293608","47","91","106",67,39,7,"2",5,0.0746,0.0513,0.066,0.8585
"12466",231420,"AVERETT COLLEGE",1,0,1992,"9090","12.070149","47","76","104",62,42,25,"6",19,0.3065,0.1429,0.2404,0.7308
"12467",231420,"AVERETT COLLEGE",1,0,1993,"9710","12.758703","48","135","168",101,67,56,"17",39,0.3861,0.2537,0.3333,0.8036
"12468",231420,"AVERETT COLLEGE",1,0,1995,"10800","15.619264","52","118","147",79,68,35,"13",22,0.2785,0.1912,0.2381,0.8027
"12469",231420,"AVERETT COLLEGE",1,0,1996,"11450","18.252635","56","107","149",81,68,42,"20",22,0.2716,0.2941,0.2819,0.7181
"12470",231420,"AVERETT COLLEGE",1,0,1997,"12100","15.67054","60","115","160",91,69,43,"16",27,0.2967,0.2319,0.2688,0.7188
"12471",231420,"AVERETT COLLEGE",1,0,1998,"12985","15.022909","61","119","145",78,67,31,"18",13,0.1667,0.2687,0.2138,0.8207
"12472",231420,"AVERETT COLLEGE",1,0,1999,"13145","16.101881","59","161","204",123,81,72,"22",50,0.4065,0.2716,0.3529,0.7892
"12473",231420,"AVERETT COLLEGE",1,0,2000,"13740","16.958671","59.5","139","192",64,128,44,"17",27,0.4219,0.1328,0.2292,0.724
"12474",231420,"AVERETT UNIVERSITY",1,0,2001,"14490","19.342373","60","129","175",81,94,48,"12",36,0.4444,0.1277,0.2743,0.7371
"12475",231420,"AVERETT UNIVERSITY",1,0,2002,"15800","19.603095","61","133","187",90,97,59,"20",39,0.4333,0.2062,0.3155,0.7112
"12476",231420,"AVERETT UNIVERSITY",1,0,2003,"16600","21.448666","65","144","219",83,136,78,"34",44,0.5301,0.25,0.3562,0.6575
"12477",231420,"AVERETT UNIVERSITY",1,0,2004,"17430","21.879093","68","127","191",68,123,53,"25",28,0.4118,0.2033,0.2775,0.6649
"12478",231420,"Averett University",1,0,2005,"18040","21.813701","65","158","229",84,145,59,"33",26,0.3095,0.2276,0.2576,0.69
"12479",231420,"Averett University",1,0,2006,"18762","21.109276","63","117","160",60,100,45,"19",26,0.4333,0.19,0.2812,0.7312
"12480",231420,"Averett University",1,0,2007,"19512","16.009818","54","131","238",70,168,43,"23",20,0.2857,0.1369,0.1807,0.5504
"12481",231420,"Averett University",1,0,2008,"20300","16.634193","52","111","234",88,146,53,"17",36,0.4091,0.1164,0.2265,0.4744
"12482",231420,"Averett University",1,0,2009,"21112","18.413757","52","115","222",78,144,52,"27",25,0.3205,0.1875,0.2342,0.518
"12483",231420,"Averett University",1,0,2010,"21956","19.929498","54","137","264",98,166,89,"36",53,0.5408,0.2169,0.3371,0.5189
"12484",231554,"BLUEFIELD COLLEGE",1,0,1991,"5400","3.998413","26","117","126",61,65,35,"15",20,0.3279,0.2308,0.2778,0.9286
"12485",231554,"BLUEFIELD COLLEGE",1,0,1992,"5940","5.126819","33","131","150",72,78,49,"29",20,0.2778,0.3718,0.3267,0.8733
"12486",231554,"BLUEFIELD COLLEGE",1,0,1993,"6500","6.129203","34","196","210",119,91,88,"36",52,0.437,0.3956,0.419,0.9333
"12487",231554,"BLUEFIELD COLLEGE",1,0,1995,"7770","7.449761","40","135","139",68,71,47,"22",25,0.3676,0.3099,0.3381,0.9712
"12488",231554,"BLUEFIELD COLLEGE",1,0,1996,"8200","9.153859","36","103","109",56,53,39,"20",19,0.3393,0.3774,0.3578,0.945
"12489",231554,"BLUEFIELD COLLEGE",1,0,1997,"9100","6.796062","32","119","130",64,66,44,"19",25,0.3906,0.2879,0.3385,0.9154
"12490",231554,"BLUEFIELD COLLEGE",1,0,1998,"7030","7.075987","32","119","129",69,60,4,"1",3,0.0435,0.0167,0.031,0.9225
"12491",231554,"BLUEFIELD COLLEGE",1,0,1999,"6900","9.128446","30","129","144",79,65,43,"18",25,0.3165,0.2769,0.2986,0.8958
"12492",231554,"BLUEFIELD COLLEGE",1,0,2000,"7900","8.126222","32","94","107",54,53,26,"13",13,0.2407,0.2453,0.243,0.8785
"12493",231554,"BLUEFIELD COLLEGE",1,0,2001,"8690","7.917262","34","137","162",91,71,53,"21",32,0.3516,0.2958,0.3272,0.8457
"12494",231554,"BLUEFIELD COLLEGE",1,0,2002,"9345","8.176958","32","113","131",62,69,36,"17",19,0.3065,0.2464,0.2748,0.8626
"12495",231554,"BLUEFIELD COLLEGE",1,0,2003,"9715","8.588797","31","73","83",50,33,27,"10",17,0.34,0.303,0.3253,0.8795
"12496",231554,"BLUEFIELD COLLEGE",1,0,2004,"10105","8.657194","33","123","135",82,53,38,"14",24,0.2927,0.2642,0.2815,0.9111
"12497",231554,"Bluefield College",1,0,2005,"10860","9.176157","33","90","103",57,46,32,"15",17,0.2982,0.3261,0.3107,0.8738
"12498",231554,"Bluefield College",1,0,2006,"11675","9.72441","33","90","106",59,47,19,"5",14,0.2373,0.1064,0.1792,0.8491
"12499",231554,"Bluefield College",1,0,2007,"12550","10.338494","34","82","89",49,40,34,"10",24,0.4898,0.25,0.382,0.9213
"12500",231554,"Bluefield College",1,0,2008,"15000","11.41239","37","52","80",47,33,29,"8",21,0.4468,0.2424,0.3625,0.65
"12501",231554,"Bluefield College",1,0,2009,"17250","12.0313","36","75","115",64,51,36,"11",25,0.3906,0.2157,0.313,0.6522
"12502",231554,"Bluefield College",1,0,2010,"17990","11.584398","37","77","112",58,54,28,"8",20,0.3448,0.1481,0.25,0.6875
"12503",231624,"COLLEGE OF WILLIAM AND MARY",1,0,1991,"3730","109.714726","448","1024","1222",609,613,920,"413",507,0.8325,0.6737,0.7529,0.838
"12504",231624,"COLLEGE OF WILLIAM AND MARY",1,0,1992,"4046","112.189873","447","978","1202",680,522,954,"386",568,0.8353,0.7395,0.7937,0.8136
"12505",231624,"COLLEGE OF WILLIAM AND MARY",1,0,1993,"4414","116.818609","470","994","1201",690,511,913,"360",553,0.8014,0.7045,0.7602,0.8276
"12506",231624,"COLLEGE OF WILLIAM AND MARY",1,0,1995,"4738","131.320969","492","1126","1369",850,519,1086,"378",708,0.8329,0.7283,0.7933,0.8225
"12507",231624,"COLLEGE OF WILLIAM AND MARY",1,0,1996,"4906","134.172472","502","1135","1328",789,539,1053,"381",672,0.8517,0.7069,0.7929,0.8547
"12508",231624,"COLLEGE OF WILLIAM AND MARY",1,0,1997,"5032","145.44591","506","1110","1327",802,525,1063,"381",682,0.8504,0.7257,0.8011,0.8365
"12509",231624,"COLLEGE OF WILLIAM AND MARY",1,0,1998,"5178","152.532564","516","1085","1290",701,589,1007,"412",595,0.8488,0.6995,0.7806,0.8411
"12510",231624,"COLLEGE OF WILLIAM AND MARY",1,0,1999,"2302","163.614654","514","1099","1298",736,562,1052,"418",634,0.8614,0.7438,0.8105,0.8467
"12511",231624,"COLLEGE OF WILLIAM AND MARY",1,0,2000,"2302","180.201518","529","1121","1347",782,565,1118,"425",693,0.8862,0.7522,0.83,0.8322
"12512",231624,"COLLEGE OF WILLIAM AND MARY",1,0,2001,"2302","187.277077","544","1119","1358",793,565,1140,"441",699,0.8815,0.7805,0.8395,0.824
"12513",231624,"COLLEGE OF WILLIAM AND MARY",1,0,2002,"2510","205.025491","532","1069","1314",721,593,1082,"456",626,0.8682,0.769,0.8234,0.8135
"12514",231624,"COLLEGE OF WILLIAM AND MARY",1,0,2003,"3760","188.475075","535","860","1319",736,583,1098,"439",659,0.8954,0.753,0.8324,0.652
"12515",231624,"COLLEGE OF WILLIAM AND MARY",1,0,2004,"4330","203.234358","541","870","1335",683,652,1097,"494",603,0.8829,0.7577,0.8217,0.6517
"12516",231624,"College of William and Mary",1,0,2005,"4730","216.063909","587","954","1339",714,625,1134,"489",645,0.9034,0.7824,0.8469,0.7125
"12517",231624,"College of William and Mary",1,0,2006,"5180","230.570973","588","856","1341",693,648,1107,"497",610,0.8802,0.767,0.8255,0.6383
"12518",231624,"College of William and Mary",1,0,2007,"5549","230.891237","602","760","1341",729,612,1114,"474",640,0.8779,0.7745,0.8307,0.5667
"12519",231624,"College of William and Mary",1,0,2008,"6090","296.580173","601","715","1381",780,601,1146,"462",684,0.8769,0.7687,0.8298,0.5177
"12520",231624,"College of William and Mary",1,0,2009,"6388","294.539121","613","712","1384",728,656,1133,"503",630,0.8654,0.7668,0.8186,0.5145
"12521",231624,"College of William and Mary",1,0,2010,"7523","272.716801","616","868","1396",791,605,1180,"483",697,0.8812,0.7983,0.8453,0.6218
"12522",231712,"CHRISTOPHER NEWPORT COLLEGE",1,0,1991,"2285","21.882284","137","355","443",287,156,44,"14",30,0.1045,0.0897,0.0993,0.8014
"12523",231712,"CHRISTOPHER NEWPORT UNIVERSITY",1,0,1992,"2860","22.403875","160","387","478",300,178,44,"10",34,0.1133,0.0562,0.0921,0.8096
"12524",231712,"CHRISTOPHER NEWPORT UNIVERSITY",1,0,1993,"3196","24.519808","166","345","428",266,162,29,"7",22,0.0827,0.0432,0.0678,0.8061
"12525",231712,"CHRISTOPHER NEWPORT UNIVERSITY",1,0,1995,"3350","30.061232","164","426","534",320,214,59,"18",41,0.1281,0.0841,0.1105,0.7978
"12526",231712,"CHRISTOPHER NEWPORT UNIVERSITY",1,0,1996,"3326","31.156057","166","393","517",304,213,65,"16",49,0.1612,0.0751,0.1257,0.7602
"12527",231712,"CHRISTOPHER NEWPORT UNIVERSITY",1,0,1997,"3466","35.815847","166","504","665",398,267,88,"29",59,0.1482,0.1086,0.1323,0.7579
"12528",231712,"CHRISTOPHER NEWPORT UNIVERSITY",1,0,1998,"3474","39.192661","172","569","693",414,279,121,"35",86,0.2077,0.1254,0.1746,0.8211
"12529",231712,"CHRISTOPHER NEWPORT UNIVERSITY",1,0,1999,"1888","44.217372","185","648","808",485,323,148,"44",104,0.2144,0.1362,0.1832,0.802
"12530",231712,"CHRISTOPHER NEWPORT UNIVERSITY",1,0,2000,"1888","47.283851","184.5","827","999",587,412,262,"73",189,0.322,0.1772,0.2623,0.8278
"12531",231712,"CHRISTOPHER NEWPORT UNIVERSITY",1,0,2001,"1888","52.856034","184","883","1042",595,447,318,"100",218,0.3664,0.2237,0.3052,0.8474
"12532",231712,"CHRISTOPHER NEWPORT UNIVERSITY",1,0,2002,"2058","57.327161","184","1041","1176",660,516,363,"128",235,0.3561,0.2481,0.3087,0.8852
"12533",231712,"CHRISTOPHER NEWPORT UNIVERSITY",1,0,2003,"2814","64.268223","167","1042","1205",619,586,475,"176",299,0.483,0.3003,0.3942,0.8647
"12534",231712,"CHRISTOPHER NEWPORT UNIVERSITY",1,0,2004,"3152","68.052861","195","1003","1174",638,536,498,"151",347,0.5439,0.2817,0.4242,0.8543
"12535",231712,"Christopher Newport University",1,0,2005,"3442","73.950875","218","257","1245",667,578,578,"203",375,0.5622,0.3512,0.4643,0.2064
"12536",231712,"Christopher Newport University",1,0,2006,"3784","91.179664","226","976","1172",644,528,594,"203",391,0.6071,0.3845,0.5068,0.8328
"12537",231712,"Christopher Newport University",1,0,2007,"4012","99.476544","226","1017","1241",706,535,618,"200",418,0.5921,0.3738,0.498,0.8195
"12538",231712,"Christopher Newport University",1,0,2008,"4172","110.53423","239","897","1134",640,494,624,"207",417,0.6516,0.419,0.5503,0.791
"12539",231712,"Christopher Newport University",1,0,2009,"4380","108.099276","236","962","1212",719,493,689,"235",454,0.6314,0.4767,0.5685,0.7937
"12540",231712,"Christopher Newport University",1,0,2010,"5280","105.490702","243","890","1150",673,477,723,"250",473,0.7028,0.5241,0.6287,0.7739
"12541",232025,"EMORY AND HENRY COLLEGE",1,0,1991,"7270","11.808655","54","138","143",78,65,82,"36",46,0.5897,0.5538,0.5734,0.965
"12542",232025,"EMORY AND HENRY COLLEGE",1,0,1992,"7820","12.448687","53","175","188",79,109,61,"25",36,0.4557,0.2294,0.3245,0.9309
"12543",232025,"EMORY AND HENRY COLLEGE",1,0,1993,"8546","12.378639","54","211","230",120,110,91,"30",61,0.5083,0.2727,0.3957,0.9174
"12544",232025,"EMORY AND HENRY COLLEGE",1,0,1995,"9990","16.146367","57","200","221",107,114,103,"47",56,0.5234,0.4123,0.4661,0.905
"12545",232025,"EMORY AND HENRY COLLEGE",1,0,1996,"10938","18.214876","58","235","256",121,135,123,"52",71,0.5868,0.3852,0.4805,0.918
"12546",232025,"EMORY AND HENRY COLLEGE",1,0,1997,"11572","13.771484","62","190","197",98,99,92,"35",57,0.5816,0.3535,0.467,0.9645
"12547",232025,"EMORY AND HENRY COLLEGE",1,0,1998,"11978","16.337681","64","263","290",144,146,120,"43",77,0.5347,0.2945,0.4138,0.9069
"12548",232025,"EMORY AND HENRY COLLEGE",1,0,1999,"12596","15.491785","66","243","271",129,142,117,"50",67,0.5194,0.3521,0.4317,0.8967
"12549",232025,"EMORY AND HENRY COLLEGE",1,0,2000,"12950","16.117596","64","231","251",127,124,126,"53",73,0.5748,0.4274,0.502,0.9203
"12550",232025,"EMORY AND HENRY COLLEGE",1,0,2001,"13900","17.434527","62","240","267",130,137,113,"48",65,0.5,0.3504,0.4232,0.8989
"12551",232025,"EMORY AND HENRY COLLEGE",1,0,2002,"14600","18.499594","64","220","235",130,105,118,"48",70,0.5385,0.4571,0.5021,0.9362
"12552",232025,"EMORY AND HENRY COLLEGE",1,0,2003,"15700","19.039569","68","205","223",106,117,96,"43",53,0.5,0.3675,0.4305,0.9193
"12553",232025,"EMORY AND HENRY COLLEGE",1,0,2004,"16490","18.96492","67","234","260",142,118,125,"48",77,0.5423,0.4068,0.4808,0.9
"12554",232025,"Emory and Henry College",1,0,2005,"19530","19.297593","68","304","338",155,183,177,"80",97,0.6258,0.4372,0.5237,0.8994
"12555",232025,"Emory and Henry College",1,0,2006,"20860","21.637637","74","227","267",115,152,84,"36",48,0.4174,0.2368,0.3146,0.8502
"12556",232025,"Emory and Henry College",1,0,2007,"22320","22.688471","74","201","240",103,137,80,"37",43,0.4175,0.2701,0.3333,0.8375
"12557",232025,"Emory and Henry College",1,0,2008,"23860","24.450639","76","193","241",123,118,87,"31",56,0.4553,0.2627,0.361,0.8008
"12558",232025,"Emory and Henry College",1,0,2009,"24880","25.224035","73","217","283",115,168,108,"52",56,0.487,0.3095,0.3816,0.7668
"12559",232025,"Emory and Henry College",1,0,2010,"26000","25.199536","74","193","248",124,124,84,"34",50,0.4032,0.2742,0.3387,0.7782
"12560",232043,"EASTERN MENNONITE COLLEGE AND SEMINARY",1,0,1991,"7900","13.307824","48","182","201",129,72,95,"29",66,0.5116,0.4028,0.4726,0.9055
"12561",232043,"EASTERN MENNONITE COLLEGE AND SEMINARY",1,0,1992,"8600","15.291992","62","181","205",117,88,87,"31",56,0.4786,0.3523,0.4244,0.8829
"12562",232043,"EASTERN MENNONITE COLLEGE AND SEMINARY",1,0,1993,"9100","15.599221","69","205","229",130,99,108,"42",66,0.5077,0.4242,0.4716,0.8952
"12563",232043,"EASTERN MENNONITE UNIVERSITY",1,0,1995,"10400","18.451161","67","179","206",144,62,96,"27",69,0.4792,0.4355,0.466,0.8689
"12564",232043,"EASTERN MENNONITE UNIVERSITY",1,0,1996,"11130","18.974252","67","203","228",143,85,90,"26",64,0.4476,0.3059,0.3947,0.8904
"12565",232043,"EASTERN MENNONITE UNIVERSITY",1,0,1997,"12000","18.126648","68","208","242",138,104,109,"44",65,0.471,0.4231,0.4504,0.8595
"12566",232043,"EASTERN MENNONITE UNIVERSITY",1,0,1998,"12600","17.178329","67","206","229",130,99,107,"43",64,0.4923,0.4343,0.4672,0.8996
"12567",232043,"EASTERN MENNONITE UNIVERSITY",1,0,1999,"13434","19.937022","80","179","218",131,87,111,"36",75,0.5725,0.4138,0.5092,0.8211
"12568",232043,"EASTERN MENNONITE UNIVERSITY",1,0,2000,"14110","21.074539","88.5","185","220",137,83,106,"35",71,0.5182,0.4217,0.4818,0.8409
"12569",232043,"EASTERN MENNONITE UNIVERSITY",1,0,2001,"15254","22.971314","97","171","208",124,84,115,"44",71,0.5726,0.5238,0.5529,0.8221
"12570",232043,"EASTERN MENNONITE UNIVERSITY",1,0,2002,"16324","24.36638","108","181","208",120,88,113,"46",67,0.5583,0.5227,0.5433,0.8702
"12571",232043,"EASTERN MENNONITE UNIVERSITY",1,0,2003,"17304","25.292394","107","159","195",121,74,94,"32",62,0.5124,0.4324,0.4821,0.8154
"12572",232043,"EASTERN MENNONITE UNIVERSITY",1,0,2004,"18174","26.540138","112","151","207",134,73,91,"33",58,0.4328,0.4521,0.4396,0.7295
"12573",232043,"Eastern Mennonite University",1,0,2005,"19500","26.695777","101","159","202",123,79,116,"40",76,0.6179,0.5063,0.5743,0.7871
"12574",232043,"Eastern Mennonite University",1,0,2006,"20612","27.626466","95","156","205",119,86,93,"31",62,0.521,0.3605,0.4537,0.761
"12575",232043,"Eastern Mennonite University",1,0,2007,"21860","27.820236","100","162","203",121,82,100,"34",66,0.5455,0.4146,0.4926,0.798
"12576",232043,"Eastern Mennonite University",1,0,2008,"23180","28.708548","100","146","183",103,80,90,"35",55,0.534,0.4375,0.4918,0.7978
"12577",232043,"Eastern Mennonite University",1,0,2009,"24120","29.465319","97","168","218",135,83,110,"40",70,0.5185,0.4819,0.5046,0.7706
"12578",232043,"Eastern Mennonite University",1,0,2010,"25060","30.714491","100","148","206",122,84,96,"32",64,0.5246,0.381,0.466,0.7184
"12579",232089,"FERRUM COLLEGE",1,0,1991,"7400","15.748884","74","292","339",122,217,58,"29",29,0.2377,0.1336,0.1711,0.8614
"12580",232089,"FERRUM COLLEGE",1,0,1992,"8120","17.11752","72","283","337",130,207,78,"46",32,0.2462,0.2222,0.2315,0.8398
"12581",232089,"FERRUM COLLEGE",1,0,1993,"8800","18.878012","69","282","332",131,201,68,"29",39,0.2977,0.1443,0.2048,0.8494
"12582",232089,"FERRUM COLLEGE",1,0,1995,"9950","18.953042","72","243","297",109,188,66,"28",38,0.3486,0.1489,0.2222,0.8182
"12583",232089,"FERRUM COLLEGE",1,0,1996,"10200","18.965847","71","250","309",111,198,59,"24",35,0.3153,0.1212,0.1909,0.8091
"12584",232089,"FERRUM COLLEGE",1,0,1997,"10750","14.657786","71","181","240",102,138,72,"35",37,0.3627,0.2536,0.3,0.7542
"12585",232089,"FERRUM COLLEGE",1,0,1998,"10750","14.628053","67","233","305",128,177,60,"29",31,0.2422,0.1638,0.1967,0.7639
"12586",232089,"FERRUM COLLEGE",1,0,1999,"10990","16.02602","64","225","309",104,205,56,"26",30,0.2885,0.1268,0.1812,0.7282
"12587",232089,"FERRUM COLLEGE",1,0,2000,"11900","16.273787","64.5","181","281",102,179,47,"23",24,0.2353,0.1285,0.1673,0.6441
"12588",232089,"FERRUM COLLEGE",1,0,2001,"12950","17.511408","65","189","269",104,165,51,"20",31,0.2981,0.1212,0.1896,0.7026
"12589",232089,"FERRUM COLLEGE",1,0,2002,"14390","17.993142","63","187","288",97,191,69,"32",37,0.3814,0.1675,0.2396,0.6493
"12590",232089,"FERRUM COLLEGE",1,0,2003,"15640","17.296936","63","187","301",106,195,71,"37",34,0.3208,0.1897,0.2359,0.6213
"12591",232089,"FERRUM COLLEGE",1,0,2004,"16840","17.378373","59","167","287",114,173,53,"21",32,0.2807,0.1214,0.1847,0.5819
"12592",232089,"Ferrum College",1,0,2005,"17990","17.98771","62","202","330",110,220,53,"18",35,0.3182,0.0818,0.1606,0.6121
"12593",232089,"Ferrum College",1,0,2006,"19490","19.942274","64","235","417",156,261,126,"65",61,0.391,0.249,0.3022,0.5635
"12594",232089,"Ferrum College",1,0,2007,"20885","22.807258","70","295","525",228,297,103,"42",61,0.2675,0.1414,0.1962,0.5619
"12595",232089,"Ferrum College",1,0,2008,"22500","25.415545","69","306","581",253,328,80,"26",54,0.2134,0.0793,0.1377,0.5267
"12596",232089,"Ferrum College",1,0,2009,"23520","26.875107","69","245","531",262,269,106,"45",61,0.2328,0.1673,0.1996,0.4614
"12597",232089,"Ferrum College",1,0,2010,"24900","29.212408","71","275","565",243,322,106,"49",57,0.2346,0.1522,0.1876,0.4867
"12598",232186,"GEORGE MASON UNIVERSITY",1,0,1991,"2988","155.425011","643","1096","1678",927,751,348,"106",242,0.2611,0.1411,0.2074,0.6532
"12599",232186,"GEORGE MASON UNIVERSITY",1,0,1992,"3336","161.135143","630","1148","1732",981,751,467,"146",321,0.3272,0.1944,0.2696,0.6628
"12600",232186,"GEORGE MASON UNIVERSITY",1,0,1993,"3888","169.915219","660","1115","1670",934,736,442,"140",302,0.3233,0.1902,0.2647,0.6677
"12601",232186,"GEORGE MASON UNIVERSITY",1,0,1995,"4212","205.015959","689","1136","1852",1065,787,486,"145",341,0.3202,0.1842,0.2624,0.6134
"12602",232186,"GEORGE MASON UNIVERSITY",1,0,1996,"4248","214.360455","711","1187","1875",1040,835,480,"150",330,0.3173,0.1796,0.256,0.6331
"12603",232186,"GEORGE MASON UNIVERSITY",1,0,1997,"4296","234.163409","748","1194","1930",1072,858,437,"140",297,0.2771,0.1632,0.2264,0.6187
"12604",232186,"GEORGE MASON UNIVERSITY",1,0,1998,"4344","244.590236","759","1258","2022",1112,910,540,"164",376,0.3381,0.1802,0.2671,0.6222
"12605",232186,"GEORGE MASON UNIVERSITY",1,0,1999,"2376","264.999971","765","1248","2030",1129,901,534,"161",373,0.3304,0.1787,0.2631,0.6148
"12606",232186,"GEORGE MASON UNIVERSITY",1,0,2000,"2376","293.63651","806.5","1363","2097",1132,965,650,"194",456,0.4028,0.201,0.31,0.65
"12607",232186,"GEORGE MASON UNIVERSITY",1,0,2001,"2376","321.520201","848","1293","2068",1136,932,631,"191",440,0.3873,0.2049,0.3051,0.6252
"12608",232186,"GEORGE MASON UNIVERSITY",1,0,2002,"2976","318.056423","915","1429","2161",1180,981,770,"254",516,0.4373,0.2589,0.3563,0.6613
"12609",232186,"GEORGE MASON UNIVERSITY",1,0,2003,"3630","337.297531","962","1452","2191",1166,1025,847,"284",563,0.4828,0.2771,0.3866,0.6627
"12610",232186,"GEORGE MASON UNIVERSITY",1,0,2004,"3942","360.376293","974","1125","2210",1203,1007,869,"311",558,0.4638,0.3088,0.3932,0.509
"12611",232186,"George Mason University",1,0,2005,"4260","392.890955","997","1284","2454",1339,1115,999,"348",651,0.4862,0.3121,0.4071,0.5232
"12612",232186,"George Mason University",1,0,2006,"4752","434.969166","1055","1276","2390",1335,1055,992,"355",637,0.4772,0.3365,0.4151,0.5339
"12613",232186,"George Mason University",1,0,2007,"5035","487.516299","1104","1010","2174",1222,952,942,"316",626,0.5123,0.3319,0.4333,0.4646
"12614",232186,"George Mason University",1,0,2008,"5526","541.427355","1134","1252","2476",1328,1148,1099,"406",693,0.5218,0.3537,0.4439,0.5057
"12615",232186,"George Mason University",1,0,2009,"5840","562.545015","1138","1334","2627",1367,1260,1198,"446",752,0.5501,0.354,0.456,0.5078
"12616",232186,"George Mason University",1,0,2010,"6320","588.521375","1144","1439","2577",1324,1253,1198,"462",736,0.5559,0.3687,0.4649,0.5584
"12617",232265,"HAMPTON UNIVERSITY",1,0,1991,"6550","63.896323","306","5","1188",718,470,445,"112",333,0.4638,0.2383,0.3746,0.0042
"12618",232265,"HAMPTON UNIVERSITY",1,0,1992,"7006","67.720197","302","8","1139",675,464,364,"80",284,0.4207,0.1724,0.3196,0.007
"12619",232265,"HAMPTON UNIVERSITY",1,0,1993,"7356","68.0264","302","6","1427",879,548,410,"85",325,0.3697,0.1551,0.2873,0.0042
"12620",232265,"HAMPTON UNIVERSITY",1,0,1995,"8362","86.873594","295","3","1272",780,492,418,"98",320,0.4103,0.1992,0.3286,0.0024
"12621",232265,"HAMPTON UNIVERSITY",1,0,1996,"8948","90.927287","288","4","917",591,326,358,"70",288,0.4873,0.2147,0.3904,0.0044
"12622",232265,"HAMPTON UNIVERSITY",1,0,1997,"9596","77.056478","297","8","1218",765,453,459,"119",340,0.4444,0.2627,0.3768,0.0066
"12623",232265,"HAMPTON UNIVERSITY",1,0,1998,"10076","82.616086","293","10","1153",715,438,461,"105",356,0.4979,0.2397,0.3998,0.0087
"12624",232265,"HAMPTON UNIVERSITY",1,0,1999,"9490","92.345872","303","30","1190",728,462,422,"102",320,0.4396,0.2208,0.3546,0.0252
"12625",232265,"HAMPTON UNIVERSITY",1,0,2000,"9968","98.057024","303.5","18","828",527,301,327,"79",248,0.4706,0.2625,0.3949,0.0217
"12626",232265,"HAMPTON UNIVERSITY",1,0,2001,"10464","99.698158","304","15","1189",748,441,450,"106",344,0.4599,0.2404,0.3785,0.0126
"12627",232265,"HAMPTON UNIVERSITY",1,0,2002,"10990","108.493731","282","11","1017",644,373,384,"90",294,0.4565,0.2413,0.3776,0.0108
"12628",232265,"HAMPTON UNIVERSITY",1,0,2003,"11540","110.36731","311","17","1379",873,506,506,"131",375,0.4296,0.2589,0.3669,0.0123
"12629",232265,"HAMPTON UNIVERSITY",1,0,2004,"12116","148.401743","322","13","1345",863,482,514,"131",383,0.4438,0.2718,0.3822,0.0097
"12630",232265,"Hampton University",1,0,2005,"12722","153.591115","305","6","1099",701,398,445,"114",331,0.4722,0.2864,0.4049,0.0055
"12631",232265,"Hampton University",1,0,2006,"13358","148.329994","399","7","1098",700,398,447,"119",328,0.4686,0.299,0.4071,0.0064
"12632",232265,"Hampton University",1,0,2007,"14026","140.994241","353","10","1179",757,422,585,"163",422,0.5575,0.3863,0.4962,0.0085
"12633",232265,"Hampton University",1,0,2008,"14728","137.423079","371","10","1190",792,398,489,"120",369,0.4659,0.3015,0.4109,0.0084
"12634",232265,"Hampton University",1,0,2009,"15464","148.5458","347","9","1017",632,385,135,"135",0,0,0.3506,0.1327,0.0088
"12635",232265,"Hampton University",1,0,2010,"16238","141.874364","371","16","978",605,373,351,"87",264,0.4364,0.2332,0.3589,0.0164
"12636",232423,"JAMES MADISON UNIVERSITY",1,0,1991,"3298","106.543765","482","1805","2121",1223,898,1105,"381",724,0.592,0.4243,0.521,0.851
"12637",232423,"JAMES MADISON UNIVERSITY",1,0,1992,"3576","113.465741","496","1731","2038",1171,867,1075,"361",714,0.6097,0.4164,0.5275,0.8494
"12638",232423,"JAMES MADISON UNIVERSITY",1,0,1993,"3798","115.769438","508","1788","2079",1170,909,1239,"453",786,0.6718,0.4983,0.596,0.86
"12639",232423,"JAMES MADISON UNIVERSITY",1,0,1995,"4014","134.780104","528","2181","2537",1484,1053,1548,"523",1025,0.6907,0.4967,0.6102,0.8597
"12640",232423,"JAMES MADISON UNIVERSITY",1,0,1996,"4104","141.892202","559","2890","3258",1878,1380,1958,"704",1254,0.6677,0.5101,0.601,0.887
"12641",232423,"JAMES MADISON UNIVERSITY",1,0,1997,"4148","165.470296","581","2634","3059",1791,1268,1855,"643",1212,0.6767,0.5071,0.6064,0.8611
"12642",232423,"JAMES MADISON UNIVERSITY",1,0,1998,"4256","173.244989","617","2623","2971",1788,1183,1830,"546",1284,0.7181,0.4615,0.616,0.8829
"12643",232423,"JAMES MADISON UNIVERSITY",1,0,1999,"1550","199.754645","640","2692","3040",1855,1185,1887,"610",1277,0.6884,0.5148,0.6207,0.8855
"12644",232423,"JAMES MADISON UNIVERSITY",1,0,2000,"1550","202.572231","639","2766","3223",1981,1242,2089,"684",1405,0.7092,0.5507,0.6482,0.8582
"12645",232423,"JAMES MADISON UNIVERSITY",1,0,2001,"1550","223.976729","638","2734","3244",2004,1240,2103,"696",1407,0.7021,0.5613,0.6483,0.8428
"12646",232423,"JAMES MADISON UNIVERSITY",1,0,2002,"1690","216.003632","704","2804","3283",2116,1167,2220,"690",1530,0.7231,0.5913,0.6762,0.8541
"12647",232423,"JAMES MADISON UNIVERSITY",1,0,2003,"2382","224.545295","721","2931","3386",2167,1219,2220,"697",1523,0.7028,0.5718,0.6556,0.8656
"12648",232423,"JAMES MADISON UNIVERSITY",1,0,2004,"2752","237.203939","749","2785","3281",2112,1169,2216,"690",1526,0.7225,0.5902,0.6754,0.8488
"12649",232423,"James Madison University",1,0,2005,"2998","258.159766","795","2883","3796",2421,1375,2465,"803",1662,0.6865,0.584,0.6494,0.7595
"12650",232423,"James Madison University",1,0,2006,"3228","283.317022","831","2998","3745",2431,1314,2357,"713",1644,0.6763,0.5426,0.6294,0.8005
"12651",232423,"James Madison University",1,0,2007,"3420","311.321512","854","3193","3864",2401,1463,2520,"829",1691,0.7043,0.5666,0.6522,0.8263
"12652",232423,"James Madison University",1,0,2008,"3556","339.705602","897","3162","3956",2425,1531,2577,"876",1701,0.7014,0.5722,0.6514,0.7993
"12653",232423,"James Madison University",1,0,2009,"3734","357.014959","906","3216","3948",2488,1460,2625,"823",1802,0.7243,0.5637,0.6649,0.8146
"12654",232423,"James Madison University",1,0,2010,"4182","370.856509","906","3185","3995",2482,1513,2599,"838",1761,0.7095,0.5539,0.6506,0.7972
"12655",232557,"LIBERTY UNIVERSITY",1,0,1991,"5850","80.682559","223","737","849",451,398,146,"53",93,0.2062,0.1332,0.172,0.8681
"12656",232557,"LIBERTY UNIVERSITY",1,0,1992,"6150","67.225271","196","660","766",369,397,156,"81",75,0.2033,0.204,0.2037,0.8616
"12657",232557,"LIBERTY UNIVERSITY",1,0,1993,"6600","65.29979","168","1168","1407",691,716,204,"81",123,0.178,0.1131,0.145,0.8301
"12658",232557,"LIBERTY UNIVERSITY",1,0,1995,"7350","98.461774","159","992","1165",600,565,224,"70",154,0.2567,0.1239,0.1923,0.8515
"12659",232557,"LIBERTY UNIVERSITY",1,0,1996,"7680","73.11617","163","1032","1253",635,618,253,"91",162,0.2551,0.1472,0.2019,0.8236
"12660",232557,"LIBERTY UNIVERSITY",1,0,1997,"8050","50.300362","173","799","995",531,464,279,"101",178,0.3352,0.2177,0.2804,0.803
"12661",232557,"LIBERTY UNIVERSITY",1,0,1998,"8500","59.408453","175","910","1020",479,541,327,"126",201,0.4196,0.2329,0.3206,0.8922
"12662",232557,"LIBERTY UNIVERSITY",1,0,1999,"8550","48.776968","176","841","1074",557,517,268,"103",165,0.2962,0.1992,0.2495,0.7831
"12663",232557,"LIBERTY UNIVERSITY",1,0,2000,"8550","48.362846","174","997","1216",657,559,431,"167",264,0.4018,0.2987,0.3544,0.8199
"12664",232557,"LIBERTY UNIVERSITY",1,0,2001,"9000","51.999176","172","963","1129",602,527,381,"146",235,0.3904,0.277,0.3375,0.853
"12665",232557,"LIBERTY UNIVERSITY",1,0,2002,"9840","56.310953","181","1177","1530",812,718,393,"154",239,0.2943,0.2145,0.2569,0.7693
"12666",232557,"LIBERTY UNIVERSITY",1,0,2003,"11520","67.481519","218","1358","1811",1024,787,506,"190",316,0.3086,0.2414,0.2794,0.7499
"12667",232557,"LIBERTY UNIVERSITY",1,0,2004,"12600","83.458607","272","1644","2173",1178,995,647,"251",396,0.3362,0.2523,0.2977,0.7566
"12668",232557,"Liberty University",1,0,2005,"13700","108.820428","305","1373","1915",982,933,488,"204",284,0.2892,0.2186,0.2548,0.717
"12669",232557,"Liberty University",1,0,2006,"14400","141.780712","354","1365","2028",1022,1006,489,"209",280,0.274,0.2078,0.2411,0.6731
"12670",232557,"Liberty University",1,0,2007,"14850","183.197073","340","1820","2715",1474,1241,715,"278",437,0.2965,0.224,0.2634,0.6703
"12671",232557,"Liberty University",1,0,2008,"15444","197.603317","350","1873","3063",1663,1400,857,"314",543,0.3265,0.2243,0.2798,0.6115
"12672",232557,"Liberty University",1,0,2009,"15992","226.884979","379","2201","3871",2113,1758,1154,"439",715,0.3384,0.2497,0.2981,0.5686
"12673",232557,"Liberty University",1,0,2010,"16792","272.421699","390","2026","3438",1874,1564,1005,"410",595,0.3175,0.2621,0.2923,0.5893
"12674",232566,"LONGWOOD COLLEGE",1,0,1991,"3190","32.316255","148","568","634",465,169,223,"43",180,0.3871,0.2544,0.3517,0.8959
"12675",232566,"LONGWOOD COLLEGE",1,0,1992,"3664","33.787985","148","608","687",473,214,268,"50",218,0.4609,0.2336,0.3901,0.885
"12676",232566,"LONGWOOD COLLEGE",1,0,1993,"4106","36.57555","150","647","724",509,215,275,"40",235,0.4617,0.186,0.3798,0.8936
"12677",232566,"LONGWOOD COLLEGE",1,0,1995,"4370","41.787355","157","599","671",445,226,283,"57",226,0.5079,0.2522,0.4218,0.8927
"12678",232566,"LONGWOOD COLLEGE",1,0,1996,"4370","41.356407","158","559","657",447,210,242,"53",189,0.4228,0.2524,0.3683,0.8508
"12679",232566,"LONGWOOD COLLEGE",1,0,1997,"4416","43.748619","158","637","728",513,215,303,"67",236,0.46,0.3116,0.4162,0.875
"12680",232566,"LONGWOOD COLLEGE",1,0,1998,"4528","45.530553","158","709","812",539,273,362,"91",271,0.5028,0.3333,0.4458,0.8732
"12681",232566,"LONGWOOD COLLEGE",1,0,1999,"2020","48.522948","162","708","815",534,281,391,"101",290,0.5431,0.3594,0.4798,0.8687
"12682",232566,"LONGWOOD COLLEGE",1,0,2000,"1995","53.404707","166.5","771","895",611,284,412,"105",307,0.5025,0.3697,0.4603,0.8615
"12683",232566,"LONGWOOD COLLEGE",1,0,2001,"1970","56.606181","171","776","891",611,280,410,"103",307,0.5025,0.3679,0.4602,0.8709
"12684",232566,"LONGWOOD UNIVERSITY",1,0,2002,"2148","59.871689","171","770","860",593,267,410,"101",309,0.5211,0.3783,0.4767,0.8953
"12685",232566,"LONGWOOD UNIVERSITY",1,0,2003,"3046","55.986989","182","763","872",576,296,340,"91",249,0.4323,0.3074,0.3899,0.875
"12686",232566,"LONGWOOD UNIVERSITY",1,0,2004,"3320","58.678372","194","872","972",631,341,386,"111",275,0.4358,0.3255,0.3971,0.8971
"12687",232566,"Longwood University",1,0,2005,"3586","65.684803","201","809","938",632,306,379,"88",291,0.4604,0.2876,0.4041,0.8625
"12688",232566,"Longwood University",1,0,2006,"3960","74.045598","203","872","985",627,358,411,"111",300,0.4785,0.3101,0.4173,0.8853
"12689",232566,"Longwood University",1,0,2007,"4249","87.057905","208","848","984",650,334,412,"107",305,0.4692,0.3204,0.4187,0.8618
"12690",232566,"Longwood University",1,0,2008,"4509","98.334546","211","889","1043",700,343,467,"104",363,0.5186,0.3032,0.4477,0.8523
"12691",232566,"Longwood University",1,0,2009,"4680","111.128881","207","754","934",631,303,414,"96",318,0.504,0.3168,0.4433,0.8073
"12692",232566,"Longwood University",1,0,2010,"5370","98.518466","214","801","970",667,303,454,"93",361,0.5412,0.3069,0.468,0.8258
"12693",232609,"LYNCHBURG COLLEGE",1,0,1991,"10300","29.183804","141","286","327",200,127,142,"47",95,0.475,0.3701,0.4343,0.8746
"12694",232609,"LYNCHBURG COLLEGE",1,0,1992,"10900","29.649362","131","357","416",248,168,177,"52",125,0.504,0.3095,0.4255,0.8582
"12695",232609,"LYNCHBURG COLLEGE",1,0,1993,"11600","30.228179","125","316","361",221,140,120,"36",84,0.3801,0.2571,0.3324,0.8753
"12696",232609,"LYNCHBURG COLLEGE",1,0,1995,"14080","29.821704","116","230","262",181,81,142,"42",100,0.5525,0.5185,0.542,0.8779
"12697",232609,"LYNCHBURG COLLEGE",1,0,1996,"14720","28.721863","104","235","287",169,118,151,"51",100,0.5917,0.4322,0.5261,0.8188
"12698",232609,"LYNCHBURG COLLEGE",1,0,1997,"15490","24.775681","106","407","477",275,202,220,"72",148,0.5382,0.3564,0.4612,0.8532
"12699",232609,"LYNCHBURG COLLEGE",1,0,1998,"16290","26.238005","104","377","433",267,166,218,"65",153,0.573,0.3916,0.5035,0.8707
"12700",232609,"LYNCHBURG COLLEGE",1,0,1999,"17120","28.371226","108","426","473",277,196,222,"73",149,0.5379,0.3724,0.4693,0.9006
"12701",232609,"LYNCHBURG COLLEGE",1,0,2000,"17980","30.157841","108.5","373","438",252,186,188,"70",118,0.4683,0.3763,0.4292,0.8516
"12702",232609,"LYNCHBURG COLLEGE",1,0,2001,"18880","32.316896","109","424","475",278,197,219,"67",152,0.5468,0.3401,0.4611,0.8926
"12703",232609,"LYNCHBURG COLLEGE",1,0,2002,"20040","33.21317","106","371","438",246,192,220,"72",148,0.6016,0.375,0.5023,0.847
"12704",232609,"LYNCHBURG COLLEGE",1,0,2003,"21270","33.459501","135","479","589",342,247,316,"116",200,0.5848,0.4696,0.5365,0.8132
"12705",232609,"LYNCHBURG COLLEGE",1,0,2004,"22640","36.50224","136","459","568",328,240,275,"87",188,0.5732,0.3625,0.4842,0.8081
"12706",232609,"Lynchburg College",1,0,2005,"23700","41.32651","149","378","553",321,232,246,"84",162,0.5047,0.3621,0.4448,0.6835
"12707",232609,"Lynchburg College",1,0,2006,"24860","45.045632","157","333","552",305,247,259,"88",171,0.5607,0.3563,0.4692,0.6033
"12708",232609,"Lynchburg College",1,0,2007,"26360","49.0382","158","407","598",324,274,274,"95",179,0.5525,0.3467,0.4582,0.6806
"12709",232609,"Lynchburg College",1,0,2008,"27160","51.421236","161","480","593",336,257,252,"85",167,0.497,0.3307,0.425,0.8094
"12710",232609,"Lynchburg College",1,0,2009,"27980","53.768083","163","481","592",348,244,278,"91",187,0.5374,0.373,0.4696,0.8125
"12711",232609,"Lynchburg College",1,0,2010,"28960","55.112286","171","455","571",328,243,275,"89",186,0.5671,0.3663,0.4816,0.7968
"12712",232681,"MARY WASHINGTON COLLEGE",1,0,1991,"2618","33.098263","162","620","712",496,216,458,"123",335,0.6754,0.5694,0.6433,0.8708
"12713",232681,"MARY WASHINGTON COLLEGE",1,0,1992,"2896","33.989816","160","623","698",474,224,448,"132",316,0.6667,0.5893,0.6418,0.8926
"12714",232681,"MARY WASHINGTON COLLEGE",1,0,1993,"3066","35.750935","157","662","750",477,273,486,"161",325,0.6813,0.5897,0.648,0.8827
"12715",232681,"MARY WASHINGTON COLLEGE",1,0,1995,"3300","40.33876","174","654","758",497,261,443,"138",305,0.6137,0.5287,0.5844,0.8628
"12716",232681,"MARY WASHINGTON COLLEGE",1,0,1996,"3318","40.879048","170","655","729",504,225,450,"112",338,0.6706,0.4978,0.6173,0.8985
"12717",232681,"MARY WASHINGTON COLLEGE",1,0,1997,"3556","44.697399","177","731","808",547,261,479,"129",350,0.6399,0.4943,0.5928,0.9047
"12718",232681,"MARY WASHINGTON COLLEGE",1,0,1998,"3674","45.139114","179","741","812",557,255,530,"156",374,0.6715,0.6118,0.6527,0.9126
"12719",232681,"MARY WASHINGTON COLLEGE",1,0,1999,"1550","48.153915","184","753","834",619,215,583,"142",441,0.7124,0.6605,0.699,0.9029
"12720",232681,"MARY WASHINGTON COLLEGE",1,0,2000,"1550","56.408925","193.5","779","873",609,264,622,"175",447,0.734,0.6629,0.7125,0.8923
"12721",232681,"MARY WASHINGTON COLLEGE",1,0,2001,"1550","58.005036","203","742","840",574,266,570,"158",412,0.7178,0.594,0.6786,0.8833
"12722",232681,"MARY WASHINGTON COLLEGE",1,0,2002,"1690","57.168679","206","760","862",618,244,607,"164",443,0.7168,0.6721,0.7042,0.8817
"12723",232681,"MARY WASHINGTON COLLEGE",1,0,2003,"2344","59.227512","209","791","879",572,307,590,"181",409,0.715,0.5896,0.6712,0.8999
"12724",232681,"UNIVERSITY OF MARY WASHINGTON",1,0,2004,"2544","62.303726","214","779","869",569,300,590,"183",407,0.7153,0.61,0.6789,0.8964
"12725",232681,"University of Mary Washington",1,0,2005,"2806","66.125462","231","644","877",581,296,552,"159",393,0.6764,0.5372,0.6294,0.7343
"12726",232681,"University of Mary Washington",1,0,2006,"3072","72.534604","242","619","909",614,295,625,"180",445,0.7248,0.6102,0.6876,0.681
"12727",232681,"University of Mary Washington",1,0,2007,"3256","80.055295","246","600","951",649,302,626,"175",451,0.6949,0.5795,0.6583,0.6309
"12728",232681,"University of Mary Washington",1,0,2008,"3386","87.656539","246","586","848",553,295,539,"160",379,0.6854,0.5424,0.6356,0.691
"12729",232681,"University of Mary Washington",1,0,2009,"3554","99.822988","242","521","925",600,325,543,"156",387,0.645,0.48,0.587,0.5632
"12730",232681,"University of Mary Washington",1,0,2010,"3984","89.141917","239","503","950",612,338,586,"179",407,0.665,0.5296,0.6168,0.5295
"12731",232706,"MARYMOUNT UNIVERSITY",1,0,1991,"9707","26.231489","92","151","211",159,52,81,"21",60,0.3774,0.4038,0.3839,0.7156
"12732",232706,"MARYMOUNT UNIVERSITY",1,0,1992,"10192","29.742449","114","155","212",165,47,77,"19",58,0.3515,0.4043,0.3632,0.7311
"12733",232706,"MARYMOUNT UNIVERSITY",1,0,1993,"10804","33.304737","112","128","175",130,45,66,"10",56,0.4308,0.2222,0.3771,0.7314
"12734",232706,"MARYMOUNT UNIVERSITY",1,0,1995,"11900","37.154106","111","114","167",122,45,82,"22",60,0.4918,0.4889,0.491,0.6826
"12735",232706,"MARYMOUNT UNIVERSITY",1,0,1996,"12400","40.026974","108","136","212",145,67,102,"27",75,0.5172,0.403,0.4811,0.6415
"12736",232706,"MARYMOUNT UNIVERSITY",1,0,1997,"12770","34.883562","108","186","261",190,71,111,"28",83,0.4368,0.3944,0.4253,0.7126
"12737",232706,"MARYMOUNT UNIVERSITY",1,0,1998,"13300","37.199479","115","164","262",177,85,100,"24",76,0.4294,0.2824,0.3817,0.626
"12738",232706,"MARYMOUNT UNIVERSITY",1,0,1999,"13750","36.947968","118","185","302",220,82,116,"26",90,0.4091,0.3171,0.3841,0.6126
"12739",232706,"MARYMOUNT UNIVERSITY",1,0,2000,"14300","38.696917","120","166","309",230,79,120,"21",99,0.4304,0.2658,0.3883,0.5372
"12740",232706,"MARYMOUNT UNIVERSITY",1,0,2001,"14850","40.084197","122","187","354",241,113,123,"29",94,0.39,0.2566,0.3475,0.5282
"12741",232706,"MARYMOUNT UNIVERSITY",1,0,2002,"15600","41.661391","128","170","361",261,100,128,"25",103,0.3946,0.25,0.3546,0.4709
"12742",232706,"MARYMOUNT UNIVERSITY",1,0,2003,"16300","43.61735","128","193","379",290,89,158,"30",128,0.4414,0.3371,0.4169,0.5092
"12743",232706,"MARYMOUNT UNIVERSITY",1,0,2004,"16952","45.73234","129","222","414",310,104,180,"45",135,0.4355,0.4327,0.4348,0.5362
"12744",232706,"Marymount University",1,0,2005,"17970","47.901106","134","208","422",310,112,152,"34",118,0.3806,0.3036,0.3602,0.4929
"12745",232706,"Marymount University",1,0,2006,"19048","51.45973","143","173","365",268,97,136,"28",108,0.403,0.2887,0.3726,0.474
"12746",232706,"Marymount University",1,0,2007,"20190","54.36914","138","198","396",288,108,176,"35",141,0.4896,0.3241,0.4444,0.5
"12747",232706,"Marymount University",1,0,2008,"21300","56.212727","138","173","404",294,110,141,"25",116,0.3946,0.2273,0.349,0.4282
"12748",232706,"Marymount University",1,0,2009,"22370","57.657777","141","161","383",274,109,131,"31",100,0.365,0.2844,0.342,0.4204
"12749",232706,"Marymount University",1,0,2010,"23160","59.800326","144","153","415",295,120,151,"36",115,0.3898,0.3,0.3639,0.3687
"12750",232937,"NORFOLK STATE UNIVERSITY",1,0,1991,"2330","62.69427","308","33","1543",920,623,95,"24",71,0.0772,0.0385,0.0616,0.0214
"12751",232937,"NORFOLK STATE UNIVERSITY",1,0,1992,"2530","66.097675","275","47","1492",893,599,76,"24",52,0.0582,0.0401,0.0509,0.0315
"12752",232937,"NORFOLK STATE UNIVERSITY",1,0,1993,"2710","70.439106","297","27","1324",759,565,70,"24",46,0.0606,0.0425,0.0529,0.0204
"12753",232937,"NORFOLK STATE UNIVERSITY",1,0,1995,"2865","75.281125","294","33","1257",706,551,91,"24",67,0.0949,0.0436,0.0724,0.0263
"12754",232937,"NORFOLK STATE UNIVERSITY",1,0,1996,"2865","79.12129","317","34","1329",809,520,124,"34",90,0.1112,0.0654,0.0933,0.0256
"12755",232937,"NORFOLK STATE UNIVERSITY",1,0,1997,"3000","83.591616","320","23","1132",700,432,104,"30",74,0.1057,0.0694,0.0919,0.0203
"12756",232937,"NORFOLK STATE UNIVERSITY",1,0,1998,"3335","80.807929","337","22","1092",680,412,95,"26",69,0.1015,0.0631,0.087,0.0201
"12757",232937,"NORFOLK STATE UNIVERSITY",1,0,1999,"1350","85.745423","326","28","1111",687,424,118,"27",91,0.1325,0.0637,0.1062,0.0252
"12758",232937,"NORFOLK STATE UNIVERSITY",1,0,2000,"1326","95.50131","314","17","1262",808,454,141,"52",89,0.1101,0.1145,0.1117,0.0135
"12759",232937,"NORFOLK STATE UNIVERSITY",1,0,2001,"1530","101.793832","302","22","1067",655,412,113,"25",88,0.1344,0.0607,0.1059,0.0206
"12760",232937,"NORFOLK STATE UNIVERSITY",1,0,2002,"1658","104.110297","314","21","1091",634,457,133,"35",98,0.1546,0.0766,0.1219,0.0192
"12761",232937,"NORFOLK STATE UNIVERSITY",1,0,2003,"1920","104.338485","299","29","1080",593,487,123,"41",82,0.1383,0.0842,0.1139,0.0269
"12762",232937,"NORFOLK STATE UNIVERSITY",1,0,2004,"2220","110.490188","285","32","970",580,390,103,"20",83,0.1431,0.0513,0.1062,0.033
"12763",232937,"Norfolk State University",1,0,2005,"2370","120.338017","280","21","957",551,406,138,"39",99,0.1797,0.0961,0.1442,0.0219
"12764",232937,"Norfolk State University",1,0,2006,"2580","122.637158","277","23","1023",638,385,130,"34",96,0.1505,0.0883,0.1271,0.0225
"12765",232937,"Norfolk State University",1,0,2007,"2700","127.825593","272","18","938",571,367,179,"46",133,0.2329,0.1253,0.1908,0.0192
"12766",232937,"Norfolk State University",1,0,2008,"2781","132.664508","272","24","1143",657,486,182,"53",129,0.1963,0.1091,0.1592,0.021
"12767",232937,"Norfolk State University",1,0,2009,"2952","133.7407","270","32","1160",654,506,183,"63",120,0.1835,0.1245,0.1578,0.0276
"12768",232937,"Norfolk State University",1,0,2010,"3159","136.880638","269","30","902",528,374,185,"67",118,0.2235,0.1791,0.2051,0.0333
"12769",232982,"OLD DOMINION UNIVERSITY",1,0,1991,"2848","118.718394","621","1017","1363",685,678,161,"48",113,0.165,0.0708,0.1181,0.7461
"12770",232982,"OLD DOMINION UNIVERSITY",1,0,1992,"2828","125.861484","601","1080","1491",764,727,158,"50",108,0.1414,0.0688,0.106,0.7243
"12771",232982,"OLD DOMINION UNIVERSITY",1,0,1993,"3098","137.303959","640","825","1173",580,593,137,"39",98,0.169,0.0658,0.1168,0.7033
"12772",232982,"OLD DOMINION UNIVERSITY",1,0,1995,"3288","141.827102","625","978","1514",827,687,149,"30",119,0.1439,0.0437,0.0984,0.646
"12773",232982,"OLD DOMINION UNIVERSITY",1,0,1996,"3312","152.503698","623","926","1478",803,675,210,"60",150,0.1868,0.0889,0.1421,0.6265
"12774",232982,"OLD DOMINION UNIVERSITY",1,0,1997,"3428","161.367165","592","896","1464",791,673,207,"54",153,0.1934,0.0802,0.1414,0.612
"12775",232982,"OLD DOMINION UNIVERSITY",1,0,1998,"3476","176.766491","582","930","1561",904,657,324,"82",242,0.2677,0.1248,0.2076,0.5958
"12776",232982,"OLD DOMINION UNIVERSITY",1,0,1999,"2184","182.815319","599","875","1500",833,667,327,"103",224,0.2689,0.1544,0.218,0.5833
"12777",232982,"OLD DOMINION UNIVERSITY",1,0,2000,"1747","202.608745","597.5","798","1407",798,609,321,"93",228,0.2857,0.1527,0.2281,0.5672
"12778",232982,"OLD DOMINION UNIVERSITY",1,0,2001,"1747","208.776644","596","856","1502",821,681,340,"116",224,0.2728,0.1703,0.2264,0.5699
"12779",232982,"OLD DOMINION UNIVERSITY",1,0,2002,"1891","205.682118","575","958","1701",902,799,373,"139",234,0.2594,0.174,0.2193,0.5632
"12780",232982,"OLD DOMINION UNIVERSITY",1,0,2003,"2364","195.538708","566","1159","2001",1139,862,457,"136",321,0.2818,0.1578,0.2284,0.5792
"12781",232982,"OLD DOMINION UNIVERSITY",1,0,2004,"2569","204.27703","605","1093","1917",1053,864,474,"136",338,0.321,0.1574,0.2473,0.5702
"12782",232982,"Old Dominion University",1,0,2005,"2785","219.412081","620","459","2054",1160,894,474,"145",329,0.2836,0.1622,0.2308,0.2235
"12783",232982,"Old Dominion University",1,0,2006,"3051","250.407437","663","555","2059",1108,951,507,"159",348,0.3141,0.1672,0.2462,0.2695
"12784",232982,"Old Dominion University",1,0,2007,"3219","284.736474","686","1420","2513",1327,1186,581,"200",381,0.2871,0.1686,0.2312,0.5651
"12785",232982,"Old Dominion University",1,0,2008,"3348","309.270741","697","1567","2757",1381,1376,652,"233",419,0.3034,0.1693,0.2365,0.5684
"12786",232982,"Old Dominion University",1,0,2009,"3516","325.205402","696","1533","2691",1346,1345,698,"263",435,0.3232,0.1955,0.2594,0.5697
"12787",232982,"Old Dominion University",1,0,2010,"3763","337.85241","723","1360","2579",1280,1299,666,"252",414,0.3234,0.194,0.2582,0.5273
"12788",233277,"RADFORD UNIVERSITY",1,0,1991,"2430","75.02447","396","1706","1857",1122,735,365,"88",277,0.2469,0.1197,0.1966,0.9187
"12789",233277,"RADFORD UNIVERSITY",1,0,1992,"2746","76.185385","396","1651","1807",1128,679,445,"99",346,0.3067,0.1458,0.2463,0.9137
"12790",233277,"RADFORD UNIVERSITY",1,0,1993,"2924","79.111709","394","1580","1736",1088,648,460,"128",332,0.3051,0.1975,0.265,0.9101
"12791",233277,"RADFORD UNIVERSITY",1,0,1995,"3114","84.156589","395","1252","1381",833,548,425,"121",304,0.3649,0.2208,0.3077,0.9066
"12792",233277,"RADFORD UNIVERSITY",1,0,1996,"3146","80.592628","361","1274","1419",867,552,476,"141",335,0.3864,0.2554,0.3354,0.8978
"12793",233277,"RADFORD UNIVERSITY",1,0,1997,"3180","81.368393","352","1443","1619",1048,571,551,"145",406,0.3874,0.2539,0.3403,0.8913
"12794",233277,"RADFORD UNIVERSITY",1,0,1998,"3238","88.551307","352","1356","1518",1011,507,569,"154",415,0.4105,0.3037,0.3748,0.8933
"12795",233277,"RADFORD UNIVERSITY",1,0,1999,"1629","93.387789","356","1462","1655",1075,580,610,"164",446,0.4149,0.2828,0.3686,0.8834
"12796",233277,"RADFORD UNIVERSITY",1,0,2000,"1629","98.900124","357","1563","1753",1081,672,610,"191",419,0.3876,0.2842,0.348,0.8916
"12797",233277,"RADFORD UNIVERSITY",1,0,2001,"1629","107.209557","358","1679","1875",1155,720,674,"200",474,0.4104,0.2778,0.3595,0.8955
"12798",233277,"RADFORD UNIVERSITY",1,0,2002,"1774","97.984813","355","1590","1813",1109,704,754,"244",510,0.4599,0.3466,0.4159,0.877
"12799",233277,"RADFORD UNIVERSITY",1,0,2003,"2476","101.531609","340","1614","1800",1097,703,719,"214",505,0.4603,0.3044,0.3994,0.8967
"12800",233277,"RADFORD UNIVERSITY",1,0,2004,"2974","103.722246","356","1604","1828",1135,693,708,"209",499,0.4396,0.3016,0.3873,0.8775
"12801",233277,"Radford University",1,0,2005,"3235","113.922176","377","1647","1890",1101,789,725,"254",471,0.4278,0.3219,0.3836,0.8714
"12802",233277,"Radford University",1,0,2006,"3720","126.391167","383","1507","1730",1045,685,730,"252",478,0.4574,0.3679,0.422,0.8711
"12803",233277,"Radford University",1,0,2007,"4026","136.910495","397","1611","1840",1055,785,758,"273",485,0.4597,0.3478,0.412,0.8755
"12804",233277,"Radford University",1,0,2008,"4187","147.755828","400","1573","1871",1119,752,809,"261",548,0.4897,0.3471,0.4324,0.8407
"12805",233277,"Radford University",1,0,2009,"4396","149.673653","387","1249","1444",838,606,637,"217",420,0.5012,0.3581,0.4411,0.865
"12806",233277,"Radford University",1,0,2010,"5012","153.033022","393","1557","1836",1068,768,783,"259",524,0.4906,0.3372,0.4265,0.848
"12807",233374,"UNIVERSITY OF RICHMOND",1,0,1991,"11695","67.525809","208","753","805",409,396,623,"294",329,0.8044,0.7424,0.7739,0.9354
"12808",233374,"UNIVERSITY OF RICHMOND",1,0,1992,"12620","76.208503","212","689","749",361,388,576,"294",282,0.7812,0.7577,0.769,0.9199
"12809",233374,"UNIVERSITY OF RICHMOND",1,0,1993,"13540","78.751414","222","664","728",383,345,559,"251",308,0.8042,0.7275,0.7679,0.9121
"12810",233374,"UNIVERSITY OF RICHMOND",1,0,1995,"15500","87.064605","221","671","762",398,364,581,"251",330,0.8291,0.6896,0.7625,0.8806
"12811",233374,"UNIVERSITY OF RICHMOND",1,0,1996,"16570","83.798951","226","698","793",399,394,610,"284",326,0.817,0.7208,0.7692,0.8802
"12812",233374,"UNIVERSITY OF RICHMOND",1,0,1997,"17570","92.694678","225","660","750",367,383,548,"258",290,0.7902,0.6736,0.7307,0.88
"12813",233374,"UNIVERSITY OF RICHMOND",1,0,1998,"18595","87.024325","226","633","739",358,381,576,"281",295,0.824,0.7375,0.7794,0.8566
"12814",233374,"UNIVERSITY OF RICHMOND",1,0,1999,"19340","107.328863","224","773","854",465,389,647,"273",374,0.8043,0.7018,0.7576,0.9052
"12815",233374,"UNIVERSITY OF RICHMOND",1,0,2000,"20140","116.038631","235.5","632","723",366,357,574,"278",296,0.8087,0.7787,0.7939,0.8741
"12816",233374,"UNIVERSITY OF RICHMOND",1,0,2001,"21700","121.966716","247","696","790",430,360,640,"277",363,0.8442,0.7694,0.8101,0.881
"12817",233374,"UNIVERSITY OF RICHMOND",1,0,2002,"22995","128.57395","292","668","775",422,353,634,"279",355,0.8412,0.7904,0.8181,0.8619
"12818",233374,"UNIVERSITY OF RICHMOND",1,0,2003,"24170","133.012953","283","730","835",440,395,688,"313",375,0.8523,0.7924,0.824,0.8743
"12819",233374,"UNIVERSITY OF RICHMOND",1,0,2004,"26520","139.593064","299","640","763",391,372,620,"298",322,0.8235,0.8011,0.8126,0.8388
"12820",233374,"University of Richmond",1,0,2005,"29250","150.229216","334","577","775",401,374,593,"268",325,0.8105,0.7166,0.7652,0.7445
"12821",233374,"University of Richmond",1,0,2006,"32870","159.391209","336","540","757",387,370,585,"267",318,0.8217,0.7216,0.7728,0.7133
"12822",233374,"University of Richmond",1,0,2007,"35718","169.274384","344","605","801",427,374,653,"295",358,0.8384,0.7888,0.8152,0.7553
"12823",233374,"University of Richmond",1,0,2008,"38850","186.128173","343","485","737",412,325,591,"255",336,0.8155,0.7846,0.8019,0.6581
"12824",233374,"University of Richmond",1,0,2009,"40010","201.682855","374","505","918",546,372,758,"293",465,0.8516,0.7876,0.8257,0.5501
"12825",233374,"University of Richmond",1,0,2010,"41610","212.794386","371","506","816",452,364,685,"286",399,0.8827,0.7857,0.8395,0.6201
"12826",233426,"ROANOKE COLLEGE",1,0,1991,"11250","24.985736","91","403","421",267,154,188,"58",130,0.4869,0.3766,0.4466,0.9572
"12827",233426,"ROANOKE COLLEGE",1,0,1992,"12000","27.338988","91","395","422",259,163,222,"65",157,0.6062,0.3988,0.5261,0.936
"12828",233426,"ROANOKE COLLEGE",1,0,1993,"12625","28.614198","92","415","438",275,163,242,"67",175,0.6364,0.411,0.5525,0.9475
"12829",233426,"ROANOKE COLLEGE",1,0,1995,"14100","31.519358","94","405","431",247,184,223,"77",146,0.5911,0.4185,0.5174,0.9397
"12830",233426,"ROANOKE COLLEGE",1,0,1996,"14750","33.558533","94","408","437",278,159,263,"84",179,0.6439,0.5283,0.6018,0.9336
"12831",233426,"ROANOKE COLLEGE",1,0,1997,"15380","26.237627","92","407","438",248,190,225,"70",155,0.625,0.3684,0.5137,0.9292
"12832",233426,"ROANOKE COLLEGE",1,0,1998,"16035","27.956382","93","400","426",272,154,222,"68",154,0.5662,0.4416,0.5211,0.939
"12833",233426,"ROANOKE COLLEGE",1,0,1999,"16655","29.124509","98","428","450",274,176,257,"88",169,0.6168,0.5,0.5711,0.9511
"12834",233426,"ROANOKE COLLEGE",1,0,2000,"17320","30.643669","97","403","444",274,170,259,"80",179,0.6533,0.4706,0.5833,0.9077
"12835",233426,"ROANOKE COLLEGE",1,0,2001,"18186","32.348794","96","452","498",311,187,283,"96",187,0.6013,0.5134,0.5683,0.9076
"12836",233426,"ROANOKE COLLEGE",1,0,2002,"19186","35.382092","105","417","460",274,186,256,"95",161,0.5876,0.5108,0.5565,0.9065
"12837",233426,"ROANOKE COLLEGE",1,0,2003,"20355","36.657888","132","477","519",282,237,301,"130",171,0.6064,0.5485,0.58,0.9191
"12838",233426,"ROANOKE COLLEGE",1,0,2004,"21504","39.576864","139","434","483",288,195,314,"114",200,0.6944,0.5846,0.6501,0.8986
"12839",233426,"Roanoke College",1,0,2005,"22848","41.274318","133","464","534",310,224,316,"120",196,0.6323,0.5357,0.5918,0.8689
"12840",233426,"Roanoke College",1,0,2006,"24048","43.991554","146","433","503",296,207,285,"104",181,0.6115,0.5024,0.5666,0.8608
"12841",233426,"Roanoke College",1,0,2007,"25550","46.841227","157","471","565",335,230,327,"115",212,0.6328,0.5,0.5788,0.8336
"12842",233426,"Roanoke College",1,0,2008,"27210","52.431322","151","458","529",284,245,302,"115",187,0.6585,0.4694,0.5709,0.8658
"12843",233426,"Roanoke College",1,0,2009,"28734","52.498118","164","480","560",325,235,327,"123",204,0.6277,0.5234,0.5839,0.8571
"12844",233426,"Roanoke College",1,0,2010,"30314","57.714611","164","503","564",323,241,321,"115",206,0.6378,0.4772,0.5691,0.8918
"12845",233541,"SHENANDOAH UNIVERSITY",1,0,1991,"8100","12.391932","75","153","180",104,76,35,"10",25,0.2404,0.1316,0.1944,0.85
"12846",233541,"SHENANDOAH UNIVERSITY",1,0,1992,"8750","14.654488","81","186","221",141,80,46,"16",30,0.2128,0.2,0.2081,0.8416
"12847",233541,"SHENANDOAH UNIVERSITY",1,0,1993,"9800","17.932373","89","164","185",88,97,47,"17",30,0.3409,0.1753,0.2541,0.8865
"12848",233541,"SHENANDOAH UNIVERSITY",1,0,1995,"11470","24.606237","113","179","212",118,94,53,"16",37,0.3136,0.1702,0.25,0.8443
"12849",233541,"SHENANDOAH UNIVERSITY",1,0,1996,"13700","27.070271","114","214","251",149,102,59,"14",45,0.302,0.1373,0.2351,0.8526
"12850",233541,"SHENANDOAH UNIVERSITY",1,0,1997,"14400","25.889249","128","223","257",159,98,61,"17",44,0.2767,0.1735,0.2374,0.8677
"12851",233541,"SHENANDOAH UNIVERSITY",1,0,1998,"15080","25.558173","142","251","288",178,110,80,"19",61,0.3427,0.1727,0.2778,0.8715
"12852",233541,"SHENANDOAH UNIVERSITY",1,0,1999,"15700","32.719696","147","249","292",163,129,87,"36",51,0.3129,0.2791,0.2979,0.8527
"12853",233541,"SHENANDOAH UNIVERSITY",1,0,2000,"16300","36.184344","153","303","377",187,190,105,"35",70,0.3743,0.1842,0.2785,0.8037
"12854",233541,"SHENANDOAH UNIVERSITY",1,0,2001,"17000","38.835436","159","268","308",158,150,106,"40",66,0.4177,0.2667,0.3442,0.8701
"12855",233541,"SHENANDOAH UNIVERSITY",1,0,2002,"17510","42.429146","167","267","323",163,160,115,"42",73,0.4479,0.2625,0.356,0.8266
"12856",233541,"SHENANDOAH UNIVERSITY",1,0,2003,"18310","45.685504","175","317","328",185,143,106,"34",72,0.3892,0.2378,0.3232,0.9665
"12857",233541,"SHENANDOAH UNIVERSITY",1,0,2004,"19090","46.5469","175","301","325",160,165,98,"39",59,0.3688,0.2364,0.3015,0.9262
"12858",233541,"Shenandoah University",1,0,2005,"19900","50.111087","181","158","369",211,158,123,"44",79,0.3744,0.2785,0.3333,0.4282
"12859",233541,"Shenandoah University",1,0,2006,"21090","53.244675","191","50","304",157,147,75,"29",46,0.293,0.1973,0.2467,0.1645
"12860",233541,"Shenandoah University",1,0,2007,"22040","56.697075","196","287","397",205,192,135,"49",86,0.4195,0.2552,0.3401,0.7229
"12861",233541,"Shenandoah University",1,0,2008,"22740","61.658035","211","292","399",200,199,145,"52",93,0.465,0.2613,0.3634,0.7318
"12862",233541,"Shenandoah University",1,0,2009,"23850","66.949433","215","320","443",235,208,155,"46",109,0.4638,0.2212,0.3499,0.7223
"12863",233541,"Shenandoah University",1,0,2010,"24780","68.39136","222","297","414",228,186,164,"57",107,0.4693,0.3065,0.3961,0.7174
"12864",233897,"UNIVERSITY OF VIRGINIA CLINCH VALLEY COLLEGE",1,0,1991,"2300","11.525596","52","303","326",155,171,52,"16",36,0.2323,0.0936,0.1595,0.9294
"12865",233897,"UNIVERSITY OF VIRGINIA CLINCH VALLEY COLLEGE",1,0,1992,"2650","13.247172","57","219","232",110,122,41,"14",27,0.2455,0.1148,0.1767,0.944
"12866",233897,"UNIVERSITY OF VIRGINIA-CLINCH VALLEY COLLEGE",1,0,1993,"2988","14.189734","58","229","253",110,143,53,"22",31,0.2818,0.1538,0.2095,0.9051
"12867",233897,"UNIVERSITY OF VIRGINIA-CLINCH VALLEY COLLEGE",1,0,1995,"3200","14.323701","57","255","269",141,128,67,"27",40,0.2837,0.2109,0.2491,0.948
"12868",233897,"UNIVERSITY OF VIRGINIA-CLINCH VALLEY COLLEGE",1,0,1996,"3258","14.481934","56","234","247",132,115,69,"31",38,0.2879,0.2696,0.2794,0.9474
"12869",233897,"UNIVERSITY OF VIRGINIA-CLINCH VALLEY COLLEGE",1,0,1997,"3348","15.645383","59","279","303",155,148,80,"28",52,0.3355,0.1892,0.264,0.9208
"12870",233897,"UNIVERSITY OF VIRGINIA-CLINCH VALLEY COLLEGE",1,0,1998,"3520","11.853363","63","268","297",146,151,57,"18",39,0.2671,0.1192,0.1919,0.9024
"12871",233897,"UNIVERSITY OF VIRGINIA'S COLLEGE AT WISE",1,0,1999,"1930","19.023288","69","274","299",151,148,76,"36",40,0.2649,0.2432,0.2542,0.9164
"12872",233897,"UNIVERSITY OF VIRGINIA'S COLLEGE AT WISE",1,0,2000,"1930","20.973365","69","252","277",137,140,74,"22",52,0.3796,0.1571,0.2671,0.9097
"12873",233897,"UNIVERSITY OF VIRGINIA'S COLLEGE AT WISE",1,0,2001,"1885","22.278339","69","280","325",154,171,80,"36",44,0.2857,0.2105,0.2462,0.8615
"12874",233897,"UNIVERSITY OF VIRGINIA'S COLLEGE AT WISE",1,0,2002,"2055","24.525495","67","315","345",181,164,100,"34",66,0.3646,0.2073,0.2899,0.913
"12875",233897,"THE UNIVERSITY OF VIRGINIA'S COLLEGE AT WISE",1,0,2003,"2630","24.80859","76","296","349",177,172,109,"39",70,0.3955,0.2267,0.3123,0.8481
"12876",233897,"THE UNIVERSITY OF VIRGINIA'S COLLEGE AT WISE",1,0,2004,"2788","26.989531","74","336","373",180,193,130,"61",69,0.3833,0.3161,0.3485,0.9008
"12877",233897,"The University of Virginia's College at Wise",1,0,2005,"2984","28.233527","89","314","366",186,180,94,"27",67,0.3602,0.15,0.2568,0.8579
"12878",233897,"The University of Virginia's College at Wise",1,0,2006,"3252","30.62599","91","349","401",187,214,98,"45",53,0.2834,0.2103,0.2444,0.8703
"12879",233897,"The University of Virginia's College at Wise",1,0,2007,"3422","34.944334","95","332","401",184,217,97,"41",56,0.3043,0.1889,0.2419,0.8279
"12880",233897,"The University of Virginia's College at Wise",1,0,2008,"3482","43.365422","94","350","427",194,233,98,"42",56,0.2887,0.1803,0.2295,0.8197
"12881",233897,"The University of Virginia's College at Wise",1,0,2009,"3586","37.843073","93","314","397",172,225,87,"40",47,0.2733,0.1778,0.2191,0.7909
"12882",233897,"The University of Virginia's College at Wise",1,0,2010,"3910","40.639058","91","323","399",197,202,92,"33",59,0.2995,0.1634,0.2306,0.8095
"12883",233921,"VIRGINIA POLYTECHNIC INSTITUTE AND STATE UNIV",1,0,1991,"3304","449.499681","1468","3760","4407",1878,2529,1566,"697",869,0.4627,0.2756,0.3553,0.8532
"12884",233921,"VIRGINIA POLYTECHNIC INSTITUTE AND STATE UNIV",1,0,1992,"3538","465.13678","1452","3259","3851",1639,2212,1386,"603",783,0.4777,0.2726,0.3599,0.8463
"12885",233921,"VIRGINIA POLYTECHNIC INSTITUTE AND STATE UNIV",1,0,1993,"3812","471.171223","1485","3631","4270",1776,2494,1459,"620",839,0.4724,0.2486,0.3417,0.8504
"12886",233921,"VIRGINIA POLYTECHNIC INSTITUTE AND STATE UNIV",1,0,1995,"4087","516.546758","1424","4074","4687",2050,2637,1819,"745",1074,0.5239,0.2825,0.3881,0.8692
"12887",233921,"VIRGINIA POLYTECHNIC INSTITUTE AND STATE UNIV",1,0,1996,"4131","503.789277","1410","4377","5057",2061,2996,2120,"970",1150,0.558,0.3238,0.4192,0.8655
"12888",233921,"VIRGINIA POLYTECHNIC INSTITUTE AND STATE UNIV",1,0,1997,"4147","558.25447","1414","3910","4522",1818,2704,1903,"869",1034,0.5688,0.3214,0.4208,0.8647
"12889",233921,"VIRGINIA POLYTECHNIC INSTITUTE AND STATE UNIV",1,0,1998,"4305","585.915359","1209","3978","4638",1941,2697,1999,"855",1144,0.5894,0.317,0.431,0.8577
"12890",233921,"VIRGINIA POLYTECHNIC INSTITUTE AND STATE UNIV",1,0,1999,"2792","628.937812","1253","4020","4653",1957,2696,2177,"996",1181,0.6035,0.3694,0.4679,0.864
"12891",233921,"VIRGINIA POLYTECHNIC INSTITUTE AND STATE UNIV",1,0,2000,"2792","670.841623","1274","3878","4586",2024,2562,2339,"1047",1292,0.6383,0.4087,0.51,0.8456
"12892",233921,"VIRGINIA POLYTECHNIC INSTITUTE AND STATE UNIV",1,0,2001,"2792","710.281876","1295","3868","5020",2063,2957,2511,"1228",1283,0.6219,0.4153,0.5002,0.7705
"12893",233921,"VIRGINIA POLYTECHNIC INSTITUTE AND STATE UNIV",1,0,2002,"3044","706.133191","1301","3579","4714",2002,2712,2437,"1151",1286,0.6424,0.4244,0.517,0.7592
"12894",233921,"VIRGINIA POLYTECHNIC INSTITUTE AND STATE UNIV",1,0,2003,"4190","703.601849","1251","3635","4923",2092,2831,2588,"1213",1375,0.6573,0.4285,0.5257,0.7384
"12895",233921,"VIRGINIA POLYTECHNIC INSTITUTE AND STATE UNIV",1,0,2004,"4513","707.281787","1265","3613","4923",2042,2881,2599,"1252",1347,0.6596,0.4346,0.5279,0.7339
"12896",233921,"Virginia Polytechnic Institute and State University",1,0,2005,"4959","750.663387","1304","3697","5026",2190,2836,2797,"1296",1501,0.6854,0.457,0.5565,0.7356
"12897",233921,"Virginia Polytechnic Institute and State University",1,0,2006,"5450","826.337186","1340","3423","5078",2273,2805,2953,"1367",1586,0.6978,0.4873,0.5815,0.6741
"12898",233921,"Virginia Polytechnic Institute and State University",1,0,2007,"5772","896.176815","1371","3852","5112",2264,2848,3063,"1430",1633,0.7213,0.5021,0.5992,0.7535
"12899",233921,"Virginia Polytechnic Institute and State University",1,0,2008,"6332","957.835365","1369","4219","5449",2449,3000,3306,"1509",1797,0.7338,0.503,0.6067,0.7743
"12900",233921,"Virginia Polytechnic Institute and State University",1,0,2009,"6639","983.238767","1364","3885","5036",2266,2770,3075,"1446",1629,0.7189,0.522,0.6106,0.7714
"12901",233921,"Virginia Polytechnic Institute and State University",1,0,2010,"7309","982.778306","1306","4007","5193",2158,3035,3130,"1587",1543,0.715,0.5229,0.6027,0.7716
"12902",234030,"VIRGINIA COMMONWEALTH UNIVERSITY",1,0,1991,"3069","607.414864","780","896","1318",799,519,216,"65",151,0.189,0.1252,0.1639,0.6798
"12903",234030,"VIRGINIA COMMONWEALTH UNIVERSITY",1,0,1992,"3529","650.185045","768","994","1460",877,583,270,"92",178,0.203,0.1578,0.1849,0.6808
"12904",234030,"VIRGINIA COMMONWEALTH UNIVERSITY",1,0,1993,"3747","670.147718","784","1001","1466",874,592,281,"80",201,0.23,0.1351,0.1917,0.6828
"12905",234030,"VIRGINIA COMMONWEALTH UNIVERSITY",1,0,1995,"4030","726.923414","778","1001","1655",963,692,320,"104",216,0.2243,0.1503,0.1934,0.6048
"12906",234030,"VIRGINIA COMMONWEALTH UNIVERSITY",1,0,1996,"4071","745.763884","734","1102","1875",1146,729,352,"103",249,0.2173,0.1413,0.1877,0.5877
"12907",234030,"VIRGINIA COMMONWEALTH UNIVERSITY",1,0,1997,"4111","812.014757","770","1313","2175",1301,874,337,"106",231,0.1776,0.1213,0.1549,0.6037
"12908",234030,"VIRGINIA COMMONWEALTH UNIVERSITY",1,0,1998,"4182","444.620963","800","1359","2141",1257,884,364,"117",247,0.1965,0.1324,0.17,0.6348
"12909",234030,"VIRGINIA COMMONWEALTH UNIVERSITY",1,0,1999,"2492","473.136106","813","1476","2408",1427,981,499,"164",335,0.2348,0.1672,0.2072,0.613
"12910",234030,"VIRGINIA COMMONWEALTH UNIVERSITY",1,0,2000,"2492","491.315488","819.5","1684","2670",1608,1062,522,"161",361,0.2245,0.1516,0.1955,0.6307
"12911",234030,"VIRGINIA COMMONWEALTH UNIVERSITY",1,0,2001,"2492","509.566123","826","1682","2675",1563,1112,547,"170",377,0.2412,0.1529,0.2045,0.6288
"12912",234030,"VIRGINIA COMMONWEALTH UNIVERSITY",1,0,2002,"2716","510.071771","807","1893","3014",1810,1204,711,"237",474,0.2619,0.1968,0.2359,0.6281
"12913",234030,"VIRGINIA COMMONWEALTH UNIVERSITY",1,0,2003,"3600","499.789964","809","2006","3230",1912,1318,779,"218",561,0.2934,0.1654,0.2412,0.6211
"12914",234030,"VIRGINIA COMMONWEALTH UNIVERSITY",1,0,2004,"3780","518.035721","834","2051","3271",1960,1311,749,"220",529,0.2699,0.1678,0.229,0.627
"12915",234030,"Virginia Commonwealth University",1,0,2005,"4012","579.397262","868","1937","3432",2052,1380,904,"306",598,0.2914,0.2217,0.2634,0.5644
"12916",234030,"Virginia Commonwealth University",1,0,2006,"4270","656.133528","899","1811","3445",1986,1459,1018,"346",672,0.3384,0.2371,0.2955,0.5257
"12917",234030,"Virginia Commonwealth University",1,0,2007,"4525","706.062326","1085","1942","3802",2159,1643,1129,"405",724,0.3353,0.2465,0.2969,0.5108
"12918",234030,"Virginia Commonwealth University",1,0,2008,"4992","747.036697","1119","1858","3640",2128,1512,1227,"429",798,0.375,0.2837,0.3371,0.5104
"12919",234030,"Virginia Commonwealth University",1,0,2009,"5253","794.472993","1096","1814","3588",2094,1494,1318,"475",843,0.4026,0.3179,0.3673,0.5056
"12920",234030,"Virginia Commonwealth University",1,0,2010,"6953","787.456786","1106","1809","3533",2086,1447,1256,"445",811,0.3888,0.3075,0.3555,0.512
"12921",234085,"VIRGINIA MILITARY INSTITUTE",1,0,1991,"4325","29.372906","91","289","351",0,351,127,"127",0,NA,0.3618,0.3618,0.8234
"12922",234085,"VIRGINIA MILITARY INSTITUTE",1,0,1992,"4640","28.190817","94","296","349",0,349,174,"174",0,NA,0.4986,0.4986,0.8481
"12923",234085,"VIRGINIA MILITARY INSTITUTE",1,0,1993,"4940","28.403465","94","226","278",0,278,131,"131",0,NA,0.4712,0.4712,0.8129
"12924",234085,"VIRGINIA MILITARY INSTITUTE",1,0,1995,"5820","31.566316","100","283","335",0,335,182,"182",0,NA,0.5433,0.5433,0.8448
"12925",234085,"VIRGINIA MILITARY INSTITUTE",1,0,1996,"6050","32.850718","101","306","339",0,339,170,"170",0,NA,0.5015,0.5015,0.9027
"12926",234085,"VIRGINIA MILITARY INSTITUTE",1,0,1997,"6380","34.36657","103","322","394",20,374,201,"188",13,0.65,0.5027,0.5102,0.8173
"12927",234085,"VIRGINIA MILITARY INSTITUTE",1,0,1998,"6490","37.380572","95","322","375",23,352,180,"174",6,0.2609,0.4943,0.48,0.8587
"12928",234085,"VIRGINIA MILITARY INSTITUTE",1,0,1999,"2924","40.116321","98","304","369",24,345,194,"180",14,0.5833,0.5217,0.5257,0.8238
"12929",234085,"VIRGINIA MILITARY INSTITUTE",1,0,2000,"2924","44.348465","101","310","349",22,327,204,"189",15,0.6818,0.578,0.5845,0.8883
"12930",234085,"VIRGINIA MILITARY INSTITUTE",1,0,2001,"2924","47.880795","104","310","372",17,355,205,"196",9,0.5294,0.5521,0.5511,0.8333
"12931",234085,"VIRGINIA MILITARY INSTITUTE",1,0,2002,"3124","43.528655","102","310","356",24,332,209,"197",12,0.5,0.5934,0.5871,0.8708
"12932",234085,"VIRGINIA MILITARY INSTITUTE",1,0,2003,"3856","46.703116","106","330","384",36,348,246,"223",23,0.6389,0.6408,0.6406,0.8594
"12933",234085,"VIRGINIA MILITARY INSTITUTE",1,0,2004,"4050","49.6221","111","315","363",24,339,216,"205",11,0.4583,0.6047,0.595,0.8678
"12934",234085,"Virginia Military Institute",1,0,2005,"4382","52.049908","111","307","363",40,323,209,"187",22,0.55,0.5789,0.5758,0.8457
"12935",234085,"Virginia Military Institute",1,0,2006,"4776","56.843831","115","330","387",34,353,216,"200",16,0.4706,0.5666,0.5581,0.8527
"12936",234085,"Virginia Military Institute",1,0,2007,"5062","60.629342","116","334","410",36,374,240,"221",19,0.5278,0.5909,0.5854,0.8146
"12937",234085,"Virginia Military Institute",1,0,2008,"5262","100.999558","120","314","391",33,358,210,"192",18,0.5455,0.5363,0.5371,0.8031
"12938",234085,"Virginia Military Institute",1,0,2009,"5500","69.396826","121","360","429",42,387,261,"237",24,0.5714,0.6124,0.6084,0.8392
"12939",234085,"Virginia Military Institute",1,0,2010,"6024","69.483221","117","384","440",51,389,64,"27",37,0.7255,0.0694,0.1455,0.8727
"12940",234155,"VIRGINIA STATE UNIVERSITY",1,0,1991,"2668","53.03494","194","11","1161",692,469,107,"12",95,0.1373,0.0256,0.0922,0.0095
"12941",234155,"VIRGINIA STATE UNIVERSITY",1,0,1992,"2913","47.421389","188","13","911",496,415,46,"11",35,0.0706,0.0265,0.0505,0.0143
"12942",234155,"VIRGINIA STATE UNIVERSITY",1,0,1993,"3050","48.443341","191","12","695",409,286,88,"33",55,0.1345,0.1154,0.1266,0.0173
"12943",234155,"VIRGINIA STATE UNIVERSITY",1,0,1995,"3256","55.458246","171","10","734",431,303,131,"35",96,0.2227,0.1155,0.1785,0.0136
"12944",234155,"VIRGINIA STATE UNIVERSITY",1,0,1996,"3291","53.636044","165","6","782",465,317,186,"47",139,0.2989,0.1483,0.2379,0.0077
"12945",234155,"VIRGINIA STATE UNIVERSITY",1,0,1997,"3307","58.133939","168","11","865",493,372,170,"48",122,0.2475,0.129,0.1965,0.0127
"12946",234155,"VIRGINIA STATE UNIVERSITY",1,0,1998,"3439","60.910875","170","11","871",526,345,192,"48",144,0.2738,0.1391,0.2204,0.0126
"12947",234155,"VIRGINIA STATE UNIVERSITY",1,0,1999,"1588","62.928257","176","3","937",543,394,185,"48",137,0.2523,0.1218,0.1974,0.0032
"12948",234155,"VIRGINIA STATE UNIVERSITY",1,0,2000,"1588","71.656584","178","7","885",498,387,187,"45",142,0.2851,0.1163,0.2113,0.0079
"12949",234155,"VIRGINIA STATE UNIVERSITY",1,0,2001,"1588","84.333341","180","9","1085",618,467,252,"61",191,0.3091,0.1306,0.2323,0.0083
"12950",234155,"VIRGINIA STATE UNIVERSITY",1,0,2002,"1780","77.146445","207","9","1129",650,479,237,"60",177,0.2723,0.1253,0.2099,0.008
"12951",234155,"VIRGINIA STATE UNIVERSITY",1,0,2003,"2412","80.944385","207","7","959",563,396,240,"62",178,0.3162,0.1566,0.2503,0.0073
"12952",234155,"VIRGINIA STATE UNIVERSITY",1,0,2004,"2150","80.70791","214","7","1025",656,369,250,"54",196,0.2988,0.1463,0.2439,0.0068
"12953",234155,"Virginia State University",1,0,2005,"2317","89.014376","223","11","1176",775,401,234,"48",186,0.24,0.1197,0.199,0.0094
"12954",234155,"Virginia State University",1,0,2006,"3007","95.827352","238","5","869",540,329,209,"54",155,0.287,0.1641,0.2405,0.0058
"12955",234155,"Virginia State University",1,0,2007,"3186","108.297882","263","9","1185",796,389,259,"58",201,0.2525,0.1491,0.2186,0.0076
"12956",234155,"Virginia State University",1,0,2008,"3313","112.208049","254","22","1323",832,491,302,"64",238,0.2861,0.1303,0.2283,0.0166
"12957",234155,"Virginia State University",1,0,2009,"3584","122.111792","247","14","1225",806,419,353,"93",260,0.3226,0.222,0.2882,0.0114
"12958",234155,"Virginia State University",1,0,2010,"3886","125.376039","247","16","1282",802,480,307,"64",243,0.303,0.1333,0.2395,0.0125
"12959",234164,"VIRGINIA UNION UNIVERSITY",1,0,1991,"6153","14.920568","78","0","382",196,186,53,"9",44,0.2245,0.0484,0.1387,0
"12960",234164,"VIRGINIA UNION UNIVERSITY",1,0,1992,"6557","16.034138","76","0","449",238,211,45,"12",33,0.1387,0.0569,0.1002,0
"12961",234164,"VIRGINIA UNION UNIVERSITY",1,0,1993,"7061","17.534339","78","0","435",240,195,49,"15",34,0.1417,0.0769,0.1126,0
"12962",234164,"VIRGINIA UNION UNIVERSITY",1,0,1995,"8219","20.176516","74","1","441",234,207,2,"0",2,0.0085,0,0.0045,0.0023
"12963",234164,"VIRGINIA UNION UNIVERSITY",1,0,1996,"8590","20.975303","83","5","380",211,169,75,"16",59,0.2796,0.0947,0.1974,0.0132
"12964",234164,"VIRGINIA UNION UNIVERSITY",1,0,1997,"8980","17.230367","81","1","304",155,149,3,"1",2,0.0129,0.0067,0.0099,0.0033
"12965",234164,"VIRGINIA UNION UNIVERSITY",1,0,1998,"9110","17.813727","92","0","313",191,122,61,"15",46,0.2408,0.123,0.1949,0
"12966",234164,"VIRGINIA UNION UNIVERSITY",1,0,1999,"8780","19.293334","90","0","268",167,101,50,"8",42,0.2515,0.0792,0.1866,0
"12967",234164,"VIRGINIA UNION UNIVERSITY",1,0,2000,"8780","20.562091","83","3","456",265,191,69,"16",53,0.2,0.0838,0.1513,0.0066
"12968",234164,"VIRGINIA UNION UNIVERSITY",1,0,2001,"9640","21.492861","76","3","534",316,218,68,"12",56,0.1772,0.055,0.1273,0.0056
"12969",234164,"VIRGINIA UNION UNIVERSITY",1,0,2002,"16082","24.746765","84","3","437",259,178,74,"14",60,0.2317,0.0787,0.1693,0.0069
"12970",234164,"VIRGINIA UNION UNIVERSITY",1,0,2003,"10460","24.355352","84","5","512",318,194,99,"16",83,0.261,0.0825,0.1934,0.0098
"12971",234164,"VIRGINIA UNION UNIVERSITY",1,0,2004,"11090","25.947494","74","4","431",247,184,78,"17",61,0.247,0.0924,0.181,0.0093
"12972",234164,"Virginia Union University",1,0,2005,"11600","24.573759","74","4","356",197,159,57,"14",43,0.2183,0.0881,0.1601,0.0112
"12973",234164,"Virginia Union University",1,0,2006,"11948","23.39115","85","1","325",160,165,58,"13",45,0.2812,0.0788,0.1785,0.0031
"12974",234164,"Virginia Union University",1,0,2007,"12188","23.851325","74","2","375",209,166,81,"17",64,0.3062,0.1024,0.216,0.0053
"12975",234164,"Virginia Union University",1,0,2008,"12432","25.298897","62","0","345",170,175,48,"20",28,0.1647,0.1143,0.1391,0
"12976",234164,"Virginia Union University",1,0,2009,"12680","25.488849","87","0","554",303,251,99,"34",65,0.2145,0.1355,0.1787,0
"12977",234164,"Virginia Union University",1,0,2010,"13314","29.410034","88","0","460",260,200,76,"26",50,0.1923,0.13,0.1652,0
"12978",235097,"EASTERN WASHINGTON UNIVERSITY",0,1,1991,"1698","78.989946","358","611","730",421,309,114,"40",74,0.1758,0.1294,0.1562,0.837
"12979",235097,"EASTERN WASHINGTON UNIVERSITY",0,1,1992,"1785","82.181118","363","615","753",480,273,124,"38",86,0.1792,0.1392,0.1647,0.8167
"12980",235097,"EASTERN WASHINGTON UNIVERSITY",0,1,1993,"2091","88.375969","348","581","725",424,301,131,"45",86,0.2028,0.1495,0.1807,0.8014
"12981",235097,"EASTERN WASHINGTON UNIVERSITY",0,1,1995,"2463","90.675923","389","546","687",464,223,109,"18",91,0.1961,0.0807,0.1587,0.7948
"12982",235097,"EASTERN WASHINGTON UNIVERSITY",0,1,1996,"2445","93.498492","381","506","639",399,240,114,"29",85,0.213,0.1208,0.1784,0.7919
"12983",235097,"EASTERN WASHINGTON UNIVERSITY",0,1,1997,"2520","93.62107","349","512","624",367,257,86,"21",65,0.1771,0.0817,0.1378,0.8205
"12984",235097,"EASTERN WASHINGTON UNIVERSITY",0,1,1998,"2622","95.315132","348","637","816",486,330,148,"34",114,0.2346,0.103,0.1814,0.7806
"12985",235097,"EASTERN WASHINGTON UNIVERSITY",0,1,1999,"2700","100.939479","346","851","1072",652,420,164,"45",119,0.1825,0.1071,0.153,0.7938
"12986",235097,"EASTERN WASHINGTON UNIVERSITY",0,1,2000,"2790","110.328502","349","876","1085",642,443,227,"64",163,0.2539,0.1445,0.2092,0.8074
"12987",235097,"EASTERN WASHINGTON UNIVERSITY",0,1,2001,"2964","119.580469","352","939","1179",694,485,256,"98",158,0.2277,0.2021,0.2171,0.7964
"12988",235097,"EASTERN WASHINGTON UNIVERSITY",0,1,2002,"3357","121.810941","356","1003","1265",768,497,274,"84",190,0.2474,0.169,0.2166,0.7929
"12989",235097,"EASTERN WASHINGTON UNIVERSITY",0,1,2003,"3582","136.301648","371","948","1374",843,531,295,"81",214,0.2539,0.1525,0.2147,0.69
"12990",235097,"EASTERN WASHINGTON UNIVERSITY",0,1,2004,"3822","136.341306","396","999","1403",813,590,297,"102",195,0.2399,0.1729,0.2117,0.712
"12991",235097,"Eastern Washington University",0,1,2005,"4044","144.073663","411","1124","1610",992,618,340,"120",220,0.2218,0.1942,0.2112,0.6981
"12992",235097,"Eastern Washington University",0,1,2006,"4278","154.09943","424","941","1412",855,557,280,"84",196,0.2292,0.1508,0.1983,0.6664
"12993",235097,"Eastern Washington University",0,1,2007,"4805","168.057832","427","897","1313",770,543,243,"81",162,0.2104,0.1492,0.1851,0.6832
"12994",235097,"Eastern Washington University",0,1,2008,"4701","185.060428","427","1019","1488",859,629,295,"110",185,0.2154,0.1749,0.1983,0.6848
"12995",235097,"Eastern Washington University",0,1,2009,"5340","188.126013","410","940","1459",848,611,298,"98",200,0.2358,0.1604,0.2042,0.6443
"12996",235097,"Eastern Washington University",0,1,2010,"6063","181.634153","410","1035","1524",887,637,324,"109",215,0.2424,0.1711,0.2126,0.6791
"12997",235167,"EVERGREEN STATE COLLEGE",0,1,1991,"1758","38.920261","160","348","445",263,182,173,"59",114,0.4335,0.3242,0.3888,0.782
"12998",235167,"EVERGREEN STATE COLLEGE",0,1,1992,"1785","38.664965","157","313","399",239,160,116,"39",77,0.3222,0.2438,0.2907,0.7845
"12999",235167,"EVERGREEN STATE COLLEGE",0,1,1993,"1971","42.528437","154","335","435",253,182,158,"63",95,0.3755,0.3462,0.3632,0.7701
"13000",235167,"EVERGREEN STATE COLLEGE",0,1,1995,"2442","44.675136","154","396","536",318,218,224,"88",136,0.4277,0.4037,0.4179,0.7388
"13001",235167,"EVERGREEN STATE COLLEGE",0,1,1996,"2544","44.029327","151","407","530",308,222,200,"74",126,0.4091,0.3333,0.3774,0.7679
"13002",235167,"EVERGREEN STATE COLLEGE",0,1,1997,"2573","47.930222","153","340","494",271,223,186,"71",115,0.4244,0.3184,0.3765,0.6883
"13003",235167,"EVERGREEN STATE COLLEGE",0,1,1998,"2637","49.182542","156","348","475",280,195,185,"65",120,0.4286,0.3333,0.3895,0.7326
"13004",235167,"EVERGREEN STATE COLLEGE",0,1,1999,"2757","52.383525","165","323","456",256,200,190,"69",121,0.4727,0.345,0.4167,0.7083
"13005",235167,"EVERGREEN STATE COLLEGE",0,1,2000,"2856","57.789578","162","333","468",254,214,208,"81",127,0.5,0.3785,0.4444,0.7115
"13006",235167,"EVERGREEN STATE COLLEGE",0,1,2001,"3024","63.527638","159","347","460",236,224,206,"93",113,0.4788,0.4152,0.4478,0.7543
"13007",235167,"EVERGREEN STATE COLLEGE",0,1,2002,"3441","80.374414","161","361","486",236,250,250,"133",117,0.4958,0.532,0.5144,0.7428
"13008",235167,"EVERGREEN STATE COLLEGE",0,1,2003,"3651","74.67742","157","308","454",246,208,193,"98",95,0.3862,0.4712,0.4251,0.6784
"13009",235167,"EVERGREEN STATE COLLEGE",0,1,2004,"3900","100.320059","160","333","479",250,229,185,"87",98,0.392,0.3799,0.3862,0.6952
"13010",235167,"The Evergreen State College",0,1,2005,"4128","81.343161","158","429","590",296,294,243,"114",129,0.4358,0.3878,0.4119,0.7271
"13011",235167,"The Evergreen State College",0,1,2006,"4371","86.175289","158","414","577",300,277,227,"103",124,0.4133,0.3718,0.3934,0.7175
"13012",235167,"The Evergreen State College",0,1,2007,"4590","87.767019","158","488","677",347,330,288,"138",150,0.4323,0.4182,0.4254,0.7208
"13013",235167,"The Evergreen State College",0,1,2008,"4797","90.310143","164","498","658",321,337,302,"146",156,0.486,0.4332,0.459,0.7568
"13014",235167,"The Evergreen State College",0,1,2009,"5412","93.827918","169","408","576",284,292,234,"112",122,0.4296,0.3836,0.4062,0.7083
"13015",235167,"The Evergreen State College",0,1,2010,"6108","94.563259","169","431","612",332,280,265,"118",147,0.4428,0.4214,0.433,0.7042
"13016",236230,"PACIFIC LUTHERAN UNIVERSITY",1,0,1991,"11075","49.086886","225","432","489",291,198,215,"63",152,0.5223,0.3182,0.4397,0.8834
"13017",236230,"PACIFIC LUTHERAN UNIVERSITY",1,0,1992,"11968","50.347564","225","441","500",295,205,214,"69",145,0.4915,0.3366,0.428,0.882
"13018",236230,"PACIFIC LUTHERAN UNIVERSITY",1,0,1993,"12672","53.213086","229","437","499",269,230,228,"90",138,0.513,0.3913,0.4569,0.8758
"13019",236230,"PACIFIC LUTHERAN UNIVERSITY",1,0,1995,"13856","59.333301","229","571","667",394,273,264,"81",183,0.4645,0.2967,0.3958,0.8561
"13020",236230,"PACIFIC LUTHERAN UNIVERSITY",1,0,1996,"14560","59.557568","232","523","610",359,251,284,"97",187,0.5209,0.3865,0.4656,0.8574
"13021",236230,"PACIFIC LUTHERAN UNIVERSITY",1,0,1997,"15316","50.449246","231","551","660",394,266,303,"87",216,0.5482,0.3271,0.4591,0.8348
"13022",236230,"PACIFIC LUTHERAN UNIVERSITY",1,0,1998,"15680","52.386087","229","541","652",414,238,272,"77",195,0.471,0.3235,0.4172,0.8298
"13023",236230,"PACIFIC LUTHERAN UNIVERSITY",1,0,1999,"16224","57.235901","234","455","562",370,192,241,"77",164,0.4432,0.401,0.4288,0.8096
"13024",236230,"PACIFIC LUTHERAN UNIVERSITY",1,0,2000,"16800","59.912805","230","495","580",355,225,293,"94",199,0.5606,0.4178,0.5052,0.8534
"13025",236230,"PACIFIC LUTHERAN UNIVERSITY",1,0,2001,"17728","63.637383","226","483","578",348,230,287,"89",198,0.569,0.387,0.4965,0.8356
"13026",236230,"PACIFIC LUTHERAN UNIVERSITY",1,0,2002,"18500","67.566586","214","508","625",400,225,325,"98",227,0.5675,0.4356,0.52,0.8128
"13027",236230,"PACIFIC LUTHERAN UNIVERSITY",1,0,2003,"19610","68.258823","228","556","693",426,267,361,"118",243,0.5704,0.4419,0.5209,0.8023
"13028",236230,"PACIFIC LUTHERAN UNIVERSITY",1,0,2004,"20790","71.500034","237","540","697",462,235,327,"96",231,0.5,0.4085,0.4692,0.7747
"13029",236230,"Pacific Lutheran University",1,0,2005,"22040","76.365171","202","550","687",432,255,340,"106",234,0.5417,0.4157,0.4949,0.8006
"13030",236230,"Pacific Lutheran University",1,0,2006,"23450","83.130638","220","517","668",418,250,401,"142",259,0.6196,0.568,0.6003,0.774
"13031",236230,"Pacific Lutheran University",1,0,2007,"25088","85.945318","235","533","714",453,261,394,"134",260,0.574,0.5134,0.5518,0.7465
"13032",236230,"Pacific Lutheran University",1,0,2008,"26800","91.654353","211","553","712",444,268,372,"115",257,0.5788,0.4291,0.5225,0.7767
"13033",236230,"Pacific Lutheran University",1,0,2009,"28100","94.11123","206","557","712",436,276,373,"123",250,0.5734,0.4457,0.5239,0.7823
"13034",236230,"Pacific Lutheran University",1,0,2010,"29200","94.935509","209","512","687",415,272,398,"141",257,0.6193,0.5184,0.5793,0.7453
"13035",236328,"UNIVERSITY OF PUGET SOUND",1,0,1991,"12690","61.499","173","531","696",395,301,401,"162",239,0.6051,0.5382,0.5761,0.7629
"13036",236328,"UNIVERSITY OF PUGET SOUND",1,0,1992,"13780","67.156","173","557","725",446,279,433,"166",267,0.5987,0.595,0.5972,0.7683
"13037",236328,"UNIVERSITY OF PUGET SOUND",1,0,1993,"15220","71.585","175","518","687",402,285,402,"159",243,0.6045,0.5579,0.5852,0.754
"13038",236328,"UNIVERSITY OF PUGET SOUND",1,0,1995,"17310","68.566","178","494","656",374,282,404,"162",242,0.6471,0.5745,0.6159,0.753
"13039",236328,"UNIVERSITY OF PUGET SOUND",1,0,1996,"18030","75.603","177","525","740",445,295,459,"171",288,0.6472,0.5797,0.6203,0.7095
"13040",236328,"UNIVERSITY OF PUGET SOUND",1,0,1997,"18940","57.945","178","492","642",390,252,430,"155",275,0.7051,0.6151,0.6698,0.7664
"13041",236328,"UNIVERSITY OF PUGET SOUND",1,0,1998,"19795","58.716001","181","525","680",417,263,446,"151",295,0.7074,0.5741,0.6559,0.7721
"13042",236328,"UNIVERSITY OF PUGET SOUND",1,0,1999,"20450","60.73","211","528","682",413,269,443,"170",273,0.661,0.632,0.6496,0.7742
"13043",236328,"UNIVERSITY OF PUGET SOUND",1,0,2000,"21270","63.691","215.5","474","647",408,239,442,"155",287,0.7034,0.6485,0.6832,0.7326
"13044",236328,"UNIVERSITY OF PUGET SOUND",1,0,2001,"22350","66.973","220","562","702",423,279,477,"182",295,0.6974,0.6523,0.6795,0.8006
"13045",236328,"UNIVERSITY OF PUGET SOUND",1,0,2002,"23780","69.136","218","531","666",399,267,459,"173",286,0.7168,0.6479,0.6892,0.7973
"13046",236328,"UNIVERSITY OF PUGET SOUND",1,0,2003,"25190","65.912","235","483","639",358,281,438,"164",274,0.7654,0.5836,0.6854,0.7559
"13047",236328,"UNIVERSITY OF PUGET SOUND",1,0,2004,"26700","77.023","232","513","671",390,281,471,"190",281,0.7205,0.6762,0.7019,0.7645
"13048",236328,"University of Puget Sound",1,0,2005,"28270","79.025","237","497","669",385,284,446,"180",266,0.6909,0.6338,0.6667,0.7429
"13049",236328,"University of Puget Sound",1,0,2006,"29870","82.554","238","522","677",406,271,464,"173",291,0.7167,0.6384,0.6854,0.771
"13050",236328,"University of Puget Sound",1,0,2007,"31700","87.405","238","473","641",393,248,437,"157",280,0.7125,0.6331,0.6817,0.7379
"13051",236328,"University of Puget Sound",1,0,2008,"33780","94.397","236","540","676",377,299,459,"187",272,0.7215,0.6254,0.679,0.7988
"13052",236328,"University of Puget Sound",1,0,2009,"35440","99.995","230","547","719",419,300,517,"198",319,0.7613,0.66,0.7191,0.7608
"13053",236328,"University of Puget Sound",1,0,2010,"37030","100.85","233","495","625",355,270,436,"168",268,0.7549,0.6222,0.6976,0.792
"13054",236577,"SEATTLE PACIFIC UNIVERSITY",0,1,1991,"10581","41.906","141","311","370",253,117,95,"27",68,0.2688,0.2308,0.2568,0.8405
"13055",236577,"SEATTLE PACIFIC UNIVERSITY",0,1,1992,"11301","42.506","144","316","380",253,127,103,"24",79,0.3123,0.189,0.2711,0.8316
"13056",236577,"SEATTLE PACIFIC UNIVERSITY",0,1,1993,"11979","45.187","144","346","395",263,132,117,"42",75,0.2852,0.3182,0.2962,0.8759
"13057",236577,"SEATTLE PACIFIC UNIVERSITY",0,1,1995,"13479","51.013","138","340","397",254,143,138,"58",80,0.315,0.4056,0.3476,0.8564
"13058",236577,"SEATTLE PACIFIC UNIVERSITY",0,1,1996,"13680","53.288","140","421","465",323,142,173,"52",121,0.3746,0.3662,0.372,0.9054
"13059",236577,"SEATTLE PACIFIC UNIVERSITY",0,1,1997,"14130","43.01","138","496","584",392,192,233,"63",170,0.4337,0.3281,0.399,0.8493
"13060",236577,"SEATTLE PACIFIC UNIVERSITY",0,1,1998,"14541","43.862","145","506","582",376,206,232,"75",157,0.4176,0.3641,0.3986,0.8694
"13061",236577,"SEATTLE PACIFIC UNIVERSITY",0,1,1999,"14924","46.75","152","490","567",392,175,272,"79",193,0.4923,0.4514,0.4797,0.8642
"13062",236577,"SEATTLE PACIFIC UNIVERSITY",0,1,2000,"15381","50.686","162.5","532","612",413,199,293,"90",203,0.4915,0.4523,0.4788,0.8693
"13063",236577,"SEATTLE PACIFIC UNIVERSITY",0,1,2001,"16335","55.309","173","565","645",433,212,327,"95",232,0.5358,0.4481,0.507,0.876
"13064",236577,"SEATTLE PACIFIC UNIVERSITY",0,1,2002,"17592","59.892","168","519","601",412,189,302,"94",208,0.5049,0.4974,0.5025,0.8636
"13065",236577,"SEATTLE PACIFIC UNIVERSITY",0,1,2003,"18822","65.212","169","599","683",485,198,410,"105",305,0.6289,0.5303,0.6003,0.877
"13066",236577,"SEATTLE PACIFIC UNIVERSITY",0,1,2004,"20139","69.028","177","497","633",414,219,341,"115",226,0.5459,0.5251,0.5387,0.7852
"13067",236577,"Seattle Pacific University",0,1,2005,"21447","71.916","178","596","710",490,220,425,"123",302,0.6163,0.5591,0.5986,0.8394
"13068",236577,"Seattle Pacific University",0,1,2006,"23055","74.09","183","514","622",413,209,350,"111",239,0.5787,0.5311,0.5627,0.8264
"13069",236577,"Seattle Pacific University",0,1,2007,"24783","77.467","187","548","716",499,217,390,"110",280,0.5611,0.5069,0.5447,0.7654
"13070",236577,"Seattle Pacific University",0,1,2008,"26457","87.772","190","563","712",492,220,431,"122",309,0.628,0.5545,0.6053,0.7907
"13071",236577,"Seattle Pacific University",0,1,2009,"27450","85.067","195","484","682",489,193,361,"93",268,0.5481,0.4819,0.5293,0.7097
"13072",236577,"Seattle Pacific University",0,1,2010,"28602","87.605","201","549","726",501,225,405,"120",285,0.5689,0.5333,0.5579,0.7562
"13073",236595,"SEATTLE UNIVERSITY",0,1,1991,"10710","52.071957","186","218","390",229,161,133,"51",82,0.3581,0.3168,0.341,0.559
"13074",236595,"SEATTLE UNIVERSITY",0,1,1992,"11520","61.774622","211","231","439",236,203,161,"74",87,0.3686,0.3645,0.3667,0.5262
"13075",236595,"SEATTLE UNIVERSITY",0,1,1993,"12150","67.39984","237","309","489",276,213,165,"61",104,0.3768,0.2864,0.3374,0.6319
"13076",236595,"SEATTLE UNIVERSITY",0,1,1995,"13635","89.343376","293","235","426",245,181,165,"56",109,0.4449,0.3094,0.3873,0.5516
"13077",236595,"SEATTLE UNIVERSITY",0,1,1996,"14265","93.234744","288","319","576",358,218,245,"78",167,0.4665,0.3578,0.4253,0.5538
"13078",236595,"SEATTLE UNIVERSITY",0,1,1997,"14805","79.508045","288","278","499",288,211,220,"78",142,0.4931,0.3697,0.4409,0.5571
"13079",236595,"SEATTLE UNIVERSITY",0,1,1998,"15255","82.08868","303","335","626",369,257,287,"114",173,0.4688,0.4436,0.4585,0.5351
"13080",236595,"SEATTLE UNIVERSITY",0,1,1999,"16110","85.295099","311","300","578",351,227,256,"92",164,0.4672,0.4053,0.4429,0.519
"13081",236595,"SEATTLE UNIVERSITY",0,1,2000,"17010","90.230947","321","353","664",428,236,338,"104",234,0.5467,0.4407,0.509,0.5316
"13082",236595,"SEATTLE UNIVERSITY",0,1,2001,"17865","98.184132","331","358","643",412,231,321,"101",220,0.534,0.4372,0.4992,0.5568
"13083",236595,"SEATTLE UNIVERSITY",0,1,2002,"18885","108.236841","312","341","633",387,246,324,"110",214,0.553,0.4472,0.5118,0.5387
"13084",236595,"SEATTLE UNIVERSITY",0,1,2003,"20070","115.19906","312","330","619",418,201,323,"75",248,0.5933,0.3731,0.5218,0.5331
"13085",236595,"SEATTLE UNIVERSITY",0,1,2004,"21285","126.257767","354","404","719",447,272,407,"138",269,0.6018,0.5074,0.5661,0.5619
"13086",236595,"Seattle University",0,1,2005,"22905","134.303649","355","425","739",454,285,422,"156",266,0.5859,0.5474,0.571,0.5751
"13087",236595,"Seattle University",0,1,2006,"24615","146.505081","360","394","731",463,268,455,"165",290,0.6263,0.6157,0.6224,0.539
"13088",236595,"Seattle University",0,1,2007,"26325","157.632461","406","399","736",479,257,432,"127",305,0.6367,0.4942,0.587,0.5421
"13089",236595,"Seattle University",0,1,2008,"28260","166.906979","413","522","881",557,324,530,"170",360,0.6463,0.5247,0.6016,0.5925
"13090",236595,"Seattle University",0,1,2009,"29340","173.232063","393","375","730",459,271,468,"156",312,0.6797,0.5756,0.6411,0.5137
"13091",236595,"Seattle University",0,1,2010,"30825","175.03125","423","566","1037",660,377,667,"232",435,0.6591,0.6154,0.6432,0.5458
"13092",236896,"WALLA WALLA COLLEGE",0,1,1991,"9089","22.196755","107","231","282",132,150,55,"26",29,0.2197,0.1733,0.195,0.8191
"13093",236896,"WALLA WALLA COLLEGE",0,1,1992,"9666","24.127737","112","205","267",126,141,58,"27",31,0.246,0.1915,0.2172,0.7678
"13094",236896,"WALLA WALLA COLLEGE",0,1,1993,"10200","25.715262","117","219","263",138,125,70,"29",41,0.2971,0.232,0.2662,0.8327
"13095",236896,"WALLA WALLA COLLEGE",0,1,1995,"12140","26.053053","121","262","288",145,143,57,"22",35,0.2414,0.1538,0.1979,0.9097
"13096",236896,"WALLA WALLA COLLEGE",0,1,1996,"12033","30.695063","125","263","292",144,148,40,"18",22,0.1528,0.1216,0.137,0.9007
"13097",236896,"WALLA WALLA COLLEGE",0,1,1997,"12588","31.489817","135","244","283",142,141,62,"29",33,0.2324,0.2057,0.2191,0.8622
"13098",236896,"WALLA WALLA COLLEGE",0,1,1998,"13854","27.175246","135","274","305",165,140,60,"27",33,0.2,0.1929,0.1967,0.8984
"13099",236896,"WALLA WALLA COLLEGE",0,1,1999,"14601","27.636555","128","275","323",158,165,64,"28",36,0.2278,0.1697,0.1981,0.8514
"13100",236896,"WALLA WALLA COLLEGE",0,1,2000,"15303","30.017582","132.5","289","338",160,178,62,"25",37,0.2312,0.1404,0.1834,0.855
"13101",236896,"WALLA WALLA COLLEGE",0,1,2001,"16107","32.483816","137","248","285",149,136,63,"26",37,0.2483,0.1912,0.2211,0.8702
"13102",236896,"WALLA WALLA COLLEGE",0,1,2002,"16134","33.885712","133","282","336",172,164,61,"29",32,0.186,0.1768,0.1815,0.8393
"13103",236896,"WALLA WALLA COLLEGE",0,1,2003,"16860","35.387757","135","265","326",157,169,66,"31",35,0.2229,0.1834,0.2025,0.8129
"13104",236896,"WALLA WALLA COLLEGE",0,1,2004,"17655","39.864243","140","279","352",173,179,83,"33",50,0.289,0.1844,0.2358,0.7926
"13105",236896,"Walla Walla College",0,1,2005,"18696","38.275163","138","229","292",132,160,62,"34",28,0.2121,0.2125,0.2123,0.7842
"13106",236896,"Walla Walla College",0,1,2006,"19725","40.942781","133","238","323",164,159,62,"28",34,0.2073,0.1761,0.192,0.7368
"13107",236896,"Walla Walla University",0,1,2007,"20910","42.053249","126","263","344",162,182,58,"25",33,0.2037,0.1374,0.1686,0.7645
"13108",236896,"Walla Walla University",0,1,2008,"21726","43.424496","127","224","310",158,152,63,"24",39,0.2468,0.1579,0.2032,0.7226
"13109",236896,"Walla Walla University",0,1,2009,"22575","44.55942","118","241","316",157,159,59,"20",39,0.2484,0.1258,0.1867,0.7627
"13110",236896,"Walla Walla University",0,1,2010,"23229","43.139411","119","243","305",151,154,72,"35",37,0.245,0.2273,0.2361,0.7967
"13111",236939,"WASHINGTON STATE UNIVERSITY",1,0,1991,"2178","347.496606","973","1544","1852",982,870,470,"171",299,0.3045,0.1966,0.2538,0.8337
"13112",236939,"WASHINGTON STATE UNIVERSITY",1,0,1992,"2254","360.897245","962","1703","2027",1019,1008,527,"212",315,0.3091,0.2103,0.26,0.8402
"13113",236939,"WASHINGTON STATE UNIVERSITY",1,0,1993,"2532","374.000966","965","2000","2431",1234,1197,644,"235",409,0.3314,0.1963,0.2649,0.8227
"13114",236939,"WASHINGTON STATE UNIVERSITY",1,0,1995,"3022","408.167981","983","2022","2512",1217,1295,734,"315",419,0.3443,0.2432,0.2922,0.8049
"13115",236939,"WASHINGTON STATE UNIVERSITY",1,0,1996,"3142","438.01062","1004","1828","2272",1169,1103,694,"263",431,0.3687,0.2384,0.3055,0.8046
"13116",236939,"WASHINGTON STATE UNIVERSITY",1,0,1997,"3266","454.107002","1000","1791","2276",1191,1085,657,"235",422,0.3543,0.2166,0.2887,0.7869
"13117",236939,"WASHINGTON STATE UNIVERSITY",1,0,1998,"3396","467.667717","1006","2353","2934",1526,1408,888,"335",553,0.3624,0.2379,0.3027,0.802
"13118",236939,"WASHINGTON STATE UNIVERSITY",1,0,1999,"3233","472.95475","980","2042","2456",1276,1180,791,"306",485,0.3801,0.2593,0.3221,0.8314
"13119",236939,"WASHINGTON STATE UNIVERSITY",1,0,2000,"3351","497.814989","985.5","1982","2440",1257,1183,794,"277",517,0.4113,0.2342,0.3254,0.8123
"13120",236939,"WASHINGTON STATE UNIVERSITY",1,0,2001,"3574","542.695662","991","2044","2575",1369,1206,852,"314",538,0.393,0.2604,0.3309,0.7938
"13121",236939,"WASHINGTON STATE UNIVERSITY",1,0,2002,"4145","606.172643","1013","2139","2771",1469,1302,1018,"372",646,0.4398,0.2857,0.3674,0.7719
"13122",236939,"WASHINGTON STATE UNIVERSITY",1,0,2003,"4435","615.532567","1018","2355","2997",1613,1384,1204,"417",787,0.4879,0.3013,0.4017,0.7858
"13123",236939,"WASHINGTON STATE UNIVERSITY",1,0,2004,"4745","642.457502","1016","2398","3089",1622,1467,1251,"495",756,0.4661,0.3374,0.405,0.7763
"13124",236939,"Washington State University",1,0,2005,"5077","679.157967","1028","2301","2855",1418,1437,1072,"413",659,0.4647,0.2874,0.3755,0.806
"13125",236939,"Washington State University",1,0,2006,"5432","714.504144","1049","2108","2676",1349,1327,1040,"417",623,0.4618,0.3142,0.3886,0.7877
"13126",236939,"Washington State University",1,0,2007,"5812","744.406851","1118","2468","3184",1588,1596,1275,"508",767,0.483,0.3183,0.4004,0.7751
"13127",236939,"Washington State University",1,0,2008,"6218","831.103756","1215","2610","3391",1744,1647,1408,"536",872,0.5,0.3254,0.4152,0.7697
"13128",236939,"Washington State University",1,0,2009,"7088","841.37936","1166","2665","3627",1888,1739,1366,"549",817,0.4327,0.3157,0.3766,0.7348
"13129",236939,"Washington State University",1,0,2010,"8080","845.005761","1182","2276","3241",1634,1607,1327,"525",802,0.4908,0.3267,0.4094,0.7023
"13130",236948,"UNIVERSITY OF WASHINGTON",0,1,1991,"2178","1065.914","1890","2295","3484",1788,1696,1287,"482",805,0.4502,0.2842,0.3694,0.6587
"13131",236948,"UNIVERSITY OF WASHINGTON",0,1,1992,"2253","1135.659","1883","2282","3509",1769,1740,1315,"517",798,0.4511,0.2971,0.3748,0.6503
"13132",236948,"UNIVERSITY OF WASHINGTON",0,1,1993,"2532","1259.487","1906","2084","3206",1576,1630,1217,"515",702,0.4454,0.316,0.3796,0.65
"13133",236948,"UNIVERSITY OF WASHINGTON",0,1,1995,"3019","1408.205","1855","2182","3500",1783,1717,1405,"562",843,0.4728,0.3273,0.4014,0.6234
"13134",236948,"UNIVERSITY OF WASHINGTON",0,1,1996,"3250","1458.911","1858","2227","3789",1964,1825,1613,"648",965,0.4913,0.3551,0.4257,0.5878
"13135",236948,"UNIVERSITY OF WASHINGTON",0,1,1997,"3366","1528.754","1861","2438","4346",2270,2076,1734,"667",1067,0.47,0.3213,0.399,0.561
"13136",236948,"UNIVERSITY OF WASHINGTON",0,1,1998,"3495","1626.574","1900","2172","4038",2076,1962,1716,"718",998,0.4807,0.366,0.425,0.5379
"13137",236948,"UNIVERSITY OF WASHINGTON-SEATTLE CAMPUS",0,1,1999,"3251","1825.467","1930","2303","4319",2279,2040,1977,"790",1187,0.5208,0.3873,0.4577,0.5332
"13138",236948,"UNIVERSITY OF WASHINGTON-SEATTLE CAMPUS",0,1,2000,"3638","1956.961","2684","2632","4765",2495,2270,2271,"926",1345,0.5391,0.4079,0.4766,0.5524
"13139",236948,"UNIVERSITY OF WASHINGTON-SEATTLE CAMPUS",0,1,2001,"3593","2151.293","3438","2693","5288",2737,2551,2555,"1099",1456,0.532,0.4308,0.4832,0.5093
"13140",236948,"UNIVERSITY OF WASHINGTON-SEATTLE CAMPUS",0,1,2002,"4167","2276.752668","2009","2615","4776",2561,2215,2450,"1039",1411,0.551,0.4691,0.513,0.5475
"13141",236948,"UNIVERSITY OF WASHINGTON-SEATTLE CAMPUS",0,1,2003,"4458","2420.594261","1768","2652","4948",2654,2294,2665,"1106",1559,0.5874,0.4821,0.5386,0.536
"13142",236948,"UNIVERSITY OF WASHINGTON-SEATTLE CAMPUS",0,1,2004,"4770","2560.18579","1787","2614","4867",2639,2228,2625,"1075",1550,0.5873,0.4825,0.5393,0.5371
"13143",236948,"University of Washington-Seattle Campus",0,1,2005,"5103","2730.036873","1947","2641","4892",2622,2270,2883,"1209",1674,0.6384,0.5326,0.5893,0.5399
"13144",236948,"University of Washington-Seattle Campus",0,1,2006,"5460","2889.526814","1978","2845","5284",2800,2484,2939,"1245",1694,0.605,0.5012,0.5562,0.5384
"13145",236948,"University of Washington-Seattle Campus",0,1,2007,"5842","3045.886326","1852","2697","5163",2771,2392,2968,"1213",1755,0.6333,0.5071,0.5749,0.5224
"13146",236948,"University of Washington-Seattle Campus",0,1,2008,"6250","3242.807934","1881","2762","5377",2896,2481,3296,"1351",1945,0.6716,0.5445,0.613,0.5137
"13147",236948,"University of Washington-Seattle Campus",0,1,2009,"7125","3473.693012","1839","2400","5119",2795,2324,3227,"1338",1889,0.6758,0.5757,0.6304,0.4688
"13148",236948,"University of Washington-Seattle Campus",0,1,2010,"8122","3535.634308","1880","2506","5460",2917,2543,3525,"1504",2021,0.6928,0.5914,0.6456,0.459
"13149",237011,"WESTERN WASHINGTON UNIVERSITY",0,1,1991,"1698","94.586815","410","1332","1547",921,626,288,"86",202,0.2193,0.1374,0.1862,0.861
"13150",237011,"WESTERN WASHINGTON UNIVERSITY",0,1,1992,"1785","103.772155","408","1208","1455",883,572,341,"98",243,0.2752,0.1713,0.2344,0.8302
"13151",237011,"WESTERN WASHINGTON UNIVERSITY",0,1,1993,"2120","110.6988","385","1231","1542",941,601,365,"91",274,0.2912,0.1514,0.2367,0.7983
"13152",237011,"WESTERN WASHINGTON UNIVERSITY",0,1,1995,"2523","114.125219","397","1379","1745",1105,640,457,"120",337,0.305,0.1875,0.2619,0.7903
"13153",237011,"WESTERN WASHINGTON UNIVERSITY",0,1,1996,"2613","119.198546","414","1596","2026",1177,849,507,"176",331,0.2812,0.2073,0.2502,0.7878
"13154",237011,"WESTERN WASHINGTON UNIVERSITY",0,1,1997,"2526","127.45432","433","1606","2068",1266,802,601,"176",425,0.3357,0.2195,0.2906,0.7766
"13155",237011,"WESTERN WASHINGTON UNIVERSITY",0,1,1998,"2622","136.013835","433","1629","2104",1221,883,623,"202",421,0.3448,0.2288,0.2961,0.7742
"13156",237011,"WESTERN WASHINGTON UNIVERSITY",0,1,1999,"2737","140.621417","443","1749","2074",1264,810,623,"172",451,0.3568,0.2123,0.3004,0.8433
"13157",237011,"WESTERN WASHINGTON UNIVERSITY",0,1,2000,"2832","149.58334","445.5","2013","2351",1427,924,692,"212",480,0.3364,0.2294,0.2943,0.8562
"13158",237011,"WESTERN WASHINGTON UNIVERSITY",0,1,2001,"3015","161.185271","448","1755","2205",1284,921,641,"207",434,0.338,0.2248,0.2907,0.7959
"13159",237011,"WESTERN WASHINGTON UNIVERSITY",0,1,2002,"3408","165.92035","455","1768","2213",1290,923,761,"225",536,0.4155,0.2438,0.3439,0.7989
"13160",237011,"WESTERN WASHINGTON UNIVERSITY",0,1,2003,"3639","183.107443","453","1789","2194",1266,928,778,"233",545,0.4305,0.2511,0.3546,0.8154
"13161",237011,"WESTERN WASHINGTON UNIVERSITY",0,1,2004,"3885","179.356499","457","1922","2425",1405,1020,876,"287",589,0.4192,0.2814,0.3612,0.7926
"13162",237011,"Western Washington University",0,1,2005,"4113","191.826674","489","1856","2365",1364,1001,943,"302",641,0.4699,0.3017,0.3987,0.7848
"13163",237011,"Western Washington University",0,1,2006,"4356","202.259478","485","1902","2425",1397,1028,850,"293",557,0.3987,0.285,0.3505,0.7843
"13164",237011,"Western Washington University",0,1,2007,"4568","218.845743","520","1949","2572",1484,1088,970,"324",646,0.4353,0.2978,0.3771,0.7578
"13165",237011,"Western Washington University",0,1,2008,"4788","230.071905","522","2018","2667",1560,1107,1057,"328",729,0.4673,0.2963,0.3963,0.7567
"13166",237011,"Western Washington University",0,1,2009,"5397","236.052915","513","2015","2670",1521,1149,1062,"369",693,0.4556,0.3211,0.3978,0.7547
"13167",237011,"Western Washington University",0,1,2010,"6081","241.845757","504","2061","2722",1614,1108,1077,"345",732,0.4535,0.3114,0.3957,0.7572
"13168",237057,"WHITMAN COLLEGE",1,0,1991,"13110","26.922522","104","269","319",167,152,201,"82",119,0.7126,0.5395,0.6301,0.8433
"13169",237057,"WHITMAN COLLEGE",1,0,1992,"14360","26.674126","99","285","336",167,169,218,"104",114,0.6826,0.6154,0.6488,0.8482
"13170",237057,"WHITMAN COLLEGE",1,0,1993,"15650","30.552234","93","289","341",196,145,249,"102",147,0.75,0.7034,0.7302,0.8475
"13171",237057,"WHITMAN COLLEGE",1,0,1995,"17630","39.253001","100","306","369",189,180,247,"119",128,0.6772,0.6611,0.6694,0.8293
"13172",237057,"WHITMAN COLLEGE",1,0,1996,"18650","39.534507","98","295","355",207,148,274,"111",163,0.7874,0.75,0.7718,0.831
"13173",237057,"WHITMAN COLLEGE",1,0,1997,"19580","30.893568","102","321","370",223,147,277,"97",180,0.8072,0.6599,0.7486,0.8676
"13174",237057,"WHITMAN COLLEGE",1,0,1998,"20120","32.74","105","337","386",204,182,286,"132",154,0.7549,0.7253,0.7409,0.8731
"13175",237057,"WHITMAN COLLEGE",1,0,1999,"20720","34.582213","107","313","361",209,152,294,"120",174,0.8325,0.7895,0.8144,0.867
"13176",237057,"WHITMAN COLLEGE",1,0,2000,"21550","36.885614","111","291","349",220,129,278,"99",179,0.8136,0.7674,0.7966,0.8338
"13177",237057,"WHITMAN COLLEGE",1,0,2001,"22600","37.749122","115","273","362",195,167,288,"126",162,0.8308,0.7545,0.7956,0.7541
"13178",237057,"WHITMAN COLLEGE",1,0,2002,"24070","40.777197","129","274","379",230,149,322,"126",196,0.8522,0.8456,0.8496,0.723
"13179",237057,"WHITMAN COLLEGE",1,0,2003,"25400","44.48848","136","236","362",182,180,294,"144",150,0.8242,0.8,0.8122,0.6519
"13180",237057,"WHITMAN COLLEGE",1,0,2004,"26870","47.660832","124","259","385",222,163,308,"124",184,0.8288,0.7607,0.8,0.6727
"13181",237057,"Whitman College",1,0,2005,"28400","49.443935","140","231","360",180,180,288,"140",148,0.8222,0.7778,0.8,0.6417
"13182",237057,"Whitman College",1,0,2006,"30530","51.859736","150","241","367",219,148,294,"109",185,0.8447,0.7365,0.8011,0.6567
"13183",237057,"Whitman College",1,0,2007,"32670","54.877949","144","269","400",239,161,319,"124",195,0.8159,0.7702,0.7975,0.6725
"13184",237057,"Whitman College",1,0,2008,"34880","57.566463","152","276","401",230,171,328,"130",198,0.8609,0.7602,0.818,0.6883
"13185",237057,"Whitman College",1,0,2009,"36620","63.760573","140","275","395",238,157,314,"117",197,0.8277,0.7452,0.7949,0.6962
"13186",237057,"Whitman College",1,0,2010,"38450","61.512574","149","283","415",237,178,345,"141",204,0.8608,0.7921,0.8313,0.6819
"13187",237066,"WHITWORTH COLLEGE",1,0,1991,"10300","19.374004","70","203","240",141,99,94,"29",65,0.461,0.2929,0.3917,0.8458
"13188",237066,"WHITWORTH COLLEGE",1,0,1992,"11029","19.26323","80","218","266",151,115,113,"44",69,0.457,0.3826,0.4248,0.8195
"13189",237066,"WHITWORTH COLLEGE",1,0,1993,"11965","19.469342","93","305","361",206,155,160,"59",101,0.4903,0.3806,0.4432,0.8449
"13190",237066,"WHITWORTH COLLEGE",1,0,1995,"13410","28.461748","87","331","395",229,166,198,"73",125,0.5459,0.4398,0.5013,0.838
"13191",237066,"WHITWORTH COLLEGE",1,0,1996,"14100","31.334322","89","252","315",193,122,177,"56",121,0.6269,0.459,0.5619,0.8
"13192",237066,"WHITWORTH COLLEGE",1,0,1997,"14750","25.362895","84","345","398",212,186,226,"103",123,0.5802,0.5538,0.5678,0.8668
"13193",237066,"WHITWORTH COLLEGE",1,0,1998,"15370","26.699443","82","313","373",224,149,197,"74",123,0.5491,0.4966,0.5282,0.8391
"13194",237066,"WHITWORTH COLLEGE",1,0,1999,"15970","29.111326","83","358","406",266,140,233,"74",159,0.5977,0.5286,0.5739,0.8818
"13195",237066,"WHITWORTH COLLEGE",1,0,2000,"16700","30.29877","93.5","354","402",234,168,242,"86",156,0.6667,0.5119,0.602,0.8806
"13196",237066,"WHITWORTH COLLEGE",1,0,2001,"17800","32.288119","104","396","427",265,162,251,"88",163,0.6151,0.5432,0.5878,0.9274
"13197",237066,"WHITWORTH COLLEGE",1,0,2002,"18550","35.107079","112","373","433",232,201,261,"107",154,0.6638,0.5323,0.6028,0.8614
"13198",237066,"WHITWORTH COLLEGE",1,0,2003,"19810","37.162717","119","364","438",259,179,267,"105",162,0.6255,0.5866,0.6096,0.8311
"13199",237066,"WHITWORTH COLLEGE",1,0,2004,"20980","40.406247","119","406","469",266,203,308,"127",181,0.6805,0.6256,0.6567,0.8657
"13200",237066,"Whitworth College",1,0,2005,"22400","42.455785","120","383","451",266,185,304,"125",179,0.6729,0.6757,0.6741,0.8492
"13201",237066,"Whitworth College",1,0,2006,"23850","45.473043","124","408","469",285,184,303,"115",188,0.6596,0.625,0.6461,0.8699
"13202",237066,"Whitworth University",1,0,2007,"25382","49.373889","127","456","532",293,239,347,"141",206,0.7031,0.59,0.6523,0.8571
"13203",237066,"Whitworth University",1,0,2008,"27100","53.622786","133","458","545",289,256,354,"149",205,0.7093,0.582,0.6495,0.8404
"13204",237066,"Whitworth University",1,0,2009,"28320","58.433329","140","457","555",324,231,354,"145",209,0.6451,0.6277,0.6378,0.8234
"13205",237066,"Whitworth University",1,0,2010,"29890","60.328517","162","542","683",403,280,430,"161",269,0.6675,0.575,0.6296,0.7936
"13206",237215,"BLUEFIELD STATE COLLEGE",1,0,1991,"1454","11.173834","92","280","305",163,142,9,"2",7,0.0429,0.0141,0.0295,0.918
"13207",237215,"BLUEFIELD STATE COLLEGE",1,0,1992,"1729","12.481434","93","336","371",192,179,9,"4",5,0.026,0.0223,0.0243,0.9057
"13208",237215,"BLUEFIELD STATE COLLEGE",1,0,1993,"1832","13.775622","91","312","358",215,143,10,"5",5,0.0233,0.035,0.0279,0.8715
"13209",237215,"BLUEFIELD STATE COLLEGE",1,0,1995,"1916","12.901186","84","387","416",243,173,8,"5",3,0.0123,0.0289,0.0192,0.9303
"13210",237215,"BLUEFIELD STATE COLLEGE",1,0,1996,"2000","15.414374","77","368","384",207,177,4,"1",3,0.0145,0.0056,0.0104,0.9583
"13211",237215,"BLUEFIELD STATE COLLEGE",1,0,1997,"2044","17.365204","77","391","423",237,186,6,"0",6,0.0253,0,0.0142,0.9243
"13212",237215,"BLUEFIELD STATE COLLEGE",1,0,1998,"2110","17.845742","79","382","426",215,211,7,"4",3,0.014,0.019,0.0164,0.8967
"13213",237215,"BLUEFIELD STATE COLLEGE",1,0,1999,"1140","19.432717","80","342","370",225,145,8,"3",5,0.0222,0.0207,0.0216,0.9243
"13214",237215,"BLUEFIELD STATE COLLEGE",1,0,2000,"2288","20.697971","80","401","443",254,189,30,"14",16,0.063,0.0741,0.0677,0.9052
"13215",237215,"BLUEFIELD STATE COLLEGE",1,0,2001,"2288","22.497613","80","343","380",233,147,3,"1",2,0.0086,0.0068,0.0079,0.9026
"13216",237215,"BLUEFIELD STATE COLLEGE",1,0,2002,"2598","20.819754","85","454","499",265,234,2,"2",0,0,0.0085,0.004,0.9098
"13217",237215,"BLUEFIELD STATE COLLEGE",1,0,2003,"2806","22.515053","94","251","273",155,118,15,"7",8,0.0516,0.0593,0.0549,0.9194
"13218",237215,"BLUEFIELD STATE COLLEGE",1,0,2004,"3114","26.446376","99","211","244",138,106,14,"8",6,0.0435,0.0755,0.0574,0.8648
"13219",237215,"Bluefield State College",1,0,2005,"3410","20.584707","75","219","246",133,113,5,"3",2,0.015,0.0265,0.0203,0.8902
"13220",237215,"Bluefield State College",1,0,2006,"3648","20.929861","75","211","253",134,119,28,"19",9,0.0672,0.1597,0.1107,0.834
"13221",237215,"Bluefield State College",1,0,2007,"3984","20.511929","77","252","296",167,129,18,"11",7,0.0419,0.0853,0.0608,0.8514
"13222",237215,"Bluefield State College",1,0,2008,"4272","22.843787","74","235","270",156,114,33,"15",18,0.1154,0.1316,0.1222,0.8704
"13223",237215,"Bluefield State College",1,0,2009,"4596","23.905256","78","253","304",177,127,28,"18",10,0.0565,0.1417,0.0921,0.8322
"13224",237215,"Bluefield State College",1,0,2010,"4596","23.847588","76","254","289",181,108,22,"13",9,0.0497,0.1204,0.0761,0.8789
"13225",237330,"CONCORD COLLEGE",1,0,1991,"1602","16.165881","88","376","401",229,172,87,"32",55,0.2402,0.186,0.217,0.9377
"13226",237330,"CONCORD COLLEGE",1,0,1992,"1736","18.006734","91","364","393",233,160,50,"9",41,0.176,0.0562,0.1272,0.9262
"13227",237330,"CONCORD COLLEGE",1,0,1993,"1936","19.520792","94","452","487",284,203,71,"25",46,0.162,0.1232,0.1458,0.9281
"13228",237330,"CONCORD COLLEGE",1,0,1995,"2150","19.904995","94","494","542",282,260,148,"62",86,0.305,0.2385,0.2731,0.9114
"13229",237330,"CONCORD COLLEGE",1,0,1996,"2218","19.921167","93","519","582",301,281,107,"34",73,0.2425,0.121,0.1838,0.8918
"13230",237330,"CONCORD COLLEGE",1,0,1997,"2310","21.111225","100","662","726",390,336,121,"49",72,0.1846,0.1458,0.1667,0.9118
"13231",237330,"CONCORD COLLEGE",1,0,1998,"2388","25.406386","96","500","545",293,252,74,"30",44,0.1502,0.119,0.1358,0.9174
"13232",237330,"CONCORD COLLEGE",1,0,1999,"250","26.751214","91","560","612",317,295,92,"37",55,0.1735,0.1254,0.1503,0.915
"13233",237330,"CONCORD COLLEGE",1,0,2000,"250","29.011149","95.5","642","694",381,313,87,"26",61,0.1601,0.0831,0.1254,0.9251
"13234",237330,"CONCORD COLLEGE",1,0,2001,"250","31.647482","100","594","646",343,303,199,"74",125,0.3644,0.2442,0.308,0.9195
"13235",237330,"CONCORD COLLEGE",1,0,2002,"250","29.893021","97","534","587",273,314,74,"34",40,0.1465,0.1083,0.1261,0.9097
"13236",237330,"CONCORD COLLEGE",1,0,2003,"250","30.229594","95","463","508",286,222,98,"29",69,0.2413,0.1306,0.1929,0.9114
"13237",237330,"CONCORD UNIVERSITY",1,0,2004,"250","29.942234","98","443","488",262,226,75,"30",45,0.1718,0.1327,0.1537,0.9078
"13238",237330,"Concord University",1,0,2005,"250","30.019441","94","582","639",352,287,104,"35",69,0.196,0.122,0.1628,0.9108
"13239",237330,"Concord University",1,0,2006,"250","31.956107","95","517","593",306,287,102,"37",65,0.2124,0.1289,0.172,0.8718
"13240",237330,"Concord University",1,0,2007,"250","31.808869","101","554","618",335,283,115,"49",66,0.197,0.1731,0.1861,0.8964
"13241",237330,"Concord University",1,0,2008,"250","33.854319","106","631","706",380,326,128,"38",90,0.2368,0.1166,0.1813,0.8938
"13242",237330,"Concord University",1,0,2009,"4974","37.362473","108","540","607",348,259,121,"44",77,0.2213,0.1699,0.1993,0.8896
"13243",237330,"Concord University",1,0,2010,"4974","40.281971","108","490","568",288,280,105,"37",68,0.2361,0.1321,0.1849,0.8627
"13244",237358,"DAVIS AND ELKINS COLLEGE",1,0,1991,"7600","11.975954","55","123","141",80,61,13,"4",9,0.1125,0.0656,0.0922,0.8723
"13245",237358,"DAVIS AND ELKINS COLLEGE",1,0,1992,"8050","12.208644","55","186","201",108,93,49,"22",27,0.25,0.2366,0.2438,0.9254
"13246",237358,"DAVIS AND ELKINS COLLEGE",1,0,1993,"8980","13.341596","55","160","167",100,67,24,"10",14,0.14,0.1493,0.1437,0.9581
"13247",237358,"DAVIS AND ELKINS COLLEGE",1,0,1995,"10330","13.700528","50","171","180",101,79,35,"13",22,0.2178,0.1646,0.1944,0.95
"13248",237358,"DAVIS AND ELKINS COLLEGE",1,0,1996,"10580","13.908942","58","107","120",66,54,27,"16",11,0.1667,0.2963,0.225,0.8917
"13249",237358,"DAVIS AND ELKINS COLLEGE",1,0,1997,"11000","17.569","56","88","95",54,41,6,"3",3,0.0556,0.0732,0.0632,0.9263
"13250",237358,"DAVIS AND ELKINS COLLEGE",1,0,1998,"11500","18.818744","54","139","152",87,65,66,"29",37,0.4253,0.4462,0.4342,0.9145
"13251",237358,"DAVIS AND ELKINS COLLEGE",1,0,1999,"12080","17.42111","47","115","129",72,57,34,"15",19,0.2639,0.2632,0.2636,0.8915
"13252",237358,"DAVIS AND ELKINS COLLEGE",1,0,2000,"12624","18.149526","46","116","133",76,57,39,"18",21,0.2763,0.3158,0.2932,0.8722
"13253",237358,"DAVIS AND ELKINS COLLEGE",1,0,2001,"13224","18.013408","45","105","123",71,52,31,"13",18,0.2535,0.25,0.252,0.8537
"13254",237358,"DAVIS AND ELKINS COLLEGE",1,0,2002,"13700","17.498293","46","103","122",68,54,29,"18",11,0.1618,0.3333,0.2377,0.8443
"13255",237358,"DAVIS AND ELKINS COLLEGE",1,0,2003,"14248","17.269559","45","84","104",60,44,27,"8",19,0.3167,0.1818,0.2596,0.8077
"13256",237358,"DAVIS AND ELKINS COLLEGE",1,0,2004,"15246","17.696599","45","118","142",77,65,57,"26",31,0.4026,0.4,0.4014,0.831
"13257",237358,"Davis & Elkins College",1,0,2005,"16312","14.708757","44","93","109",67,42,25,"5",20,0.2985,0.119,0.2294,0.8532
"13258",237358,"Davis & Elkins College",1,0,2006,"17210","15.190132","45","89","119",65,54,30,"14",16,0.2462,0.2593,0.2521,0.7479
"13259",237358,"Davis & Elkins College",1,0,2007,"18226","15.296827","44","87","120",70,50,21,"9",12,0.1714,0.18,0.175,0.725
"13260",237358,"Davis & Elkins College",1,0,2008,"19320","14.228288","37","90","129",68,61,35,"19",16,0.2353,0.3115,0.2713,0.6977
"13261",237358,"Davis & Elkins College",1,0,2009,"19170","14.316347","39","163","234",139,95,60,"23",37,0.2662,0.2421,0.2564,0.6966
"13262",237358,"Davis & Elkins College",1,0,2010,"20800","15.834471","45","161","253",149,104,64,"29",35,0.2349,0.2788,0.253,0.6364
"13263",237367,"FAIRMONT STATE COLLEGE",1,0,1991,"1424","27.151361","170","898","1034",567,467,83,"35",48,0.0847,0.0749,0.0803,0.8685
"13264",237367,"FAIRMONT STATE COLLEGE",1,0,1992,"1686","30.415988","175","926","1107",578,529,66,"18",48,0.083,0.034,0.0596,0.8365
"13265",237367,"FAIRMONT STATE COLLEGE",1,0,1993,"1800","33.467976","182","1000","1053",553,500,93,"29",64,0.1157,0.058,0.0883,0.9497
"13266",237367,"FAIRMONT STATE COLLEGE",1,0,1995,"1858","36.30639","190","999","1123",618,505,96,"36",60,0.0971,0.0713,0.0855,0.8896
"13267",237367,"FAIRMONT STATE COLLEGE",1,0,1996,"1918","37.735084","191","994","1049",570,479,119,"43",76,0.1333,0.0898,0.1134,0.9476
"13268",237367,"FAIRMONT STATE COLLEGE",1,0,1997,"2040","38.761916","194","514","540",300,240,115,"45",70,0.2333,0.1875,0.213,0.9519
"13269",237367,"FAIRMONT STATE COLLEGE",1,0,1998,"2106","41.679079","194","522","555",311,244,93,"27",66,0.2122,0.1107,0.1676,0.9405
"13270",237367,"FAIRMONT STATE COLLEGE",1,0,1999,"2284","44.736395","196","472","534",286,248,77,"28",49,0.1713,0.1129,0.1442,0.8839
"13271",237367,"FAIRMONT STATE COLLEGE",1,0,2000,"2316","48.31937","198","534","589",333,256,87,"25",62,0.1862,0.0977,0.1477,0.9066
"13272",237367,"FAIRMONT STATE COLLEGE",1,0,2001,"2408","54.033018","200","514","568",320,248,62,"18",44,0.1375,0.0726,0.1092,0.9049
"13273",237367,"FAIRMONT STATE COLLEGE",1,0,2002,"1200","62.367052","204","625","682",377,305,80,"30",50,0.1326,0.0984,0.1173,0.9164
"13274",237367,"FAIRMONT STATE COLLEGE",1,0,2003,"3130","54.887834","157","563","631",317,314,85,"31",54,0.1703,0.0987,0.1347,0.8922
"13275",237367,"FAIRMONT STATE UNIVERSITY",1,0,2004,"3640","59.010117","159","557","602",321,281,90,"27",63,0.1963,0.0961,0.1495,0.9252
"13276",237367,"Fairmont State University",1,0,2005,"4218","45.022637","163","606","653",367,286,97,"35",62,0.1689,0.1224,0.1485,0.928
"13277",237367,"Fairmont State University",1,0,2006,"4522","70.566692","232","602","642",345,297,84,"35",49,0.142,0.1178,0.1308,0.9377
"13278",237367,"Fairmont State University",1,0,2007,"4814","74.337775","236","581","632",331,301,87,"37",50,0.1511,0.1229,0.1377,0.9193
"13279",237367,"Fairmont State University",1,0,2008,"5024","76.834815","233","657","755",370,385,116,"52",64,0.173,0.1351,0.1536,0.8702
"13280",237367,"Fairmont State University",1,0,2009,"5172","79.632768","171","712","795",412,383,118,"58",60,0.1456,0.1514,0.1484,0.8956
"13281",237367,"Fairmont State University",1,0,2010,"5172","68.929386","162","675","766",393,373,103,"49",54,0.1374,0.1314,0.1345,0.8812
"13282",237792,"SHEPHERD COLLEGE",1,0,1991,"1894","18.15","111","373","395",208,187,46,"16",30,0.1442,0.0856,0.1165,0.9443
"13283",237792,"SHEPHERD COLLEGE",1,0,1992,"1954","19.471","114","464","490",270,220,3,"0",3,0.0111,0,0.0061,0.9469
"13284",237792,"SHEPHERD COLLEGE",1,0,1993,"2040","20.615","117","521","557",310,247,59,"17",42,0.1355,0.0688,0.1059,0.9354
"13285",237792,"SHEPHERD COLLEGE",1,0,1995,"2064","24.470884","120","563","598",333,265,74,"20",54,0.1622,0.0755,0.1237,0.9415
"13286",237792,"SHEPHERD COLLEGE",1,0,1996,"2160","25.681235","119","571","617",363,254,97,"24",73,0.2011,0.0945,0.1572,0.9254
"13287",237792,"SHEPHERD COLLEGE",1,0,1997,"2228","27.152218","124","581","643",341,302,111,"43",68,0.1994,0.1424,0.1726,0.9036
"13288",237792,"SHEPHERD COLLEGE",1,0,1998,"2298","27.989322","115","559","610",356,254,93,"23",70,0.1966,0.0906,0.1525,0.9164
"13289",237792,"SHEPHERD COLLEGE",1,0,1999,"250","29.755413","112","626","674",367,307,91,"25",66,0.1798,0.0814,0.135,0.9288
"13290",237792,"SHEPHERD COLLEGE",1,0,2000,"250","32.693867","115","612","669",378,291,101,"32",69,0.1825,0.11,0.151,0.9148
"13291",237792,"SHEPHERD COLLEGE",1,0,2001,"250","35.044782","118","584","647",333,314,71,"27",44,0.1321,0.086,0.1097,0.9026
"13292",237792,"SHEPHERD COLLEGE",1,0,2002,"250","40.287569","120","632","705",378,327,92,"24",68,0.1799,0.0734,0.1305,0.8965
"13293",237792,"SHEPHERD COLLEGE",1,0,2003,"250","40.24741","124","695","768",440,328,134,"48",86,0.1955,0.1463,0.1745,0.9049
"13294",237792,"SHEPHERD UNIVERSITY",1,0,2004,"250","39.624025","126","709","774",427,347,119,"44",75,0.1756,0.1268,0.1537,0.916
"13295",237792,"Shepherd University",1,0,2005,"350","37.056034","112","593","657",352,305,134,"52",82,0.233,0.1705,0.204,0.9026
"13296",237792,"Shepherd University",1,0,2006,"350","43.343784","116","618","688",395,293,135,"40",95,0.2405,0.1365,0.1962,0.8983
"13297",237792,"Shepherd University",1,0,2007,"350","44.719819","116","599","691",366,325,124,"48",76,0.2077,0.1477,0.1795,0.8669
"13298",237792,"Shepherd University",1,0,2008,"350","50.045143","119","562","698",395,303,137,"42",95,0.2405,0.1386,0.1963,0.8052
"13299",237792,"Shepherd University",1,0,2009,"350","53.368982","124","486","786",437,349,169,"63",106,0.2426,0.1805,0.215,0.6183
"13300",237792,"Shepherd University",1,0,2010,"350","56.800573","125","649","759",436,323,191,"59",132,0.3028,0.1827,0.2516,0.8551
"13301",237899,"WEST VIRGINIA STATE COLLEGE",1,0,1991,"1578","21.235","138","375","475",227,248,15,"7",8,0.0352,0.0282,0.0316,0.7895
"13302",237899,"WEST VIRGINIA STATE COLLEGE",1,0,1992,"1712","22.143","140","299","400",188,212,17,"7",10,0.0532,0.033,0.0425,0.7475
"13303",237899,"WEST VIRGINIA STATE COLLEGE",1,0,1993,"1894","24.767","138","511","634",308,326,21,"8",13,0.0422,0.0245,0.0331,0.806
"13304",237899,"WEST VIRGINIA STATE COLLEGE",1,0,1995,"2050","24.160418","140","474","572",292,280,28,"13",15,0.0514,0.0464,0.049,0.8287
"13305",237899,"WEST VIRGINIA STATE COLLEGE",1,0,1996,"2116","27.568547","137","418","529",254,275,28,"10",18,0.0709,0.0364,0.0529,0.7902
"13306",237899,"WEST VIRGINIA STATE COLLEGE",1,0,1997,"2184","30.727902","131","442","581",288,293,33,"13",20,0.0694,0.0444,0.0568,0.7608
"13307",237899,"WEST VIRGINIA STATE COLLEGE",1,0,1998,"2254","31.070765","133","436","551",282,269,31,"13",18,0.0638,0.0483,0.0563,0.7913
"13308",237899,"WEST VIRGINIA STATE COLLEGE",1,0,1999,"2386","33.500148","140","437","555",260,295,31,"13",18,0.0692,0.0441,0.0559,0.7874
"13309",237899,"WEST VIRGINIA STATE COLLEGE",1,0,2000,"2464","37.597113","135.5","397","542",277,265,19,"6",13,0.0469,0.0226,0.0351,0.7325
"13310",237899,"WEST VIRGINIA STATE COLLEGE",1,0,2001,"2562","52.173122","131","276","379",193,186,16,"5",11,0.057,0.0269,0.0422,0.7282
"13311",237899,"WEST VIRGINIA STATE COLLEGE",1,0,2002,"2610","54.063574","150","271","351",178,173,28,"8",20,0.1124,0.0462,0.0798,0.7721
"13312",237899,"WEST VIRGINIA STATE COLLEGE",1,0,2003,"2609","44.571814","161","252","333",187,146,20,"6",14,0.0749,0.0411,0.0601,0.7568
"13313",237899,"WEST VIRGINIA STATE UNIVERSITY",1,0,2004,"3222","48.634625","116","249","331",175,156,18,"8",10,0.0571,0.0513,0.0544,0.7523
"13314",237899,"West Virginia State University",1,0,2005,"3528","47.874931","120","227","306",152,154,21,"11",10,0.0658,0.0714,0.0686,0.7418
"13315",237899,"West Virginia State University",1,0,2006,"3776","54.947521","124","231","341",170,171,24,"8",16,0.0941,0.0468,0.0704,0.6774
"13316",237899,"West Virginia State University",1,0,2007,"4136","57.160739","129","214","364",170,194,14,"5",9,0.0529,0.0258,0.0385,0.5879
"13317",237899,"West Virginia State University",1,0,2008,"4346","60.259229","125","176","302",147,155,16,"5",11,0.0748,0.0323,0.053,0.5828
"13318",237899,"West Virginia State University",1,0,2009,"4524","49.984795","121","163","246",120,126,28,"9",19,0.1583,0.0714,0.1138,0.6626
"13319",237899,"West Virginia State University",1,0,2010,"4544","54.411458","120","198","270",128,142,26,"9",17,0.1328,0.0634,0.0963,0.7333
"13320",237932,"WEST LIBERTY STATE COLLEGE",1,0,1991,"1500","16.985406","131","415","437",227,210,75,"25",50,0.2203,0.119,0.1716,0.9497
"13321",237932,"WEST LIBERTY STATE COLLEGE",1,0,1992,"1590","18.055533","130","462","488",263,225,104,"29",75,0.2852,0.1289,0.2131,0.9467
"13322",237932,"WEST LIBERTY STATE COLLEGE",1,0,1993,"1800","19.106762","130","459","474",238,236,85,"32",53,0.2227,0.1356,0.1793,0.9684
"13323",237932,"WEST LIBERTY STATE COLLEGE",1,0,1995,"1960","20.165464","126","486","509",273,236,108,"27",81,0.2967,0.1144,0.2122,0.9548
"13324",237932,"WEST LIBERTY STATE COLLEGE",1,0,1996,"2020","21.05765","125","438","464",250,214,77,"20",57,0.228,0.0935,0.1659,0.944
"13325",237932,"WEST LIBERTY STATE COLLEGE",1,0,1997,"2120","27.717049","120","469","491",257,234,77,"21",56,0.2179,0.0897,0.1568,0.9552
"13326",237932,"WEST LIBERTY STATE COLLEGE",1,0,1998,"2190","21.870984","115","478","498",268,230,96,"35",61,0.2276,0.1522,0.1928,0.9598
"13327",237932,"WEST LIBERTY STATE COLLEGE",1,0,1999,"2320","25.217483","108","474","494",245,249,96,"31",65,0.2653,0.1245,0.1943,0.9595
"13328",237932,"WEST LIBERTY STATE COLLEGE",1,0,2000,"2420","26.820745","110","486","513",275,238,91,"29",62,0.2255,0.1218,0.1774,0.9474
"13329",237932,"WEST LIBERTY STATE COLLEGE",1,0,2001,"2516","27.461913","112","502","521",298,223,99,"40",59,0.198,0.1794,0.19,0.9635
"13330",237932,"WEST LIBERTY STATE COLLEGE",1,0,2002,"2748","31.760669","111","424","445",253,192,107,"23",84,0.332,0.1198,0.2404,0.9528
"13331",237932,"WEST LIBERTY STATE COLLEGE",1,0,2003,"3138","27.50829","114","423","453",248,205,69,"16",53,0.2137,0.078,0.1523,0.9338
"13332",237932,"WEST LIBERTY STATE COLLEGE",1,0,2004,"3380","25.805645","100","432","459",238,221,92,"35",57,0.2395,0.1584,0.2004,0.9412
"13333",237932,"West Liberty State College",1,0,2005,"3686","25.680553","100","390","416",234,182,94,"25",69,0.2949,0.1374,0.226,0.9375
"13334",237932,"West Liberty State College",1,0,2006,"3946","25.405677","97","432","476",269,207,84,"28",56,0.2082,0.1353,0.1765,0.9076
"13335",237932,"West Liberty State College",1,0,2007,"4172","27.66237","99","460","499",264,235,110,"27",83,0.3144,0.1149,0.2204,0.9218
"13336",237932,"West Liberty State College",1,0,2008,"4464","29.735045","101","509","550",299,251,96,"30",66,0.2207,0.1195,0.1745,0.9255
"13337",237932,"West Liberty University",1,0,2009,"4880","31.692813","111","531","569",340,229,130,"33",97,0.2853,0.1441,0.2285,0.9332
"13338",237932,"West Liberty University",1,0,2010,"4880","36.376701","117","473","526",285,241,103,"31",72,0.2526,0.1286,0.1958,0.8992
"13339",237969,"WEST VIRGINIA WESLEYAN COLLEGE",1,0,1991,"11830","22.301191","78","321","363",195,168,155,"44",111,0.5692,0.2619,0.427,0.8843
"13340",237969,"WEST VIRGINIA WESLEYAN COLLEGE",1,0,1992,"12605","25.034396","73","416","467",223,244,173,"72",101,0.4529,0.2951,0.3704,0.8908
"13341",237969,"WEST VIRGINIA WESLEYAN COLLEGE",1,0,1993,"13400","27.303213","74","424","475",235,240,172,"64",108,0.4596,0.2667,0.3621,0.8926
"13342",237969,"WEST VIRGINIA WESLEYAN COLLEGE",1,0,1995,"14750","31.472625","76","406","453",240,213,200,"77",123,0.5125,0.3615,0.4415,0.8962
"13343",237969,"WEST VIRGINIA WESLEYAN COLLEGE",1,0,1996,"14975","34.723815","75","330","377",204,173,161,"57",104,0.5098,0.3295,0.4271,0.8753
"13344",237969,"WEST VIRGINIA WESLEYAN COLLEGE",1,0,1997,"15275","24.43588","72","395","480",260,220,201,"72",129,0.4962,0.3273,0.4188,0.8229
"13345",237969,"WEST VIRGINIA WESLEYAN COLLEGE",1,0,1998,"15750","24.709431","80","423","472",247,225,204,"74",130,0.5263,0.3289,0.4322,0.8962
"13346",237969,"WEST VIRGINIA WESLEYAN COLLEGE",1,0,1999,"16300","26.384013","81","424","472",261,211,211,"89",122,0.4674,0.4218,0.447,0.8983
"13347",237969,"WEST VIRGINIA WESLEYAN COLLEGE",1,0,2000,"16800","27.45086","82.5","376","415",232,183,169,"56",113,0.4871,0.306,0.4072,0.906
"13348",237969,"WEST VIRGINIA WESLEYAN COLLEGE",1,0,2001,"17300","30.683955","84","358","400",202,198,175,"65",110,0.5446,0.3283,0.4375,0.895
"13349",237969,"WEST VIRGINIA WESLEYAN COLLEGE",1,0,2002,"17900","26.327498","88","450","500",283,217,224,"83",141,0.4982,0.3825,0.448,0.9
"13350",237969,"WEST VIRGINIA WESLEYAN COLLEGE",1,0,2003,"18450","26.184337","88","355","457",257,200,197,"64",133,0.5175,0.32,0.4311,0.7768
"13351",237969,"WEST VIRGINIA WESLEYAN COLLEGE",1,0,2004,"19450","26.213585","85","262","348",181,167,148,"59",89,0.4917,0.3533,0.4253,0.7529
"13352",237969,"West Virginia Wesleyan College",1,0,2005,"20250","25.884629","80","251","307",161,146,129,"38",91,0.5652,0.2603,0.4202,0.8176
"13353",237969,"West Virginia Wesleyan College",1,0,2006,"20250","24.87928","72","161","291",167,124,117,"39",78,0.4671,0.3145,0.4021,0.5533
"13354",237969,"West Virginia Wesleyan College",1,0,2007,"20980","24.268733","71","288","401",203,198,174,"71",103,0.5074,0.3586,0.4339,0.7182
"13355",237969,"West Virginia Wesleyan College",1,0,2008,"21030","24.622571","76","279","382",208,174,168,"63",105,0.5048,0.3621,0.4398,0.7304
"13356",237969,"West Virginia Wesleyan College",1,0,2009,"22030","25.734107","75","312","399",197,202,151,"61",90,0.4569,0.302,0.3784,0.782
"13357",237969,"West Virginia Wesleyan College",1,0,2010,"23130","25.561284","78","302","371",196,175,141,"43",98,0.5,0.2457,0.3801,0.814
"13358",238032,"WEST VIRGINIA UNIVERSITY",1,0,1991,"1850","298.534072","903","3090","3307",1550,1757,796,"325",471,0.3039,0.185,0.2407,0.9344
"13359",238032,"WEST VIRGINIA UNIVERSITY",1,0,1992,"1928","331.83943","908","2736","2978",1444,1534,766,"296",470,0.3255,0.193,0.2572,0.9187
"13360",238032,"WEST VIRGINIA UNIVERSITY",1,0,1993,"2026","334.452473","895","2622","2806",1370,1436,658,"252",406,0.2964,0.1755,0.2345,0.9344
"13361",238032,"WEST VIRGINIA UNIVERSITY",1,0,1995,"2192","368.975243","863","2731","2938",1457,1481,783,"324",459,0.315,0.2188,0.2665,0.9295
"13362",238032,"WEST VIRGINIA UNIVERSITY",1,0,1996,"2262","393.834122","846","2850","3065",1499,1566,817,"335",482,0.3215,0.2139,0.2666,0.9299
"13363",238032,"WEST VIRGINIA UNIVERSITY",1,0,1997,"2336","396.170761","806","2829","3079",1431,1648,794,"344",450,0.3145,0.2087,0.2579,0.9188
"13364",238032,"WEST VIRGINIA UNIVERSITY",1,0,1998,"2662","398.423812","804","3070","3335",1571,1764,818,"348",470,0.2992,0.1973,0.2453,0.9205
"13365",238032,"WEST VIRGINIA UNIVERSITY",1,0,1999,"1332","435.961603","797","3199","3523",1641,1882,885,"363",522,0.3181,0.1929,0.2512,0.908
"13366",238032,"WEST VIRGINIA UNIVERSITY",1,0,2000,"1332","452.613913","803.5","3193","3480",1679,1801,889,"346",543,0.3234,0.1921,0.2555,0.9175
"13367",238032,"WEST VIRGINIA UNIVERSITY",1,0,2001,"1332","482.283742","810","3263","3593",1743,1850,928,"381",547,0.3138,0.2059,0.2583,0.9082
"13368",238032,"WEST VIRGINIA UNIVERSITY",1,0,2002,"3240","503.478843","796","3573","3917",1841,2076,1161,"473",688,0.3737,0.2278,0.2964,0.9122
"13369",238032,"WEST VIRGINIA UNIVERSITY",1,0,2003,"3548","553.421803","778","4070","4366",2104,2262,1387,"583",804,0.3821,0.2577,0.3177,0.9322
"13370",238032,"WEST VIRGINIA UNIVERSITY",1,0,2004,"3938","549.711423","776","3961","4308",2032,2276,1416,"571",845,0.4158,0.2509,0.3287,0.9195
"13371",238032,"West Virginia University",1,0,2005,"4164","583.622175","785","4129","4524",2126,2398,1457,"639",818,0.3848,0.2665,0.3221,0.9127
"13372",238032,"West Virginia University",1,0,2006,"4476","652.897407","813","4354","4777",2151,2626,1596,"746",850,0.3952,0.2841,0.3341,0.9115
"13373",238032,"West Virginia University",1,0,2007,"4722","690.130519","802","4187","4664",2156,2508,1561,"696",865,0.4012,0.2775,0.3347,0.8977
"13374",238032,"West Virginia University",1,0,2008,"5100","776.835464","876","4548","5083",2300,2783,1656,"766",890,0.387,0.2752,0.3258,0.8947
"13375",238032,"West Virginia University",1,0,2009,"5304","834.561921","968","4058","4555",2098,2457,1501,"661",840,0.4004,0.269,0.3295,0.8909
"13376",238032,"West Virginia University",1,0,2010,"5406","899.855596","980","4312","5006",2290,2716,1619,"755",864,0.3773,0.278,0.3234,0.8614
"13377",238333,"BELOIT COLLEGE",1,0,1991,"13050","23.097083","83","231","261",147,114,135,"50",85,0.5782,0.4386,0.5172,0.8851
"13378",238333,"BELOIT COLLEGE",1,0,1992,"14250","25.36893","83","259","306",159,147,171,"68",103,0.6478,0.4626,0.5588,0.8464
"13379",238333,"BELOIT COLLEGE",1,0,1993,"15430","27.018256","80","234","284",161,123,158,"61",97,0.6025,0.4959,0.5563,0.8239
"13380",238333,"BELOIT COLLEGE",1,0,1995,"17544","32.20218","83","242","291",163,128,187,"74",113,0.6933,0.5781,0.6426,0.8316
"13381",238333,"BELOIT COLLEGE",1,0,1996,"18230","33.125269","80","224","284",147,137,175,"76",99,0.6735,0.5547,0.6162,0.7887
"13382",238333,"BELOIT COLLEGE",1,0,1997,"19050","27.270983","88","275","339",194,145,204,"73",131,0.6753,0.5034,0.6018,0.8112
"13383",238333,"BELOIT COLLEGE",1,0,1998,"19770","27.956382","86","245","302",180,122,166,"58",108,0.6,0.4754,0.5497,0.8113
"13384",238333,"BELOIT COLLEGE",1,0,1999,"20220","28.862057","97","244","303",173,130,196,"75",121,0.6994,0.5769,0.6469,0.8053
"13385",238333,"BELOIT COLLEGE",1,0,2000,"21330","30.699264","98","255","306",177,129,168,"79",89,0.5028,0.6124,0.549,0.8333
"13386",238333,"BELOIT COLLEGE",1,0,2001,"22184","32.058377","99","262","311",189,122,234,"86",148,0.7831,0.7049,0.7524,0.8424
"13387",238333,"BELOIT COLLEGE",1,0,2002,"23016","33.22746","99","266","303",191,112,210,"75",135,0.7068,0.6696,0.6931,0.8779
"13388",238333,"BELOIT COLLEGE",1,0,2003,"24166","35.456095","103","307","346",217,129,251,"88",163,0.7512,0.6822,0.7254,0.8873
"13389",238333,"BELOIT COLLEGE",1,0,2004,"25516","34.952593","103","285","323",176,147,218,"97",121,0.6875,0.6599,0.6749,0.8824
"13390",238333,"Beloit College",1,0,2005,"26664","37.290074","103","277","326",198,128,216,"71",145,0.7323,0.5547,0.6626,0.8497
"13391",238333,"Beloit College",1,0,2006,"28130","39.696897","109","284","347",207,140,243,"94",149,0.7198,0.6714,0.7003,0.8184
"13392",238333,"Beloit College",1,0,2007,"29678","40.669205","127","248","325",183,142,229,"99",130,0.7104,0.6972,0.7046,0.7631
"13393",238333,"Beloit College",1,0,2008,"31310","45.267227","123","222","337",182,155,240,"104",136,0.7473,0.671,0.7122,0.6588
"13394",238333,"Beloit College",1,0,2009,"33188","48.837771","123","242","332",199,133,233,"90",143,0.7186,0.6767,0.7018,0.7289
"13395",238333,"Beloit College",1,0,2010,"34808","46.238483","127","237","333",191,142,212,"89",123,0.644,0.6268,0.6366,0.7117
"13396",238430,"CARDINAL STRITCH COLLEGE",1,0,1991,"6960","14.569108","51","98","125",89,36,24,"7",17,0.191,0.1944,0.192,0.784
"13397",238430,"CARDINAL STRITCH COLLEGE",1,0,1992,"7360","15.188151","59","158","199",133,66,20,"10",10,0.0752,0.1515,0.1005,0.794
"13398",238430,"CARDINAL STRITCH COLLEGE",1,0,1993,"7720","17.227336","69","375","481",327,154,39,"12",27,0.0826,0.0779,0.0811,0.7796
"13399",238430,"CARDINAL STRITCH COLLEGE",1,0,1995,"8320","19.09992","68","114","139",93,46,20,"3",17,0.1828,0.0652,0.1439,0.8201
"13400",238430,"CARDINAL STRITCH COLLEGE",1,0,1996,"8960","19.103957","80","197","253",174,79,40,"16",24,0.1379,0.2025,0.1581,0.7787
"13401",238430,"CARDINAL STRITCH UNIVERSITY",1,0,1997,"10080","21.187872","72","164","226",149,77,55,"19",36,0.2416,0.2468,0.2434,0.7257
"13402",238430,"CARDINAL STRITCH UNIVERSITY",1,0,1998,"10496","23.097883","62","159","224",140,84,71,"28",43,0.3071,0.3333,0.317,0.7098
"13403",238430,"CARDINAL STRITCH UNIVERSITY",1,0,1999,"11000","21.963158","78","152","203",132,71,28,"10",18,0.1364,0.1408,0.1379,0.7488
"13404",238430,"CARDINAL STRITCH UNIVERSITY",1,0,2000,"11680","24.919124","88","155","207",122,85,129,"53",76,0.623,0.6235,0.6232,0.7488
"13405",238430,"CARDINAL STRITCH UNIVERSITY",1,0,2001,"12480","29.280491","98","197","296",215,81,78,"29",49,0.2279,0.358,0.2635,0.6655
"13406",238430,"CARDINAL STRITCH UNIVERSITY",1,0,2002,"13280","33.628961","88","137","197",155,42,55,"12",43,0.2774,0.2857,0.2792,0.6954
"13407",238430,"CARDINAL STRITCH UNIVERSITY",1,0,2003,"14240","37.943877","97","135","205",136,69,28,"11",17,0.125,0.1594,0.1366,0.6585
"13408",238430,"CARDINAL STRITCH UNIVERSITY",1,0,2004,"15360","39.126221","97","103","157",120,37,63,"8",55,0.4583,0.2162,0.4013,0.6561
"13409",238430,"Cardinal Stritch University",1,0,2005,"16130","39.429372","93","120","182",139,43,19,"4",15,0.1079,0.093,0.1044,0.6593
"13410",238430,"Cardinal Stritch University",1,0,2006,"17600","41.639605","98","125","245",168,77,19,"6",13,0.0774,0.0779,0.0776,0.5102
"13411",238430,"Cardinal Stritch University",1,0,2007,"18624","44.221465","98","87","173",115,58,25,"6",19,0.1652,0.1034,0.1445,0.5029
"13412",238430,"Cardinal Stritch University",1,0,2008,"20000","49.572392","95","162","258",177,81,39,"14",25,0.1412,0.1728,0.1512,0.6279
"13413",238430,"Cardinal Stritch University",1,0,2009,"21280","54.527935","103","101","209",119,90,19,"4",15,0.1261,0.0444,0.0909,0.4833
"13414",238430,"Cardinal Stritch University",1,0,2010,"22240","53.547256","105","124","213",128,85,37,"14",23,0.1797,0.1647,0.1737,0.5822
"13415",238458,"CARROLL COLLEGE",1,0,1991,"11068","25.107183","87","250","275",168,107,132,"35",97,0.5774,0.3271,0.48,0.9091
"13416",238458,"CARROLL COLLEGE",1,0,1992,"11432","24.225084","86","258","298",193,105,93,"27",66,0.342,0.2571,0.3121,0.8658
"13417",238458,"CARROLL COLLEGE",1,0,1993,"11790","24.031108","70","309","345",211,134,130,"45",85,0.4028,0.3358,0.3768,0.8957
"13418",238458,"CARROLL COLLEGE",1,0,1995,"12880","27.284324","74","378","429",296,133,202,"41",161,0.5439,0.3083,0.4709,0.8811
"13419",238458,"CARROLL COLLEGE",1,0,1996,"13190","29.110313","73","401","450",295,155,214,"67",147,0.4983,0.4323,0.4756,0.8911
"13420",238458,"CARROLL COLLEGE",1,0,1997,"13670","22.543141","74","404","459",287,172,232,"65",167,0.5819,0.3779,0.5054,0.8802
"13421",238458,"CARROLL COLLEGE",1,0,1998,"14200","24.388178","85","390","414",296,118,156,"31",125,0.4223,0.2627,0.3768,0.942
"13422",238458,"CARROLL COLLEGE",1,0,1999,"14740","26.565057","98","446","482",327,155,219,"63",156,0.4771,0.4065,0.4544,0.9253
"13423",238458,"CARROLL COLLEGE",1,0,2000,"15250","30.434618","101","465","500",334,166,220,"58",162,0.485,0.3494,0.44,0.93
"13424",238458,"CARROLL COLLEGE",1,0,2001,"15860","30.960098","104","424","471",319,152,197,"48",149,0.4671,0.3158,0.4183,0.9002
"13425",238458,"CARROLL COLLEGE",1,0,2002,"16400","31.158046","99","492","529",324,205,240,"70",170,0.5247,0.3415,0.4537,0.9301
"13426",238458,"CARROLL COLLEGE",1,0,2003,"17020","31.526529","96","468","501",329,172,220,"62",158,0.4802,0.3605,0.4391,0.9341
"13427",238458,"CARROLL COLLEGE",1,0,2004,"17800","32.523373","94","543","616",405,211,234,"61",173,0.4272,0.2891,0.3799,0.8815
"13428",238458,"Carroll College",1,0,2005,"18650","34.14364","99","530","598",383,215,231,"63",168,0.4386,0.293,0.3863,0.8863
"13429",238458,"Carroll College",1,0,2006,"19500","36.871849","108","585","675",485,190,284,"58",226,0.466,0.3053,0.4207,0.8667
"13430",238458,"Carroll College",1,0,2007,"20400","39.359474","117","561","652",440,212,277,"88",189,0.4295,0.4151,0.4248,0.8604
"13431",238458,"Carroll University",1,0,2008,"21410","42.418385","113","577","655",447,208,263,"77",186,0.4161,0.3702,0.4015,0.8809
"13432",238458,"Carroll University",1,0,2009,"22470","45.332645","115","644","738",482,256,311,"102",209,0.4336,0.3984,0.4214,0.8726
"13433",238458,"Carroll University",1,0,2010,"23582","50.504183","121","654","751",502,249,386,"115",271,0.5398,0.4618,0.514,0.8708
"13434",238476,"CARTHAGE COLLEGE",1,0,1991,"10640","20.58779","75","358","401",227,174,183,"65",118,0.5198,0.3736,0.4564,0.8928
"13435",238476,"CARTHAGE COLLEGE",1,0,1992,"11525","22.481669","76","367","406",233,173,196,"80",116,0.4979,0.4624,0.4828,0.9039
"13436",238476,"CARTHAGE COLLEGE",1,0,1993,"12400","25.477544","81","399","441",227,214,216,"99",117,0.5154,0.4626,0.4898,0.9048
"13437",238476,"CARTHAGE COLLEGE",1,0,1995,"13850","31.37692","89","369","395",175,220,190,"89",101,0.5771,0.4045,0.481,0.9342
"13438",238476,"CARTHAGE COLLEGE",1,0,1996,"14600","33.517686","93","383","401",210,191,215,"87",128,0.6095,0.4555,0.5362,0.9551
"13439",238476,"CARTHAGE COLLEGE",1,0,1997,"15365","24.596852","93","364","395",201,194,174,"75",99,0.4925,0.3866,0.4405,0.9215
"13440",238476,"CARTHAGE COLLEGE",1,0,1998,"16060","25.558173","93","405","432",216,216,190,"86",104,0.4815,0.3981,0.4398,0.9375
"13441",238476,"CARTHAGE COLLEGE",1,0,1999,"16690","27.768046","91","389","427",216,211,190,"78",112,0.5185,0.3697,0.445,0.911
"13442",238476,"CARTHAGE COLLEGE",1,0,2000,"17350","31.081448","96.5","462","532",295,237,232,"91",141,0.478,0.384,0.4361,0.8684
"13443",238476,"CARTHAGE COLLEGE",1,0,2001,"18205","31.560557","102","478","578",280,298,237,"112",125,0.4464,0.3758,0.41,0.827
"13444",238476,"CARTHAGE COLLEGE",1,0,2002,"19150","36.405149","111","511","618",351,267,236,"84",152,0.433,0.3146,0.3819,0.8269
"13445",238476,"CARTHAGE COLLEGE",1,0,2003,"20150","39.218545","108","469","575",307,268,249,"103",146,0.4756,0.3843,0.433,0.8157
"13446",238476,"CARTHAGE COLLEGE",1,0,2004,"21250","40.674763","116","469","579",344,235,277,"101",176,0.5116,0.4298,0.4784,0.81
"13447",238476,"Carthage College",1,0,2005,"22500","44.394129","122","507","593",315,278,281,"120",161,0.5111,0.4317,0.4739,0.855
"13448",238476,"Carthage College",1,0,2006,"23650","44.555827","124","538","653",368,285,337,"136",201,0.5462,0.4772,0.5161,0.8239
"13449",238476,"Carthage College",1,0,2007,"25000","47.038801","135","575","683",350,333,371,"145",226,0.6457,0.4354,0.5432,0.8419
"13450",238476,"Carthage College",1,0,2008,"26500","51.38754","145","620","753",359,394,405,"192",213,0.5933,0.4873,0.5378,0.8234
"13451",238476,"Carthage College",1,0,2009,"28250","53.620349","145","597","721",351,370,359,"158",201,0.5726,0.427,0.4979,0.828
"13452",238476,"Carthage College",1,0,2010,"29750","58.587381","148","628","730",384,346,398,"164",234,0.6094,0.474,0.5452,0.8603
"13453",238616,"CONCORDIA UNIVERSITY-WISCONSIN",1,0,1991,"7400","10.921535","62","171","205",104,101,64,"27",37,0.3558,0.2673,0.3122,0.8341
"13454",238616,"CONCORDIA UNIVERSITY-WISCONSIN",1,0,1992,"8100","13.151337","68","158","183",103,80,69,"31",38,0.3689,0.3875,0.377,0.8634
"13455",238616,"CONCORDIA UNIVERSITY-WISCONSIN",1,0,1993,"8700","15.196757","74","246","289",139,150,81,"37",44,0.3165,0.2467,0.2803,0.8512
"13456",238616,"CONCORDIA UNIVERSITY-WISCONSIN",1,0,1995,"10000","20.770075","86","208","234",132,102,59,"21",38,0.2879,0.2059,0.2521,0.8889
"13457",238616,"CONCORDIA UNIVERSITY-WISCONSIN",1,0,1996,"10700","23.600003","96","213","254",138,116,117,"44",73,0.529,0.3793,0.4606,0.8386
"13458",238616,"CONCORDIA UNIVERSITY-WISCONSIN",1,0,1997,"11300","20.962472","91","237","253",147,106,128,"45",83,0.5646,0.4245,0.5059,0.9368
"13459",238616,"CONCORDIA UNIVERSITY-WISCONSIN",1,0,1998,"11900","24.032708","89","249","337",187,150,126,"46",80,0.4278,0.3067,0.3739,0.7389
"13460",238616,"CONCORDIA UNIVERSITY-WISCONSIN",1,0,1999,"12400","26.770069","95","260","321",197,124,104,"38",66,0.335,0.3065,0.324,0.81
"13461",238616,"CONCORDIA UNIVERSITY-WISCONSIN",1,0,2000,"12900","29.846117","93.5","239","285",169,116,106,"43",63,0.3728,0.3707,0.3719,0.8386
"13462",238616,"CONCORDIA UNIVERSITY-WISCONSIN",1,0,2001,"13550","30.287832","92","218","351",169,182,158,"82",76,0.4497,0.4505,0.4501,0.6211
"13463",238616,"CONCORDIA UNIVERSITY-WISCONSIN",1,0,2002,"14500","33.41554","93","217","287",139,148,96,"42",54,0.3885,0.2838,0.3345,0.7561
"13464",238616,"CONCORDIA UNIVERSITY-WISCONSIN",1,0,2003,"15590","35.94548","92","272","352",192,160,111,"35",76,0.3958,0.2188,0.3153,0.7727
"13465",238616,"CONCORDIA UNIVERSITY-WISCONSIN",1,0,2004,"16370","38.232124","89","309","363",198,165,145,"57",88,0.4444,0.3455,0.3994,0.8512
"13466",238616,"Concordia University-Wisconsin",1,0,2005,"17190","36.411362","93","315","386",207,179,134,"52",82,0.3961,0.2905,0.3472,0.8161
"13467",238616,"Concordia University-Wisconsin",1,0,2006,"18050","39.920942","89","320","391",214,177,135,"53",82,0.3832,0.2994,0.3453,0.8184
"13468",238616,"Concordia University-Wisconsin",1,0,2007,"18950","42.519072","95","363","422",232,190,143,"46",97,0.4181,0.2421,0.3389,0.8602
"13469",238616,"Concordia University-Wisconsin",1,0,2008,"19900","46.242073","99","330","402",222,180,139,"59",80,0.3604,0.3278,0.3458,0.8209
"13470",238616,"Concordia University-Wisconsin",1,0,2009,"20900","51.248978","110","401","468",266,202,171,"63",108,0.406,0.3119,0.3654,0.8568
"13471",238616,"Concordia University-Wisconsin",1,0,2010,"21940","54.921995","128","436","537",317,220,198,"71",127,0.4006,0.3227,0.3687,0.8119
"13472",238661,"EDGEWOOD COLLEGE",1,0,1991,"6950","7.569014","50","105","126",96,30,17,"1",16,0.1667,0.0333,0.1349,0.8333
"13473",238661,"EDGEWOOD COLLEGE",1,0,1992,"7500","9.41473","53","98","131",90,41,25,"7",18,0.2,0.1707,0.1908,0.7481
"13474",238661,"EDGEWOOD COLLEGE",1,0,1993,"8000","11.769807","59","127","161",121,40,42,"7",35,0.2893,0.175,0.2609,0.7888
"13475",238661,"EDGEWOOD COLLEGE",1,0,1995,"9000","14.582577","70","178","231",155,76,44,"10",34,0.2194,0.1316,0.1905,0.7706
"13476",238661,"EDGEWOOD COLLEGE",1,0,1996,"9500","15.954773","74","141","210",152,58,40,"4",36,0.2368,0.069,0.1905,0.6714
"13477",238661,"EDGEWOOD COLLEGE",1,0,1997,"10100","15.662562","73","151","222",164,58,53,"11",42,0.2561,0.1897,0.2387,0.6802
"13478",238661,"EDGEWOOD COLLEGE",1,0,1998,"10884","14.805698","76","134","213",157,56,55,"13",42,0.2675,0.2321,0.2582,0.6291
"13479",238661,"EDGEWOOD COLLEGE",1,0,1999,"11450","15.909089","75","108","196",132,64,49,"9",40,0.303,0.1406,0.25,0.551
"13480",238661,"EDGEWOOD COLLEGE",1,0,2000,"12250","17.355351","78.5","128","274",203,71,81,"13",68,0.335,0.1831,0.2956,0.4672
"13481",238661,"EDGEWOOD COLLEGE",1,0,2001,"13300","19.260852","82","145","291",203,88,70,"21",49,0.2414,0.2386,0.2405,0.4983
"13482",238661,"EDGEWOOD COLLEGE",1,0,2002,"14200","21.236539","86","237","271",205,66,70,"10",60,0.2927,0.1515,0.2583,0.8745
"13483",238661,"EDGEWOOD COLLEGE",1,0,2003,"15100","23.896081","92","260","307",229,78,85,"14",71,0.31,0.1795,0.2769,0.8469
"13484",238661,"EDGEWOOD COLLEGE",1,0,2004,"16050","26.152609","97","270","298",214,84,95,"20",75,0.3505,0.2381,0.3188,0.906
"13485",238661,"Edgewood College",1,0,2005,"17000","28.828473","97","256","281",210,71,77,"21",56,0.2667,0.2958,0.274,0.911
"13486",238661,"Edgewood College",1,0,2006,"18000","30.970762","100","258","293",220,73,101,"21",80,0.3636,0.2877,0.3447,0.8805
"13487",238661,"Edgewood College",1,0,2007,"19080","32.860727","102","261","302",202,100,98,"28",70,0.3465,0.28,0.3245,0.8642
"13488",238661,"Edgewood College",1,0,2008,"20040","35.487294","99","259","298",219,79,108,"29",79,0.3607,0.3671,0.3624,0.8691
"13489",238661,"Edgewood College",1,0,2009,"21042","37.597083","104","228","285",213,72,110,"27",83,0.3897,0.375,0.386,0.8
"13490",238661,"Edgewood College",1,0,2010,"21988","37.439849","106","284","324",243,81,130,"36",94,0.3868,0.4444,0.4012,0.8765
"13491",239080,"MARIAN COLLEGE OF FOND DU LAC",1,0,1991,"7500","10.111732","63","141","146",105,41,52,"10",42,0.4,0.2439,0.3562,0.9658
"13492",239080,"MARIAN COLLEGE OF FOND DU LAC",1,0,1992,"8120","12.451086","67","177","190",125,65,52,"14",38,0.304,0.2154,0.2737,0.9316
"13493",239080,"MARIAN COLLEGE OF FOND DU LAC",1,0,1993,"8650","14.681689","71","154","170",115,55,47,"12",35,0.3043,0.2182,0.2765,0.9059
"13494",239080,"MARIAN COLLEGE OF FOND DU LAC",1,0,1995,"10120","16.237759","70","170","184",117,67,44,"15",29,0.2479,0.2239,0.2391,0.9239
"13495",239080,"MARIAN COLLEGE OF FOND DU LAC",1,0,1996,"10730","17.345904","68","189","199",126,73,53,"21",32,0.254,0.2877,0.2663,0.9497
"13496",239080,"MARIAN COLLEGE OF FOND DU LAC",1,0,1997,"11370","15.802965","60","184","208",119,89,62,"16",46,0.3866,0.1798,0.2981,0.8846
"13497",239080,"MARIAN COLLEGE OF FOND DU LAC",1,0,1998,"11785","15.72104","60","174","204",137,67,64,"20",44,0.3212,0.2985,0.3137,0.8529
"13498",239080,"MARIAN COLLEGE OF FOND DU LAC",1,0,1999,"11966","16.637607","66","195","224",156,68,71,"17",54,0.3462,0.25,0.317,0.8705
"13499",239080,"MARIAN COLLEGE OF FOND DU LAC",1,0,2000,"12624","22.07121","66","212","245",180,65,85,"18",67,0.3722,0.2769,0.3469,0.8653
"13500",239080,"MARIAN COLLEGE OF FOND DU LAC",1,0,2001,"13230","19.326842","66","196","227",149,78,65,"18",47,0.3154,0.2308,0.2863,0.8634
"13501",239080,"MARIAN COLLEGE OF FOND DU LAC",1,0,2002,"13880","20.779308","71","203","247",176,71,52,"13",39,0.2216,0.1831,0.2105,0.8219
"13502",239080,"MARIAN COLLEGE OF FOND DU LAC",1,0,2003,"14700","22.482395","71","221","251",170,81,72,"17",55,0.3235,0.2099,0.2869,0.8805
"13503",239080,"MARIAN COLLEGE OF FOND DU LAC",1,0,2004,"15500","23.613682","73","227","270",191,79,84,"16",68,0.356,0.2025,0.3111,0.8407
"13504",239080,"Marian College of Fond du Lac",1,0,2005,"16380","24.827756","73","235","262",190,72,78,"17",61,0.3211,0.2361,0.2977,0.8969
"13505",239080,"Marian College of Fond du Lac",1,0,2006,"17300","27.217421","79","217","245",172,73,61,"15",46,0.2674,0.2055,0.249,0.8857
"13506",239080,"Marian College of Fond du Lac",1,0,2007,"18330","29.41101","83","220","266",191,75,80,"8",72,0.377,0.1067,0.3008,0.8271
"13507",239080,"Marian University-Wisconsin",1,0,2008,"19590","30.882963","83","232","284",210,74,103,"15",88,0.419,0.2027,0.3627,0.8169
"13508",239080,"Marian University",1,0,2009,"20550","32.065066","84","221","316",228,88,88,"19",69,0.3026,0.2159,0.2785,0.6994
"13509",239080,"Marian University",1,0,2010,"21140","29.993294","84","236","309",219,90,92,"12",80,0.3653,0.1333,0.2977,0.7638
"13510",239105,"MARQUETTE UNIVERSITY",1,0,1991,"9000","135.695138","492","1366","1598",852,746,870,"349",521,0.6115,0.4678,0.5444,0.8548
"13511",239105,"MARQUETTE UNIVERSITY",1,0,1992,"9900","146.871065","485","1370","1651",846,805,804,"322",482,0.5697,0.4,0.487,0.8298
"13512",239105,"MARQUETTE UNIVERSITY",1,0,1993,"10700","152.896725","483","1433","1684",895,789,880,"339",541,0.6045,0.4297,0.5226,0.851
"13513",239105,"MARQUETTE UNIVERSITY",1,0,1995,"13010","179.998","492","1380","1627",883,744,870,"327",543,0.6149,0.4395,0.5347,0.8482
"13514",239105,"MARQUETTE UNIVERSITY",1,0,1996,"14710","198.151","478","1191","1420",799,621,803,"303",500,0.6258,0.4879,0.5655,0.8387
"13515",239105,"MARQUETTE UNIVERSITY",1,0,1997,"15160","154.495","481","1321","1573",830,743,876,"351",525,0.6325,0.4724,0.5569,0.8398
"13516",239105,"MARQUETTE UNIVERSITY",1,0,1998,"15620","164.696","473","1488","1730",952,778,960,"355",605,0.6355,0.4563,0.5549,0.8601
"13517",239105,"MARQUETTE UNIVERSITY",1,0,1999,"16280","179.772","474","1497","1715",963,752,1064,"414",650,0.675,0.5505,0.6204,0.8729
"13518",239105,"MARQUETTE UNIVERSITY",1,0,2000,"17080","189.241","473","1426","1675",926,749,963,"404",559,0.6037,0.5394,0.5749,0.8513
"13519",239105,"MARQUETTE UNIVERSITY",1,0,2001,"18180","193.077","472","1410","1658",950,708,947,"374",573,0.6032,0.5282,0.5712,0.8504
"13520",239105,"MARQUETTE UNIVERSITY",1,0,2002,"19400","205.955","567","1574","1856",1034,822,1052,"433",619,0.5986,0.5268,0.5668,0.8481
"13521",239105,"MARQUETTE UNIVERSITY",1,0,2003,"20350","224.075","579","1648","1882",1042,840,1125,"462",663,0.6363,0.55,0.5978,0.8757
"13522",239105,"MARQUETTE UNIVERSITY",1,0,2004,"21550","243.286","589","1558","1802",979,823,1118,"454",664,0.6782,0.5516,0.6204,0.8646
"13523",239105,"Marquette University",1,0,2005,"22950","262.916","592","1488","1775",967,808,1083,"448",635,0.6567,0.5545,0.6101,0.8383
"13524",239105,"Marquette University",1,0,2006,"24670","277.026","600","1494","1842",1025,817,1096,"445",651,0.6351,0.5447,0.595,0.8111
"13525",239105,"Marquette University",1,0,2007,"26270","290.918","609","1500","1811",966,845,1038,"442",596,0.617,0.5231,0.5732,0.8283
"13526",239105,"Marquette University",1,0,2008,"27720","313.46","622","1630","1950",1043,907,1153,"481",672,0.6443,0.5303,0.5913,0.8359
"13527",239105,"Marquette University",1,0,2009,"28680","327.559","627","1583","1945",1005,940,1135,"505",630,0.6269,0.5372,0.5835,0.8139
"13528",239105,"Marquette University",1,0,2010,"30040","330.88","629","1524","1929",1015,914,1161,"504",657,0.6473,0.5514,0.6019,0.79
"13529",239628,"RIPON COLLEGE",1,0,1991,"12900","17.551131","71","144","164",84,80,86,"35",51,0.6071,0.4375,0.5244,0.878
"13530",239628,"RIPON COLLEGE",1,0,1992,"13170","18.769247","70","163","180",92,88,88,"32",56,0.6087,0.3636,0.4889,0.9056
"13531",239628,"RIPON COLLEGE",1,0,1993,"14340","19.797148","69","195","211",102,109,113,"47",66,0.6471,0.4312,0.5355,0.9242
"13532",239628,"RIPON COLLEGE",1,0,1995,"16110","22.811614","59","168","184",101,83,99,"42",57,0.5644,0.506,0.538,0.913
"13533",239628,"RIPON COLLEGE",1,0,1996,"17000","23.546026","61","146","169",97,72,81,"28",53,0.5464,0.3889,0.4793,0.8639
"13534",239628,"RIPON COLLEGE",1,0,1997,"17580","15.220737","58","116","135",62,73,71,"35",36,0.5806,0.4795,0.5259,0.8593
"13535",239628,"RIPON COLLEGE",1,0,1998,"18240","16.033509","60","150","162",66,96,99,"55",44,0.6667,0.5729,0.6111,0.9259
"13536",239628,"RIPON COLLEGE",1,0,1999,"18000","17.684661","61","247","283",156,127,174,"73",101,0.6474,0.5748,0.6148,0.8728
"13537",239628,"RIPON COLLEGE",1,0,2000,"18000","18.424463","59","242","280",166,114,171,"64",107,0.6446,0.5614,0.6107,0.8643
"13538",239628,"RIPON COLLEGE",1,0,2001,"19260","20.395089","57","178","200",108,92,119,"48",71,0.6574,0.5217,0.595,0.89
"13539",239628,"RIPON COLLEGE",1,0,2002,"19260","19.781812","48","214","250",116,134,139,"75",64,0.5517,0.5597,0.556,0.856
"13540",239628,"RIPON COLLEGE",1,0,2003,"19700","18.771387","51","225","259",130,129,156,"72",84,0.6462,0.5581,0.6023,0.8687
"13541",239628,"RIPON COLLEGE",1,0,2004,"20490","19.08297","49","165","202",114,88,115,"53",62,0.5439,0.6023,0.5693,0.8168
"13542",239628,"Ripon College",1,0,2005,"21310","19.770185","50","216","261",119,142,148,"70",78,0.6555,0.493,0.567,0.8276
"13543",239628,"Ripon College",1,0,2006,"22162","21.46129","50","229","264",154,110,153,"57",96,0.6234,0.5182,0.5795,0.8674
"13544",239628,"Ripon College",1,0,2007,"23048","21.818547","53","232","262",124,138,158,"78",80,0.6452,0.5652,0.6031,0.8855
"13545",239628,"Ripon College",1,0,2008,"23970","24.697671","56","239","282",143,139,145,"59",86,0.6014,0.4245,0.5142,0.8475
"13546",239628,"Ripon College",1,0,2009,"25170","27.186349","62","189","248",123,125,148,"68",80,0.6504,0.544,0.5968,0.7621
"13547",239628,"Ripon College",1,0,2010,"26806","28.342851","63","253","289",162,127,167,"66",101,0.6235,0.5197,0.5779,0.8754
"13548",239716,"SAINT NORBERT COLLEGE",1,0,1991,"10225","28.995476","110","430","442",262,180,288,"95",193,0.7366,0.5278,0.6516,0.9729
"13549",239716,"SAINT NORBERT COLLEGE",1,0,1992,"10805","30.379893","110","479","496",275,221,328,"142",186,0.6764,0.6425,0.6613,0.9657
"13550",239716,"SAINT NORBERT COLLEGE",1,0,1993,"11465","33.598495","109","538","569",320,249,352,"142",210,0.6562,0.5703,0.6186,0.9455
"13551",239716,"SAINT NORBERT COLLEGE",1,0,1995,"12940","38.692196","106","487","520",296,224,319,"112",207,0.6993,0.5,0.6135,0.9365
"13552",239716,"SAINT NORBERT COLLEGE",1,0,1996,"13700","41.653887","108","489","508",321,187,339,"121",218,0.6791,0.6471,0.6673,0.9626
"13553",239716,"SAINT NORBERT COLLEGE",1,0,1997,"14234","34.311875","111","447","480",288,192,324,"121",203,0.7049,0.6302,0.675,0.9312
"13554",239716,"SAINT NORBERT COLLEGE",1,0,1998,"14789","35.66321","100","418","460",247,213,282,"106",176,0.7126,0.4977,0.613,0.9087
"13555",239716,"SAINT NORBERT COLLEGE",1,0,1999,"15600","36.064222","100","480","519",296,223,332,"136",196,0.6622,0.6099,0.6397,0.9249
"13556",239716,"SAINT NORBERT COLLEGE",1,0,2000,"16570","36.636984","99","505","548",321,227,364,"128",236,0.7352,0.5639,0.6642,0.9215
"13557",239716,"SAINT NORBERT COLLEGE",1,0,2001,"17757","39.912485","98","514","558",306,252,359,"142",217,0.7092,0.5635,0.6434,0.9211
"13558",239716,"SAINT NORBERT COLLEGE",1,0,2002,"18834","42.584755","103","457","495",273,222,345,"134",211,0.7729,0.6036,0.697,0.9232
"13559",239716,"SAINT NORBERT COLLEGE",1,0,2003,"19822","45.281753","108","493","529",289,240,336,"128",208,0.7197,0.5333,0.6352,0.9319
"13560",239716,"SAINT NORBERT COLLEGE",1,0,2004,"21210","45.103746","103","464","520",298,222,364,"138",226,0.7584,0.6216,0.7,0.8923
"13561",239716,"Saint Norbert College",1,0,2005,"22209","44.231111","109","467","504",282,222,328,"147",181,0.6418,0.6622,0.6508,0.9266
"13562",239716,"Saint Norbert College",1,0,2006,"23097","45.15797","109","502","551",305,246,356,"140",216,0.7082,0.5691,0.6461,0.9111
"13563",239716,"Saint Norbert College",1,0,2007,"24253","47.074421","109","489","542",328,214,372,"130",242,0.7378,0.6075,0.6863,0.9022
"13564",239716,"Saint Norbert College",1,0,2008,"25526","50.282509","132","486","531",293,238,335,"131",204,0.6962,0.5504,0.6309,0.9153
"13565",239716,"Saint Norbert College",1,0,2009,"26522","52.365765","134","483","543",308,235,359,"135",224,0.7273,0.5745,0.6611,0.8895
"13566",239716,"Saint Norbert College",1,0,2010,"27583","55.122034","135","534","603",367,236,408,"144",264,0.7193,0.6102,0.6766,0.8856
"13567",240107,"VITERBO COLLEGE",1,0,1991,"7960","10.246939","72","187","201",145,56,63,"14",49,0.3379,0.25,0.3134,0.9303
"13568",240107,"VITERBO COLLEGE",1,0,1992,"8360","12.194277","75","214","218",151,67,61,"12",49,0.3245,0.1791,0.2798,0.9817
"13569",240107,"VITERBO COLLEGE",1,0,1993,"8770","13.226135","73","257","270",205,65,67,"14",53,0.2585,0.2154,0.2481,0.9519
"13570",240107,"VITERBO COLLEGE",1,0,1995,"9850","18.324238","80","308","335",224,111,92,"24",68,0.3036,0.2162,0.2746,0.9194
"13571",240107,"VITERBO COLLEGE",1,0,1996,"10560","21.077345","81","271","284",195,89,70,"10",60,0.3077,0.1124,0.2465,0.9542
"13572",240107,"VITERBO COLLEGE",1,0,1997,"11150","16.433943","82","313","331",240,91,96,"18",78,0.325,0.1978,0.29,0.9456
"13573",240107,"VITERBO COLLEGE",1,0,1998,"11690","17.742295","82","290","318",220,98,88,"21",67,0.3045,0.2143,0.2767,0.9119
"13574",240107,"VITERBO COLLEGE",1,0,1999,"12220","19.198671","83","290","311",235,76,111,"22",89,0.3787,0.2895,0.3569,0.9325
"13575",240107,"VITERBO UNIVERSITY",1,0,2000,"12770","20.467693","86.5","308","327",252,75,98,"16",82,0.3254,0.2133,0.2997,0.9419
"13576",240107,"VITERBO UNIVERSITY",1,0,2001,"13350","21.4346","90","313","335",254,81,97,"20",77,0.3031,0.2469,0.2896,0.9343
"13577",240107,"VITERBO UNIVERSITY",1,0,2002,"14020","22.857265","92","298","321",236,85,91,"19",72,0.3051,0.2235,0.2835,0.9283
"13578",240107,"VITERBO UNIVERSITY",1,0,2003,"14900","23.491829","96","330","355",261,94,107,"18",89,0.341,0.1915,0.3014,0.9296
"13579",240107,"VITERBO UNIVERSITY",1,0,2004,"15570","27.024337","106","286","308",210,98,82,"19",63,0.3,0.1939,0.2662,0.9286
"13580",240107,"Viterbo University",1,0,2005,"16240","29.930476","109","271","289",207,82,82,"11",71,0.343,0.1341,0.2837,0.9377
"13581",240107,"Viterbo University",1,0,2006,"17220","32.032155","110","275","308",223,85,100,"21",79,0.3543,0.2471,0.3247,0.8929
"13582",240107,"Viterbo University",1,0,2007,"18170","33.399391","109","341","361",252,109,108,"26",82,0.3254,0.2385,0.2992,0.9446
"13583",240107,"Viterbo University",1,0,2008,"19000","34.726349","107","337","357",250,107,102,"27",75,0.3,0.2523,0.2857,0.944
"13584",240107,"Viterbo University",1,0,2009,"19670","35.620824","112","373","405",287,118,119,"24",95,0.331,0.2034,0.2938,0.921
"13585",240107,"Viterbo University",1,0,2010,"20360","36.315846","119","309","340",242,98,103,"21",82,0.3388,0.2143,0.3029,0.9088
"13586",240189,"UNIVERSITY OF WISCONSIN-WHITEWATER",1,0,1991,"1914","70.767662","400","1596","1765",990,775,200,"60",140,0.1414,0.0774,0.1133,0.9042
"13587",240189,"UNIVERSITY OF WISCONSIN-WHITEWATER",1,0,1992,"2039","72.283721","388","1575","1746",933,813,204,"68",136,0.1458,0.0836,0.1168,0.9021
"13588",240189,"UNIVERSITY OF WISCONSIN-WHITEWATER",1,0,1993,"2178","80.429932","379","1671","1823",1019,804,251,"78",173,0.1698,0.097,0.1377,0.9166
"13589",240189,"UNIVERSITY OF WISCONSIN-WHITEWATER",1,0,1995,"2474","82.897165","368","1712","1856",989,867,294,"108",186,0.1881,0.1246,0.1584,0.9224
"13590",240189,"UNIVERSITY OF WISCONSIN-WHITEWATER",1,0,1996,"2586","84.50455","370","1704","1825",995,830,369,"137",232,0.2332,0.1651,0.2022,0.9337
"13591",240189,"UNIVERSITY OF WISCONSIN-WHITEWATER",1,0,1997,"2772","86.168338","366","1745","1881",944,937,349,"138",211,0.2235,0.1473,0.1855,0.9277
"13592",240189,"UNIVERSITY OF WISCONSIN-WHITEWATER",1,0,1998,"2919","89.734906","370","1756","1901",965,936,354,"122",232,0.2404,0.1303,0.1862,0.9237
"13593",240189,"UNIVERSITY OF WISCONSIN-WHITEWATER",1,0,1999,"2594","96.416468","365","1718","1877",1017,860,357,"119",238,0.234,0.1384,0.1902,0.9153
"13594",240189,"UNIVERSITY OF WISCONSIN-WHITEWATER",1,0,2000,"2594","100.981438","359.5","1829","2052",1051,1001,423,"155",268,0.255,0.1548,0.2061,0.8913
"13595",240189,"UNIVERSITY OF WISCONSIN-WHITEWATER",1,0,2001,"2776","108.850678","354","1681","1857",936,921,379,"153",226,0.2415,0.1661,0.2041,0.9052
"13596",240189,"UNIVERSITY OF WISCONSIN-WHITEWATER",1,0,2002,"3106","111.930035","366","1827","2004",1095,909,463,"176",287,0.2621,0.1936,0.231,0.9117
"13597",240189,"UNIVERSITY OF WISCONSIN-WHITEWATER",1,0,2003,"3623","104.639092","390","1604","1825",975,850,459,"199",260,0.2667,0.2341,0.2515,0.8789
"13598",240189,"UNIVERSITY OF WISCONSIN-WHITEWATER",1,0,2004,"4150","112.368658","395","1474","1745",836,909,427,"193",234,0.2799,0.2123,0.2447,0.8447
"13599",240189,"University of Wisconsin-Whitewater",1,0,2005,"4427","113.440881","412","1509","1701",823,878,437,"196",241,0.2928,0.2232,0.2569,0.8871
"13600",240189,"University of Wisconsin-Whitewater",1,0,2006,"4728","118.974991","423","1615","1780",836,944,533,"233",300,0.3589,0.2468,0.2994,0.9073
"13601",240189,"University of Wisconsin-Whitewater",1,0,2007,"4988","129.03101","409","1815","2048",993,1055,564,"258",306,0.3082,0.2445,0.2754,0.8862
"13602",240189,"University of Wisconsin-Whitewater",1,0,2008,"5262","136.584913","425","1859","2132",1025,1107,575,"276",299,0.2917,0.2493,0.2697,0.872
"13603",240189,"University of Wisconsin-Whitewater",1,0,2009,"5551","143.314928","423","1655","1941",941,1000,542,"250",292,0.3103,0.25,0.2792,0.8527
"13604",240189,"University of Wisconsin-Whitewater",1,0,2010,"5857","155.299504","430","1750","2033",973,1060,590,"267",323,0.332,0.2519,0.2902,0.8608
"13605",240277,"UNIVERSITY OF WISCONSIN-GREEN BAY",1,0,1991,"1806","37.847584","149","725","775",506,269,75,"21",54,0.1067,0.0781,0.0968,0.9355
"13606",240277,"UNIVERSITY OF WISCONSIN-GREEN BAY",1,0,1992,"1995","45.989897","153","715","780",487,293,85,"22",63,0.1294,0.0751,0.109,0.9167
"13607",240277,"UNIVERSITY OF WISCONSIN-GREEN BAY",1,0,1993,"2104","46.335354","157","678","703",438,265,96,"29",67,0.153,0.1094,0.1366,0.9644
"13608",240277,"UNIVERSITY OF WISCONSIN-GREEN BAY",1,0,1995,"2427","47.402331","146","755","780",522,258,98,"30",68,0.1303,0.1163,0.1256,0.9679
"13609",240277,"UNIVERSITY OF WISCONSIN-GREEN BAY",1,0,1996,"2548","48.861848","145","895","939",581,358,138,"48",90,0.1549,0.1341,0.147,0.9531
"13610",240277,"UNIVERSITY OF WISCONSIN-GREEN BAY",1,0,1997,"2736","50.242501","151","859","895",568,327,141,"39",102,0.1796,0.1193,0.1575,0.9598
"13611",240277,"UNIVERSITY OF WISCONSIN-GREEN BAY",1,0,1998,"2916","55.257513","147","906","946",612,334,155,"53",102,0.1667,0.1587,0.1638,0.9577
"13612",240277,"UNIVERSITY OF WISCONSIN-GREEN BAY",1,0,1999,"2594","60.606249","163","828","879",578,301,164,"45",119,0.2059,0.1495,0.1866,0.942
"13613",240277,"UNIVERSITY OF WISCONSIN-GREEN BAY",1,0,2000,"2594","68.351938","166","890","929",631,298,216,"55",161,0.2552,0.1846,0.2325,0.958
"13614",240277,"UNIVERSITY OF WISCONSIN-GREEN BAY",1,0,2001,"2776","70.218117","169","824","866",608,258,214,"45",169,0.278,0.1744,0.2471,0.9515
"13615",240277,"UNIVERSITY OF WISCONSIN-GREEN BAY",1,0,2002,"3000","65.007797","170","825","896",595,301,204,"55",149,0.2504,0.1827,0.2277,0.9208
"13616",240277,"UNIVERSITY OF WISCONSIN-GREEN BAY",1,0,2003,"3500","68.30934","177","896","960",640,320,241,"70",171,0.2672,0.2188,0.251,0.9333
"13617",240277,"UNIVERSITY OF WISCONSIN-GREEN BAY",1,0,2004,"4000","74.310334","183","910","989",636,353,228,"71",157,0.2469,0.2011,0.2305,0.9201
"13618",240277,"University of Wisconsin-Green Bay",1,0,2005,"4277","73.321227","183","838","904",587,317,198,"45",153,0.2606,0.142,0.219,0.927
"13619",240277,"University of Wisconsin-Green Bay",1,0,2006,"4568","70.725347","175","928","1019",667,352,226,"63",163,0.2444,0.179,0.2218,0.9107
"13620",240277,"University of Wisconsin-Green Bay",1,0,2007,"4819","70.189292","177","904","987",644,343,201,"42",159,0.2469,0.1224,0.2036,0.9159
"13621",240277,"University of Wisconsin-Green Bay",1,0,2008,"5084","74.561096","189","918","1000",614,386,236,"67",169,0.2752,0.1736,0.236,0.918
"13622",240277,"University of Wisconsin-Green Bay",1,0,2009,"5364","78.169057","188","928","1037",647,390,248,"58",190,0.2937,0.1487,0.2392,0.8949
"13623",240277,"University of Wisconsin-Green Bay",1,0,2010,"5659","83.83104","194","804","894",572,322,214,"46",168,0.2937,0.1429,0.2394,0.8993
"13624",240329,"UNIVERSITY OF WISCONSIN-LA CROSSE",1,0,1991,"1945","66.301566","362","1580","1648",959,689,159,"57",102,0.1064,0.0827,0.0965,0.9587
"13625",240329,"UNIVERSITY OF WISCONSIN-LA CROSSE",1,0,1992,"2076","68.989337","365","1390","1486",921,565,161,"42",119,0.1292,0.0743,0.1083,0.9354
"13626",240329,"UNIVERSITY OF WISCONSIN-LA CROSSE",1,0,1993,"2217","70.897325","369","1595","1695",1008,687,243,"83",160,0.1587,0.1208,0.1434,0.941
"13627",240329,"UNIVERSITY OF WISCONSIN-LA CROSSE",1,0,1995,"2513","79.554789","354","1643","1731",1035,696,324,"104",220,0.2126,0.1494,0.1872,0.9492
"13628",240329,"UNIVERSITY OF WISCONSIN-LA CROSSE",1,0,1996,"2633","82.750934","347","1650","1721",1074,647,393,"109",284,0.2644,0.1685,0.2284,0.9587
"13629",240329,"UNIVERSITY OF WISCONSIN-LA CROSSE",1,0,1997,"2857","87.987605","342","1620","1700",1042,658,386,"108",278,0.2668,0.1641,0.2271,0.9529
"13630",240329,"UNIVERSITY OF WISCONSIN-LA CROSSE",1,0,1998,"3009","94.408006","345","1649","1740",1123,617,450,"128",322,0.2867,0.2075,0.2586,0.9477
"13631",240329,"UNIVERSITY OF WISCONSIN-LA CROSSE",1,0,1999,"2594","89.61818","340","1544","1631",1035,596,395,"128",267,0.258,0.2148,0.2422,0.9467
"13632",240329,"UNIVERSITY OF WISCONSIN-LA CROSSE",1,0,2000,"2594","104.076608","347","1501","1609",1009,600,420,"131",289,0.2864,0.2183,0.261,0.9329
"13633",240329,"UNIVERSITY OF WISCONSIN-LA CROSSE",1,0,2001,"2776","111.661912","354","1504","1596",1022,574,444,"138",306,0.2994,0.2404,0.2782,0.9424
"13634",240329,"UNIVERSITY OF WISCONSIN-LA CROSSE",1,0,2002,"3000","101.219435","349","1456","1555",1006,549,463,"128",335,0.333,0.2332,0.2977,0.9363
"13635",240329,"UNIVERSITY OF WISCONSIN-LA CROSSE",1,0,2003,"3540","102.155666","356","1398","1506",984,522,507,"153",354,0.3598,0.2931,0.3367,0.9283
"13636",240329,"UNIVERSITY OF WISCONSIN-LA CROSSE",1,0,2004,"4040","105.974865","358","1411","1539",958,581,498,"157",341,0.3559,0.2702,0.3236,0.9168
"13637",240329,"University of Wisconsin-La Crosse",1,0,2005,"4331","106.68451","360","1611","1755",1056,699,579,"176",403,0.3816,0.2518,0.3299,0.9179
"13638",240329,"University of Wisconsin-La Crosse",1,0,2006,"4623","110.896755","357","1585","1751",1098,653,633,"190",443,0.4035,0.291,0.3615,0.9052
"13639",240329,"University of Wisconsin-La Crosse",1,0,2007,"4876","116.26802","370","1558","1750",1084,666,621,"196",425,0.3921,0.2943,0.3549,0.8903
"13640",240329,"University of Wisconsin-La Crosse",1,0,2008,"5643","118.234747","360","1573","1779",1081,698,577,"192",385,0.3562,0.2751,0.3243,0.8842
"13641",240329,"University of Wisconsin-La Crosse",1,0,2009,"6425","129.04209","384","1608","1826",1128,698,660,"193",467,0.414,0.2765,0.3614,0.8806
"13642",240329,"University of Wisconsin-La Crosse",1,0,2010,"6809","138.852427","404","1648","1836",1093,743,660,"209",451,0.4126,0.2813,0.3595,0.8976
"13643",240338,"WISCONSIN LUTHERAN COLLEGE",1,0,1991,"7500","5.282816","22","69","71",45,26,20,"8",12,0.2667,0.3077,0.2817,0.9718
"13644",240338,"WISCONSIN LUTHERAN COLLEGE",1,0,1992,"8280","6.872634","24","73","77",45,32,22,"7",15,0.3333,0.2188,0.2857,0.9481
"13645",240338,"WISCONSIN LUTHERAN COLLEGE",1,0,1993,"8600","6.519208","25","74","80",55,25,31,"10",21,0.3818,0.4,0.3875,0.925
"13646",240338,"WISCONSIN LUTHERAN COLLEGE",1,0,1995,"9940","8.307274","29","105","109",63,46,51,"18",33,0.5238,0.3913,0.4679,0.9633
"13647",240338,"WISCONSIN LUTHERAN COLLEGE",1,0,1996,"11000","7.025154","31","95","101",71,30,55,"12",43,0.6056,0.4,0.5446,0.9406
"13648",240338,"WISCONSIN LUTHERAN COLLEGE",1,0,1997,"11450","7.533418","29","104","109",61,48,50,"21",29,0.4754,0.4375,0.4587,0.9541
"13649",240338,"WISCONSIN LUTHERAN COLLEGE",1,0,1998,"11960","8.8766","33","120","124",80,44,60,"20",40,0.5,0.4545,0.4839,0.9677
"13650",240338,"WISCONSIN LUTHERAN COLLEGE",1,0,1999,"12460","10.759044","39","149","161",92,69,79,"23",56,0.6087,0.3333,0.4907,0.9255
"13651",240338,"WISCONSIN LUTHERAN COLLEGE",1,0,2000,"12980","12.183624","42","184","194",125,69,91,"33",58,0.464,0.4783,0.4691,0.9485
"13652",240338,"WISCONSIN LUTHERAN COLLEGE",1,0,2001,"13990","15.208885","45","194","200",124,76,96,"31",65,0.5242,0.4079,0.48,0.97
"13653",240338,"WISCONSIN LUTHERAN COLLEGE",1,0,2002,"14970","15.629203","50","147","158",88,70,79,"31",48,0.5455,0.4429,0.5,0.9304
"13654",240338,"WISCONSIN LUTHERAN COLLEGE",1,0,2003,"15720","16.281884","43","196","207",126,81,110,"31",79,0.627,0.3827,0.5314,0.9469
"13655",240338,"WISCONSIN LUTHERAN COLLEGE",1,0,2004,"16510","17.308235","44","173","186",112,74,79,"28",51,0.4554,0.3784,0.4247,0.9301
"13656",240338,"Wisconsin Lutheran College",1,0,2005,"17340","19.99759","50","172","180",110,70,81,"33",48,0.4364,0.4714,0.45,0.9556
"13657",240338,"Wisconsin Lutheran College",1,0,2006,"18520","23.262883","57","184","198",116,82,81,"31",50,0.431,0.378,0.4091,0.9293
"13658",240338,"Wisconsin Lutheran College",1,0,2007,"19430","25.696017","61","155","181",97,84,82,"34",48,0.4948,0.4048,0.453,0.8564
"13659",240338,"Wisconsin Lutheran College",1,0,2008,"20420","26.070924","60","190","223",128,95,110,"43",67,0.5234,0.4526,0.4933,0.852
"13660",240338,"Wisconsin Lutheran College",1,0,2009,"21040","26.394378","61","176","202",104,98,89,"33",56,0.5385,0.3367,0.4406,0.8713
"13661",240338,"Wisconsin Lutheran College",1,0,2010,"21820","24.65726","58","206","246",136,110,108,"32",76,0.5588,0.2909,0.439,0.8374
"13662",240365,"UNIVERSITY OF WISCONSIN-OSHKOSH",1,0,1991,"1821","77.288906","382","1314","1411",787,624,136,"31",105,0.1334,0.0497,0.0964,0.9313
"13663",240365,"UNIVERSITY OF WISCONSIN-OSHKOSH",1,0,1992,"1927","79.787583","372","1356","1461",834,627,172,"32",140,0.1679,0.051,0.1177,0.9281
"13664",240365,"UNIVERSITY OF WISCONSIN-OSHKOSH",1,0,1993,"2037","83.172978","356","1368","1465",833,632,200,"53",147,0.1765,0.0839,0.1365,0.9338
"13665",240365,"UNIVERSITY OF WISCONSIN-OSHKOSH",1,0,1995,"2300","90.292715","340","1428","1487",844,643,211,"74",137,0.1623,0.1151,0.1419,0.9603
"13666",240365,"UNIVERSITY OF WISCONSIN-OSHKOSH",1,0,1996,"2417","91.847798","350","1432","1501",855,646,227,"65",162,0.1895,0.1006,0.1512,0.954
"13667",240365,"UNIVERSITY OF WISCONSIN-OSHKOSH",1,0,1997,"2607","93.128885","360","1656","1719",994,725,242,"69",173,0.174,0.0952,0.1408,0.9634
"13668",240365,"UNIVERSITY OF WISCONSIN-OSHKOSH",1,0,1998,"2780","97.982638","382","1820","1894",1095,799,252,"67",185,0.1689,0.0839,0.1331,0.9609
"13669",240365,"UNIVERSITY OF WISCONSIN-OSHKOSH",1,0,1999,"2594","103.847194","360","1750","1834",1084,750,284,"85",199,0.1836,0.1133,0.1549,0.9542
"13670",240365,"UNIVERSITY OF WISCONSIN-OSHKOSH",1,0,2000,"2594","108.7502","342","1550","1624",969,655,236,"65",171,0.1765,0.0992,0.1453,0.9544
"13671",240365,"UNIVERSITY OF WISCONSIN-OSHKOSH",1,0,2001,"2776","116.444668","324","1726","1822",994,828,249,"86",163,0.164,0.1039,0.1367,0.9473
"13672",240365,"UNIVERSITY OF WISCONSIN-OSHKOSH",1,0,2002,"3000","112.329671","341","1669","1775",1045,730,259,"71",188,0.1799,0.0973,0.1459,0.9403
"13673",240365,"UNIVERSITY OF WISCONSIN-OSHKOSH",1,0,2003,"3551","124.327261","368","1641","1765",1077,688,261,"67",194,0.1801,0.0974,0.1479,0.9297
"13674",240365,"UNIVERSITY OF WISCONSIN-OSHKOSH",1,0,2004,"4110","132.347924","405","1577","1708",1033,675,250,"78",172,0.1665,0.1156,0.1464,0.9233
"13675",240365,"University of Wisconsin-Oshkosh",1,0,2005,"4387","129.585732","385","1471","1617",982,635,234,"81",153,0.1558,0.1276,0.1447,0.9097
"13676",240365,"University of Wisconsin-Oshkosh",1,0,2006,"4678","134.374606","377","1575","1726",1024,702,272,"83",189,0.1846,0.1182,0.1576,0.9125
"13677",240365,"University of Wisconsin-Oshkosh",1,0,2007,"4929","139.709558","386","1576","1723",1018,705,300,"96",204,0.2004,0.1362,0.1741,0.9147
"13678",240365,"University of Wisconsin-Oshkosh",1,0,2008,"5194","149.048664","389","1618","1807",1048,759,294,"112",182,0.1737,0.1476,0.1627,0.8954
"13679",240365,"University of Wisconsin-Oshkosh",1,0,2009,"5477","159.310702","413","1680","1874",1061,813,274,"95",179,0.1687,0.1169,0.1462,0.8965
"13680",240365,"University of Wisconsin-Oshkosh",1,0,2010,"5775","166.346529","424","1610","1817",1039,778,328,"116",212,0.204,0.1491,0.1805,0.8861
"13681",240374,"UNIVERSITY OF WISCONSIN-PARKSIDE",1,0,1991,"1863","33.841447","164","556","627",333,294,29,"11",18,0.0541,0.0374,0.0463,0.8868
"13682",240374,"UNIVERSITY OF WISCONSIN-PARKSIDE",1,0,1992,"1990","34.963095","161","549","633",321,312,32,"14",18,0.0561,0.0449,0.0506,0.8673
"13683",240374,"UNIVERSITY OF WISCONSIN-PARKSIDE",1,0,1993,"2113","35.422157","163","566","668",355,313,51,"17",34,0.0958,0.0543,0.0763,0.8473
"13684",240374,"UNIVERSITY OF WISCONSIN-PARKSIDE",1,0,1995,"2406","38.350656","158","532","637",369,268,42,"13",29,0.0786,0.0485,0.0659,0.8352
"13685",240374,"UNIVERSITY OF WISCONSIN-PARKSIDE",1,0,1996,"2523","38.680288","157","530","606",354,252,49,"14",35,0.0989,0.0556,0.0809,0.8746
"13686",240374,"UNIVERSITY OF WISCONSIN-PARKSIDE",1,0,1997,"2705","39.210083","153","583","726",440,286,87,"24",63,0.1432,0.0839,0.1198,0.803
"13687",240374,"UNIVERSITY OF WISCONSIN-PARKSIDE",1,0,1998,"2840","41.819555","143","644","790",441,349,83,"24",59,0.1338,0.0688,0.1051,0.8152
"13688",240374,"UNIVERSITY OF WISCONSIN-PARKSIDE",1,0,1999,"2594","44.927893","152","644","811",419,392,78,"30",48,0.1146,0.0765,0.0962,0.7941
"13689",240374,"UNIVERSITY OF WISCONSIN-PARKSIDE",1,0,2000,"2594","49.777471","157.5","578","747",413,334,82,"31",51,0.1235,0.0928,0.1098,0.7738
"13690",240374,"UNIVERSITY OF WISCONSIN-PARKSIDE",1,0,2001,"2776","53.965203","163","678","854",486,368,84,"21",63,0.1296,0.0571,0.0984,0.7939
"13691",240374,"UNIVERSITY OF WISCONSIN-PARKSIDE",1,0,2002,"3000","48.108757","177","627","760",418,342,70,"24",46,0.11,0.0702,0.0921,0.825
"13692",240374,"UNIVERSITY OF WISCONSIN-PARKSIDE",1,0,2003,"3500","50.187817","170","713","863",469,394,68,"27",41,0.0874,0.0685,0.0788,0.8262
"13693",240374,"UNIVERSITY OF WISCONSIN-PARKSIDE",1,0,2004,"4000","53.272728","174","670","890",491,399,87,"34",53,0.1079,0.0852,0.0978,0.7528
"13694",240374,"University of Wisconsin-Parkside",1,0,2005,"4277","56.16469","170","582","783",442,341,61,"27",34,0.0769,0.0792,0.0779,0.7433
"13695",240374,"University of Wisconsin-Parkside",1,0,2006,"4568","57.452913","175","587","814",442,372,60,"18",42,0.095,0.0484,0.0737,0.7211
"13696",240374,"University of Wisconsin-Parkside",1,0,2007,"4819","58.491679","171","600","833",418,415,75,"38",37,0.0885,0.0916,0.09,0.7203
"13697",240374,"University of Wisconsin-Parkside",1,0,2008,"5084","59.658644","173","544","833",420,413,70,"36",34,0.081,0.0872,0.084,0.6531
"13698",240374,"University of Wisconsin-Parkside",1,0,2009,"5364","66.352545","174","557","788",427,361,88,"31",57,0.1335,0.0859,0.1117,0.7069
"13699",240374,"University of Wisconsin-Parkside",1,0,2010,"5659","75.508969","177","492","711",355,356,40,"14",26,0.0732,0.0393,0.0563,0.692
"13700",240417,"UNIVERSITY OF WISCONSIN-STOUT",1,0,1991,"1933","71.575546","310","1086","1158",606,552,77,"19",58,0.0957,0.0344,0.0665,0.9378
"13701",240417,"UNIVERSITY OF WISCONSIN-STOUT",1,0,1992,"2054","73.160475","298","909","988",530,458,114,"25",89,0.1679,0.0546,0.1154,0.92
"13702",240417,"UNIVERSITY OF WISCONSIN-STOUT",1,0,1993,"2175","74.692344","300","962","1023",488,535,143,"36",107,0.2193,0.0673,0.1398,0.9404
"13703",240417,"UNIVERSITY OF WISCONSIN-STOUT",1,0,1995,"2461","79.93944","287","1085","1133",542,591,143,"36",107,0.1974,0.0609,0.1262,0.9576
"13704",240417,"UNIVERSITY OF WISCONSIN-STOUT",1,0,1996,"2619","78.278898","294","1226","1275",644,631,194,"61",133,0.2065,0.0967,0.1522,0.9616
"13705",240417,"UNIVERSITY OF WISCONSIN-STOUT",1,0,1997,"2806","79.910277","276","1185","1241",604,637,170,"47",123,0.2036,0.0738,0.137,0.9549
"13706",240417,"UNIVERSITY OF WISCONSIN-STOUT",1,0,1998,"2938","89.080487","290","1287","1333",614,719,209,"74",135,0.2199,0.1029,0.1568,0.9655
"13707",240417,"UNIVERSITY OF WISCONSIN-STOUT",1,0,1999,"2724","93.349135","282","1259","1317",661,656,185,"57",128,0.1936,0.0869,0.1405,0.956
"13708",240417,"UNIVERSITY OF WISCONSIN-STOUT",1,0,2000,"2724","98.961355","276.5","1258","1307",668,639,195,"58",137,0.2051,0.0908,0.1492,0.9625
"13709",240417,"UNIVERSITY OF WISCONSIN-STOUT",1,0,2001,"2916","109.955008","271","1225","1272",652,620,202,"62",140,0.2147,0.1,0.1588,0.9631
"13710",240417,"UNIVERSITY OF WISCONSIN-STOUT",1,0,2002,"3150","94.220904","282","1243","1303",658,645,219,"51",168,0.2553,0.0791,0.1681,0.954
"13711",240417,"UNIVERSITY OF WISCONSIN-STOUT",1,0,2003,"5024","97.823313","295","1216","1267",654,613,244,"75",169,0.2584,0.1223,0.1926,0.9597
"13712",240417,"UNIVERSITY OF WISCONSIN-STOUT",1,0,2004,"5580","101.31888","310","1178","1277",649,628,254,"67",187,0.2881,0.1067,0.1989,0.9225
"13713",240417,"University of Wisconsin-Stout",1,0,2005,"4745","102.352856","304","1565","1699",863,836,322,"103",219,0.2538,0.1232,0.1895,0.9211
"13714",240417,"University of Wisconsin-Stout",1,0,2006,"5087","111.06355","312","1394","1507",792,715,275,"90",185,0.2336,0.1259,0.1825,0.925
"13715",240417,"University of Wisconsin-Stout",1,0,2007,"5367","114.260199","308","1375","1489",763,726,309,"108",201,0.2634,0.1488,0.2075,0.9234
"13716",240417,"University of Wisconsin-Stout",1,0,2008,"5662","121.491356","327","1502","1633",837,796,313,"103",210,0.2509,0.1294,0.1917,0.9198
"13717",240417,"University of Wisconsin-Stout",1,0,2009,"5974","127.833803","336","1395","1517",788,729,350,"111",239,0.3033,0.1523,0.2307,0.9196
"13718",240417,"University of Wisconsin-Stout",1,0,2010,"6302","135.142055","333","1428","1571",756,815,324,"124",200,0.2646,0.1521,0.2062,0.909
"13719",240426,"UNIVERSITY OF WISCONSIN-SUPERIOR",1,0,1991,"1806","27.711058","90","420","443",220,223,24,"10",14,0.0636,0.0448,0.0542,0.9481
"13720",240426,"UNIVERSITY OF WISCONSIN-SUPERIOR",1,0,1992,"1917","28.918791","101","319","350",189,161,35,"14",21,0.1111,0.087,0.1,0.9114
"13721",240426,"UNIVERSITY OF WISCONSIN-SUPERIOR",1,0,1993,"2036","29.303042","100","306","323",182,141,41,"14",27,0.1484,0.0993,0.1269,0.9474
"13722",240426,"UNIVERSITY OF WISCONSIN-SUPERIOR",1,0,1995,"2335","31.664442","95","268","288",173,115,52,"17",35,0.2023,0.1478,0.1806,0.9306
"13723",240426,"UNIVERSITY OF WISCONSIN-SUPERIOR",1,0,1996,"2463","31.330124","97","286","308",158,150,42,"13",29,0.1835,0.0867,0.1364,0.9286
"13724",240426,"UNIVERSITY OF WISCONSIN-SUPERIOR",1,0,1997,"2652","32.134265","102","300","326",182,144,36,"13",23,0.1264,0.0903,0.1104,0.9202
"13725",240426,"UNIVERSITY OF WISCONSIN-SUPERIOR",1,0,1998,"2770","34.402788","98","356","376",218,158,55,"16",39,0.1789,0.1013,0.1463,0.9468
"13726",240426,"UNIVERSITY OF WISCONSIN-SUPERIOR",1,0,1999,"2594","37.191845","106","387","406",241,165,38,"6",32,0.1328,0.0364,0.0936,0.9532
"13727",240426,"UNIVERSITY OF WISCONSIN-SUPERIOR",1,0,2000,"2594","40.911808","100.5","367","395",234,161,57,"21",36,0.1538,0.1304,0.1443,0.9291
"13728",240426,"UNIVERSITY OF WISCONSIN-SUPERIOR",1,0,2001,"2776","45.64373","95","297","339",192,147,53,"24",29,0.151,0.1633,0.1563,0.8761
"13729",240426,"UNIVERSITY OF WISCONSIN-SUPERIOR",1,0,2002,"3000","35.372016","97","254","286",150,136,37,"15",22,0.1467,0.1103,0.1294,0.8881
"13730",240426,"UNIVERSITY OF WISCONSIN-SUPERIOR",1,0,2003,"3650","35.254777","113","303","336",213,123,66,"14",52,0.2441,0.1138,0.1964,0.9018
"13731",240426,"UNIVERSITY OF WISCONSIN-SUPERIOR",1,0,2004,"4150","40.046105","114","293","329",190,139,54,"20",34,0.1789,0.1439,0.1641,0.8906
"13732",240426,"University of Wisconsin-Superior",1,0,2005,"4427","39.725064","114","290","336",208,128,61,"11",50,0.2404,0.0859,0.1815,0.8631
"13733",240426,"University of Wisconsin-Superior",1,0,2006,"4718","45.98148","115","255","293",143,150,53,"26",27,0.1888,0.1733,0.1809,0.8703
"13734",240426,"University of Wisconsin-Superior",1,0,2007,"4969","44.656559","116","307","343",197,146,47,"14",33,0.1675,0.0959,0.137,0.895
"13735",240426,"University of Wisconsin-Superior",1,0,2008,"5291","45.307272","114","259","303",168,135,59,"15",44,0.2619,0.1111,0.1947,0.8548
"13736",240426,"University of Wisconsin-Superior",1,0,2009,"5571","50.764722","116","297","364",194,170,58,"22",36,0.1856,0.1294,0.1593,0.8159
"13737",240426,"University of Wisconsin-Superior",1,0,2010,"5866","57.002818","126","303","369",197,172,80,"27",53,0.269,0.157,0.2168,0.8211
"13738",240444,"UNIVERSITY OF WISCONSIN-MADISON",1,0,1991,"2188","1192.036811","1647","4138","4582",2387,2195,1516,"589",927,0.3884,0.2683,0.3309,0.9031
"13739",240444,"UNIVERSITY OF WISCONSIN-MADISON",1,0,1992,"2346","1263.373043","1641","3910","4390",2244,2146,1514,"599",915,0.4078,0.2791,0.3449,0.8907
"13740",240444,"UNIVERSITY OF WISCONSIN-MADISON",1,0,1993,"2540","1343.045292","1637","4052","4585",2396,2189,1686,"659",1027,0.4286,0.3011,0.3677,0.8838
"13741",240444,"UNIVERSITY OF WISCONSIN-MADISON",1,0,1995,"2881","1401.707301","1495","4547","5101",2779,2322,2037,"768",1269,0.4566,0.3307,0.3993,0.8914
"13742",240444,"UNIVERSITY OF WISCONSIN-MADISON",1,0,1996,"3030","1437.810172","1474","4772","5394",2954,2440,2090,"769",1321,0.4472,0.3152,0.3875,0.8847
"13743",240444,"UNIVERSITY OF WISCONSIN-MADISON",1,0,1997,"3241","1205.241497","1421","5148","5828",3156,2672,2303,"835",1468,0.4651,0.3125,0.3952,0.8833
"13744",240444,"UNIVERSITY OF WISCONSIN-MADISON",1,0,1998,"3408","1301.522564","1436","4850","5548",3038,2510,2190,"844",1346,0.4431,0.3363,0.3947,0.8742
"13745",240444,"UNIVERSITY OF WISCONSIN-MADISON",1,0,1999,"3290","1332.182882","1397","4831","5520",2985,2535,2263,"847",1416,0.4744,0.3341,0.41,0.8752
"13746",240444,"UNIVERSITY OF WISCONSIN-MADISON",1,0,2000,"3290","1479.290777","1445.5","4979","5636",3120,2516,2500,"963",1537,0.4926,0.3828,0.4436,0.8834
"13747",240444,"UNIVERSITY OF WISCONSIN-MADISON",1,0,2001,"3658","1610.3083","1494","5223","6050",3370,2680,2758,"1046",1712,0.508,0.3903,0.4559,0.8633
"13748",240444,"UNIVERSITY OF WISCONSIN-MADISON",1,0,2002,"3854","1536.515881","1461","4742","5488",3016,2472,2729,"1037",1692,0.561,0.4195,0.4973,0.8641
"13749",240444,"UNIVERSITY OF WISCONSIN-MADISON",1,0,2003,"4554","1643.577596","1614","4649","5553",2968,2585,2689,"1114",1575,0.5307,0.4309,0.4842,0.8372
"13750",240444,"UNIVERSITY OF WISCONSIN-MADISON",1,0,2004,"5254","1796.248705","1623","4607","5617",3124,2493,2792,"1096",1696,0.5429,0.4396,0.4971,0.8202
"13751",240444,"University of Wisconsin-Madison",1,0,2005,"5618","1878.040572","1646","4942","6118",3434,2684,3174,"1255",1919,0.5588,0.4676,0.5188,0.8078
"13752",240444,"University of Wisconsin-Madison",1,0,2006,"6000","1931.143253","1686","4458","5633",3033,2600,2965,"1202",1763,0.5813,0.4623,0.5264,0.7914
"13753",240444,"University of Wisconsin-Madison",1,0,2007,"6330","1988.673506","1650","4658","5980",3197,2783,3291,"1332",1959,0.6128,0.4786,0.5503,0.7789
"13754",240444,"University of Wisconsin-Madison",1,0,2008,"6678","2125.029369","1641","4465","5759",3027,2732,3148,"1333",1815,0.5996,0.4879,0.5466,0.7753
"13755",240444,"University of Wisconsin-Madison",1,0,2009,"7296","2277.086731","1658","4394","5673",3033,2640,3179,"1277",1902,0.6271,0.4837,0.5604,0.7745
"13756",240444,"University of Wisconsin-Madison",1,0,2010,"7933","2298.77243","1665","4676","5920",3108,2812,3337,"1328",2009,0.6464,0.4723,0.5637,0.7899
"13757",240453,"UNIVERSITY OF WISCONSIN-MILWAUKEE",1,0,1991,"2231","209.217843","813","1241","1392",730,662,145,"53",92,0.126,0.0801,0.1042,0.8915
"13758",240453,"UNIVERSITY OF WISCONSIN-MILWAUKEE",1,0,1992,"2391","217.583793","806","1056","1187",566,621,113,"40",73,0.129,0.0644,0.0952,0.8896
"13759",240453,"UNIVERSITY OF WISCONSIN-MILWAUKEE",1,0,1993,"2548","226.457268","797","1411","1712",849,863,117,"51",66,0.0777,0.0591,0.0683,0.8242
"13760",240453,"UNIVERSITY OF WISCONSIN-MILWAUKEE",1,0,1995,"2947","240.596115","782","1467","1785",926,859,186,"75",111,0.1199,0.0873,0.1042,0.8218
"13761",240453,"UNIVERSITY OF WISCONSIN-MILWAUKEE",1,0,1996,"3102","242.063118","754","1690","2033",1113,920,233,"88",145,0.1303,0.0957,0.1146,0.8313
"13762",240453,"UNIVERSITY OF WISCONSIN-MILWAUKEE",1,0,1997,"3327","248.659129","743","1866","2272",1263,1009,327,"124",203,0.1607,0.1229,0.1439,0.8213
"13763",240453,"UNIVERSITY OF WISCONSIN-MILWAUKEE",1,0,1998,"3482","266.259641","724","2019","2513",1367,1146,273,"102",171,0.1251,0.089,0.1086,0.8034
"13764",240453,"UNIVERSITY OF WISCONSIN-MILWAUKEE",1,0,1999,"3194","281.714543","751","2243","2694",1523,1171,356,"127",229,0.1504,0.1085,0.1321,0.8326
"13765",240453,"UNIVERSITY OF WISCONSIN-MILWAUKEE",1,0,2000,"3194","290.831192","763","2187","2663",1449,1214,395,"142",253,0.1746,0.117,0.1483,0.8213
"13766",240453,"UNIVERSITY OF WISCONSIN-MILWAUKEE",1,0,2001,"3462","324.949071","775","2335","2884",1532,1352,423,"160",263,0.1717,0.1183,0.1467,0.8096
"13767",240453,"UNIVERSITY OF WISCONSIN-MILWAUKEE",1,0,2002,"3738","320.909434","809","2633","3178",1736,1442,457,"175",282,0.1624,0.1214,0.1438,0.8285
"13768",240453,"UNIVERSITY OF WISCONSIN-MILWAUKEE",1,0,2003,"4439","333.801501","902","3089","3716",2023,1693,552,"217",335,0.1656,0.1282,0.1485,0.8313
"13769",240453,"UNIVERSITY OF WISCONSIN-MILWAUKEE",1,0,2004,"5138","351.388831","935","3051","3714",2000,1714,555,"216",339,0.1695,0.126,0.1494,0.8215
"13770",240453,"University of Wisconsin-Milwaukee",1,0,2005,"5494","371.98765","964","3456","4218",2233,1985,604,"258",346,0.1549,0.13,0.1432,0.8193
"13771",240453,"University of Wisconsin-Milwaukee",1,0,2006,"5868","389.710029","991","3280","3977",2064,1913,554,"247",307,0.1487,0.1291,0.1393,0.8247
"13772",240453,"University of Wisconsin-Milwaukee",1,0,2007,"6191","419.625586","996","3619","4465",2228,2237,585,"259",326,0.1463,0.1158,0.131,0.8105
"13773",240453,"University of Wisconsin-Milwaukee",1,0,2008,"6531","443.326857","1022","3124","4002",2100,1902,572,"246",326,0.1552,0.1293,0.1429,0.7806
"13774",240453,"University of Wisconsin-Milwaukee",1,0,2009,"6890","460.903168","1041","3138","4051",2020,2031,578,"250",328,0.1624,0.1231,0.1427,0.7746
"13775",240453,"University of Wisconsin-Milwaukee",1,0,2010,"7269","487.327861","1075","2737","3731",1876,1855,506,"225",281,0.1498,0.1213,0.1356,0.7336
"13776",240462,"UNIVERSITY OF WISCONSIN-PLATTEVILLE",1,0,1991,"1955","48.09629","227","939","986",339,647,110,"56",54,0.1593,0.0866,0.1116,0.9523
"13777",240462,"UNIVERSITY OF WISCONSIN-PLATTEVILLE",1,0,1992,"2087","50.059803","234","843","878",304,574,98,"48",50,0.1645,0.0836,0.1116,0.9601
"13778",240462,"UNIVERSITY OF WISCONSIN-PLATTEVILLE",1,0,1993,"2207","50.665176","221","871","917",276,641,109,"51",58,0.2101,0.0796,0.1189,0.9498
"13779",240462,"UNIVERSITY OF WISCONSIN-PLATTEVILLE",1,0,1995,"2485","55.320288","219","883","926",315,611,125,"59",66,0.2095,0.0966,0.135,0.9536
"13780",240462,"UNIVERSITY OF WISCONSIN-PLATTEVILLE",1,0,1996,"2591","56.686168","206","907","933",300,633,120,"59",61,0.2033,0.0932,0.1286,0.9721
"13781",240462,"UNIVERSITY OF WISCONSIN-PLATTEVILLE",1,0,1997,"2775","57.851495","197","940","978",304,674,138,"69",69,0.227,0.1024,0.1411,0.9611
"13782",240462,"UNIVERSITY OF WISCONSIN-PLATTEVILLE",1,0,1998,"2916","61.095707","219","1070","1118",369,749,134,"63",71,0.1924,0.0841,0.1199,0.9571
"13783",240462,"UNIVERSITY OF WISCONSIN-PLATTEVILLE",1,0,1999,"2594","63.705838","212","1059","1093",377,716,148,"61",87,0.2308,0.0852,0.1354,0.9689
"13784",240462,"UNIVERSITY OF WISCONSIN-PLATTEVILLE",1,0,2000,"2594","65.870336","210","925","958",340,618,129,"53",76,0.2235,0.0858,0.1347,0.9656
"13785",240462,"UNIVERSITY OF WISCONSIN-PLATTEVILLE",1,0,2001,"2776","72.862389","208","1010","1039",373,666,176,"85",91,0.244,0.1276,0.1694,0.9721
"13786",240462,"UNIVERSITY OF WISCONSIN-PLATTEVILLE",1,0,2002,"3000","68.944825","209","1076","1120",395,725,184,"75",109,0.2759,0.1034,0.1643,0.9607
"13787",240462,"UNIVERSITY OF WISCONSIN-PLATTEVILLE",1,0,2003,"3500","75.063829","237","1081","1116",406,710,203,"105",98,0.2414,0.1479,0.1819,0.9686
"13788",240462,"UNIVERSITY OF WISCONSIN-PLATTEVILLE",1,0,2004,"4000","75.435109","243","1103","1164",398,766,205,"90",115,0.2889,0.1175,0.1761,0.9476
"13789",240462,"University of Wisconsin-Platteville",1,0,2005,"4277","77.189826","248","1152","1218",426,792,187,"83",104,0.2441,0.1048,0.1535,0.9458
"13790",240462,"University of Wisconsin-Platteville",1,0,2006,"4568","81.882817","268","1292","1387",467,920,259,"145",114,0.2441,0.1576,0.1867,0.9315
"13791",240462,"University of Wisconsin-Platteville",1,0,2007,"4819","89.136995","278","1371","1466",500,966,275,"127",148,0.296,0.1315,0.1876,0.9352
"13792",240462,"University of Wisconsin-Platteville",1,0,2008,"5184","93.658825","286","1353","1468",496,972,235,"117",118,0.2379,0.1204,0.1601,0.9217
"13793",240462,"University of Wisconsin-Platteville",1,0,2009,"5466","99.981013","291","1409","1531",512,1019,304,"166",138,0.2695,0.1629,0.1986,0.9203
"13794",240462,"University of Wisconsin-Platteville",1,0,2010,"5766","101.962265","294","1428","1534",508,1026,297,"170",127,0.25,0.1657,0.1936,0.9309
"13795",240471,"UNIVERSITY OF WISCONSIN-RIVER FALLS",1,0,1991,"2199","52.166482","244","966","1022",557,465,122,"48",74,0.1329,0.1032,0.1194,0.9452
"13796",240471,"UNIVERSITY OF WISCONSIN-RIVER FALLS",1,0,1992,"2024","55.783022","234","962","1009",543,466,151,"68",83,0.1529,0.1459,0.1497,0.9534
"13797",240471,"UNIVERSITY OF WISCONSIN-RIVER FALLS",1,0,1993,"2145","57.834935","238","776","838",443,395,162,"64",98,0.2212,0.162,0.1933,0.926
"13798",240471,"UNIVERSITY OF WISCONSIN-RIVER FALLS",1,0,1995,"2445","61.469649","222","909","957",548,409,204,"73",131,0.2391,0.1785,0.2132,0.9498
"13799",240471,"UNIVERSITY OF WISCONSIN-RIVER FALLS",1,0,1996,"2565","63.326434","214","1106","1149",688,461,249,"82",167,0.2427,0.1779,0.2167,0.9626
"13800",240471,"UNIVERSITY OF WISCONSIN-RIVER FALLS",1,0,1997,"2750","64.675068","209","1100","1144",698,446,269,"79",190,0.2722,0.1771,0.2351,0.9615
"13801",240471,"UNIVERSITY OF WISCONSIN-RIVER FALLS",1,0,1998,"2890","68.640335","212","1149","1199",773,426,287,"87",200,0.2587,0.2042,0.2394,0.9583
"13802",240471,"UNIVERSITY OF WISCONSIN-RIVER FALLS",1,0,1999,"2594","73.212201","216","1038","1104",684,420,277,"95",182,0.2661,0.2262,0.2509,0.9402
"13803",240471,"UNIVERSITY OF WISCONSIN-RIVER FALLS",1,0,2000,"2594","80.009781","218","1018","1096",669,427,259,"81",178,0.2661,0.1897,0.2363,0.9288
"13804",240471,"UNIVERSITY OF WISCONSIN-RIVER FALLS",1,0,2001,"2776","85.364001","220","1028","1108",680,428,265,"86",179,0.2632,0.2009,0.2392,0.9278
"13805",240471,"UNIVERSITY OF WISCONSIN-RIVER FALLS",1,0,2002,"3000","61.477484","214","971","1045",642,403,277,"81",196,0.3053,0.201,0.2651,0.9292
"13806",240471,"UNIVERSITY OF WISCONSIN-RIVER FALLS",1,0,2003,"3500","66.163827","221","1113","1220",757,463,305,"98",207,0.2734,0.2117,0.25,0.9123
"13807",240471,"UNIVERSITY OF WISCONSIN-RIVER FALLS",1,0,2004,"4000","68.530144","223","1086","1197",722,475,311,"109",202,0.2798,0.2295,0.2598,0.9073
"13808",240471,"University of Wisconsin-River Falls",1,0,2005,"4277","71.288768","231","1076","1192",734,458,268,"80",188,0.2561,0.1747,0.2248,0.9027
"13809",240471,"University of Wisconsin-River Falls",1,0,2006,"4568","75.869581","238","1176","1289",773,516,281,"77",204,0.2639,0.1492,0.218,0.9123
"13810",240471,"University of Wisconsin-River Falls",1,0,2007,"4891","86.273479","237","1184","1276",743,533,297,"103",194,0.2611,0.1932,0.2328,0.9279
"13811",240471,"University of Wisconsin-River Falls",1,0,2008,"5156","90.710984","241","1228","1332",783,549,365,"136",229,0.2925,0.2477,0.274,0.9219
"13812",240471,"University of Wisconsin-River Falls",1,0,2009,"5436","92.532447","231","1214","1325",836,489,382,"108",274,0.3278,0.2209,0.2883,0.9162
"13813",240471,"University of Wisconsin-River Falls",1,0,2010,"5731","96.300899","240","1104","1230",758,472,360,"112",248,0.3272,0.2373,0.2927,0.8976
"13814",240480,"UNIVERSITY OF WISCONSIN-STEVENS POINT",1,0,1991,"1955","80.109568","367","1434","1494",763,731,183,"62",121,0.1586,0.0848,0.1225,0.9598
"13815",240480,"UNIVERSITY OF WISCONSIN-STEVENS POINT",1,0,1992,"2078","82.685612","349","1315","1388",772,616,229,"61",168,0.2176,0.099,0.165,0.9474
"13816",240480,"UNIVERSITY OF WISCONSIN-STEVENS POINT",1,0,1993,"2218","82.789049","344","1298","1359",702,657,201,"72",129,0.1838,0.1096,0.1479,0.9551
"13817",240480,"UNIVERSITY OF WISCONSIN-STEVENS POINT",1,0,1995,"2488","90.968201","324","1392","1474",817,657,285,"82",203,0.2485,0.1248,0.1934,0.9444
"13818",240480,"UNIVERSITY OF WISCONSIN-STEVENS POINT",1,0,1996,"2601","92.366546","314","1485","1555",806,749,301,"97",204,0.2531,0.1295,0.1936,0.955
"13819",240480,"UNIVERSITY OF WISCONSIN-STEVENS POINT",1,0,1997,"2790","94.889823","308","1445","1527",837,690,262,"78",184,0.2198,0.113,0.1716,0.9463
"13820",240480,"UNIVERSITY OF WISCONSIN-STEVENS POINT",1,0,1998,"2929","97.345165","311","1442","1503",868,635,310,"85",225,0.2592,0.1339,0.2063,0.9594
"13821",240480,"UNIVERSITY OF WISCONSIN-STEVENS POINT",1,0,1999,"2594","101.933374","311","1409","1490",849,641,285,"99",186,0.2191,0.1544,0.1913,0.9456
"13822",240480,"UNIVERSITY OF WISCONSIN-STEVENS POINT",1,0,2000,"2594","105.656449","314.5","1438","1518",925,593,333,"107",226,0.2443,0.1804,0.2194,0.9473
"13823",240480,"UNIVERSITY OF WISCONSIN-STEVENS POINT",1,0,2001,"2776","114.2242","318","1424","1505",849,656,297,"108",189,0.2226,0.1646,0.1973,0.9462
"13824",240480,"UNIVERSITY OF WISCONSIN-STEVENS POINT",1,0,2002,"3000","108.912459","316","1369","1464",806,658,286,"109",177,0.2196,0.1657,0.1954,0.9351
"13825",240480,"UNIVERSITY OF WISCONSIN-STEVENS POINT",1,0,2003,"3500","113.867037","369","1403","1498",853,645,335,"101",234,0.2743,0.1566,0.2236,0.9366
"13826",240480,"UNIVERSITY OF WISCONSIN-STEVENS POINT",1,0,2004,"4000","121.605466","366","1413","1525",857,668,322,"118",204,0.238,0.1766,0.2111,0.9266
"13827",240480,"University of Wisconsin-Stevens Point",1,0,2005,"4277","119.153975","362","1414","1521",832,689,365,"136",229,0.2752,0.1974,0.24,0.9297
"13828",240480,"University of Wisconsin-Stevens Point",1,0,2006,"4568","124.965474","349","1529","1640",888,752,395,"153",242,0.2725,0.2035,0.2409,0.9323
"13829",240480,"University of Wisconsin-Stevens Point",1,0,2007,"4819","133.727205","359","1458","1611",892,719,358,"145",213,0.2388,0.2017,0.2222,0.905
"13830",240480,"University of Wisconsin-Stevens Point",1,0,2008,"5084","138.435098","355","1441","1608",882,726,412,"145",267,0.3027,0.1997,0.2562,0.8961
"13831",240480,"University of Wisconsin-Stevens Point",1,0,2009,"5364","141.570769","355","1454","1632",835,797,422,"156",266,0.3186,0.1957,0.2586,0.8909
"13832",240480,"University of Wisconsin-Stevens Point",1,0,2010,"5659","155.103886","375","1479","1644",881,763,499,"213",286,0.3246,0.2792,0.3035,0.8996
"13833",240727,"UNIVERSITY OF WYOMING",1,0,1991,"1293","172.941457","635","1105","1257",534,723,174,"73",101,0.1891,0.101,0.1384,0.8791
"13834",240727,"UNIVERSITY OF WYOMING",1,0,1992,"1430","190.318057","600","1134","1281",640,641,221,"73",148,0.2312,0.1139,0.1725,0.8852
"13835",240727,"UNIVERSITY OF WYOMING",1,0,1993,"1648","192.223747","591","1080","1212",560,652,207,"79",128,0.2286,0.1212,0.1708,0.8911
"13836",240727,"UNIVERSITY OF WYOMING",1,0,1995,"2005","213.509458","626","1076","1267",661,606,276,"88",188,0.2844,0.1452,0.2178,0.8493
"13837",240727,"UNIVERSITY OF WYOMING",1,0,1996,"2144","205.061438","620","1035","1203",628,575,297,"101",196,0.3121,0.1757,0.2469,0.8603
"13838",240727,"UNIVERSITY OF WYOMING",1,0,1997,"2326","207.963777","615","956","1119",562,557,276,"97",179,0.3185,0.1741,0.2466,0.8543
"13839",240727,"UNIVERSITY OF WYOMING",1,0,1998,"2330","212.275713","612","1042","1225",660,565,306,"104",202,0.3061,0.1841,0.2498,0.8506
"13840",240727,"UNIVERSITY OF WYOMING",1,0,1999,"2016","219.420689","606","1042","1194",654,540,352,"124",228,0.3486,0.2296,0.2948,0.8727
"13841",240727,"UNIVERSITY OF WYOMING",1,0,2000,"2166","213.16853","605","1138","1313",658,655,337,"126",211,0.3207,0.1924,0.2567,0.8667
"13842",240727,"UNIVERSITY OF WYOMING",1,0,2001,"2316","249.593293","604","1256","1411",724,687,369,"135",234,0.3232,0.1965,0.2615,0.8901
"13843",240727,"UNIVERSITY OF WYOMING",1,0,2002,"2400","246.008038","612","1284","1443",733,710,328,"113",215,0.2933,0.1592,0.2273,0.8898
"13844",240727,"UNIVERSITY OF WYOMING",1,0,2003,"2520","273.593337","624","1224","1388",709,679,310,"102",208,0.2934,0.1502,0.2233,0.8818
"13845",240727,"UNIVERSITY OF WYOMING",1,0,2004,"2088","289.694461","643","1302","1496",754,742,336,"133",203,0.2692,0.1792,0.2246,0.8703
"13846",240727,"University of Wyoming",1,0,2005,"2208","307.911441","688","1219","1399",739,660,320,"107",213,0.2882,0.1621,0.2287,0.8713
"13847",240727,"University of Wyoming",1,0,2006,"2256","315.180324","666","1283","1543",761,782,359,"118",241,0.3167,0.1509,0.2327,0.8315
"13848",240727,"University of Wyoming",1,0,2007,"2256","334.864229","692","1356","1614",831,783,389,"132",257,0.3093,0.1686,0.241,0.8401
"13849",240727,"University of Wyoming",1,0,2008,"2256","373.425537","715","1406","1674",851,823,408,"148",260,0.3055,0.1798,0.2437,0.8399
"13850",240727,"University of Wyoming",1,0,2009,"2256","405.223407","730","1331","1568",799,769,405,"136",269,0.3367,0.1769,0.2583,0.8489
"13851",240727,"University of Wyoming",1,0,2010,"2376","430.562185","740","1210","1451",711,740,386,"144",242,0.3404,0.1946,0.266,0.8339
"13852",243443,"UNIVERSITY OF SACRED HEART",1,0,1991,"2795","29.373834","168","0","518",370,148,1,"0",1,0.0027,0,0.0019,0
"13853",243443,"UNIVERSITY OF SACRED HEART",1,0,1992,"3245","27.532108","167","0","584",396,188,47,"7",40,0.101,0.0372,0.0805,0
"13854",243443,"UNIVERSITY OF SACRED HEART",1,0,1993,"3245","25.874677","141","0","796",541,255,44,"8",36,0.0665,0.0314,0.0553,0
"13855",243443,"UNIVERSITY OF SACRED HEART",1,0,1995,"3745","27.451065","126","0","728",466,262,33,"8",25,0.0536,0.0305,0.0453,0
"13856",243443,"UNIVERSITY OF SACRED HEART",1,0,1996,"3800","28.970351","123","0","780",483,297,46,"11",35,0.0725,0.037,0.059,0
"13857",243443,"UNIVERSITY OF SACRED HEART",1,0,1997,"4000","20.578177","119","0","723",471,252,50,"6",44,0.0934,0.0238,0.0692,0
"13858",243443,"UNIVERSITY OF SACRED HEART",1,0,1998,"4000","21.687269","118","0","885",567,318,76,"10",66,0.1164,0.0314,0.0859,0
"13859",243443,"UNIVERSITY OF SACRED HEART",1,0,1999,"3900","22.673669","114","0","799",506,293,63,"13",50,0.0988,0.0444,0.0788,0
"13860",243443,"UNIVERSITY OF SACRED HEART",1,0,2000,"4050","23.380745","110","0","540",350,190,59,"10",49,0.14,0.0526,0.1093,0
"13861",243443,"UNIVERSITY OF SACRED HEART",1,0,2001,"4200","26.290497","106","0","478",333,145,52,"7",45,0.1351,0.0483,0.1088,0
"13862",243443,"UNIVERSITY OF SACRED HEART",1,0,2002,"4200","27.880471","108","0","496",320,176,43,"8",35,0.1094,0.0455,0.0867,0
"13863",243443,"UNIVERSITY OF SACRED HEART",1,0,2003,"4350","30.026804","108","0","425",274,151,10,"3",7,0.0255,0.0199,0.0235,0
"13864",243443,"UNIVERSITY OF SACRED HEART",1,0,2004,"4350","31.359384","105","0","519",340,179,50,"11",39,0.1147,0.0615,0.0963,0
"13865",243443,"University of Sacred Heart",1,0,2005,"4500","34.940937","104","0","796",500,296,66,"8",58,0.116,0.027,0.0829,0
"13866",243443,"University of Sacred Heart",1,0,2006,"4650","33.023301","100","0","764",532,232,66,"13",53,0.0996,0.056,0.0864,0
"13867",243443,"University of Sacred Heart",1,0,2007,"3840","32.158333","98","0","690",422,268,41,"10",31,0.0735,0.0373,0.0594,0
"13868",243443,"University of Sacred Heart",1,0,2008,"3960","35.781694","99","0","750",435,315,43,"9",34,0.0782,0.0286,0.0573,0
"13869",243443,"University of Sacred Heart",1,0,2009,"4080","38.585184","101","0","726",461,265,43,"12",31,0.0672,0.0453,0.0592,0
"13870",243443,"University of Sacred Heart",1,0,2010,"4200","39.253544","100","0","933",541,392,63,"19",44,0.0813,0.0485,0.0675,0
"13871",243780,"PURDUE UNIVERSITY MAIN CAMPUS",1,0,1991,"2324","567.065473","1485","5057","5754",2516,3238,1682,"790",892,0.3545,0.244,0.2923,0.8789
"13872",243780,"PURDUE UNIVERSITY MAIN CAMPUS",1,0,1992,"2520","603.053451","1475","4886","5583",2396,3187,1589,"761",828,0.3456,0.2388,0.2846,0.8752
"13873",243780,"PURDUE UNIVERSITY-MAIN CAMPUS",1,0,1993,"2696","627.264029","1443","5059","5725",2560,3165,1625,"773",852,0.3328,0.2442,0.2838,0.8837
"13874",243780,"PURDUE UNIVERSITY-MAIN CAMPUS",1,0,1995,"3056","670.004914","1457","5375","6064",2696,3368,1625,"786",839,0.3112,0.2334,0.268,0.8864
"13875",243780,"PURDUE UNIVERSITY-MAIN CAMPUS",1,0,1996,"3208","697.184789","1462","5548","6339",2713,3626,1843,"903",940,0.3465,0.249,0.2907,0.8752
"13876",243780,"PURDUE UNIVERSITY-MAIN CAMPUS",1,0,1997,"3352","756.600835","1469","5521","6369",2806,3563,1994,"953",1041,0.371,0.2675,0.3131,0.8669
"13877",243780,"PURDUE UNIVERSITY-MAIN CAMPUS",1,0,1998,"3532","770.628106","1505","5820","6625",2825,3800,2040,"998",1042,0.3688,0.2626,0.3079,0.8785
"13878",243780,"PURDUE UNIVERSITY-MAIN CAMPUS",1,0,1999,"3409","836.154651","1481","5965","6895",2945,3950,2083,"974",1109,0.3766,0.2466,0.3021,0.8651
"13879",243780,"PURDUE UNIVERSITY-MAIN CAMPUS",1,0,2000,"3552","882.379659","1652.5","5548","6403",2646,3757,2209,"1046",1163,0.4395,0.2784,0.345,0.8665
"13880",243780,"PURDUE UNIVERSITY-MAIN CAMPUS",1,0,2001,"3830","936.519134","1824","5611","6567",2601,3966,2218,"1059",1159,0.4456,0.267,0.3377,0.8544
"13881",243780,"PURDUE UNIVERSITY-MAIN CAMPUS",1,0,2002,"5228","968.153089","1831","5139","6294",2535,3759,2230,"1046",1184,0.4671,0.2783,0.3543,0.8165
"13882",243780,"PURDUE UNIVERSITY-MAIN CAMPUS",1,0,2003,"5498","1012.294646","1857","5345","6459",2559,3900,2254,"1121",1133,0.4428,0.2874,0.349,0.8275
"13883",243780,"PURDUE UNIVERSITY-MAIN CAMPUS",1,0,2004,"5962","1093.749603","2131","5604","6766",2781,3985,2419,"1066",1353,0.4865,0.2675,0.3575,0.8283
"13884",243780,"Purdue University-Main Campus",1,0,2005,"6320","1217.891578","2183","5851","7167",2860,4307,2547,"1189",1358,0.4748,0.2761,0.3554,0.8164
"13885",243780,"Purdue University-Main Campus",1,0,2006,"6700","1210.225215","2255","5954","7430",3019,4411,2764,"1350",1414,0.4684,0.3061,0.372,0.8013
"13886",243780,"Purdue University-Main Campus",1,0,2007,"7002","1264.493933","2347","5431","6830",2882,3948,2702,"1260",1442,0.5003,0.3191,0.3956,0.7952
"13887",243780,"Purdue University-Main Campus",1,0,2008,"7317","1367.653109","2311","5628","7058",3083,3975,3028,"1409",1619,0.5251,0.3545,0.429,0.7974
"13888",243780,"Purdue University-Main Campus",1,0,2009,"8183","1443.567929","2367","4560","6308",2660,3648,2868,"1412",1456,0.5474,0.3871,0.4547,0.7229
"13889",243780,"Purdue University-Main Campus",1,0,2010,"8592","1505.591136","2393","4593","6454",2706,3748,3133,"1579",1554,0.5743,0.4213,0.4854,0.7117
